WKT;WKT_2;ID;CO_FRAC_RA;COMUNA;FRACCION;RADIO;TOTAL_POB;T_VARON;T_MUJER;I_MASCULINIDAD;T_VIVIENDA;V_PARTICUL;V_PARTICUL_POR;V_COLECTIV;V_COLECTIV_POR;T_HOGAR;H_CON_NBI;H_CON_NBI_POR;H_SIN_NBI;H_SIN_NBI_POR;H_CON_NBI_POR_NUMBER;NBI
"MULTIPOLYGON (((-58.3724897640821 -34.5915465708107,-58.3726119195164 -34.5915127160526,-58.372623878948 -34.5916825496944,-58.3736907626257 -34.5911648295757,-58.3737502692039 -34.5911535188844,-58.3739745417299 -34.5911309739871,-58.3741530451682 -34.5911121801701,-58.374001304695 -34.590945612853,-58.3735516937449 -34.5904958460311,-58.3737909069729 -34.5903576900843,-58.3734976811433 -34.5899830951109,-58.3726893235965 -34.5889914059596,-58.3772513488885 -34.5864186669828,-58.3772147454051 -34.5862397609208,-58.3771413848715 -34.5860322363801,-58.3770537566925 -34.5858590053353,-58.3770532176402 -34.5858118710261,-58.3769275628094 -34.585686321587,-58.3766327692747 -34.5856386794102,-58.3755367870144 -34.5843118246194,-58.3756481811196 -34.5842222129066,-58.3757794905326 -34.5841916226563,-58.3764362898041 -34.5837931987455,-58.3772901033118 -34.5832910562935,-58.3767105119888 -34.5825891236038,-58.37662456939 -34.5824729278449,-58.3765024522448 -34.5822967657414,-58.3763803317411 -34.5821243498051,-58.3759279469754 -34.5815733234387,-58.3758329630304 -34.5814421354896,-58.3751269621437 -34.5805351929169,-58.3739717397656 -34.5791022963031,-58.3739726628069 -34.5791002663181,-58.3738505825076 -34.5789449855822,-58.3743037280201 -34.5786997740452,-58.3680091460423 -34.5782103146619,-58.367976707758 -34.5782082471541,-58.3679498041206 -34.5782060430833,-58.3679285122827 -34.5782107450584,-58.3679094285606 -34.5782204489518,-58.3678777326762 -34.5782394392046,-58.3654290036212 -34.5796403166919,-58.3653334043613 -34.5796950314547,-58.3653152564566 -34.5797048765369,-58.3652929240805 -34.5797252116666,-58.3652425456341 -34.5801381461791,-58.3652507831981 -34.580156815495,-58.3652752942103 -34.5801667650478,-58.3653021135059 -34.5801687583643,-58.3705629521872 -34.5805825782406,-58.3705900267242 -34.5805849931405,-58.3706087477124 -34.5805955710813,-58.3706166404915 -34.5806191695544,-58.3705969566128 -34.580786767216,-58.3705901210309 -34.5808082418126,-58.3705720550759 -34.5808213273063,-58.3698305350582 -34.581244867229,-58.3690273190929 -34.5817042018109,-58.3690087457538 -34.5817137654111,-58.3689877011772 -34.5817250173208,-58.3689510835617 -34.5817279470673,-58.3689294574809 -34.5817262402442,-58.3688982103754 -34.581723751344,-58.368871305739 -34.581721406625,-58.3652059583363 -34.5814281698256,-58.3626691758005 -34.5812274470099,-58.3626392047036 -34.5812262956361,-58.3626122852947 -34.5812365556746,-58.3605446208912 -34.5824106651636,-58.3605253613461 -34.5824233960391,-58.3605091571177 -34.5824443692415,-58.3605055533948 -34.5824667615007,-58.360465333313 -34.582838221781,-58.3604712640201 -34.582862593935,-58.3604898032398 -34.5828819060196,-58.3605101421839 -34.582891782606,-58.3605379830123 -34.5828946229293,-58.3652034746267 -34.583263383423,-58.3660922860967 -34.5833338113367,-58.3661149319042 -34.5833376322311,-58.36613926355 -34.5833563142128,-58.3661418762755 -34.5833796270847,-58.3661442456725 -34.583539705873,-58.3661427763514 -34.5835585082897,-58.3661316015617 -34.5835757536689,-58.3661131915041 -34.5835907397088,-58.3660721099655 -34.5836240183998,-58.3655375476292 -34.5840467097267,-58.3652025910765 -34.5843115941704,-58.3649867903901 -34.5844784001616,-58.3649591806723 -34.584495773122,-58.3649341416789 -34.5844993447613,-58.3649091951779 -34.584496648611,-58.3605244274675 -34.584160507894,-58.3599495410014 -34.5841115021711,-58.3599067788625 -34.584124354007,-58.3598948985988 -34.5841601905171,-58.3597091190953 -34.5858676377885,-58.3597085756768 -34.585893976414,-58.3597173247059 -34.5859116605616,-58.3597319540408 -34.5859255467006,-58.3597507619095 -34.585934577013,-58.3597790294951 -34.5859374178688,-58.3598019333484 -34.585939479517,-58.3598370987423 -34.5859420444734,-58.3636144325425 -34.5862353925756,-58.3636356321545 -34.5862385789263,-58.3636534125681 -34.5862527488543,-58.3636554273554 -34.5862771176629,-58.3635216950966 -34.5874576196218,-58.3634970454428 -34.5874910516253,-58.3634416130531 -34.5874878374136,-58.3596515471886 -34.5871846840987,-58.3596149331193 -34.5871825404173,-58.3595922758699 -34.587187380626,-58.3595687547986 -34.587202150074,-58.3595562115041 -34.5872227740991,-58.3595519258139 -34.5872453770119,-58.359455945544 -34.5880799065262,-58.3594784217584 -34.5880839397825,-58.359501238599 -34.5880879733226,-58.3595242259278 -34.588091866152,-58.3595470431209 -34.5880956179825,-58.3595697747249 -34.5880997218632,-58.3595919952212 -34.5881039661582,-58.3596137042619 -34.5881086325696,-58.3596346462922 -34.5881137913065,-58.3596369214178 -34.5881333010449,-58.3596377495871 -34.5881522461585,-58.3596410474568 -34.5881710525071,-58.3596449417685 -34.5881895776578,-58.3596517318243 -34.5882077531269,-58.3596597145905 -34.5882255070504,-58.3596694865085 -34.5882425582307,-58.3596800250967 -34.5882593987812,-58.3596938870397 -34.5882744110773,-58.3597086863142 -34.5882889311854,-58.3597256168448 -34.5883015516063,-58.3597434850544 -34.5883133981371,-58.3597633148154 -34.5883228518586,-58.3597841685396 -34.5883306162325,-58.3598052782574 -34.5883379582666,-58.3598347351141 -34.588343828401,-58.3608324278462 -34.5885522791261,-58.3608136339019 -34.5886707892633,-58.3607972244261 -34.5887194394632,-58.3607402454872 -34.5889360201718,-58.3607725980405 -34.5889418220739,-58.3608472704954 -34.5886710286165,-58.3608762660714 -34.5885665416264,-58.3614053889026 -34.5886697325036,-58.3634673182689 -34.5890349676776,-58.3645304960114 -34.5892488648233,-58.3651908654204 -34.5893750316155,-58.365639921829 -34.5894573270005,-58.3668219789845 -34.5896931486444,-58.3679908386115 -34.5899234861003,-58.3679750334129 -34.5901116159819,-58.3679315748821 -34.5904406450255,-58.3677743409839 -34.5905285523551,-58.3677286880625 -34.5905578600124,-58.3675308838587 -34.5906625029764,-58.3674616032482 -34.5906479968588,-58.3674283960491 -34.5906438862712,-58.3673950173297 -34.5906408319203,-58.3673614673303 -34.5906386225302,-58.367327916206 -34.5906373990843,-58.3672942788775 -34.5906370910908,-58.3672606402608 -34.590637909892,-58.3672270858354 -34.5906395738535,-58.3671937005171 -34.5906422943177,-58.3671603993878 -34.5906458599425,-58.3671271822047 -34.5906504820034,-58.3670943045231 -34.5906560902756,-58.3670615961859 -34.5906625437754,-58.367029227348 -34.5906699834869,-58.3669971980892 -34.590678338985,-58.3669655084085 -34.5906876102702,-58.3669342434636 -34.5906977974095,-58.3669034031729 -34.5907089708282,-58.3668730729366 -34.590720919318,-58.3668433378319 -34.5907337133716,-58.3668141125378 -34.5907474937727,-58.3667853973771 -34.5907619788205,-58.3667573625859 -34.5907772390752,-58.3667300079209 -34.5907934858124,-58.3667034188643 -34.5908104373987,-58.366677510338 -34.5908280233421,-58.3666522820179 -34.5908465253448,-58.3666279897852 -34.5908655914814,-58.3666043779204 -34.5908854328271,-58.366581701981 -34.5909059791582,-58.3665599620482 -34.5909271600505,-58.3665389879667 -34.5909488345194,-58.3665190349701 -34.5909712140423,-58.3664999329031 -34.5909941576351,-58.3664815960387 -34.5910181582076,-58.3663638701507 -34.5911969456003,-58.366268193955 -34.5911598967518,-58.3662285217732 -34.5912231777431,-58.3663184005264 -34.5912659969184,-58.3658962889928 -34.5919067442916,-58.3658018914712 -34.5918680763139,-58.3657600863281 -34.591934172463,-58.3658497094711 -34.5919775551783,-58.3651915322111 -34.5929767884179,-58.3650478833627 -34.5931798504836,-58.3643799593357 -34.594195339568,-58.3643682637298 -34.5942194155857,-58.3643625375266 -34.5942366651614,-58.3643589396314 -34.5942545502792,-58.3643573855471 -34.5942725074695,-58.3643579604374 -34.5942905368006,-58.3643607497979 -34.5943083566405,-58.3643655833053 -34.5943259668514,-58.3643724613758 -34.5943430153076,-58.3643813840104 -34.5943595020085,-58.3643921812174 -34.5943751451158,-58.3644047680007 -34.594389803709,-58.3644189740361 -34.5944034776528,-58.3644347996555 -34.5944158852438,-58.364452074617 -34.5944269559196,-58.3644704583533 -34.5944366189801,-58.3644900362749 -34.5944446632179,-58.3645102973232 -34.5944511586464,-58.3645955880007 -34.5944870737028,-58.3646147380641 -34.5944968782081,-58.3646344869182 -34.5945044295831,-58.3646552602088 -34.5945098690203,-58.3646767172844 -34.5945131962453,-58.3646984323304 -34.5945144109158,-58.364720235103 -34.5945134424698,-58.364741614625 -34.594510290497,-58.364762485567 -34.5945050957796,-58.3647823371175 -34.5944977170575,-58.3648010836997 -34.594488506389,-58.3648182995001 -34.5944774634328,-58.3648337288653 -34.5944647288353,-58.3648472863026 -34.5944505842294,-58.364858630997 -34.5944351701932,-58.3648675922942 -34.5944187682915,-58.3648738295454 -34.5944013782516,-58.3651912838275 -34.5939182332952,-58.3656777373055 -34.5931788739436,-58.3658929794519 -34.5928510743507,-58.3659072192041 -34.5928356625093,-58.3659272422114 -34.5928268752289,-58.3659561986928 -34.5928253488317,-58.3659851415437 -34.5928355834392,-58.3660985192201 -34.5928845483875,-58.3661198875151 -34.5928906923002,-58.3661445101794 -34.592881063521,-58.3661689612129 -34.5928725614056,-58.3661928470621 -34.5928372972309,-58.3663799346196 -34.5929206172996,-58.366359370022 -34.5929559545578,-58.3663669270744 -34.5929752570507,-58.3663682652628 -34.5929963856914,-58.3663863037927 -34.593009921583,-58.3667777659801 -34.5931784759084,-58.3669114961876 -34.5932291463023,-58.3669775544799 -34.5931783510846,-58.367166013585 -34.5932551918951,-58.3671505978751 -34.5933308869999,-58.3691219069146 -34.5941732923529,-58.3690543239596 -34.5942171858771,-58.3678993852208 -34.5974866314194,-58.3678849414612 -34.5975127152805,-58.3678631419091 -34.5975197836817,-58.3678340039927 -34.597518886633,-58.3665017951265 -34.5974188922774,-58.3664821277252 -34.5974262240946,-58.3664627064785 -34.5974446066663,-58.366456756241 -34.5974713838432,-58.3664487149453 -34.5974964466287,-58.3664421279048 -34.5975554949591,-58.366426952144 -34.597688869495,-58.3663604025359 -34.5982579908119,-58.3660923220831 -34.5982376372526,-58.3661753987338 -34.5974673918875,-58.3661743823672 -34.5974242497147,-58.3661489307913 -34.5973936346057,-58.3661033578196 -34.5973858528899,-58.3638368441831 -34.5972078348575,-58.3638200978183 -34.5972004655142,-58.3638105962882 -34.5971876483101,-58.3643999392249 -34.5955249141113,-58.3644059426514 -34.5954892837705,-58.3644046864349 -34.5954712538944,-58.3644006194081 -34.5954535738802,-58.3643938264874 -34.5954364550718,-58.3643786200715 -34.5954141484399,-58.3643679333362 -34.5953988874096,-58.3643509895931 -34.5953835221769,-58.364313319387 -34.5953621366209,-58.3641474813395 -34.5953178681402,-58.3640824730369 -34.5953045824346,-58.3640670709134 -34.5953038398174,-58.3640471753346 -34.5953050226543,-58.3639972307572 -34.5953113284276,-58.3639704165427 -34.5953188067436,-58.3639441864069 -34.5953301437039,-58.3639222390005 -34.5953426019146,-58.3639013567609 -34.595357693198,-58.3638840577247 -34.5953754826946,-58.3638606047308 -34.5954073928196,-58.3638484279451 -34.5954353727677,-58.3638179795447 -34.595427929221,-58.3638094363408 -34.595452883261,-58.363820083473 -34.5954554880449,-58.3637924233902 -34.5955327733983,-58.3637997684979 -34.5955345732235,-58.3637917959837 -34.5955562735139,-58.3637846470807 -34.5955544828615,-58.3635825874623 -34.5961322791829,-58.3636000362245 -34.5961354664341,-58.3635325496429 -34.5963266707899,-58.3635226107302 -34.5963242738884,-58.3634951347677 -34.5964020911637,-58.3635050736889 -34.5964044880674,-58.3634145950768 -34.5966608299594,-58.3631379337714 -34.5966376662005,-58.3627661035258 -34.5965671482968,-58.362483013031 -34.5964986740777,-58.3622390675202 -34.5963853705575,-58.3620162271152 -34.5962856056096,-58.3616793408887 -34.5961248280608,-58.3610941512834 -34.5958578885871,-58.3611154060281 -34.5958261090033,-58.3609259300308 -34.5957393438483,-58.3609069969955 -34.5957667781267,-58.3604288267917 -34.5955377779654,-58.3603797424235 -34.5955123093604,-58.3603488376419 -34.5954772443472,-58.3603289843497 -34.5954705389854,-58.3603182470136 -34.5954293712087,-58.3603189432605 -34.5953827660535,-58.3603524366004 -34.5952572096204,-58.3603608123222 -34.5952150335803,-58.3603607210965 -34.5951944639834,-58.3603624060392 -34.595177697139,-58.3603592011359 -34.5951593951539,-58.3603370584496 -34.5951090399923,-58.3603234811973 -34.5950869793011,-58.3603094267974 -34.5950717781909,-58.3602945978319 -34.5950570722229,-58.360283914095 -34.5950488961809,-58.3602711176262 -34.5950407251259,-58.3602382259166 -34.5950243475863,-58.3602056617488 -34.5950181002813,-58.3601847032262 -34.5950149456534,-58.3601605371353 -34.5950139968632,-58.3601095722597 -34.5950079287824,-58.3600811797177 -34.5950021646086,-58.3600457415461 -34.5949949700406,-58.3600152505741 -34.5949959540036,-58.3598869314109 -34.5949910863387,-58.3595046053622 -34.5949466109317,-58.3594338314818 -34.5949410719761,-58.3593389935214 -34.5949309178497,-58.3593077918707 -34.5949275771295,-58.359260960895 -34.5949282495822,-58.3592340345314 -34.5949378029797,-58.3591995669401 -34.5949372390019,-58.3591452729516 -34.5949346148124,-58.3590841645074 -34.5949331296457,-58.3589434240321 -34.5949238153407,-58.358885983929 -34.5949177989342,-58.3588379801398 -34.5949148734684,-58.3588059691608 -34.5949197140126,-58.3587438705352 -34.5949343005654,-58.3586806434598 -34.594962155369,-58.3586736969582 -34.5949730208525,-58.3586730649341 -34.5949903280242,-58.358667017701 -34.5950138037747,-58.3585315231779 -34.59495046265,-58.3584999458009 -34.5949363729589,-58.3584759755745 -34.5949347502947,-58.3559316288795 -34.5947740376218,-58.3542612703442 -34.5946881248612,-58.3511400947457 -34.5951669496678,-58.3511383082587 -34.5953566032127,-58.3542795308719 -34.5948573025395,-58.35732317442 -34.595093242042,-58.3576885129925 -34.5951431492088,-58.3585157896017 -34.5951816778156,-58.359252361857 -34.5952403200459,-58.3632814134076 -34.5970858989454,-58.3634509301195 -34.5971256863433,-58.3634398206906 -34.5971575799367,-58.3635335606837 -34.5971803330759,-58.363499349393 -34.5973024226173,-58.3632336651729 -34.5980613902626,-58.3637307296019 -34.5981044016808,-58.3638616777082 -34.5981361991659,-58.3640886223846 -34.5981561722634,-58.3650687183131 -34.5982276672882,-58.3659609314573 -34.5982928169569,-58.3666064564148 -34.5983250183593,-58.3673594031048 -34.5982597613946,-58.367777702989 -34.5982929760832,-58.3679807014699 -34.5984018703661,-58.3681163318431 -34.5984371881812,-58.3695123426162 -34.59832128598,-58.3704784770947 -34.595927632361,-58.3721891715766 -34.5917628356131,-58.3722898663127 -34.5916141782274,-58.3723505411043 -34.5915345659399,-58.3724897640821 -34.5915465708107)))";;"1";1_1_1;COMUNA 1;"1";"1";"336";"212";"124";"170,97%";"82";"80";"97,56%";"2";"2,50%";"65";"19";"29.23";"46";"70,77%";"29.23";29.230
"MULTIPOLYGON (((-58.3865223305709 -34.6039930934744,-58.3863422007972 -34.6039824875315,-58.3851326494337 -34.6039115811284,-58.3850425622164 -34.6050741023789,-58.3850386271316 -34.6051839631136,-58.3864759318777 -34.6052759292113,-58.3864951041146 -34.6051737542899,-58.3865223305709 -34.6039930934744)))";;"2";1_12_1;COMUNA 1;"12";"1";"341";"184";"157";"117,20%";"365";"361";"98,90%";"4";"1,11%";"116";"25";"21.55";"91";"78,45%";"21.55";21.550
"MULTIPOLYGON (((-58.3793832787935 -34.6048381774772,-58.3780064642962 -34.6047443387825,-58.3780710188837 -34.6034915199651,-58.3766587039104 -34.6034050360748,-58.3766539540579 -34.6035510240969,-58.3765793937739 -34.6046573507563,-58.3765698790309 -34.6047984760462,-58.3765288717204 -34.6058256682707,-58.3765142693366 -34.6061917982487,-58.3765022819359 -34.6064175727616,-58.3767247081353 -34.6063011760998,-58.3775080537986 -34.6058899497881,-58.3779572468383 -34.6056541975237,-58.3793790356703 -34.604907895481,-58.3793832787935 -34.6048381774772)))";;"3";1_12_10;COMUNA 1;"12";"10";"296";"162";"134";"120,90%";"629";"627";"99,68%";"2";"0,32%";"101";"1";"0.99";"100";"99,01%";"0.99";0.990
"MULTIPOLYGON (((-58.3679211414675 -34.6051742616164,-58.3677246250643 -34.6069133278502,-58.368012847948 -34.6069224254328,-58.3681551318853 -34.6069644387104,-58.3683805472332 -34.6069157006283,-58.368828936543 -34.6068254468133,-58.3690821472615 -34.606767174167,-58.3692202138962 -34.6067370008298,-58.3692508180986 -34.6065895647965,-58.3693658778097 -34.6065238757988,-58.3694388120307 -34.6065019589293,-58.3696631849498 -34.6065297869318,-58.3698444435866 -34.606552622271,-58.3698461651104 -34.606552765321,-58.369846280498 -34.6065527749091,-58.3701924554836 -34.6067716916192,-58.3701942580999 -34.6067904624654,-58.3703036812934 -34.6071908112497,-58.3705822670259 -34.6073639186097,-58.3706240431428 -34.6073898739428,-58.3707576868857 -34.6075092242001,-58.3708238998349 -34.6075851742064,-58.3709272883214 -34.60769946955,-58.3709177655179 -34.6078389041119,-58.3721779351043 -34.6079293558925,-58.3731847364087 -34.6079929179132,-58.3735179240342 -34.6080139373185,-58.3735152807714 -34.6079368903127,-58.3735708970458 -34.6079405226344,-58.3750016982012 -34.6072030816653,-58.3755796751361 -34.6069005268443,-58.3765022819359 -34.6064175727616,-58.3765142693366 -34.6061917982487,-58.3765288717204 -34.6058256682707,-58.3765698790309 -34.6047984760462,-58.3765793937739 -34.6046573507563,-58.3766539540579 -34.6035510240969,-58.3766587039104 -34.6034050360748,-58.3752163283306 -34.6033166128095,-58.3738497535087 -34.6032328757761,-58.3725751605567 -34.6031547550013,-58.3724606131028 -34.603147205272,-58.3712742602673 -34.6030691361363,-58.3710940506202 -34.6030573103966,-58.3706149965323 -34.6030257514505,-58.3704725132662 -34.6030181787688,-58.3702634299368 -34.6030071046516,-58.3700744459009 -34.602997101813,-58.3699311110221 -34.6029895278527,-58.3691828693047 -34.6029241655204,-58.369010841054 -34.6029084695901,-58.3681856739856 -34.6028332257345,-58.3680475302255 -34.6040560083767,-58.3679211414675 -34.6051742616164)))";;"4";1_12_11;COMUNA 1;"12";"11";"528";"294";"234";"125,64%";"375";"370";"98,67%";"5";"1,35%";"136";"7";"5.15";"129";"94,85%";"5.15";5.150
"MULTIPOLYGON (((-58.3851326494337 -34.6039115811284,-58.383711459096 -34.6038282015075,-58.3837106354159 -34.6039784882801,-58.3836200555909 -34.6051005840969,-58.3837354593592 -34.6051072083773,-58.3849010800801 -34.6051751427688,-58.3850386271316 -34.6051839631136,-58.3850425622164 -34.6050741023789,-58.3851326494337 -34.6039115811284)))";;"5";1_12_2;COMUNA 1;"12";"2";"229";"101";"128";"78,91%";"445";"445";"100,00%";"0";"0,00%";"129";"16";"12.4";"113";"87,60%";"12.4";12.400
"MULTIPOLYGON (((-58.3821336065038 -34.6050143267812,-58.3821258737033 -34.6051720740155,-58.3820780919728 -34.606140810754,-58.3822098512333 -34.606146743032,-58.3834501740498 -34.606224459209,-58.3835814172853 -34.6062358828317,-58.3836145402619 -34.6051683295188,-58.3836200555909 -34.6051005840969,-58.3837106354159 -34.6039784882801,-58.383711459096 -34.6038282015075,-58.3822055302283 -34.6037398196994,-58.3821500263271 -34.6046808040886,-58.3821336065038 -34.6050143267812)))";;"6";1_12_3;COMUNA 1;"12";"3";"723";"374";"349";"107,16%";"744";"739";"99,33%";"5";"0,68%";"314";"104";"33.12";"210";"66,88%";"33.12";33.120
"MULTIPOLYGON (((-58.3850386271316 -34.6051839631136,-58.3849010800801 -34.6051751427688,-58.3837354593592 -34.6051072083773,-58.3836200555909 -34.6051005840969,-58.3836145402619 -34.6051683295188,-58.3835814172853 -34.6062358828317,-58.3837086576186 -34.6062470220212,-58.3848798918541 -34.6063405949985,-58.3849924012385 -34.6063474979446,-58.3850104661725 -34.606247576175,-58.3850357398224 -34.6052662178536,-58.3850386271316 -34.6051839631136)))";;"7";1_12_4;COMUNA 1;"12";"4";"393";"168";"225";"74,67%";"341";"339";"99,41%";"2";"0,59%";"209";"110";"52.63";"99";"47,37%";"52.63";52.630
"MULTIPOLYGON (((-58.3849924012385 -34.6063474979446,-58.3849775043957 -34.6064295337428,-58.3849175459365 -34.6074293211404,-58.384915750147 -34.6075282672978,-58.3853801027268 -34.6075570142009,-58.3863094085717 -34.6076107001248,-58.3863082260692 -34.6075068223234,-58.3863667428641 -34.6065750640247,-58.3863766643457 -34.6064369665352,-58.3864507682089 -34.6054100734026,-58.3864759318777 -34.6052759292113,-58.3850386271316 -34.6051839631136,-58.3850357398224 -34.6052662178536,-58.3850104661725 -34.606247576175,-58.3849924012385 -34.6063474979446)))";;"8";1_12_5;COMUNA 1;"12";"5";"600";"264";"336";"78,57%";"505";"504";"99,80%";"1";"0,20%";"275";"32";"11.64";"243";"88,36%";"11.64";11.640
"MULTIPOLYGON (((-58.3849924012385 -34.6063474979446,-58.3848798918541 -34.6063405949985,-58.3837086576186 -34.6062470220212,-58.3835814172853 -34.6062358828317,-58.3834501740498 -34.606224459209,-58.3822098512333 -34.606146743032,-58.3820780919728 -34.606140810754,-58.3820706199965 -34.6062928536917,-58.3820223365569 -34.6073386349862,-58.3821656783362 -34.6073479553764,-58.3835088111619 -34.6074415140009,-58.3836478089876 -34.607451181956,-58.384915750147 -34.6075282672978,-58.3849175459365 -34.6074293211404,-58.3849775043957 -34.6064295337428,-58.3849924012385 -34.6063474979446)))";;"9";1_12_6;COMUNA 1;"12";"6";"472";"220";"252";"87,30%";"504";"502";"99,60%";"2";"0,40%";"202";"49";"24.26";"153";"75,74%";"24.26";24.260
"MULTIPOLYGON (((-58.3853801027268 -34.6075570142009,-58.384915750147 -34.6075282672978,-58.3836478089876 -34.607451181956,-58.3835088111619 -34.6074415140009,-58.3834642920474 -34.6085777943952,-58.383607804137 -34.6085895780804,-58.3847076152909 -34.6086748666397,-58.3848659470909 -34.60868820767,-58.385063542564 -34.6087048130407,-58.3861434374438 -34.6087768360617,-58.3862757948893 -34.6087855109042,-58.3863094085717 -34.6076107001248,-58.3853801027268 -34.6075570142009)))";;"10";1_12_7;COMUNA 1;"12";"7";"786";"381";"405";"94,07%";"546";"542";"99,27%";"4";"0,74%";"347";"89";"25.65";"258";"74,35%";"25.65";25.650
"MULTIPOLYGON (((-58.3835088111619 -34.6074415140009,-58.3821656783362 -34.6073479553764,-58.3820223365569 -34.6073386349862,-58.3819705734415 -34.6084581488728,-58.3821682521448 -34.6084756040887,-58.383304086658 -34.608564591177,-58.3834642920474 -34.6085777943952,-58.3835088111619 -34.6074415140009)))";;"11";1_12_8;COMUNA 1;"12";"8";"329";"162";"167";"97,01%";"275";"269";"97,82%";"6";"2,23%";"129";"15";"11.63";"114";"88,37%";"11.63";11.630
"MULTIPOLYGON (((-58.3765022819359 -34.6064175727616,-58.3755796751361 -34.6069005268443,-58.3750016982012 -34.6072030816653,-58.3735708970457 -34.6079405226344,-58.3741102812204 -34.6079759871749,-58.3749168452045 -34.6080296002581,-58.3749815748096 -34.6080338723194,-58.376203091214 -34.6081150994686,-58.3763993259978 -34.6081266472976,-58.3778090820198 -34.6082113013519,-58.3792171355015 -34.6082978394312,-58.3793554537479 -34.6083065962842,-58.3804914787329 -34.6083697636686,-58.3807129318885 -34.6083763917917,-58.3808871085967 -34.6083864386512,-58.3813431177582 -34.6084146319211,-58.3817924837813 -34.6084424669561,-58.3819705734415 -34.6084581488728,-58.3820223365569 -34.6073386349862,-58.3820706199965 -34.6062928536917,-58.3820780919728 -34.606140810754,-58.3821258737033 -34.6051720740155,-58.3821336065038 -34.6050143267812,-58.3821500263271 -34.6046808040886,-58.3822055302283 -34.6037398196994,-58.3820012059012 -34.6037362339015,-58.3818368203459 -34.6038276777867,-58.3814478624643 -34.6038109729291,-58.3813588761753 -34.6038058966159,-58.3812698882648 -34.6038024925778,-58.3811732246622 -34.6036732163594,-58.3809751183048 -34.6036694217223,-58.3809559355612 -34.6040365352609,-58.3805559873505 -34.6042744445584,-58.3803315960928 -34.6044078898133,-58.3794979145934 -34.6048455094925,-58.3793832787935 -34.6048381774772,-58.3793790356703 -34.604907895481,-58.3779572468383 -34.6056541975237,-58.3775080537986 -34.6058899497882,-58.3767247081353 -34.6063011760998,-58.3765022819359 -34.6064175727616)))";;"12";1_12_9;COMUNA 1;"12";"9";"1356";"650";"706";"92,07%";"895";"885";"98,88%";"10";"1,13%";"342";"57";"16.67";"285";"83,33%";"16.67";16.670
"MULTIPOLYGON (((-58.3631786307544 -34.5982184640541,-58.3630064324989 -34.5987105253208,-58.3629538825684 -34.5988606796647,-58.3629201189734 -34.5989571542864,-58.3609335449723 -34.6045753135767,-58.3615360785252 -34.6046371431964,-58.3630771584802 -34.6004046734473,-58.3637421519057 -34.6004498027802,-58.3638010173176 -34.600453797465,-58.363379292511 -34.6047921843211,-58.3635901655788 -34.6048053140177,-58.364531685486 -34.6048641054814,-58.3646484504873 -34.6048858865625,-58.3647352256481 -34.6049266368489,-58.3647988424714 -34.6049721544449,-58.3648421922254 -34.6050248346809,-58.3648768818272 -34.6050910812567,-58.3653409469768 -34.6051295524338,-58.3655360606063 -34.6051456944727,-58.3655677420817 -34.6051483254279,-58.3663802043931 -34.6051549556421,-58.3666389232824 -34.605187864968,-58.3667123440125 -34.6052139508504,-58.366743766331 -34.605263139756,-58.3668008692195 -34.6053093067786,-58.3668241442461 -34.6053224891703,-58.3668696054827 -34.6053297549122,-58.3669046036446 -34.6053109843227,-58.3669221417363 -34.6052676179238,-58.3669501379131 -34.6052546258467,-58.3669542469024 -34.605252594145,-58.3670288351346 -34.6052546875788,-58.3671057918147 -34.6052475178686,-58.3672160788132 -34.6051507218505,-58.3672878004846 -34.6051334258891,-58.3673490010819 -34.6051407037594,-58.3679211414675 -34.6051742616164,-58.3680475302255 -34.6040560083767,-58.3681856739856 -34.6028332257345,-58.3681856788079 -34.6028331830494,-58.3681857027326 -34.6028329712761,-58.3683133749384 -34.6017031685898,-58.3683895118626 -34.601029540133,-58.3686314657978 -34.6004359016709,-58.3690724057256 -34.5993540871286,-58.369129874784 -34.5992191965076,-58.3695123426163 -34.5983212859799,-58.3689420995479 -34.5983685974648,-58.3681163318431 -34.5984371881812,-58.3679807014699 -34.5984018703661,-58.367777702989 -34.5982929760833,-58.3673594031048 -34.5982597613951,-58.3666064564148 -34.5983250183593,-58.366221100126 -34.5983057699015,-58.3659609314573 -34.5982928169568,-58.3650687183131 -34.5982276672882,-58.3640886223846 -34.5981561722634,-58.3638616777082 -34.5981361991659,-58.3637307296019 -34.5981044016808,-58.3632336651729 -34.5980613902626,-58.3631786307544 -34.5982184640541),(-58.3648082800618 -34.5990255875953,-58.364696003996 -34.6000625086033,-58.3638891678704 -34.6000018342418,-58.3640016353561 -34.5989753584616,-58.3648082800618 -34.5990255875953)))";;"13";1_13_1;COMUNA 1;"13";"1";"586";"364";"222";"163,96%";"404";"402";"99,50%";"2";"0,50%";"163";"1";"0.61";"162";"99,39%";"0.61";0.610
"MULTIPOLYGON (((-58.3613960520226 -34.6050597187108,-58.3612789606035 -34.6053918872289,-58.3614931401998 -34.6054887587818,-58.3615771530787 -34.6055330554229,-58.361657317954 -34.6055899549179,-58.3617337199428 -34.6056595277698,-58.361798519313 -34.6057448662079,-58.3618443287375 -34.6058270902091,-58.361874714149 -34.6059155692839,-58.3618937791052 -34.605997700736,-58.3619471425697 -34.606102044426,-58.3620157830028 -34.6061810476535,-58.3621035839308 -34.6062633061961,-58.3621760726947 -34.6063297064071,-58.3622715740002 -34.6063834489963,-58.3623670943194 -34.6064214867235,-58.362489274506 -34.6064594758499,-58.3626382961821 -34.6064880499031,-58.36278724797 -34.606503947195,-58.3629401291428 -34.6065104105515,-58.3631390162222 -34.6065234431014,-58.3629708219999 -34.6080993693633,-58.3641345825585 -34.608168206015,-58.3638666239204 -34.6105999415102,-58.363735545654 -34.6116339204562,-58.363728293706 -34.6116973350467,-58.3636245853797 -34.6118242597683,-58.363675023471 -34.6119018869944,-58.3636751752123 -34.611902120533,-58.3636974150354 -34.611967352188,-58.3646521963877 -34.6120452386771,-58.3647047477642 -34.6120495064024,-58.3650077889919 -34.6120760884079,-58.3655926178985 -34.6120940207163,-58.365956456503 -34.6121395930829,-58.3659815784781 -34.6121450357307,-58.3660731245714 -34.6121649681371,-58.3661952018105 -34.6122270388142,-58.3663254540262 -34.6123650340389,-58.3664326947206 -34.612219197985,-58.3666091099328 -34.6121401088677,-58.36683960982 -34.6121391633939,-58.3671273247267 -34.6121612208881,-58.367259152179 -34.6109984653789,-58.3675501423758 -34.6084449380983,-58.3677246250643 -34.6069133278502,-58.3679211414675 -34.6051742616164,-58.3673490010819 -34.6051407037594,-58.3672878004846 -34.6051334258891,-58.3672160788132 -34.6051507218505,-58.3671057918147 -34.6052475178686,-58.3670288351346 -34.6052546875788,-58.3669542469024 -34.605252594145,-58.3669501379131 -34.6052546258467,-58.3669221417363 -34.6052676179238,-58.3669046036446 -34.6053109843227,-58.3668696054827 -34.6053297549122,-58.3668241442461 -34.6053224891703,-58.3668008692195 -34.6053093067786,-58.366743766331 -34.605263139756,-58.3667123440125 -34.6052139508504,-58.3666389232824 -34.605187864968,-58.3663802043931 -34.6051549556421,-58.3655677420817 -34.6051483254279,-58.3655360606063 -34.6051456944727,-58.3653409469768 -34.6051295524338,-58.3648768818272 -34.6050910812567,-58.3648421922254 -34.6050248346809,-58.3647988424714 -34.6049721544449,-58.3647352256481 -34.6049266368489,-58.3646484504873 -34.6048858865625,-58.364531685486 -34.6048641054814,-58.3635901655788 -34.6048053140177,-58.363379292511 -34.6047921843211,-58.3622798187203 -34.6046997317009,-58.3615360785252 -34.6046371431964,-58.3613960520226 -34.6050597187108)))";;"14";1_13_4;COMUNA 1;"13";"4";"725";"449";"276";"162,68%";"641";"640";"99,84%";"1";"0,16%";"136";"1";"0.74";"135";"99,26%";"0.74";0.740
"MULTIPOLYGON (((-58.3645407532191 -34.6120335629948,-58.3645036345337 -34.6123975462647,-58.3639973524885 -34.6123607364079,-58.3636793499204 -34.6123539320124,-58.3633917839758 -34.6149030533988,-58.3630384739873 -34.6148771305783,-58.3628880712605 -34.6162031811347,-58.3621016700434 -34.6161477172009,-58.3619437845843 -34.6175005521869,-58.3628795295343 -34.6175745602185,-58.3631444164426 -34.6178238698738,-58.3638980784838 -34.6178808930082,-58.3641020818789 -34.6178963402824,-58.3649335091992 -34.6179630680713,-58.3657426649405 -34.6180635060661,-58.3664514379967 -34.6181201256173,-58.3665922341315 -34.6168789960268,-58.3667344888308 -34.6156251202362,-58.3668550364472 -34.614577149764,-58.3669896232806 -34.6133918611665,-58.3671273247267 -34.6121612208881,-58.36683960982 -34.6121391633939,-58.3666091099328 -34.6121401088677,-58.3664326947206 -34.612219197985,-58.3663254540262 -34.6123650340389,-58.3661952018105 -34.6122270388142,-58.3660731245714 -34.6121649681371,-58.3659815784781 -34.6121450357307,-58.365956456503 -34.6121395930829,-58.3655926178985 -34.6120940207163,-58.3650077889919 -34.6120760884079,-58.3647047477642 -34.6120495064024,-58.3646521963877 -34.6120452386771,-58.3645407532191 -34.6120335629948)))";;"15";1_13_13;COMUNA 1;"13";"13";"358";"226";"132";"171,21%";"266";"262";"98,50%";"4";"1,53%";"104";"2";"1.92";"102";"98,08%";"1.92";1.920
"MULTIPOLYGON (((-58.3621970108778 -34.6134811795181,-58.3613438159604 -34.6134209645194,-58.3612002032032 -34.6147473710554,-58.3620561371928 -34.6148078005925,-58.3622386695877 -34.6148206979679,-58.3630384739873 -34.6148771305783,-58.3633917839758 -34.6149030533988,-58.3636793499204 -34.6123539320124,-58.3639973524885 -34.6123607364079,-58.3645036345337 -34.6123975462647,-58.3645407532191 -34.6120335629948,-58.3636974150354 -34.611967352188,-58.3636751752123 -34.611902120533,-58.363675023471 -34.6119018869944,-58.3636245853797 -34.6118242597683,-58.3635377584894 -34.6117763001856,-58.3634219847465 -34.6117163447138,-58.3625880569518 -34.6116567175067,-58.3625495563087 -34.6116539802889,-58.3625409563571 -34.6116533688704,-58.3624181371402 -34.611644605697,-58.3623442042643 -34.6117125050898,-58.3622928164588 -34.6118033111381,-58.3622850242326 -34.6119079563642,-58.36232715339 -34.6120079241903,-58.3623369810958 -34.6121229363945,-58.3621970108778 -34.6134811795181)))";;"16";1_13_9;COMUNA 1;"13";"9";"426";"211";"215";"98,14%";"252";"251";"99,60%";"1";"0,40%";"157";"2";"1.27";"155";"98,73%";"1.27";1.270
"MULTIPOLYGON (((-58.3609068046287 -34.6174184610884,-58.3610565004671 -34.6160739179046,-58.3612002032032 -34.6147473710554,-58.3613438159604 -34.6134209645194,-58.3621970108778 -34.6134811795181,-58.3623369810958 -34.6121229363945,-58.36232715339 -34.6120079241903,-58.3622850242326 -34.6119079563642,-58.3622928164588 -34.6118033111381,-58.3623442042643 -34.6117125050898,-58.3624181371402 -34.611644605697,-58.3618024233687 -34.6116005049374,-58.3595275498966 -34.6114378219771,-58.3591310645826 -34.6114845299863,-58.3592349235092 -34.6111901004915,-58.3588097777272 -34.6111330470297,-58.3588175452044 -34.6111884781701,-58.3588062654351 -34.6112857960045,-58.358776674096 -34.6113814080382,-58.3587312462584 -34.6114713725637,-58.3586790272925 -34.6115425982147,-58.3586245177812 -34.6116062864071,-58.3585700863321 -34.6116756086458,-58.3585177982841 -34.6117337351053,-58.3584747097108 -34.6117917989761,-58.3584319569556 -34.6118537364962,-58.3568448683684 -34.6163564730001,-58.3567211646212 -34.6169026252416,-58.357670111306 -34.6171192504535,-58.3578150406018 -34.6171328392468,-58.3580771647541 -34.6171622825111,-58.35983953884 -34.6173280122896,-58.3602422513715 -34.617365887698,-58.3608990569339 -34.6174178477998,-58.3609068046287 -34.6174184610884)))";;"17";1_13_10;COMUNA 1;"13";"10";"614";"312";"302";"103,31%";"641";"641";"100,00%";"0";"0,00%";"235";"5";"2.13";"230";"97,87%";"2.13";2.130
"MULTIPOLYGON (((-58.3609068046287 -34.6174184610884,-58.3617379736598 -34.6174842514906,-58.361932945957 -34.6174996949175,-58.3619437845843 -34.6175005521869,-58.3621016700434 -34.6161477172009,-58.3620737740494 -34.6161457496355,-58.3618914091498 -34.616132852152,-58.3610565004671 -34.6160739179046,-58.3609068046287 -34.6174184610884)))";;"18";1_13_11;COMUNA 1;"13";"11";"292";"146";"146";"100,00%";"382";"382";"100,00%";"0";"0,00%";"142";"1";"0.7";"141";"99,30%";"0.7";0.700
"MULTIPOLYGON (((-58.3733794744309 -34.6113898037284,-58.3746465265295 -34.6114691078819,-58.3747868094977 -34.6114770966557,-58.3762052194114 -34.6115658601288,-58.3762152436038 -34.611263391537,-58.3762638705418 -34.610451847356,-58.3763328659576 -34.6092998121196,-58.3763574816782 -34.6088890399216,-58.3763677252597 -34.6087029136163,-58.3763993259978 -34.6081266472976,-58.376203091214 -34.6081150994686,-58.3749815748096 -34.6080338723194,-58.3749168452045 -34.6080296002581,-58.3741102812204 -34.6079759871749,-58.3735708970457 -34.6079405226344,-58.3735152807714 -34.6079368903127,-58.3735179240342 -34.6080139373186,-58.3735105978974 -34.6081741490926,-58.3735073507239 -34.6083432374076,-58.3735040176063 -34.608513029906,-58.373501405733 -34.6086455680463,-58.373495817148 -34.608933180084,-58.3734987815488 -34.6090285378388,-58.3735007587736 -34.6090912176239,-58.3735137751361 -34.6095042703383,-58.3734485874544 -34.6102454467533,-58.3721814828499 -34.6101542282804,-58.3720532124599 -34.6101463158618,-58.3720472262129 -34.6102465263121,-58.3719880708007 -34.6113026472649,-58.3733794744309 -34.6113898037284)))";;"19";1_14_1;COMUNA 1;"14";"1";"622";"325";"297";"109,43%";"538";"530";"98,51%";"8";"1,51%";"247";"74";"29.96";"173";"70,04%";"29.96";29.960
"MULTIPOLYGON (((-58.3731836743749 -34.6148548545532,-58.3730018185348 -34.614844861476,-58.3719239345271 -34.6148202605477,-58.3717873918256 -34.6148145248703,-58.3715605590055 -34.6148049186701,-58.370911906381 -34.6147879529087,-58.3706554207893 -34.6147866328659,-58.3705647544111 -34.6158942796606,-58.3706899583873 -34.6159098676583,-58.3717170369033 -34.6159795840544,-58.3717140906037 -34.6160254285446,-58.3729908378018 -34.6160251768477,-58.3731275539996 -34.6160299253558,-58.3731777715214 -34.6149576707697,-58.3731836743749 -34.6148548545532)))";;"20";1_14_10;COMUNA 1;"14";"10";"431";"207";"224";"92,41%";"341";"341";"100,00%";"0";"0,00%";"220";"3";"1.36";"217";"98,64%";"1.36";1.360
"MULTIPOLYGON (((-58.3745762623799 -34.6149264343025,-58.3733965351914 -34.6148665602599,-58.3731836743749 -34.6148548545532,-58.3731777715214 -34.6149576707697,-58.3731275539996 -34.6160299253558,-58.3732675070753 -34.6160348169336,-58.3743374645162 -34.6160787671387,-58.3745333791936 -34.6160882754112,-58.3745420042038 -34.6159875034396,-58.3745684583205 -34.6150565741257,-58.3745762623799 -34.6149264343025)))";;"21";1_14_11;COMUNA 1;"14";"11";"522";"254";"268";"94,78%";"412";"412";"100,00%";"0";"0,00%";"253";"31";"12.25";"222";"87,75%";"12.25";12.250
"MULTIPOLYGON (((-58.3760364858747 -34.6150005815229,-58.3745762623799 -34.6149264343025,-58.3745684583205 -34.6150565741257,-58.3745420042038 -34.6159875034396,-58.3745333791936 -34.6160882754112,-58.3747057840759 -34.6160967100387,-58.3752514396762 -34.6161324557527,-58.3758580411228 -34.616213244013,-58.375976099996 -34.6162202296472,-58.376032657651 -34.6150776942147,-58.3760364858747 -34.6150005815229)))";;"22";1_14_12;COMUNA 1;"14";"12";"511";"241";"270";"89,26%";"309";"307";"99,35%";"2";"0,65%";"217";"43";"19.82";"174";"80,18%";"19.82";19.820
"MULTIPOLYGON (((-58.3693658778097 -34.6065238757988,-58.3692508180986 -34.6065895647965,-58.3692202138962 -34.6067370008298,-58.3690821472615 -34.606767174167,-58.368828936543 -34.6068254468133,-58.3683805472332 -34.6069157006283,-58.3681551318853 -34.6069644387104,-58.368012847948 -34.6069224254328,-58.3677246250643 -34.6069133278502,-58.3675501423758 -34.6084449380983,-58.367259152179 -34.6109984653789,-58.3671273247267 -34.6121612208881,-58.3673766276816 -34.6121794447445,-58.367365050852 -34.6122471846062,-58.3679543643049 -34.6122930678472,-58.3683873000663 -34.6123268551955,-58.3683923219428 -34.6122548846665,-58.3688756799169 -34.6122929347515,-58.3691736242276 -34.6123090795816,-58.3693589664771 -34.6123190810318,-58.3695810194769 -34.6123310821274,-58.3697781159874 -34.6123417961624,-58.3705269763086 -34.612386732015,-58.3708106099717 -34.6124037071358,-58.3712177484221 -34.6124276759248,-58.3719223200698 -34.6124690487427,-58.3719338637511 -34.6122718671599,-58.3719880708007 -34.6113026472649,-58.3720472262129 -34.6102465263121,-58.3720532124599 -34.6101463158618,-58.3721814828499 -34.6101542282803,-58.3734485874544 -34.6102454467533,-58.3735137751361 -34.6095042703383,-58.3735007587736 -34.6090912176239,-58.3734987815488 -34.6090285378388,-58.3734958171479 -34.608933180084,-58.373501405733 -34.6086455680463,-58.3735040176063 -34.608513029906,-58.3735073507239 -34.6083432374075,-58.3735105978974 -34.6081741490926,-58.3735179240342 -34.6080139373185,-58.3731847364087 -34.6079929179132,-58.3721779351043 -34.6079293558925,-58.3709177655179 -34.6078389041119,-58.3709272883214 -34.60769946955,-58.3708238998349 -34.6075851742064,-58.3707576868857 -34.6075092242001,-58.3706240431428 -34.6073898739428,-58.3705822670259 -34.6073639186097,-58.3703036812934 -34.6071908112497,-58.3701942580999 -34.6067904624654,-58.3701924554836 -34.6067716916192,-58.369846280498 -34.6065527749091,-58.3698461651104 -34.606552765321,-58.3698462813962 -34.6065519680694,-58.3698444435866 -34.606552622271,-58.3696631849498 -34.6065297869318,-58.3694388120307 -34.6065019589293,-58.3693658778097 -34.6065238757988)))";;"23";1_14_2;COMUNA 1;"14";"2";"1096";"627";"469";"133,69%";"382";"378";"98,95%";"4";"1,06%";"226";"74";"32.74";"152";"67,26%";"32.74";32.740
"MULTIPOLYGON (((-58.3733794744309 -34.6113898037284,-58.3719880708007 -34.6113026472649,-58.3719338637511 -34.6122718671599,-58.3719223200698 -34.6124690487427,-58.3721781873866 -34.6124840985446,-58.3733161297407 -34.6125547287918,-58.3733261106951 -34.6123819834291,-58.3733794744309 -34.6113898037284)))";;"24";1_14_3;COMUNA 1;"14";"3";"383";"185";"198";"93,43%";"345";"345";"100,00%";"0";"0,00%";"196";"48";"24.49";"148";"75,51%";"24.49";24.490
"MULTIPOLYGON (((-58.3747868094977 -34.6114770966557,-58.3746465265295 -34.6114691078819,-58.3733794744309 -34.6113898037284,-58.3733261106951 -34.6123819834291,-58.3733161297407 -34.6125547287918,-58.3735995935183 -34.6125723311303,-58.3747140197093 -34.6126511004704,-58.3747241628673 -34.61248335529,-58.3747868094977 -34.6114770966557)))";;"25";1_14_4;COMUNA 1;"14";"4";"70";"28";"42";"66,67%";"148";"148";"100,00%";"0";"0,00%";"39";"0";"0";"39";"100,00%";"0";0.000
"MULTIPOLYGON (((-58.3747140197093 -34.6126511004704,-58.3746430252896 -34.6138169360044,-58.3746375631642 -34.6139074986708,-58.3745762623799 -34.6149264343025,-58.3760364858747 -34.6150005815229,-58.3760865997313 -34.6139914967204,-58.376091372247 -34.6139072717537,-58.3761569680258 -34.6127530516836,-58.3762052194114 -34.6115658601288,-58.3747868094977 -34.6114770966557,-58.3747241628673 -34.61248335529,-58.3747140197093 -34.6126511004704)))";;"26";1_14_5;COMUNA 1;"14";"5";"484";"253";"231";"109,52%";"290";"289";"99,66%";"1";"0,35%";"226";"123";"54.42";"103";"45,58%";"54.42";54.420
"MULTIPOLYGON (((-58.3732487782458 -34.6137209887365,-58.3731836743749 -34.6148548545532,-58.3733965351914 -34.6148665602599,-58.3745762623799 -34.6149264343025,-58.3746375631642 -34.6139074986708,-58.3746430252896 -34.6138169360044,-58.3747140197093 -34.6126511004704,-58.3735995935183 -34.6125723311303,-58.3733161297407 -34.6125547287918,-58.3732557222168 -34.6136003557217,-58.3732487782458 -34.6137209887365)))";;"27";1_14_6;COMUNA 1;"14";"6";"698";"344";"354";"97,18%";"424";"423";"99,76%";"1";"0,24%";"293";"81";"27.65";"212";"72,35%";"27.65";27.650
"MULTIPOLYGON (((-58.3673766276816 -34.6121794447445,-58.3671273247267 -34.6121612208881,-58.3669896232806 -34.6133918611666,-58.3678203283624 -34.6134570193755,-58.3688333083288 -34.6135363973158,-58.3690545089546 -34.6135517086912,-58.36927681695 -34.6135670909387,-58.3695158194489 -34.6135836123343,-58.3696560184005 -34.6135932971444,-58.3704769376913 -34.6135759620735,-58.370675665047 -34.6135782248861,-58.3707375916115 -34.6135789758318,-58.3709203049137 -34.6135810853236,-58.3711227736541 -34.6135894067765,-58.3717193624596 -34.6136139385024,-58.371854879241 -34.6136212932675,-58.3719984027037 -34.6136290763853,-58.3730366077383 -34.6137037901259,-58.3732487782458 -34.6137209887365,-58.3732557222168 -34.6136003557217,-58.3733161297407 -34.6125547287918,-58.3721781873866 -34.6124840985446,-58.3719223200698 -34.6124690487427,-58.3712177484221 -34.6124276759248,-58.3708106099717 -34.6124037071358,-58.3705269763086 -34.612386732015,-58.3697781159874 -34.6123417961624,-58.3695810194769 -34.6123310821274,-58.3693589664772 -34.6123190810318,-58.3691736242276 -34.6123090795816,-58.3688756799169 -34.6122929347515,-58.3683923219428 -34.6122548846665,-58.3683873000663 -34.6123268551955,-58.3679543643049 -34.6122930678472,-58.367365050852 -34.6122471846062,-58.3673766276816 -34.6121794447445)))";;"28";1_14_7;COMUNA 1;"14";"7";"476";"232";"244";"95,08%";"365";"363";"99,45%";"2";"0,55%";"215";"1";"0.47";"214";"99,53%";"0.47";0.470
"MULTIPOLYGON (((-58.3667344888308 -34.6156251202362,-58.3675681179198 -34.6156852822815,-58.3685796838063 -34.6157582525421,-58.3688141594966 -34.6157776578076,-58.3691413504142 -34.615792911134,-58.3694917835464 -34.6158188065605,-58.3702471383182 -34.6158610804652,-58.3703467973212 -34.615867212501,-58.3705647544111 -34.6158942796606,-58.3706554207893 -34.6147866328659,-58.3707375916115 -34.6135789758318,-58.370675665047 -34.6135782248861,-58.3704769376913 -34.6135759620735,-58.3696560184005 -34.6135932971444,-58.3695158194489 -34.6135836123343,-58.36927681695 -34.6135670909387,-58.3690545089546 -34.6135517086912,-58.3688333083288 -34.6135363973158,-58.3678203283624 -34.6134570193755,-58.3669896232806 -34.6133918611666,-58.3668550364472 -34.614577149764,-58.3667344888308 -34.6156251202362)))";;"29";1_14_8;COMUNA 1;"14";"8";"411";"229";"182";"125,82%";"374";"374";"100,00%";"0";"0,00%";"196";"111";"56.63";"85";"43,37%";"56.63";56.630
"MULTIPOLYGON (((-58.3732487782458 -34.6137209887365,-58.3730366077383 -34.6137037901259,-58.3719984027037 -34.6136290763853,-58.371854879241 -34.6136212932675,-58.3717193624596 -34.6136139385024,-58.3711227736541 -34.6135894067765,-58.3709203049137 -34.6135810853236,-58.3707375916115 -34.6135789758318,-58.3706554207893 -34.6147866328659,-58.370911906381 -34.6147879529087,-58.3715605590055 -34.6148049186701,-58.3717873918256 -34.6148145248703,-58.3719239345271 -34.6148202605477,-58.3730018185348 -34.614844861476,-58.3731836743749 -34.6148548545532,-58.3732487782458 -34.6137209887365)))";;"30";1_14_9;COMUNA 1;"14";"9";"521";"246";"275";"89,45%";"354";"354";"100,00%";"0";"0,00%";"246";"15";"6.1";"231";"93,90%";"6.1";6.100
"MULTIPOLYGON (((-58.3819705734415 -34.6084581488728,-58.3817924837813 -34.6084424669561,-58.3813431177582 -34.6084146319211,-58.3808871085967 -34.6083864386512,-58.3807129318885 -34.6083763917917,-58.3804914787329 -34.6083697636686,-58.3793554537479 -34.6083065962842,-58.3792171355015 -34.6082978394312,-58.3778090820198 -34.6082113013519,-58.3777811391934 -34.6088017260277,-58.3777526748538 -34.6094020097904,-58.3790507882529 -34.6094839659862,-58.3791605744214 -34.6094921400938,-58.3791557664681 -34.6096150990239,-58.3791277791239 -34.6105139857398,-58.3791205032673 -34.6106345485043,-58.3792831852506 -34.6106446602034,-58.380370769885 -34.6107130774638,-58.3805934108056 -34.6107308337709,-58.3812251355926 -34.6107813999339,-58.3818611197739 -34.6108323177737,-58.3819031714294 -34.6098929453402,-58.3819131745843 -34.6096785779669,-58.3819293554434 -34.60932984358,-58.3819404912035 -34.6090892083699,-58.3819705734415 -34.6084581488728)))";;"31";1_15_1;COMUNA 1;"15";"1";"697";"345";"352";"98,01%";"434";"420";"96,77%";"14";"3,33%";"170";"36";"21.18";"134";"78,82%";"21.18";21.180
"MULTIPOLYGON (((-58.3815648149735 -34.6164880979196,-58.3811799668922 -34.6164695308578,-58.380743754925 -34.616448392786,-58.3803175944519 -34.6164278233428,-58.3801195487432 -34.6164182524911,-58.3789870666192 -34.6163657886786,-58.3788432810886 -34.616359140402,-58.3787729992231 -34.6175482184147,-58.3789485559858 -34.6175601000405,-58.3798634788662 -34.6176224170297,-58.3800431244626 -34.6176347224069,-58.3802744862214 -34.6176388931721,-58.3806837989538 -34.6176462819647,-58.3811329782256 -34.6176544002961,-58.3815111986209 -34.6176612725449,-58.3815551249047 -34.6167290858885,-58.3815648149735 -34.6164880979196)))";;"32";1_15_10;COMUNA 1;"15";"10";"625";"282";"343";"82,22%";"384";"383";"99,74%";"1";"0,26%";"291";"47";"16.15";"244";"83,85%";"16.15";16.150
"MULTIPOLYGON (((-58.3788432810886 -34.616359140402,-58.3774253595202 -34.6162934369269,-58.3773579847421 -34.617452303826,-58.3787729992231 -34.6175482184147,-58.3788432810886 -34.616359140402)))";;"33";1_15_11;COMUNA 1;"15";"11";"554";"276";"278";"99,28%";"271";"270";"99,63%";"1";"0,37%";"281";"109";"38.79";"172";"61,21%";"38.79";38.790
"MULTIPOLYGON (((-58.3762638705418 -34.610451847356,-58.3762152436038 -34.611263391537,-58.3762052194114 -34.6115658601288,-58.3767058751091 -34.6115975532009,-58.3774750873024 -34.6116457003053,-58.3776460340251 -34.6116553269846,-58.3788945335954 -34.6117260526546,-58.3790536389115 -34.6117373594289,-58.3791205032673 -34.6106345485043,-58.3791277791239 -34.6105139857398,-58.3791557664681 -34.6096150990239,-58.3791605744214 -34.6094921400938,-58.3790507882529 -34.6094839659862,-58.3777526748538 -34.6094020097904,-58.3777811391934 -34.6088017260277,-58.3778090820198 -34.6082113013519,-58.3763993259978 -34.6081266472976,-58.3763677252597 -34.6087029136163,-58.3763574816782 -34.6088890399216,-58.3763328659576 -34.6092998121196,-58.3762638705418 -34.610451847356)))";;"34";1_15_2;COMUNA 1;"15";"2";"662";"322";"340";"94,71%";"500";"498";"99,60%";"2";"0,40%";"249";"34";"13.65";"215";"86,35%";"13.65";13.650
"MULTIPOLYGON (((-58.3812251355926 -34.6107813999339,-58.3805934108056 -34.6107308337709,-58.380370769885 -34.6107130774638,-58.3792831852506 -34.6106446602034,-58.3791205032673 -34.6106345485043,-58.3790536389115 -34.6117373594289,-58.3790466228285 -34.6118534855632,-58.3790230906999 -34.612724697929,-58.3790177584933 -34.6129452655616,-58.3792856363471 -34.6129631256984,-58.3802410580221 -34.6130228618209,-58.3804820197297 -34.613039996885,-58.3808935032117 -34.6130692181941,-58.3812181077691 -34.6130922531415,-58.3813916959193 -34.6131045524891,-58.3817545446278 -34.6131303580688,-58.3817753970859 -34.6128845884414,-58.3817972555001 -34.6124797996696,-58.3818210220927 -34.6120395178958,-58.3818202887206 -34.6119174003342,-58.3818190366782 -34.6117152795413,-58.3818509350584 -34.611057952995,-58.3818611197739 -34.6108323177737,-58.3812251355926 -34.6107813999339)))";;"35";1_15_3;COMUNA 1;"15";"3";"418";"176";"242";"72,73%";"435";"435";"100,00%";"0";"0,00%";"200";"1";"0.5";"199";"99,50%";"0.5";0.500
"MULTIPOLYGON (((-58.3762052194114 -34.6115658601288,-58.3761569680258 -34.6127530516836,-58.376091372247 -34.6139072717537,-58.3775352079237 -34.6139973758855,-58.3775814395155 -34.6128510995637,-58.3777721472735 -34.6128641906796,-58.3787422148558 -34.6129269770112,-58.3790177584933 -34.6129452655616,-58.3790230906999 -34.612724697929,-58.3790466228285 -34.6118534855632,-58.3790536389115 -34.6117373594289,-58.3788945335954 -34.6117260526546,-58.3776460340251 -34.6116553269846,-58.3774750873024 -34.6116457003053,-58.3767058751091 -34.6115975532009,-58.3762052194114 -34.6115658601288)))";;"36";1_15_4;COMUNA 1;"15";"4";"759";"366";"393";"93,13%";"685";"684";"99,85%";"1";"0,15%";"335";"2";"0.6";"333";"99,40%";"0.6";0.600
"MULTIPOLYGON (((-58.3790177584933 -34.6129452655616,-58.3787422148558 -34.6129269770112,-58.3777721472735 -34.6128641906796,-58.3775814395155 -34.6128510995637,-58.3775352079237 -34.6139973758855,-58.3778298356355 -34.6140157508638,-58.378833553571 -34.6140887010788,-58.3789820147843 -34.6141007753035,-58.3791220437397 -34.6141120688956,-58.3802049062897 -34.6141773856926,-58.3804244935277 -34.6141914077125,-58.3808275530382 -34.6142171023091,-58.3812768642082 -34.6142457138784,-58.3816783910966 -34.6142712637911,-58.3817288667463 -34.6134328870749,-58.3817545446278 -34.6131303580688,-58.3813916959193 -34.6131045524891,-58.3812181077691 -34.6130922531415,-58.3808935032117 -34.6130692181941,-58.3804820197297 -34.613039996885,-58.3802410580221 -34.6130228618209,-58.3792856363471 -34.6129631256984,-58.3790177584933 -34.6129452655616)))";;"37";1_15_5;COMUNA 1;"15";"5";"464";"232";"232";"100,00%";"221";"220";"99,55%";"1";"0,45%";"187";"41";"21.93";"146";"78,07%";"21.93";21.930
"MULTIPOLYGON (((-58.3816783910966 -34.6142712637911,-58.3812768642082 -34.6142457138784,-58.3808275530382 -34.6142171023091,-58.3804244935277 -34.6141914077125,-58.3802049062897 -34.6141773856926,-58.3791220437397 -34.6141120688956,-58.3789820147843 -34.6141007753035,-58.378833553571 -34.6140887010788,-58.3778298356355 -34.6140157508638,-58.3775352079237 -34.6139973758855,-58.3774839293572 -34.6150797025177,-58.3777857128616 -34.615101463002,-58.3787517165973 -34.6151653028019,-58.3789115984338 -34.6151733003178,-58.3790287201363 -34.6151792259789,-58.380135377311 -34.6152298408771,-58.3803651929754 -34.6152402078235,-58.3807852156815 -34.6152592236281,-58.3812270447397 -34.615279168077,-58.3816129107084 -34.6152965384409,-58.3816197198726 -34.6151270299076,-58.381665578462 -34.614482812115,-58.3816783910966 -34.6142712637911)))";;"38";1_15_6;COMUNA 1;"15";"6";"804";"415";"389";"106,68%";"480";"475";"98,96%";"5";"1,05%";"305";"111";"36.39";"194";"63,61%";"36.39";36.390
"MULTIPOLYGON (((-58.3775352079237 -34.6139973758855,-58.376091372247 -34.6139072717537,-58.3760865997313 -34.6139914967204,-58.3760364858747 -34.6150005815229,-58.3772166428284 -34.6150604303398,-58.3774839293572 -34.6150797025177,-58.3775352079237 -34.6139973758855)))";;"39";1_15_7;COMUNA 1;"15";"7";"577";"287";"290";"98,97%";"365";"364";"99,73%";"1";"0,27%";"270";"58";"21.48";"212";"78,52%";"21.48";21.480
"MULTIPOLYGON (((-58.3774839293572 -34.6150797025177,-58.3772166428284 -34.6150604303398,-58.3760364858747 -34.6150005815229,-58.376032657651 -34.6150776942147,-58.375976099996 -34.6162202296472,-58.3761545512996 -34.6162307088511,-58.3772630048181 -34.6162859287065,-58.3774253595202 -34.6162934369269,-58.3774314299089 -34.6161883670396,-58.3774839293572 -34.6150797025177)))";;"40";1_15_8;COMUNA 1;"15";"8";"818";"394";"424";"92,92%";"421";"418";"99,29%";"3";"0,72%";"310";"114";"36.77";"196";"63,23%";"36.77";36.770
"MULTIPOLYGON (((-58.3789115984338 -34.6151733003178,-58.3787517165973 -34.6151653028019,-58.3777857128616 -34.615101463002,-58.3774839293572 -34.6150797025177,-58.3774314299089 -34.6161883670396,-58.3774253595202 -34.6162934369269,-58.3788432810886 -34.616359140402,-58.3789870666192 -34.6163657886786,-58.3801195487432 -34.6164182524911,-58.3803175944519 -34.6164278233428,-58.380743754925 -34.616448392786,-58.3811799668922 -34.6164695308578,-58.3815648149735 -34.6164880979196,-58.3816129107084 -34.6152965384409,-58.3812270447397 -34.615279168077,-58.3807852156815 -34.6152592236281,-58.3803651929754 -34.6152402078235,-58.380135377311 -34.6152298408771,-58.3790287201363 -34.6151792259789,-58.3789115984338 -34.6151733003178)))";;"41";1_15_9;COMUNA 1;"15";"9";"872";"389";"483";"80,54%";"527";"526";"99,81%";"1";"0,19%";"352";"80";"22.73";"272";"77,27%";"22.73";22.730
"MULTIPOLYGON (((-58.3834642920474 -34.6085777943952,-58.383304086658 -34.608564591177,-58.3821682521448 -34.6084756040887,-58.3819705734415 -34.6084581488728,-58.3819404912035 -34.6090892083699,-58.3819293554434 -34.60932984358,-58.3819131745843 -34.6096785779669,-58.3819031714294 -34.6098929453402,-58.3818611197739 -34.6108323177737,-58.3820990923803 -34.6108513491425,-58.3833636818125 -34.6109229552362,-58.3833704545539 -34.6107876026244,-58.383414018828 -34.6097623824395,-58.3834381553645 -34.6091918843693,-58.3834642920474 -34.6085777943952)))";;"42";1_16_1;COMUNA 1;"16";"1";"538";"274";"264";"103,79%";"348";"339";"97,41%";"9";"2,65%";"189";"61";"32.28";"128";"67,72%";"32.28";32.280
"MULTIPOLYGON (((-58.3917946753218 -34.6114996459632,-58.3915366012003 -34.6114747060748,-58.3903640871973 -34.6113899289759,-58.3903686234804 -34.6115612758926,-58.3903556939927 -34.6124243979722,-58.3903570228156 -34.6125618684995,-58.3915060467816 -34.6126425473013,-58.3917568026426 -34.6126631166423,-58.3917664343424 -34.6124555091322,-58.3917855878243 -34.6116685200297,-58.3917946753218 -34.6114996459632)))";;"43";1_16_10;COMUNA 1;"16";"10";"591";"252";"339";"74,34%";"438";"438";"100,00%";"0";"0,00%";"291";"0";"0";"291";"100,00%";"0";0.000
"MULTIPOLYGON (((-58.3903640871973 -34.6113899289759,-58.3889394594692 -34.611286959626,-58.3889222759923 -34.611453715834,-58.3889307947862 -34.6122231853889,-58.3889413965343 -34.6124676372248,-58.3901231298966 -34.6125453909683,-58.3903570228156 -34.6125618684995,-58.3903556939927 -34.6124243979722,-58.3903686234804 -34.6115612758926,-58.3903640871973 -34.6113899289759)))";;"44";1_16_11;COMUNA 1;"16";"11";"464";"207";"257";"80,54%";"300";"299";"99,67%";"1";"0,33%";"217";"22";"10.14";"195";"89,86%";"10.14";10.140
"MULTIPOLYGON (((-58.3889394594692 -34.611286959626,-58.3874785511187 -34.6111813455501,-58.3874703126875 -34.6113435998638,-58.3874849672222 -34.6123785054065,-58.387632753332 -34.612381554281,-58.3889413965343 -34.6124676372248,-58.3889307947862 -34.6122231853889,-58.3889222759923 -34.611453715834,-58.3889394594692 -34.611286959626)))";;"45";1_16_12;COMUNA 1;"16";"12";"364";"162";"202";"80,20%";"204";"203";"99,51%";"1";"0,49%";"139";"0";"0";"139";"100,00%";"0";0.000
"MULTIPOLYGON (((-58.384820305699 -34.6098595593227,-58.3835323251538 -34.6097689383727,-58.383414018828 -34.6097623824395,-58.3833704545539 -34.6107876026244,-58.3833636818125 -34.6109229552362,-58.3848161693982 -34.6110052320789,-58.3848208122798 -34.6108677652744,-58.3848178632439 -34.6100123098006,-58.384820305699 -34.6098595593227)))";;"46";1_16_2;COMUNA 1;"16";"2";"326";"164";"162";"101,23%";"292";"291";"99,66%";"1";"0,34%";"164";"14";"8.54";"150";"91,46%";"8.54";8.540
"MULTIPOLYGON (((-58.3862757948893 -34.6087855109042,-58.3861434374438 -34.6087768360617,-58.385063542564 -34.6087048130407,-58.3848659470909 -34.60868820767,-58.3847076152909 -34.6086748666397,-58.383607804137 -34.6085895780804,-58.3834642920474 -34.6085777943952,-58.3834381553645 -34.6091918843693,-58.383414018828 -34.6097623824395,-58.3835323251538 -34.6097689383727,-58.384820305699 -34.6098595593227,-58.3848222070237 -34.6097389927663,-58.3848409412814 -34.609288072791,-58.3862544621564 -34.6093850264877,-58.3862497408077 -34.6095178452758,-58.3862239537345 -34.6099584789707,-58.3869794401422 -34.6100093745575,-58.3875600828983 -34.610030368094,-58.3874106230208 -34.6099045671529,-58.3873018706848 -34.6097877351777,-58.3872832799222 -34.6096235627751,-58.387287520148 -34.6094558127989,-58.387300649141 -34.6092545459606,-58.3873195847267 -34.6091313841476,-58.3873775962061 -34.6090309233447,-58.3875034658108 -34.6089616322529,-58.3876564810355 -34.6089209503251,-58.3873177724097 -34.6088747539271,-58.3872294601497 -34.6088563888026,-58.3862757948893 -34.6087855109042)))";;"47";1_16_3;COMUNA 1;"16";"3";"945";"466";"479";"97,29%";"683";"673";"98,54%";"10";"1,49%";"413";"110";"26.63";"303";"73,37%";"26.63";26.630
"MULTIPOLYGON (((-58.3862544621564 -34.6093850264877,-58.3848409412814 -34.609288072791,-58.3848222070237 -34.6097389927663,-58.384820305699 -34.6098595593227,-58.3849500237358 -34.6098687268938,-58.3860624654385 -34.6099476025994,-58.3862239537345 -34.6099584789707,-58.3862497408077 -34.6095178452758,-58.3862544621564 -34.6093850264877)))";;"48";1_16_4;COMUNA 1;"16";"4";"573";"287";"286";"100,35%";"610";"608";"99,67%";"2";"0,33%";"348";"27";"7.76";"321";"92,24%";"7.76";7.760
"MULTIPOLYGON (((-58.3862239537345 -34.6099584789707,-58.3860624654385 -34.6099476025994,-58.3849500237358 -34.6098687268938,-58.384820305699 -34.6098595593227,-58.3848178632439 -34.6100123098006,-58.3848208122798 -34.6108677652744,-58.3848161693982 -34.6110052320789,-58.3849682067574 -34.6110138504754,-58.3858460112724 -34.6110739862096,-58.3861544323923 -34.6110893214964,-58.3861568735336 -34.6109353737898,-58.3862153869991 -34.6101046761029,-58.3862239537345 -34.6099584789707)))";;"49";1_16_5;COMUNA 1;"16";"5";"477";"202";"275";"73,45%";"291";"291";"100,00%";"0";"0,00%";"208";"49";"23.56";"159";"76,44%";"23.56";23.560
"MULTIPOLYGON (((-58.3869794401422 -34.6100093745575,-58.3862239537345 -34.6099584789707,-58.3862153869991 -34.6101046761029,-58.3861568735336 -34.6109353737898,-58.3861544323923 -34.6110893214964,-58.3863192474284 -34.6110974532499,-58.3874785511187 -34.6111813455501,-58.3874883510737 -34.6109876826052,-58.3875600828983 -34.610030368094,-58.3869794401422 -34.6100093745575)))";;"50";1_16_6;COMUNA 1;"16";"6";"559";"263";"296";"88,85%";"240";"240";"100,00%";"0";"0,00%";"228";"47";"20.61";"181";"79,39%";"20.61";20.610
"MULTIPOLYGON (((-58.388679876259 -34.6090291146393,-58.3885075776671 -34.6090117558347,-58.3881732862814 -34.6089780297425,-58.3878011787048 -34.6089417442214,-58.3876564810355 -34.6089209503251,-58.3875034658108 -34.6089616322529,-58.3873775962061 -34.6090309233447,-58.3873195847267 -34.6091313841476,-58.387300649141 -34.6092545459606,-58.387287520148 -34.6094558127989,-58.3872832799222 -34.6096235627751,-58.3873018706848 -34.6097877351777,-58.3874106230208 -34.6099045671529,-58.3875600828983 -34.610030368094,-58.3874883510737 -34.6109876826052,-58.3874785511187 -34.6111813455501,-58.3889394594692 -34.611286959626,-58.388958189684 -34.6111048516771,-58.3890242442072 -34.6102878196736,-58.3890497262473 -34.6100795176209,-58.3891229966573 -34.6094810893124,-58.3891506231685 -34.609255182227,-58.3891722434631 -34.60907878036,-58.388679876259 -34.6090291146393)))";;"51";1_16_7;COMUNA 1;"16";"7";"1074";"489";"585";"83,59%";"687";"685";"99,71%";"2";"0,29%";"475";"98";"20.63";"377";"79,37%";"20.63";20.630
"MULTIPOLYGON (((-58.3904172677893 -34.6101778742511,-58.3900074140571 -34.6101481226271,-58.3890497262473 -34.6100795176209,-58.3890242442072 -34.6102878196736,-58.388958189684 -34.6111048516771,-58.3889394594692 -34.611286959626,-58.3903640871973 -34.6113899289759,-58.3903598814493 -34.6112303432395,-58.3904172677893 -34.6101778742511)))";;"52";1_16_8;COMUNA 1;"16";"8";"546";"252";"294";"85,71%";"299";"297";"99,33%";"2";"0,67%";"220";"10";"4.55";"210";"95,45%";"4.55";4.550
"MULTIPOLYGON (((-58.3904172677893 -34.6101778742511,-58.3903598814493 -34.6112303432395,-58.3903640871973 -34.6113899289759,-58.3915366012003 -34.6114747060748,-58.3917946753218 -34.6114996459632,-58.391806531758 -34.6112799265883,-58.3918751326524 -34.6103404957086,-58.3919516607575 -34.6092921215986,-58.3914098776477 -34.609254058373,-58.3905527865388 -34.6091937636371,-58.3897581279972 -34.6091378665783,-58.3895555084103 -34.6091174628427,-58.3891722434631 -34.60907878036,-58.3891506231685 -34.609255182227,-58.3891229966573 -34.6094810893124,-58.3890497262473 -34.6100795176209,-58.3900074140571 -34.6101481226271,-58.3904172677893 -34.6101778742511)))";;"53";1_16_9;COMUNA 1;"16";"9";"382";"176";"206";"85,44%";"203";"203";"100,00%";"0";"0,00%";"160";"2";"1.25";"158";"98,75%";"1.25";1.250
"MULTIPOLYGON (((-58.3848161693982 -34.6110052320789,-58.3833636818125 -34.6109229552362,-58.3833081097045 -34.6120335930073,-58.3846270296338 -34.6121412085608,-58.3847686731923 -34.6121539052084,-58.3860153596689 -34.6122658259463,-58.3861556386285 -34.6122808441532,-58.3862931069319 -34.6122955787383,-58.3873406735382 -34.6123754585103,-58.3874849672222 -34.6123785054065,-58.3874703126875 -34.6113435998638,-58.3874785511187 -34.6111813455501,-58.3863192474284 -34.6110974532499,-58.3861544323923 -34.6110893214964,-58.3858460112724 -34.6110739862096,-58.3849682067574 -34.6110138504754,-58.3848161693982 -34.6110052320789)))";;"54";1_17_1;COMUNA 1;"17";"1";"888";"457";"431";"106,03%";"544";"543";"99,82%";"1";"0,18%";"389";"74";"19.02";"315";"80,98%";"19.02";19.020
"MULTIPOLYGON (((-58.384559249187 -34.6144798405129,-58.3843825851581 -34.6144738819522,-58.3832716099463 -34.6144034429062,-58.383112075332 -34.6143897469019,-58.38309453882 -34.6145565019652,-58.3830676006789 -34.6153805277606,-58.3843818507393 -34.6154372255957,-58.3844800638232 -34.6154415845328,-58.3857629681125 -34.6154982473884,-58.3859028380228 -34.6155008003928,-58.3859051223128 -34.6153328381222,-58.3859543103591 -34.6145522779255,-58.3857791861894 -34.614538927726,-58.3847022670124 -34.6144846505106,-58.384559249187 -34.6144798405129)))";;"55";1_17_10;COMUNA 1;"17";"10";"574";"264";"310";"85,16%";"363";"363";"100,00%";"0";"0,00%";"279";"37";"13.26";"242";"86,74%";"13.26";13.260
"MULTIPOLYGON (((-58.383112075332 -34.6143897469019,-58.3818809433019 -34.6142842154995,-58.3816783910966 -34.6142712637911,-58.381665578462 -34.614482812115,-58.3816197198726 -34.6151270299076,-58.3816129107084 -34.6152965384409,-58.3818050770654 -34.6153052578693,-58.3829206644381 -34.6153741639331,-58.3830676006789 -34.6153805277606,-58.38309453882 -34.6145565019652,-58.383112075332 -34.6143897469019)))";;"56";1_17_11;COMUNA 1;"17";"11";"474";"213";"261";"81,61%";"276";"274";"99,28%";"2";"0,73%";"218";"31";"14.22";"187";"85,78%";"14.22";14.220
"MULTIPOLYGON (((-58.3833636818125 -34.6109229552362,-58.3820990923803 -34.6108513491425,-58.3818611197739 -34.6108323177737,-58.3818509350584 -34.611057952995,-58.3818190366782 -34.6117152795413,-58.3818202887206 -34.6119174003342,-58.3820129545123 -34.6119301339946,-58.3831892069427 -34.6120238673398,-58.3833081097045 -34.6120335930073,-58.3833636818125 -34.6109229552362)))";;"57";1_17_2;COMUNA 1;"17";"2";"657";"328";"329";"99,70%";"467";"467";"100,00%";"0";"0,00%";"303";"89";"29.37";"214";"70,63%";"29.37";29.370
"MULTIPOLYGON (((-58.3817545446278 -34.6131303580688,-58.3817288667463 -34.6134328870749,-58.3816783910966 -34.6142712637911,-58.3818809433019 -34.6142842154995,-58.383112075332 -34.6143897469019,-58.3831326198459 -34.6141950350494,-58.3832162484479 -34.6132338580131,-58.3832348509702 -34.6130205526248,-58.3833016831784 -34.6121629596821,-58.3833081097045 -34.6120335930073,-58.3831892069427 -34.6120238673398,-58.3820129545123 -34.6119301339946,-58.3818202887206 -34.6119174003342,-58.3818210220927 -34.6120395178958,-58.3817972555001 -34.6124797996696,-58.3817753970859 -34.6128845884414,-58.3817545446278 -34.6131303580688)))";;"58";1_17_3;COMUNA 1;"17";"3";"720";"329";"391";"84,14%";"423";"422";"99,76%";"1";"0,24%";"324";"46";"14.2";"278";"85,80%";"14.2";14.200
"MULTIPOLYGON (((-58.3847686731923 -34.6121539052084,-58.3846270296338 -34.6121412085608,-58.3833081097045 -34.6120335930073,-58.3833016831784 -34.6121629596821,-58.3832348509702 -34.6130205526248,-58.3832162484479 -34.6132338580131,-58.3846557249913 -34.6133357064522,-58.3846738132929 -34.613121837116,-58.3847528605434 -34.6123030554075,-58.3847686731923 -34.6121539052084)))";;"59";1_17_4;COMUNA 1;"17";"4";"586";"252";"334";"75,45%";"378";"377";"99,74%";"1";"0,27%";"287";"27";"9.41";"260";"90,59%";"9.41";9.410
"MULTIPOLYGON (((-58.3860750195555 -34.6134347082315,-58.3848492453991 -34.6133494221308,-58.3846557249913 -34.6133357064522,-58.3832162484479 -34.6132338580131,-58.3831326198459 -34.6141950350494,-58.383112075332 -34.6143897469019,-58.3832716099463 -34.6144034429062,-58.3843825851581 -34.6144738819522,-58.384559249187 -34.6144798405129,-58.3847022670124 -34.6144846505106,-58.3857791861894 -34.614538927726,-58.3859543103591 -34.6145522779255,-58.3860435163826 -34.6136973034769,-58.3860750195555 -34.6134347082315)))";;"60";1_17_5;COMUNA 1;"17";"5";"577";"261";"316";"82,59%";"318";"318";"100,00%";"0";"0,00%";"256";"33";"12.89";"223";"87,11%";"12.89";12.890
"MULTIPOLYGON (((-58.3861556386285 -34.6122808441532,-58.3860153596689 -34.6122658259463,-58.3847686731923 -34.6121539052084,-58.3847528605434 -34.6123030554075,-58.3846738132929 -34.613121837116,-58.3846557249913 -34.6133357064522,-58.3848492453991 -34.6133494221308,-58.3860750195555 -34.6134347082315,-58.3861054922629 -34.6131809154522,-58.3861545588484 -34.6124364124565,-58.3861556386285 -34.6122808441532)))";;"61";1_17_6;COMUNA 1;"17";"6";"759";"355";"404";"87,87%";"457";"455";"99,56%";"2";"0,44%";"367";"127";"34.6";"240";"65,40%";"34.6";34.600
"MULTIPOLYGON (((-58.3874849672222 -34.6123785054065,-58.3873406735382 -34.6123754585103,-58.3862931069319 -34.6122955787383,-58.3861556386285 -34.6122808441532,-58.3861545588484 -34.6124364124565,-58.3861054922629 -34.6131809154522,-58.3860750195555 -34.6134347082315,-58.3863595944436 -34.6134544647991,-58.3875143328215 -34.613536452416,-58.3875206023259 -34.6132906728232,-58.3874871302919 -34.6125302023413,-58.3874849672222 -34.6123785054065)))";;"62";1_17_7;COMUNA 1;"17";"7";"615";"294";"321";"91,59%";"477";"477";"100,00%";"0";"0,00%";"323";"81";"25.08";"242";"74,92%";"25.08";25.080
"MULTIPOLYGON (((-58.3875143328215 -34.613536452416,-58.3863595944436 -34.6134544647991,-58.3860750195555 -34.6134347082315,-58.3860435163826 -34.6136973034769,-58.3859543103591 -34.6145522779255,-58.3861248350871 -34.6145652024365,-58.3873895391501 -34.6146704300428,-58.387495419187 -34.6146734532091,-58.3875074507462 -34.613800260435,-58.3875143328215 -34.613536452416)))";;"63";1_17_8;COMUNA 1;"17";"8";"597";"248";"349";"71,06%";"316";"313";"99,05%";"3";"0,96%";"267";"80";"29.96";"187";"70,04%";"29.96";29.960
"MULTIPOLYGON (((-58.387495419187 -34.6146734532091,-58.3873895391501 -34.6146704300428,-58.3861248350871 -34.6145652024365,-58.3859543103591 -34.6145522779255,-58.3859051223128 -34.6153328381222,-58.3859028380228 -34.6155008003928,-58.3860489262473 -34.6155034979941,-58.387329987182 -34.6155284519483,-58.3874836570771 -34.6155309412402,-58.387495419187 -34.6146734532091)))";;"64";1_17_9;COMUNA 1;"17";"9";"439";"204";"235";"86,81%";"309";"309";"100,00%";"0";"0,00%";"239";"46";"19.25";"193";"80,75%";"19.25";19.250
"MULTIPOLYGON (((-58.3917568026426 -34.6126631166423,-58.3915060467816 -34.6126425473013,-58.3903570228156 -34.6125618684995,-58.3903585809167 -34.6127296219392,-58.3903624006328 -34.6135307093073,-58.3903660605805 -34.6137304369425,-58.3914320574631 -34.6137998695971,-58.3917102415983 -34.6138250326803,-58.391749254193 -34.6128249490618,-58.3917568026426 -34.6126631166423)))";;"65";1_18_1;COMUNA 1;"18";"1";"842";"406";"436";"93,12%";"496";"495";"99,80%";"1";"0,20%";"442";"139";"31.45";"303";"68,55%";"31.45";31.450
"MULTIPOLYGON (((-58.3903570228156 -34.6125618684995,-58.3901231298966 -34.6125453909683,-58.3889413965343 -34.6124676372248,-58.3889483257326 -34.6126268724969,-58.3889426348139 -34.6133790087475,-58.3889507533141 -34.6136383187222,-58.3903660605805 -34.6137304369425,-58.3903624006328 -34.6135307093073,-58.3903585809167 -34.6127296219392,-58.3903570228156 -34.6125618684995)))";;"66";1_18_2;COMUNA 1;"18";"2";"735";"318";"417";"76,26%";"490";"487";"99,39%";"3";"0,62%";"357";"48";"13.45";"309";"86,55%";"13.45";13.450
"MULTIPOLYGON (((-58.3889413965343 -34.6124676372248,-58.387632753332 -34.612381554281,-58.3874849672222 -34.6123785054065,-58.3874871302919 -34.6125302023413,-58.3875206023259 -34.6132906728232,-58.3875143328215 -34.613536452416,-58.3875074507462 -34.613800260435,-58.387495419187 -34.6146734532091,-58.3874836570771 -34.6155309412402,-58.3876656928339 -34.6155339407635,-58.3887986126744 -34.6155666052714,-58.3889737472772 -34.615571148013,-58.3889738022574 -34.6154126212903,-58.3889707309691 -34.6148398525824,-58.3889693247609 -34.6146961142171,-58.3889679250332 -34.6145450516475,-58.3889569662894 -34.6138369915613,-58.3889507533141 -34.6136383187222,-58.3889426348139 -34.6133790087475,-58.3889483257326 -34.6126268724969,-58.3889413965343 -34.6124676372248)))";;"67";1_18_3;COMUNA 1;"18";"3";"642";"314";"328";"95,73%";"354";"352";"99,44%";"2";"0,57%";"292";"78";"26.71";"214";"73,29%";"26.71";26.710
"MULTIPOLYGON (((-58.3903660605805 -34.6137304369425,-58.3889507533141 -34.6136383187222,-58.3889569662894 -34.6138369915613,-58.3889679250332 -34.6145450516475,-58.3889693247609 -34.6146961142171,-58.3889707309691 -34.6148398525824,-58.3889738022574 -34.6154126212903,-58.3889737472772 -34.615571148013,-58.3891612334102 -34.6155759092244,-58.3902456717985 -34.6156233203183,-58.3903827281172 -34.6156291764923,-58.3903796630875 -34.6150380269016,-58.3903777983197 -34.6148309057441,-58.3903764751748 -34.6146868153172,-58.3903701297199 -34.6139494612787,-58.3903660605805 -34.6137304369425)))";;"68";1_18_4;COMUNA 1;"18";"4";"730";"316";"414";"76,33%";"436";"434";"99,54%";"2";"0,46%";"341";"70";"20.53";"271";"79,47%";"20.53";20.530
"MULTIPOLYGON (((-58.3917102415983 -34.6138250326803,-58.3914320574631 -34.6137998695971,-58.3903660605805 -34.6137304369425,-58.3903701297199 -34.6139494612787,-58.3903764751748 -34.6146868153172,-58.3903777983197 -34.6148309057441,-58.3903796630875 -34.6150380269016,-58.3903827281172 -34.6156291764923,-58.3905990880048 -34.6156384598087,-58.3914328299421 -34.6156867683051,-58.3916586420106 -34.6157002103409,-58.391660336064 -34.6155115426556,-58.3916686253246 -34.6151805497982,-58.3916767718696 -34.6149170240318,-58.3916836907107 -34.6146946961913,-58.391700488375 -34.6140749655259,-58.3917102415983 -34.6138250326803)))";;"69";1_18_5;COMUNA 1;"18";"5";"698";"296";"402";"73,63%";"362";"359";"99,17%";"3";"0,84%";"274";"27";"9.85";"247";"90,15%";"9.85";9.850
"MULTIPOLYGON (((-58.3916586420106 -34.6157002103409,-58.3914328299421 -34.6156867683051,-58.3905990880048 -34.6156384598087,-58.3903827281172 -34.6156291764923,-58.3903833024607 -34.6157527023432,-58.3903550598379 -34.6165918702424,-58.3903511375363 -34.6167925792315,-58.3905112782757 -34.6168016180752,-58.3914625752802 -34.6168645034259,-58.3916751861377 -34.6168787123964,-58.3916574195924 -34.6158352144197,-58.3916586420106 -34.6157002103409)))";;"70";1_18_6;COMUNA 1;"18";"6";"1180";"511";"669";"76,38%";"616";"616";"100,00%";"0";"0,00%";"507";"68";"13.41";"439";"86,59%";"13.41";13.410
"MULTIPOLYGON (((-58.3903827281172 -34.6156291764923,-58.3902456717985 -34.6156233203183,-58.3891612334102 -34.6155759092244,-58.3889737472772 -34.615571148013,-58.3889736020682 -34.6157353791048,-58.389043311035 -34.6165713662987,-58.3890509185666 -34.616734756944,-58.3892874700268 -34.6167441251998,-58.3901447434525 -34.6167809069519,-58.3903511375363 -34.6167925792315,-58.3903550598379 -34.6165918702424,-58.3903833024607 -34.6157527023432,-58.3903827281172 -34.6156291764923)))";;"71";1_18_7;COMUNA 1;"18";"7";"734";"331";"403";"82,13%";"416";"416";"100,00%";"0";"0,00%";"317";"67";"21.14";"250";"78,86%";"21.14";21.140
"MULTIPOLYGON (((-58.3903511375363 -34.6167925792315,-58.3901447434525 -34.6167809069519,-58.3892874700268 -34.6167441251998,-58.3890509185666 -34.616734756944,-58.3890571038498 -34.6168688499177,-58.3889643611647 -34.6179972843145,-58.39012377433 -34.6180686862898,-58.3903259120197 -34.6180806377795,-58.3903511375363 -34.6167925792315)))";;"72";1_18_8;COMUNA 1;"18";"8";"674";"324";"350";"92,57%";"368";"367";"99,73%";"1";"0,27%";"301";"25";"8.31";"276";"91,69%";"8.31";8.310
"MULTIPOLYGON (((-58.3916751861377 -34.6168787123964,-58.3914625752802 -34.6168645034259,-58.3905112782757 -34.6168016180752,-58.3903511375363 -34.6167925792315,-58.3903259120197 -34.6180806377795,-58.3914109656392 -34.6181448000338,-58.3916970106205 -34.6181591927059,-58.3916751861377 -34.6168787123964)))";;"73";1_18_9;COMUNA 1;"18";"9";"650";"307";"343";"89,50%";"528";"528";"100,00%";"0";"0,00%";"303";"39";"12.87";"264";"87,13%";"12.87";12.870
"MULTIPOLYGON (((-58.3889737472772 -34.615571148013,-58.3887986126744 -34.6155666052714,-58.3876656928339 -34.6155339407635,-58.3874836570771 -34.6155309412402,-58.3874789002439 -34.6165547069501,-58.3874880495415 -34.6167053517131,-58.3877072288308 -34.6167081627944,-58.3888020157924 -34.6167248173483,-58.3890509185666 -34.616734756944,-58.389043311035 -34.6165713662987,-58.3889736020682 -34.6157353791048,-58.3889737472772 -34.615571148013)))";;"74";1_19_1;COMUNA 1;"19";"1";"892";"412";"480";"85,83%";"493";"493";"100,00%";"0";"0,00%";"424";"89";"20.99";"335";"79,01%";"20.99";20.990
"MULTIPOLYGON (((-58.3874836570771 -34.6155309412402,-58.387329987182 -34.6155284519483,-58.3860489262473 -34.6155034979941,-58.3859028380228 -34.6155008003928,-58.3859000058399 -34.615708693307,-58.3858882876271 -34.6166854810405,-58.3861819163205 -34.6166909474407,-58.3873064365874 -34.61670298601,-58.3874880495415 -34.6167053517131,-58.3874789002439 -34.6165547069501,-58.3874836570771 -34.6155309412402)))";;"75";1_19_2;COMUNA 1;"19";"2";"1066";"485";"581";"83,48%";"641";"640";"99,84%";"1";"0,16%";"498";"12";"2.41";"486";"97,59%";"2.41";2.410
"MULTIPOLYGON (((-58.3859028380228 -34.6155008003928,-58.3857629681125 -34.6154982473884,-58.3844800638232 -34.6154415845328,-58.3843974165091 -34.6166408697233,-58.3845470769981 -34.616651529444,-58.385704290555 -34.616682055076,-58.3858882876271 -34.6166854810405,-58.3859000058399 -34.615708693307,-58.3859028380228 -34.6155008003928)))";;"76";1_19_3;COMUNA 1;"19";"3";"374";"172";"202";"85,15%";"179";"178";"99,44%";"1";"0,56%";"145";"2";"1.38";"143";"98,62%";"1.38";1.380
"MULTIPOLYGON (((-58.3844800638232 -34.6154415845328,-58.3843818507393 -34.6154372255957,-58.3830676006789 -34.6153805277606,-58.3830600535708 -34.6156122211908,-58.3830623227139 -34.616536410285,-58.3832357476717 -34.6165489886008,-58.3841866823925 -34.6166258041776,-58.3843974165091 -34.6166408697233,-58.3844800638232 -34.6154415845328)))";;"77";1_19_4;COMUNA 1;"19";"4";"720";"356";"364";"97,80%";"400";"399";"99,75%";"1";"0,25%";"303";"17";"5.61";"286";"94,39%";"5.61";5.610
"MULTIPOLYGON (((-58.3830676006789 -34.6153805277606,-58.3829206644381 -34.6153741639331,-58.3818050770654 -34.6153052578693,-58.3816129107084 -34.6152965384409,-58.3815648149735 -34.6164880979196,-58.3815551249047 -34.6167290858885,-58.3815111986209 -34.6176612725449,-58.3817824270083 -34.6176661712257,-58.382846692427 -34.6177206067837,-58.3830140703748 -34.6177344491057,-58.3830627599334 -34.6167029657414,-58.3830623227139 -34.616536410285,-58.3830600535708 -34.6156122211908,-58.3830676006789 -34.6153805277606)))";;"78";1_19_5;COMUNA 1;"19";"5";"643";"293";"350";"83,71%";"365";"363";"99,45%";"2";"0,55%";"271";"19";"7.01";"252";"92,99%";"7.01";7.010
"MULTIPOLYGON (((-58.3843974165091 -34.6166408697233,-58.3841866823925 -34.6166258041776,-58.3832357476717 -34.6165489886008,-58.3830623227139 -34.616536410285,-58.3830627599334 -34.6167029657414,-58.3830140703748 -34.6177344491057,-58.3833030849285 -34.6177583707742,-58.3843178769255 -34.6177939578128,-58.3843974165091 -34.6166408697233)))";;"79";1_19_6;COMUNA 1;"19";"6";"431";"214";"217";"98,62%";"229";"228";"99,56%";"1";"0,44%";"216";"108";"50";"108";"50,00%";"50";50.000
"MULTIPOLYGON (((-58.3858882876271 -34.6166854810405,-58.385704290555 -34.616682055076,-58.3845470769981 -34.616651529444,-58.3843974165091 -34.6166408697233,-58.3843178769255 -34.6177939578128,-58.3855725471873 -34.6178378576043,-58.3858742673712 -34.6178490342878,-58.3858882876271 -34.6166854810405)))";;"80";1_19_7;COMUNA 1;"19";"7";"746";"370";"376";"98,40%";"402";"400";"99,50%";"2";"0,50%";"325";"106";"32.62";"219";"67,38%";"32.62";32.620
"MULTIPOLYGON (((-58.3874880495415 -34.6167053517131,-58.3873064365874 -34.61670298601,-58.3861819163205 -34.6166909474407,-58.3858882876271 -34.6166854810405,-58.3858742673712 -34.6178490342878,-58.3872033023912 -34.6178981755675,-58.3874603851038 -34.6179095319708,-58.3874972820244 -34.6168582501236,-58.3874880495415 -34.6167053517131)))";;"81";1_19_8;COMUNA 1;"19";"8";"450";"240";"210";"114,29%";"187";"184";"98,40%";"3";"1,63%";"160";"103";"64.38";"57";"35,63%";"64.38";64.380
"MULTIPOLYGON (((-58.3890509185666 -34.616734756944,-58.3888020157924 -34.6167248173483,-58.3877072288308 -34.6167081627944,-58.3874880495415 -34.6167053517131,-58.3874972820244 -34.6168582501236,-58.3874603851038 -34.6179095319708,-58.3877372303982 -34.6179217450778,-58.3889643611647 -34.6179972843145,-58.3890571038498 -34.6168688499177,-58.3890509185666 -34.616734756944)))";;"82";1_19_9;COMUNA 1;"19";"9";"507";"221";"286";"77,27%";"292";"291";"99,66%";"1";"0,34%";"223";"7";"3.14";"216";"96,86%";"3.14";3.140
"MULTIPOLYGON (((-58.3916970106205 -34.6181591927059,-58.3914109656392 -34.6181448000338,-58.3903259120197 -34.6180806377795,-58.3903119784378 -34.6183323284815,-58.3902735889417 -34.6189844411968,-58.3916659597938 -34.619109348745,-58.3916970106205 -34.6181591927059)))";;"83";1_20_1;COMUNA 1;"20";"1";"627";"285";"342";"83,33%";"344";"343";"99,71%";"1";"0,29%";"259";"68";"26.25";"191";"73,75%";"26.25";26.250
"MULTIPOLYGON (((-58.3900303404585 -34.6214710730711,-58.3887414871601 -34.6213874082887,-58.3886730179669 -34.6223201453835,-58.3886508256198 -34.6225599993125,-58.3898874815497 -34.6226357463088,-58.391488484532 -34.622733807443,-58.3915537207467 -34.621559931842,-58.3902474780142 -34.6214851463732,-58.3900303404585 -34.6214710730711)))";;"84";1_20_10;COMUNA 1;"20";"10";"860";"398";"462";"86,15%";"383";"382";"99,74%";"1";"0,26%";"316";"78";"24.68";"238";"75,32%";"24.68";24.680
"MULTIPOLYGON (((-58.3903259120197 -34.6180806377795,-58.39012377433 -34.6180686862898,-58.3889643611647 -34.6179972843145,-58.3877372303982 -34.6179217450778,-58.3874603851038 -34.6179095319708,-58.3874189580216 -34.6187879174642,-58.3876628366072 -34.618802434417,-58.388682310607 -34.6188582000081,-58.3889136670625 -34.6188727068621,-58.389148430913 -34.6188874266067,-58.3900174497757 -34.6189614007342,-58.3902735889417 -34.6189844411968,-58.3903119784378 -34.6183323284815,-58.3903259120197 -34.6180806377795)))";;"85";1_20_2;COMUNA 1;"20";"2";"738";"331";"407";"81,33%";"371";"370";"99,73%";"1";"0,27%";"298";"31";"10.4";"267";"89,60%";"10.4";10.400
"MULTIPOLYGON (((-58.3889136670625 -34.6188727068621,-58.388682310607 -34.6188582000081,-58.3876628366072 -34.618802434417,-58.3874189580216 -34.6187879174642,-58.3874081368018 -34.6189792554997,-58.3873195947248 -34.6199569813686,-58.3874276920519 -34.6199647948647,-58.3888380825902 -34.6200527022541,-58.3889053491256 -34.6190308059466,-58.3889136670625 -34.6188727068621)))";;"86";1_20_3;COMUNA 1;"20";"3";"567";"254";"313";"81,15%";"311";"311";"100,00%";"0";"0,00%";"238";"21";"8.82";"217";"91,18%";"8.82";8.820
"MULTIPOLYGON (((-58.3902735889417 -34.6189844411968,-58.3900174497757 -34.6189614007342,-58.389148430913 -34.6188874266067,-58.3889136670625 -34.6188727068621,-58.3889053491256 -34.6190308059466,-58.3888380825902 -34.6200527022541,-58.3901963434759 -34.6201372523919,-58.3902150533764 -34.6199776804971,-58.3902735889417 -34.6189844411968)))";;"87";1_20_4;COMUNA 1;"20";"4";"769";"313";"456";"68,64%";"447";"447";"100,00%";"0";"0,00%";"343";"44";"12.83";"299";"87,17%";"12.83";12.830
"MULTIPOLYGON (((-58.3916659597938 -34.619109348745,-58.3902735889417 -34.6189844411968,-58.3902150533764 -34.6199776804971,-58.3901963434759 -34.6201372523919,-58.3904081966141 -34.6201504771681,-58.3913097888688 -34.6202046719622,-58.3916226707086 -34.6202245736595,-58.3916659597938 -34.619109348745)))";;"88";1_20_5;COMUNA 1;"20";"5";"700";"304";"396";"76,77%";"469";"469";"100,00%";"0";"0,00%";"352";"6";"1.7";"346";"98,30%";"1.7";1.700
"MULTIPOLYGON (((-58.3916226707086 -34.6202245736595,-58.3913097888688 -34.6202046719622,-58.3904081966141 -34.6201504771681,-58.3901963434759 -34.6201372523919,-58.3901784054109 -34.6202908386152,-58.3900303404585 -34.6214710730711,-58.3902474780142 -34.6214851463732,-58.3915537207467 -34.621559931842,-58.3916104757163 -34.6205395070681,-58.3916226707086 -34.6202245736595)))";;"89";1_20_6;COMUNA 1;"20";"6";"785";"349";"436";"80,05%";"388";"387";"99,74%";"1";"0,26%";"336";"58";"17.26";"278";"82,74%";"17.26";17.260
"MULTIPOLYGON (((-58.3901963434759 -34.6201372523919,-58.3888380825902 -34.6200527022541,-58.3888259077381 -34.6202369266351,-58.3887414871601 -34.6213874082887,-58.3900303404585 -34.6214710730711,-58.3901784054109 -34.6202908386152,-58.3901963434759 -34.6201372523919)))";;"90";1_20_7;COMUNA 1;"20";"7";"481";"211";"270";"78,15%";"320";"320";"100,00%";"0";"0,00%";"207";"5";"2.42";"202";"97,58%";"2.42";2.420
"MULTIPOLYGON (((-58.3888380825902 -34.6200527022541,-58.3874276920519 -34.6199647948647,-58.3873195947248 -34.6199569813686,-58.3872128934888 -34.6211357590713,-58.387209033729 -34.6212587891037,-58.3874660322084 -34.6212805683391,-58.3885245204982 -34.62137333241,-58.3887414871601 -34.6213874082887,-58.3888259077381 -34.6202369266351,-58.3888380825902 -34.6200527022541)))";;"91";1_20_8;COMUNA 1;"20";"8";"563";"249";"314";"79,30%";"332";"331";"99,70%";"1";"0,30%";"218";"65";"29.82";"153";"70,18%";"29.82";29.820
"MULTIPOLYGON (((-58.3887414871601 -34.6213874082887,-58.3885245204982 -34.62137333241,-58.3874660322084 -34.6212805683391,-58.387209033729 -34.6212587891037,-58.3872033306286 -34.6214418200641,-58.387179570464 -34.6224675449031,-58.3875458725623 -34.6224898141381,-58.3882995158767 -34.6225385172147,-58.3886508256198 -34.6225599993125,-58.3886730179669 -34.6223201453835,-58.3887414871601 -34.6213874082887)))";;"92";1_20_9;COMUNA 1;"20";"9";"572";"275";"297";"92,59%";"316";"316";"100,00%";"0";"0,00%";"247";"21";"8.5";"226";"91,50%";"8.5";8.500
"MULTIPOLYGON (((-58.3874603851038 -34.6179095319708,-58.3872033023912 -34.6178981755675,-58.3858742673712 -34.6178490342878,-58.3858642971964 -34.6186846206585,-58.3861155004056 -34.6187001312676,-58.3871425396018 -34.6187715488243,-58.3874189580216 -34.6187879174642,-58.3874603851038 -34.6179095319708)))";;"93";1_21_1;COMUNA 1;"21";"1";"627";"275";"352";"78,13%";"325";"324";"99,69%";"1";"0,31%";"266";"78";"29.32";"188";"70,68%";"29.32";29.320
"MULTIPOLYGON (((-58.3829769466887 -34.6197651295756,-58.3827904685709 -34.6197657822408,-58.3816847340188 -34.6197540666229,-58.3814423716614 -34.619755384351,-58.3814461030761 -34.6198601087841,-58.3814575503333 -34.6201769583896,-58.3814554282643 -34.6209558571761,-58.3814545981923 -34.6212831214424,-58.3814269908217 -34.6221629220712,-58.3829611161054 -34.6222438668531,-58.3829680593092 -34.6211303119107,-58.3829689481958 -34.6210025615997,-58.3829769466887 -34.6197651295756)))";;"94";1_21_10;COMUNA 1;"21";"10";"816";"391";"425";"92,00%";"546";"544";"99,63%";"2";"0,37%";"376";"65";"17.29";"311";"82,71%";"17.29";17.290
"MULTIPOLYGON (((-58.3858742673712 -34.6178490342878,-58.3855725471873 -34.6178378576043,-58.3843178769255 -34.6177939578128,-58.3833030849285 -34.6177583707742,-58.3830140703748 -34.6177344491057,-58.382846692427 -34.6177206067837,-58.3817824270083 -34.6176661712257,-58.3815111986209 -34.6176612725449,-58.3815008470633 -34.6178814142215,-58.3814710222347 -34.6184158496974,-58.3814674128537 -34.618535640214,-58.3816650419902 -34.6185409126765,-58.3827917842612 -34.618570811875,-58.382977737607 -34.6185816381373,-58.3831472508152 -34.6185914674465,-58.384023126009 -34.6186126699963,-58.3842929925352 -34.6186198158185,-58.3844607221366 -34.6186242194315,-58.3856575593643 -34.6186718137717,-58.3858642971964 -34.6186846206585,-58.3858742673712 -34.6178490342878)))";;"95";1_21_2;COMUNA 1;"21";"2";"640";"317";"323";"98,14%";"319";"319";"100,00%";"0";"0,00%";"266";"59";"22.18";"207";"77,82%";"22.18";22.180
"MULTIPOLYGON (((-58.382977737607 -34.6185816381373,-58.3827917842612 -34.618570811875,-58.3816650419902 -34.6185409126765,-58.3814674128537 -34.618535640214,-58.3814533307967 -34.6189995906943,-58.3814359041401 -34.619573613161,-58.3814423716614 -34.619755384351,-58.3816847340188 -34.6197540666229,-58.3827904685709 -34.6197657822408,-58.3829769466887 -34.6197651295756,-58.3829776527081 -34.6196504077385,-58.3829715433814 -34.6187342450552,-58.382977737607 -34.6185816381373)))";;"96";1_21_3;COMUNA 1;"21";"3";"400";"192";"208";"92,31%";"182";"182";"100,00%";"0";"0,00%";"170";"54";"31.76";"116";"68,24%";"31.76";31.760
"MULTIPOLYGON (((-58.3842929925352 -34.6186198158185,-58.384023126009 -34.6186126699963,-58.3831472508152 -34.6185914674465,-58.382977737607 -34.6185816381373,-58.3829715433814 -34.6187342450552,-58.3829776527081 -34.6196504077385,-58.3829769466887 -34.6197651295756,-58.3829689481958 -34.6210025615997,-58.3841415503689 -34.6210387461311,-58.3843470174424 -34.6210500054206,-58.3843535704753 -34.6199691975337,-58.3843446947685 -34.619805031199,-58.3842918618865 -34.6188256673548,-58.3842929925352 -34.6186198158185)))";;"97";1_21_4;COMUNA 1;"21";"4";"1160";"552";"608";"90,79%";"549";"548";"99,82%";"1";"0,18%";"500";"195";"39";"305";"61,00%";"39";39.000
"MULTIPOLYGON (((-58.3858642971964 -34.6186846206585,-58.3856575593643 -34.6186718137717,-58.3844607221366 -34.6186242194315,-58.3842929925352 -34.6186198158185,-58.3842918618865 -34.6188256673548,-58.3843446947685 -34.619805031199,-58.3845804027721 -34.6198141263413,-58.3856392540104 -34.6198592379734,-58.3858330471705 -34.6198709099352,-58.3858620882361 -34.6188630762077,-58.3858642971964 -34.6186846206585)))";;"98";1_21_5;COMUNA 1;"21";"5";"724";"354";"370";"95,68%";"374";"372";"99,47%";"2";"0,54%";"275";"56";"20.36";"219";"79,64%";"20.36";20.360
"MULTIPOLYGON (((-58.3874189580216 -34.6187879174642,-58.3871425396018 -34.6187715488243,-58.3861155004056 -34.6187001312676,-58.3858642971964 -34.6186846206585,-58.3858620882361 -34.6188630762077,-58.3858330471705 -34.6198709099352,-58.3860232627271 -34.6198822976406,-58.3871800648728 -34.6199468947225,-58.3873195947248 -34.6199569813686,-58.3874081368018 -34.6189792554997,-58.3874189580216 -34.6187879174642)))";;"99";1_21_6;COMUNA 1;"21";"6";"602";"274";"328";"83,54%";"319";"317";"99,37%";"2";"0,63%";"264";"70";"26.52";"194";"73,48%";"26.52";26.520
"MULTIPOLYGON (((-58.385840551573 -34.6211561000529,-58.3858425276386 -34.6213227971966,-58.3858297861835 -34.6223912766704,-58.3868594396584 -34.6224480498555,-58.387179570464 -34.6224675449031,-58.3872033306286 -34.6214418200641,-58.387209033729 -34.6212587891037,-58.3872128934888 -34.6211357590713,-58.3873195947248 -34.6199569813686,-58.3871800648728 -34.6199468947225,-58.3860232627271 -34.6198822976406,-58.3858330471705 -34.6198709099352,-58.3858278528018 -34.6200533777917,-58.385840551573 -34.6211561000529)))";;"100";1_21_7;COMUNA 1;"21";"7";"785";"375";"410";"91,46%";"390";"389";"99,74%";"1";"0,26%";"332";"111";"33.43";"221";"66,57%";"33.43";33.430
"MULTIPOLYGON (((-58.3843470174424 -34.6210500054206,-58.3843459046212 -34.6212369829958,-58.3843912357831 -34.6223145140024,-58.3847714261386 -34.6223329975354,-58.3858297861835 -34.6223912766704,-58.3858425276386 -34.6213227971966,-58.385840551573 -34.6211561000529,-58.3858278528018 -34.6200533777917,-58.3858330471705 -34.6198709099352,-58.3856392540104 -34.6198592379734,-58.3845804027721 -34.6198141263413,-58.3843446947685 -34.619805031199,-58.3843535704753 -34.6199691975337,-58.3843470174424 -34.6210500054206)))";;"101";1_21_8;COMUNA 1;"21";"8";"553";"243";"310";"78,39%";"332";"329";"99,10%";"3";"0,91%";"240";"38";"15.83";"202";"84,17%";"15.83";15.830
"MULTIPOLYGON (((-58.3843470174424 -34.6210500054206,-58.3841415503689 -34.6210387461311,-58.3829689481958 -34.6210025615997,-58.3829680593092 -34.6211303119107,-58.3829611161054 -34.6222438668531,-58.3832501544623 -34.6222591968118,-58.3843912357831 -34.6223145140024,-58.3843459046212 -34.6212369829958,-58.3843470174424 -34.6210500054206)))";;"102";1_21_9;COMUNA 1;"21";"9";"709";"319";"390";"81,79%";"430";"429";"99,77%";"1";"0,23%";"328";"31";"9.45";"297";"90,55%";"9.45";9.450
"MULTIPOLYGON (((-58.3838433859003 -34.5876791725766,-58.3828356615704 -34.5882270988567,-58.3835461730799 -34.5896079688361,-58.383674916619 -34.5895336831199,-58.3849489686869 -34.5887920071339,-58.3838433859003 -34.5876791725766)))";;"103";1_4_1;COMUNA 1;"4";"1";"1472";"656";"816";"80,39%";"1244";"1244";"100,00%";"0";"0,00%";"663";"31";"4.68";"632";"95,32%";"4.68";4.680
"MULTIPOLYGON (((-58.3828356615704 -34.5882270988567,-58.3819683995856 -34.5886992231426,-58.3809054173487 -34.5892778341573,-58.3814365889015 -34.5903682322362,-58.3815499075485 -34.5902210482916,-58.3815912484986 -34.5901807220642,-58.3816421190493 -34.5901487123406,-58.3817002184319 -34.5901265669394,-58.3817626502612 -34.5901153403091,-58.3822340088865 -34.5901068488453,-58.3823639625223 -34.590104469575,-58.3826914012896 -34.5900985576813,-58.3835461730799 -34.5896079688361,-58.3828356615704 -34.5882270988567)))";;"104";1_4_2;COMUNA 1;"4";"2";"1299";"584";"715";"81,68%";"938";"938";"100,00%";"0";"0,00%";"616";"2";"0.32";"614";"99,68%";"0.32";0.320
"MULTIPOLYGON (((-58.3842759889451 -34.5908610248398,-58.3842105510325 -34.5908991532922,-58.3835461730799 -34.5896079688361,-58.3826914012896 -34.5900985576813,-58.3823639625223 -34.590104469575,-58.3822340088865 -34.5901068488453,-58.3817626502612 -34.5901153403091,-58.3817002184319 -34.5901265669394,-58.3816421190493 -34.5901487123406,-58.3815912484986 -34.5901807220642,-58.3815499075485 -34.5902210482916,-58.3814365889015 -34.5903682322362,-58.3815462244799 -34.5905932436656,-58.3815460674703 -34.5913677811722,-58.3815570817364 -34.5916010371192,-58.3818446741824 -34.5915925656913,-58.3820625188788 -34.5915860898522,-58.3821649688806 -34.5915830587915,-58.3827323185218 -34.5915663889598,-58.3828931044783 -34.5915616348677,-58.3830824196833 -34.5915560540762,-58.3831483350795 -34.5915541251538,-58.3843319163423 -34.5915193261771,-58.3842759889451 -34.5908610248398)))";;"105";1_4_3;COMUNA 1;"4";"3";"1189";"522";"667";"78,26%";"542";"541";"99,82%";"1";"0,18%";"469";"22";"4.69";"447";"95,31%";"4.69";4.690
"MULTIPOLYGON (((-58.3849489686869 -34.5887920071339,-58.383674916619 -34.5895336831199,-58.3835461730799 -34.5896079688361,-58.3842105510325 -34.5908991532922,-58.3842759889451 -34.5908610248398,-58.3843304352904 -34.5908292979979,-58.3849131043913 -34.5904509938362,-58.3858418873776 -34.5898480372589,-58.3859359583781 -34.5897864038775,-58.3849489686869 -34.5887920071339)))";;"106";1_4_4;COMUNA 1;"4";"4";"1545";"658";"887";"74,18%";"660";"659";"99,85%";"1";"0,15%";"604";"4";"0.66";"600";"99,34%";"0.66";0.660
"MULTIPOLYGON (((-58.3859359583781 -34.5897864038775,-58.3858418873776 -34.5898480372589,-58.3849131043913 -34.5904509938362,-58.3859170047439 -34.5914128647597,-58.3860085633708 -34.5914922916591,-58.386080745985 -34.5914351516466,-58.3869174413735 -34.590775155048,-58.3859359583781 -34.5897864038775)))";;"107";1_4_5;COMUNA 1;"4";"5";"1069";"500";"569";"87,87%";"483";"483";"100,00%";"0";"0,00%";"384";"1";"0.26";"383";"99,74%";"0.26";0.260
"MULTIPOLYGON (((-58.3849131043913 -34.5904509938362,-58.3843304352904 -34.5908292979979,-58.3842759889451 -34.5908610248398,-58.3843319163423 -34.5915193261771,-58.3844356903732 -34.5927377505194,-58.3860085633708 -34.5914922916591,-58.3859170047439 -34.5914128647597,-58.3849131043913 -34.5904509938362)))";;"108";1_4_6;COMUNA 1;"4";"6";"1271";"480";"791";"60,68%";"517";"516";"99,81%";"1";"0,19%";"486";"15";"3.09";"471";"96,91%";"3.09";3.090
"MULTIPOLYGON (((-58.3870574402012 -34.5923750232724,-58.3860771473765 -34.5915517737031,-58.3860085633708 -34.5914922916591,-58.3844356903732 -34.5927377505194,-58.3844431021733 -34.5928255756163,-58.3862516744825 -34.5928151018307,-58.3865040818596 -34.5928256122097,-58.386892277049 -34.592509503535,-58.3870574402012 -34.5923750232724)))";;"109";1_4_7;COMUNA 1;"4";"7";"1393";"635";"758";"83,77%";"672";"670";"99,70%";"2";"0,30%";"549";"25";"4.55";"524";"95,45%";"4.55";4.550
"MULTIPOLYGON (((-58.386892277049 -34.592509503535,-58.3865040818596 -34.5928256122097,-58.3867047984975 -34.5928340475541,-58.3870289222642 -34.5928326996121,-58.38756654533 -34.5928304260636,-58.3879097520326 -34.5916810142272,-58.3879499768136 -34.5916482206778,-58.3878782380866 -34.5915914139141,-58.3869174413735 -34.590775155048,-58.386080745985 -34.5914351516466,-58.3860085633708 -34.5914922916591,-58.3860771473765 -34.5915517737031,-58.3870574402012 -34.5923750232724,-58.386892277049 -34.592509503535)))";;"110";1_4_8;COMUNA 1;"4";"8";"1128";"469";"659";"71,17%";"500";"499";"99,80%";"1";"0,20%";"451";"3";"0.67";"448";"99,33%";"0.67";0.670
"MULTIPOLYGON (((-58.3801567862919 -34.6197622679979,-58.3803442014167 -34.6197616904162,-58.3806149318118 -34.6197601122617,-58.3810379799083 -34.6197577200401,-58.3811201872405 -34.6197572116433,-58.3814423716614 -34.619755384351,-58.3814359041401 -34.619573613161,-58.3814533307967 -34.6189995906943,-58.3814674128537 -34.618535640214,-58.3814710222347 -34.6184158496974,-58.3815008470633 -34.6178814142215,-58.3815111986209 -34.6176612725449,-58.3811329782256 -34.6176544002961,-58.3806837989538 -34.6176462819647,-58.3802744862214 -34.6176388931721,-58.3800431244626 -34.6176347224069,-58.3798634788662 -34.6176224170297,-58.3789485559858 -34.6175601000405,-58.3787729992231 -34.6175482184147,-58.3787612124186 -34.6177483581691,-58.3787322291182 -34.6183602610498,-58.378727805571 -34.6185232918699,-58.3786947273132 -34.6197323957107,-58.3789374277004 -34.6197337598228,-58.3799236248669 -34.6197629551091,-58.3801567862919 -34.6197622679979)))";;"111";1_22_1;COMUNA 1;"22";"1";"567";"265";"302";"87,75%";"367";"367";"100,00%";"0";"0,00%";"261";"1";"0.38";"260";"99,62%";"0.38";0.380
"MULTIPOLYGON (((-58.3785871315264 -34.6236191454395,-58.3772510958531 -34.6235006072314,-58.3770828547312 -34.6234873902259,-58.3770652741459 -34.623600480332,-58.3767505462915 -34.6251141836173,-58.3780062655349 -34.6256555027427,-58.3780555695417 -34.6255948306912,-58.3785871315264 -34.6236191454395)))";;"112";1_22_10;COMUNA 1;"22";"10";"1231";"601";"630";"95,40%";"737";"737";"100,00%";"0";"0,00%";"582";"85";"14.6";"497";"85,40%";"14.6";14.600
"MULTIPOLYGON (((-58.3787729992231 -34.6175482184147,-58.3773579847421 -34.617452303826,-58.3773484450823 -34.6176175846395,-58.3773064416184 -34.6184558240132,-58.3773035302548 -34.618553642292,-58.378727805571 -34.6185232918699,-58.3787322291182 -34.6183602610498,-58.3787612124186 -34.6177483581691,-58.3787729992231 -34.6175482184147)))";;"113";1_22_2;COMUNA 1;"22";"2";"810";"352";"458";"76,86%";"564";"563";"99,82%";"1";"0,18%";"422";"42";"9.95";"380";"90,05%";"9.95";9.950
"MULTIPOLYGON (((-58.378727805571 -34.6185232918699,-58.3773035302548 -34.618553642292,-58.3772680004856 -34.6197240806939,-58.3786947273132 -34.6197323957107,-58.378727805571 -34.6185232918699)))";;"114";1_22_3;COMUNA 1;"22";"3";"817";"370";"447";"82,77%";"461";"461";"100,00%";"0";"0,00%";"371";"76";"20.49";"295";"79,51%";"20.49";20.490
"MULTIPOLYGON (((-58.3786947273132 -34.6197323957107,-58.3772680004856 -34.6197240806939,-58.3772652669117 -34.619814574878,-58.3772245501746 -34.620808383576,-58.3772283057935 -34.6208843747468,-58.3785502017924 -34.6208751525804,-58.3786639253875 -34.6208795973239,-58.3786718773886 -34.6207659369031,-58.3786918966873 -34.6198362001821,-58.3786947273132 -34.6197323957107)))";;"115";1_22_4;COMUNA 1;"22";"4";"446";"203";"243";"83,54%";"269";"267";"99,26%";"2";"0,75%";"207";"30";"14.49";"177";"85,51%";"14.49";14.490
"MULTIPOLYGON (((-58.3811201872405 -34.6197572116433,-58.3810379799083 -34.6197577200401,-58.3806149318118 -34.6197601122617,-58.3803442014167 -34.6197616904162,-58.3801567862919 -34.6197622679979,-58.3799236248669 -34.6197629551091,-58.3789374277004 -34.6197337598228,-58.3786947273132 -34.6197323957107,-58.3786918966873 -34.6198362001821,-58.3786718773886 -34.6207659369031,-58.3786639253875 -34.6208795973239,-58.3789287693302 -34.6208899911038,-58.3800869579993 -34.620939374178,-58.3800046690975 -34.6221373878542,-58.3802462671519 -34.6221406500936,-58.3803952639967 -34.6221426521871,-58.3807704395486 -34.6221477640643,-58.380994658946 -34.6221508018734,-58.3810404924346 -34.6221499874641,-58.3811470680088 -34.622148157287,-58.3814269908217 -34.6221629220712,-58.3814545981923 -34.6212831214424,-58.3814554282643 -34.6209558571761,-58.3814575503333 -34.6201769583896,-58.3814461030761 -34.6198601087841,-58.3814423716614 -34.619755384351,-58.3811201872405 -34.6197572116433)))";;"116";1_22_5;COMUNA 1;"22";"5";"447";"178";"269";"66,17%";"252";"251";"99,60%";"1";"0,40%";"186";"0";"0";"186";"100,00%";"0";0.000
"MULTIPOLYGON (((-58.3800869579993 -34.620939374178,-58.3789287693302 -34.6208899911038,-58.3786639253875 -34.6208795973239,-58.3786549356825 -34.6210085392448,-58.3786258264053 -34.6219123531322,-58.3786166908875 -34.6221012265634,-58.3800046690975 -34.6221373878542,-58.3800869579993 -34.620939374178)))";;"117";1_22_6;COMUNA 1;"22";"6";"578";"247";"331";"74,62%";"355";"353";"99,44%";"2";"0,57%";"259";"39";"15.06";"220";"84,94%";"15.06";15.060
"MULTIPOLYGON (((-58.3786639253875 -34.6208795973239,-58.3785502017924 -34.6208751525804,-58.3772283057935 -34.6208843747468,-58.3772345660637 -34.6210101581217,-58.3772114266099 -34.6218926370807,-58.3771985550991 -34.6220662959957,-58.3783860854038 -34.6220952221217,-58.3786166908875 -34.6221012265634,-58.3786258264053 -34.6219123531322,-58.3786549356825 -34.6210085392448,-58.3786639253875 -34.6208795973239)))";;"118";1_22_7;COMUNA 1;"22";"7";"562";"283";"279";"101,43%";"334";"332";"99,40%";"2";"0,60%";"268";"40";"14.93";"228";"85,07%";"14.93";14.930
"MULTIPOLYGON (((-58.3800046690975 -34.6221373878542,-58.3786166908875 -34.6221012265634,-58.3783860854038 -34.6220952221217,-58.3771985550991 -34.6220662959957,-58.3771031794206 -34.6233567662312,-58.3770828547312 -34.6234873902259,-58.3772510958531 -34.6235006072314,-58.3785871315264 -34.6236191454395,-58.3797769936261 -34.6237246819728,-58.3798049031677 -34.6235014538931,-58.3798859651625 -34.6229424757691,-58.3799421503472 -34.6225550358428,-58.3800046690975 -34.6221373878542)))";;"119";1_22_8;COMUNA 1;"22";"8";"533";"254";"279";"91,04%";"360";"358";"99,44%";"2";"0,56%";"276";"52";"18.84";"224";"81,16%";"18.84";18.840
"MULTIPOLYGON (((-58.3802462671519 -34.6221406500936,-58.3800046690975 -34.6221373878542,-58.3799421503472 -34.6225550358428,-58.3798859651625 -34.6229424757691,-58.3798049031677 -34.6235014538931,-58.3797769936261 -34.6237246819728,-58.3785871315264 -34.6236191454395,-58.3780555695417 -34.6255948306912,-58.3780062655349 -34.6256555027427,-58.3790090846087 -34.6260845896253,-58.3800548541066 -34.626340170385,-58.3801817641964 -34.6263711728379,-58.380347108283 -34.626046273634,-58.3808895537574 -34.6246474363945,-58.3814223684139 -34.6246320878171,-58.3814419362062 -34.6239603174488,-58.38144608188 -34.6238150335705,-58.3814518133062 -34.6236160869425,-58.3814443857735 -34.622933100912,-58.3814378939378 -34.6223390621433,-58.3814269908217 -34.6221629220712,-58.3811470680088 -34.622148157287,-58.3810404924346 -34.6221499874641,-58.380994658946 -34.6221508018734,-58.3807704395486 -34.6221477640643,-58.3803952639967 -34.6221426521871,-58.3802462671519 -34.6221406500936)))";;"120";1_22_9;COMUNA 1;"22";"9";"880";"413";"467";"88,44%";"441";"441";"100,00%";"0";"0,00%";"377";"68";"18.04";"309";"81,96%";"18.04";18.040
"MULTIPOLYGON (((-58.3759113723653 -34.6173536742002,-58.3759005297711 -34.6175403631752,-58.3758616307753 -34.6184102250821,-58.3758498241491 -34.6185407846149,-58.3771889509576 -34.6185560973306,-58.3773035302548 -34.618553642292,-58.3773064416184 -34.6184558240132,-58.3773484450823 -34.6176175846395,-58.3773579847421 -34.617452303826,-58.3774253595202 -34.6162934369269,-58.3772630048181 -34.6162859287065,-58.3761545512996 -34.6162307088511,-58.375976099996 -34.6162202296472,-58.3759709646581 -34.6163254409747,-58.3759113723653 -34.6173536742002)))";;"121";1_23_1;COMUNA 1;"23";"1";"607";"275";"332";"82,83%";"362";"361";"99,72%";"1";"0,28%";"272";"3";"1.1";"269";"98,90%";"1.1";1.100
"MULTIPOLYGON (((-58.3773035302548 -34.618553642292,-58.3771889509576 -34.6185560973306,-58.3758498241491 -34.6185407846149,-58.375840344761 -34.618645218129,-58.3757999035413 -34.6196041663603,-58.3758008322825 -34.6196938884462,-58.377162367533 -34.6197234432717,-58.3772680004856 -34.6197240806939,-58.3773035302548 -34.618553642292)))";;"122";1_23_10;COMUNA 1;"23";"10";"362";"177";"185";"95,68%";"191";"190";"99,48%";"1";"0,53%";"150";"51";"34";"99";"66,00%";"34";34.000
"MULTIPOLYGON (((-58.3759113723653 -34.6173536742002,-58.3744386986059 -34.6172531070939,-58.3744287230038 -34.6174224015897,-58.3743653762301 -34.6184378137938,-58.3743612881232 -34.6185173910749,-58.3744884642554 -34.6185252298502,-58.3758498241491 -34.6185407846149,-58.3758616307753 -34.6184102250821,-58.3759005297711 -34.6175403631752,-58.3759113723653 -34.6173536742002)))";;"123";1_23_2;COMUNA 1;"23";"2";"525";"258";"267";"96,63%";"313";"312";"99,68%";"1";"0,32%";"219";"1";"0.46";"218";"99,54%";"0.46";0.460
"MULTIPOLYGON (((-58.375976099996 -34.6162202296472,-58.3758580411228 -34.616213244013,-58.3752514396762 -34.6161324557527,-58.3747057840759 -34.6160967100387,-58.3745333791936 -34.6160882754112,-58.3744489344196 -34.6170793760052,-58.3744386986059 -34.6172531070939,-58.3759113723653 -34.6173536742002,-58.3759709646581 -34.6163254409747,-58.375976099996 -34.6162202296472)))";;"124";1_23_3;COMUNA 1;"23";"3";"790";"388";"402";"96,52%";"508";"505";"99,41%";"3";"0,59%";"373";"28";"7.51";"345";"92,49%";"7.51";7.510
"MULTIPOLYGON (((-58.3745333791936 -34.6160882754112,-58.3743374645162 -34.6160787671387,-58.3732675070753 -34.6160348169336,-58.3731275539996 -34.6160299253558,-58.3731234563612 -34.6161173902211,-58.3730827269358 -34.617158101147,-58.3744386986059 -34.6172531070939,-58.3744489344196 -34.6170793760052,-58.3745333791936 -34.6160882754112)))";;"125";1_23_4;COMUNA 1;"23";"4";"370";"174";"196";"88,78%";"169";"168";"99,41%";"1";"0,60%";"131";"33";"25.19";"98";"74,81%";"25.19";25.190
"MULTIPOLYGON (((-58.3731275539996 -34.6160299253558,-58.3729908378018 -34.6160251768477,-58.3717140906037 -34.6160254285446,-58.3717093231473 -34.6161008501836,-58.3716872472783 -34.6166590928085,-58.3716837431637 -34.6167476848581,-58.3716715862612 -34.617037263424,-58.3716664626548 -34.6172047302656,-58.3718665647362 -34.6172041751697,-58.3730827269358 -34.617158101147,-58.3731234563612 -34.6161173902211,-58.3731275539996 -34.6160299253558)))";;"126";1_23_5;COMUNA 1;"23";"5";"501";"246";"255";"96,47%";"250";"250";"100,00%";"0";"0,00%";"228";"46";"20.18";"182";"79,82%";"20.18";20.180
"MULTIPOLYGON (((-58.3730827269358 -34.617158101147,-58.3718665647362 -34.6172041751697,-58.3716664626548 -34.6172047302656,-58.3716605429028 -34.6173991692844,-58.3716355908853 -34.617860293563,-58.3716062905254 -34.6184026145701,-58.371599814165 -34.6184825420986,-58.3728928432387 -34.618506881938,-58.3730191789324 -34.6185039466026,-58.3730306965539 -34.6184085996302,-58.3730827269358 -34.617158101147)))";;"127";1_23_6;COMUNA 1;"23";"6";"484";"210";"274";"76,64%";"274";"273";"99,64%";"1";"0,37%";"214";"1";"0.47";"213";"99,53%";"0.47";0.470
"MULTIPOLYGON (((-58.3744386986059 -34.6172531070939,-58.3730827269358 -34.617158101147,-58.3730306965539 -34.6184085996302,-58.3730191789324 -34.6185039466026,-58.3731415106738 -34.6185011490469,-58.3742765324193 -34.6185121886466,-58.3743612881232 -34.6185173910749,-58.3743653762301 -34.6184378137938,-58.3744287230038 -34.6174224015897,-58.3744386986059 -34.6172531070939)))";;"128";1_23_7;COMUNA 1;"23";"7";"568";"282";"286";"98,60%";"314";"314";"100,00%";"0";"0,00%";"265";"96";"36.23";"169";"63,77%";"36.23";36.230
"MULTIPOLYGON (((-58.3730191789324 -34.6185039466026,-58.3728928432387 -34.618506881938,-58.371599814165 -34.6184825420986,-58.3715240813667 -34.6194186448452,-58.3715164872341 -34.6195078676176,-58.371625858827 -34.619517034142,-58.3727752175845 -34.6195961289515,-58.3729379181572 -34.6196044884994,-58.3743019734298 -34.6196652753682,-58.3743612881232 -34.6185173910749,-58.3742765324193 -34.6185121886466,-58.3731415106738 -34.6185011490469,-58.3730191789324 -34.6185039466026)))";;"129";1_23_8;COMUNA 1;"23";"8";"681";"326";"355";"91,83%";"364";"363";"99,73%";"1";"0,28%";"315";"63";"20";"252";"80,00%";"20";20.000
"MULTIPOLYGON (((-58.3758498241491 -34.6185407846149,-58.3744884642554 -34.6185252298502,-58.3743612881232 -34.6185173910749,-58.3743019734298 -34.6196652753682,-58.374428479345 -34.6196640993231,-58.3758008322825 -34.6196938884462,-58.3757999035413 -34.6196041663603,-58.375840344761 -34.618645218129,-58.3758498241491 -34.6185407846149)))";;"130";1_23_9;COMUNA 1;"23";"9";"898";"423";"475";"89,05%";"509";"508";"99,80%";"1";"0,20%";"405";"18";"4.44";"387";"95,56%";"4.44";4.440
"MULTIPOLYGON (((-58.3705647544111 -34.6158942796606,-58.3703467973212 -34.615867212501,-58.3702471383182 -34.6158610804652,-58.3694917835464 -34.6158188065605,-58.3694577027441 -34.6165747301545,-58.3700968201646 -34.616598950193,-58.3702705055242 -34.6166054905849,-58.3716872472783 -34.6166590928085,-58.3717093231473 -34.6161008501836,-58.3717140906037 -34.6160254285446,-58.3717170369033 -34.6159795840544,-58.3706899583873 -34.6159098676583,-58.3705647544111 -34.6158942796606)))";;"131";1_24_1;COMUNA 1;"24";"1";"248";"125";"123";"101,63%";"216";"214";"99,07%";"2";"0,93%";"113";"22";"19.47";"91";"80,53%";"19.47";19.470
"MULTIPOLYGON (((-58.3691413504142 -34.615792911134,-58.3688141594966 -34.6157776578076,-58.3685796838063 -34.6157582525421,-58.3675681179198 -34.6156852822815,-58.3667344888308 -34.6156251202362,-58.3665922341315 -34.6168789960268,-58.3672247674491 -34.6169261844763,-58.3674288686474 -34.6169290906139,-58.36763654765 -34.616931999198,-58.3686808555055 -34.6170113981768,-58.3689849201039 -34.6170338910628,-58.3689853089845 -34.6170343461088,-58.3692877823099 -34.6170889503748,-58.3694247511146 -34.6171169029091,-58.369424925029 -34.6171170181983,-58.369797529312 -34.6171657848042,-58.3698742796678 -34.6171676038529,-58.3714711309731 -34.6172052886006,-58.3716664626548 -34.6172047302656,-58.3716715862612 -34.617037263424,-58.3716837431637 -34.6167476848581,-58.3716872472783 -34.6166590928085,-58.3702705055242 -34.6166054905849,-58.3700968201646 -34.616598950193,-58.3694577027441 -34.6165747301545,-58.3694917835464 -34.6158188065605,-58.3691413504142 -34.615792911134)))";;"132";1_24_2;COMUNA 1;"24";"2";"287";"140";"147";"95,24%";"237";"236";"99,58%";"1";"0,42%";"145";"1";"0.69";"144";"99,31%";"0.69";0.690
"MULTIPOLYGON (((-58.3671569547074 -34.6193094539468,-58.368490114683 -34.6194128182827,-58.3686511912752 -34.619425266942,-58.3686846347589 -34.6191545086764,-58.3688084743212 -34.6191753794226,-58.3689601651215 -34.6192009194962,-58.3692979119145 -34.6183850234048,-58.3694665682837 -34.6183974767911,-58.3701523779236 -34.6184255351684,-58.3714991250753 -34.6184806358158,-58.371599814165 -34.6184825420986,-58.3716062905254 -34.6184026145701,-58.3716355908853 -34.617860293563,-58.3716605429028 -34.6173991692844,-58.3716664626548 -34.6172047302656,-58.3714711309731 -34.6172052886006,-58.3698742796678 -34.6171676038529,-58.369797529312 -34.6171657848042,-58.369424925029 -34.6171170181983,-58.3694247511146 -34.6171169029091,-58.3692877823099 -34.6170889503748,-58.3689853089845 -34.6170343461088,-58.3689849201039 -34.6170338910628,-58.3686808555055 -34.6170113981768,-58.36763654765 -34.616931999198,-58.3674288686474 -34.6169290906139,-58.3672247674491 -34.6169261844763,-58.3665922341315 -34.6168789960268,-58.3664514379967 -34.6181201256173,-58.3663238910546 -34.6192449231945,-58.3671569547074 -34.6193094539468)))";;"133";1_24_3;COMUNA 1;"24";"3";"534";"296";"238";"124,37%";"254";"252";"99,21%";"2";"0,79%";"200";"9";"4.5";"191";"95,50%";"4.5";4.500
"MULTIPOLYGON (((-58.371599814165 -34.6184825420986,-58.3714991250753 -34.6184806358158,-58.3701523779236 -34.6184255351684,-58.370106927837 -34.619386872143,-58.3702594823134 -34.6194024813343,-58.3715164872341 -34.6195078676176,-58.3715240813667 -34.6194186448452,-58.371599814165 -34.6184825420986)))";;"134";1_24_4;COMUNA 1;"24";"4";"328";"169";"159";"106,29%";"260";"259";"99,62%";"1";"0,39%";"168";"19";"11.31";"149";"88,69%";"11.31";11.310
"MULTIPOLYGON (((-58.3701523779236 -34.6184255351684,-58.3694665682837 -34.6183974767911,-58.3692979119145 -34.6183850234048,-58.3689601651215 -34.6192009194962,-58.370106927837 -34.619386872143,-58.3701523779236 -34.6184255351684)))";;"135";1_24_5;COMUNA 1;"24";"5";"345";"153";"192";"79,69%";"232";"232";"100,00%";"0";"0,00%";"168";"11";"6.55";"157";"93,45%";"6.55";6.550
"MULTIPOLYGON (((-58.3688084743212 -34.6191753794226,-58.3686846347589 -34.6191545086764,-58.3686511912752 -34.619425266942,-58.3686147376099 -34.6197211645805,-58.3684630556348 -34.6203653655532,-58.3684328066561 -34.620597462867,-58.36840247184 -34.6208299826477,-58.3683111147453 -34.6216876175334,-58.3687666010279 -34.6217113502041,-58.3697487078902 -34.6217592872168,-58.3699733694689 -34.6206741391739,-58.3699996638465 -34.6205471125217,-58.3700977565663 -34.6195141231171,-58.370106927837 -34.619386872143,-58.3689601651215 -34.6192009194962,-58.3688084743212 -34.6191753794226)))";;"136";1_24_6;COMUNA 1;"24";"6";"720";"331";"389";"85,09%";"540";"539";"99,81%";"1";"0,19%";"365";"2";"0.55";"363";"99,45%";"0.55";0.550
"MULTIPOLYGON (((-58.3634550081613 -34.6251213449807,-58.3637271095944 -34.6251279747271,-58.3664879107171 -34.6251953265707,-58.3679712229014 -34.6251954311299,-58.3679748419406 -34.6250095121744,-58.3680593108357 -34.6240722220823,-58.3680818292038 -34.6238228648925,-58.3681616390654 -34.6230102934934,-58.3681872522252 -34.6228109403447,-58.369756514611 -34.6229330657147,-58.36974653914 -34.6227110787061,-58.3697487078902 -34.6217592872168,-58.3687666010279 -34.6217113502041,-58.3683111147453 -34.6216876175333,-58.36840247184 -34.6208299826477,-58.3684328066561 -34.620597462867,-58.3684630556348 -34.6203653655532,-58.3686147376099 -34.6197211645805,-58.3686511912752 -34.619425266942,-58.368490114683 -34.6194128182827,-58.3671569547074 -34.6193094539468,-58.3663238910546 -34.6192449231945,-58.3661903166708 -34.620422182258,-58.366067066362 -34.6215088122114,-58.3659362386448 -34.6226620578251,-58.3658564321869 -34.6235999841704,-58.3658398489279 -34.6237947663491,-58.3657858685494 -34.623987335641,-58.3654787758683 -34.6239640623241,-58.3650683106179 -34.6241880378652,-58.3646979948599 -34.6243901421288,-58.3641529182783 -34.6246875299578,-58.3637377049165 -34.6248863554595,-58.3635210192558 -34.6249900562153,-58.3634550081613 -34.6251213449807)))";;"137";1_24_7;COMUNA 1;"24";"7";"566";"281";"285";"98,60%";"509";"509";"100,00%";"0";"0,00%";"261";"13";"4.98";"248";"95,02%";"4.98";4.980
"MULTIPOLYGON (((-58.3680593108357 -34.6240722220823,-58.3679748419406 -34.6250095121744,-58.3679712229014 -34.6251954311299,-58.3697230405167 -34.6252952330072,-58.369746093588 -34.6243330349498,-58.3697522495701 -34.6241604281556,-58.3697580525058 -34.6239988073755,-58.369761004799 -34.6230318753226,-58.369756514611 -34.6229330657147,-58.3681872522252 -34.6228109403447,-58.3681616390654 -34.6230102934934,-58.3680818292038 -34.6238228648925,-58.3680593108357 -34.6240722220823)))";;"138";1_24_8;COMUNA 1;"24";"8";"428";"202";"226";"89,38%";"247";"246";"99,60%";"1";"0,41%";"184";"24";"13.04";"160";"86,96%";"13.04";13.040
"MULTIPOLYGON (((-58.3743019734298 -34.6196652753682,-58.3729379181572 -34.6196044884994,-58.3728502116768 -34.620597345621,-58.3728501619921 -34.6207224907492,-58.3729747012301 -34.6207296249105,-58.374018920302 -34.6207604599468,-58.3742238864812 -34.6207601158024,-58.3742295617514 -34.62063011543,-58.3742954504154 -34.6197915426266,-58.3743019734298 -34.6196652753682)))";;"139";1_25_1;COMUNA 1;"25";"1";"424";"198";"226";"87,61%";"236";"236";"100,00%";"0";"0,00%";"175";"13";"7.43";"162";"92,57%";"7.43";7.430
"MULTIPOLYGON (((-58.3740288962071 -34.6244364380286,-58.3729769452214 -34.6243436234397,-58.3726695044509 -34.624324030064,-58.3726605435012 -34.6244962828108,-58.372622677707 -34.625479316257,-58.3726175950308 -34.6256101619855,-58.3725546255783 -34.6265654292786,-58.3725472821684 -34.6267383169728,-58.3727853037786 -34.6267520142383,-58.3738658936913 -34.6267808350979,-58.3738923945761 -34.6266961332443,-58.3739658520324 -34.6255579794093,-58.3739677491432 -34.6254564984927,-58.3740288962071 -34.6244364380286)))";;"140";1_25_10;COMUNA 1;"25";"10";"542";"254";"288";"88,19%";"246";"246";"100,00%";"0";"0,00%";"227";"12";"5.29";"215";"94,71%";"5.29";5.290
"MULTIPOLYGON (((-58.3697230405167 -34.6252952330072,-58.3679712229014 -34.6251954311299,-58.3679657947906 -34.6254738870033,-58.3679768648694 -34.6269028167969,-58.3679776098197 -34.6269969754534,-58.3679784282022 -34.6271014866239,-58.3679451553048 -34.6271423776415,-58.3680233366538 -34.627167509609,-58.3680912982142 -34.6271893940552,-58.368305448133 -34.6273688617268,-58.3686345906136 -34.6276446181408,-58.369444475919 -34.6283231498969,-58.3696300935623 -34.6284999172518,-58.3702480543503 -34.6290923786603,-58.3704592064597 -34.6292947987362,-58.370658180048 -34.6294937584333,-58.3706888922277 -34.6292253220228,-58.3706930213838 -34.6291894084559,-58.3707118620997 -34.6290242059281,-58.3707105988193 -34.6289337090193,-58.3707091842683 -34.6288258874771,-58.370793632074 -34.6281152233031,-58.370947387366 -34.6268224789971,-58.3709636823314 -34.6266471332655,-58.3725472821684 -34.6267383169728,-58.3725546255783 -34.6265654292786,-58.3726175950308 -34.6256101619855,-58.372622677707 -34.625479316257,-58.3723940400457 -34.6254573859073,-58.3712981897961 -34.6253766374245,-58.3710934758963 -34.6253696526422,-58.3697230405167 -34.6252952330072)))";;"141";1_25_11;COMUNA 1;"25";"11";"557";"271";"286";"94,76%";"308";"308";"100,00%";"0";"0,00%";"252";"27";"10.71";"225";"89,29%";"10.71";10.710
"MULTIPOLYGON (((-58.3714513372295 -34.6202689015978,-58.3714255356034 -34.6205704420079,-58.3714179265297 -34.6206731159143,-58.3713448683456 -34.6216524611329,-58.3713326552172 -34.6218361202622,-58.3715322465676 -34.6218453544101,-58.3727977892136 -34.6218900979772,-58.3728092254234 -34.6217129172234,-58.3728500474588 -34.6208287619367,-58.3728501619921 -34.6207224907492,-58.3728502116768 -34.620597345621,-58.3729379181572 -34.6196044884994,-58.3727752175845 -34.6195961289515,-58.371625858827 -34.619517034142,-58.3715164872341 -34.6195078676176,-58.3714513372295 -34.6202689015978)))";;"142";1_25_2;COMUNA 1;"25";"2";"388";"190";"198";"95,96%";"297";"296";"99,66%";"1";"0,34%";"179";"2";"1.12";"177";"98,88%";"1.12";1.120
"MULTIPOLYGON (((-58.3697487078902 -34.6217592872168,-58.3697465391401 -34.6227110787061,-58.369756514611 -34.6229330657147,-58.371268793246 -34.6230506914298,-58.3713206161979 -34.6220163286927,-58.3713326552172 -34.6218361202622,-58.3713448683456 -34.6216524611329,-58.3714179265297 -34.6206731159143,-58.3714255356034 -34.6205704420079,-58.3714513372295 -34.6202689015978,-58.3715164872341 -34.6195078676176,-58.3702594823134 -34.6194024813343,-58.370106927837 -34.619386872143,-58.3700977565663 -34.6195141231171,-58.3699996638465 -34.6205471125217,-58.3699733694689 -34.6206741391739,-58.3697487078902 -34.6217592872168)))";;"143";1_25_3;COMUNA 1;"25";"3";"513";"225";"288";"78,13%";"337";"334";"99,11%";"3";"0,90%";"221";"2";"0.9";"219";"99,10%";"0.9";0.900
"MULTIPOLYGON (((-58.3727977892136 -34.6218900979772,-58.3715322465676 -34.6218453544101,-58.3713326552172 -34.6218361202622,-58.3713206161979 -34.6220163286927,-58.371268793246 -34.6230506914298,-58.3727316973788 -34.6231381905444,-58.3727358718614 -34.6230591768428,-58.3727864385249 -34.622066926663,-58.3727977892136 -34.6218900979772)))";;"144";1_25_4;COMUNA 1;"25";"4";"912";"449";"463";"96,98%";"510";"510";"100,00%";"0";"0,00%";"430";"3";"0.7";"427";"99,30%";"0.7";0.700
"MULTIPOLYGON (((-58.3727977892136 -34.6218900979772,-58.3727864385249 -34.622066926663,-58.3727358718614 -34.6230591768428,-58.3727316973788 -34.6231381905444,-58.3741085258485 -34.6232584980798,-58.3741066798997 -34.6231517325338,-58.374165887158 -34.6221099793192,-58.3741632526022 -34.6219435632473,-58.3741599784935 -34.6217376383072,-58.3742129731966 -34.6210094122609,-58.3742238864812 -34.6207601158024,-58.374018920302 -34.6207604599468,-58.3729747012301 -34.6207296249105,-58.3728501619921 -34.6207224907492,-58.3728500474588 -34.6208287619367,-58.3728092254234 -34.6217129172234,-58.3727977892136 -34.6218900979772)))";;"145";1_25_5;COMUNA 1;"25";"5";"477";"216";"261";"82,76%";"319";"318";"99,69%";"1";"0,31%";"226";"4";"1.77";"222";"98,23%";"1.77";1.770
"MULTIPOLYGON (((-58.3727316973788 -34.6231381905444,-58.371268793246 -34.6230506914298,-58.3712635660269 -34.6231561840671,-58.3712019217831 -34.6240559571874,-58.3711883475172 -34.6242372207609,-58.3714340283509 -34.6242516306577,-58.3723266259816 -34.6243021560665,-58.3726695044509 -34.624324030064,-58.3729769452214 -34.6243436234397,-58.3740288962071 -34.6244364380286,-58.3740399982289 -34.6242509468475,-58.3741099676956 -34.6233446992492,-58.3741085258485 -34.6232584980798,-58.3727316973788 -34.6231381905444)))";;"146";1_25_6;COMUNA 1;"25";"6";"752";"365";"387";"94,32%";"404";"404";"100,00%";"0";"0,00%";"351";"77";"21.94";"274";"78,06%";"21.94";21.940
"MULTIPOLYGON (((-58.371268793246 -34.6230506914298,-58.369756514611 -34.6229330657147,-58.369761004799 -34.6230318753226,-58.3697580525058 -34.6239988073755,-58.3697522495701 -34.6241604281556,-58.3700364370965 -34.6241748702019,-58.3709499077796 -34.6242231679407,-58.3711883475172 -34.6242372207609,-58.3712019217831 -34.6240559571874,-58.3712635660269 -34.6231561840671,-58.371268793246 -34.6230506914298)))";;"147";1_25_7;COMUNA 1;"25";"7";"418";"187";"231";"80,95%";"271";"270";"99,63%";"1";"0,37%";"193";"6";"3.11";"187";"96,89%";"3.11";3.110
"MULTIPOLYGON (((-58.3711883475172 -34.6242372207609,-58.3709499077796 -34.6242231679407,-58.3700364370965 -34.6241748702019,-58.3697522495701 -34.6241604281556,-58.369746093588 -34.6243330349498,-58.3697230405167 -34.6252952330072,-58.3710934758963 -34.6253696526422,-58.3711116606215 -34.6252571977143,-58.3711883475172 -34.6242372207609)))";;"148";1_25_8;COMUNA 1;"25";"8";"612";"285";"327";"87,16%";"420";"419";"99,76%";"1";"0,24%";"321";"13";"4.05";"308";"95,95%";"4.05";4.050
"MULTIPOLYGON (((-58.3726695044509 -34.624324030064,-58.3723266259816 -34.6243021560665,-58.3714340283509 -34.6242516306577,-58.3711883475172 -34.6242372207609,-58.3711116606215 -34.6252571977143,-58.3710934758963 -34.6253696526422,-58.3712981897961 -34.6253766374245,-58.3723940400457 -34.6254573859073,-58.372622677707 -34.625479316257,-58.3726605435012 -34.6244962828108,-58.3726695044509 -34.624324030064)))";;"149";1_25_9;COMUNA 1;"25";"9";"658";"332";"326";"101,84%";"189";"187";"98,94%";"2";"1,07%";"212";"80";"37.74";"132";"62,26%";"37.74";37.740
"MULTIPOLYGON (((-58.3772680004856 -34.6197240806939,-58.377162367533 -34.6197234432717,-58.3758008322825 -34.6196938884462,-58.3758019171619 -34.6197972730877,-58.3757381558675 -34.6207343023376,-58.3757354144268 -34.6208307121626,-58.3758601207909 -34.6208413647458,-58.3772283057935 -34.6208843747468,-58.3772245501746 -34.620808383576,-58.3772652669117 -34.619814574878,-58.3772680004856 -34.6197240806939)))";;"150";1_26_1;COMUNA 1;"26";"1";"639";"312";"327";"95,41%";"295";"286";"96,95%";"9";"3,15%";"249";"102";"40.96";"147";"59,04%";"40.96";40.960
"MULTIPOLYGON (((-58.3758008322825 -34.6196938884462,-58.374428479345 -34.6196640993231,-58.3743019734298 -34.6196652753682,-58.3742954504154 -34.6197915426266,-58.3742295617514 -34.62063011543,-58.3742238864812 -34.6207601158024,-58.3743314808962 -34.6207599825162,-58.3756218669562 -34.6208209829424,-58.3757354144268 -34.6208307121626,-58.3757381558675 -34.6207343023376,-58.3758019171619 -34.6197972730877,-58.3758008322825 -34.6196938884462)))";;"151";1_26_2;COMUNA 1;"26";"2";"677";"289";"388";"74,48%";"405";"405";"100,00%";"0";"0,00%";"320";"41";"12.81";"279";"87,19%";"12.81";12.810
"MULTIPOLYGON (((-58.3757354144268 -34.6208307121626,-58.3756218669562 -34.6208209829424,-58.3743314808962 -34.6207599825162,-58.3742238864812 -34.6207601158024,-58.3742129731966 -34.6210094122609,-58.3741599784935 -34.6217376383072,-58.3741632526022 -34.6219435632473,-58.3754147362997 -34.6219934809085,-58.3756443149429 -34.6220033636065,-58.3756565105102 -34.6218274507753,-58.3757324952538 -34.6209341643559,-58.3757354144268 -34.6208307121626)))";;"152";1_26_3;COMUNA 1;"26";"3";"440";"189";"251";"75,30%";"308";"308";"100,00%";"0";"0,00%";"217";"3";"1.38";"214";"98,62%";"1.38";1.380
"MULTIPOLYGON (((-58.3772283057935 -34.6208843747468,-58.3758601207909 -34.6208413647458,-58.3757354144268 -34.6208307121626,-58.3757324952538 -34.6209341643559,-58.3756565105102 -34.6218274507753,-58.3756443149429 -34.6220033636065,-58.3769785128173 -34.6220609301213,-58.3771985550991 -34.6220662959957,-58.3772114266099 -34.6218926370807,-58.3772345660637 -34.6210101581217,-58.3772283057935 -34.6208843747468)))";;"153";1_26_4;COMUNA 1;"26";"4";"553";"249";"304";"81,91%";"291";"291";"100,00%";"0";"0,00%";"244";"0";"0";"244";"100,00%";"0";0.000
"MULTIPOLYGON (((-58.3771985550991 -34.6220662959957,-58.3769785128173 -34.6220609301213,-58.3756443149429 -34.6220033636065,-58.3755560897386 -34.6232763019202,-58.3755508613772 -34.6233880625602,-58.3755457204761 -34.6234976400874,-58.375472020938 -34.6245638912584,-58.3767505462915 -34.6251141836173,-58.3770652741459 -34.623600480332,-58.3770828547312 -34.6234873902259,-58.3771031794206 -34.6233567662312,-58.3771985550991 -34.6220662959957)))";;"154";1_26_5;COMUNA 1;"26";"5";"683";"316";"367";"86,10%";"391";"391";"100,00%";"0";"0,00%";"310";"44";"14.19";"266";"85,81%";"14.19";14.190
"MULTIPOLYGON (((-58.3756443149429 -34.6220033636065,-58.3754147362997 -34.6219934809085,-58.3741632526022 -34.6219435632473,-58.374165887158 -34.6221099793192,-58.3741066798997 -34.6231517325338,-58.3741085258485 -34.6232584980798,-58.3742265063652 -34.6232683023475,-58.3753355113944 -34.6233730488565,-58.3755508613772 -34.6233880625602,-58.3755560897386 -34.6232763019202,-58.3756443149429 -34.6220033636065)))";;"155";1_26_6;COMUNA 1;"26";"6";"465";"194";"271";"71,59%";"288";"288";"100,00%";"0";"0,00%";"214";"3";"1.4";"211";"98,60%";"1.4";1.400
"MULTIPOLYGON (((-58.3755508613772 -34.6233880625602,-58.3753355113944 -34.6233730488565,-58.3742265063652 -34.6232683023475,-58.3741085258485 -34.6232584980798,-58.3741099676956 -34.6233446992492,-58.3740399982289 -34.6242509468475,-58.3740288962071 -34.6244364380286,-58.375472020938 -34.6245638912584,-58.3755457204761 -34.6234976400874,-58.3755508613772 -34.6233880625602)))";;"156";1_26_7;COMUNA 1;"26";"7";"313";"128";"185";"69,19%";"202";"202";"100,00%";"0";"0,00%";"142";"4";"2.82";"138";"97,18%";"2.82";2.820
"MULTIPOLYGON (((-58.3767505462915 -34.6251141836173,-58.375472020938 -34.6245638912584,-58.3740288962071 -34.6244364380286,-58.3739677491432 -34.6254564984927,-58.3739658520324 -34.6255579794093,-58.3750571032533 -34.6256420810194,-58.3762245532227 -34.6262695550662,-58.3767505462915 -34.6251141836173)))";;"157";1_26_8;COMUNA 1;"26";"8";"449";"209";"240";"87,08%";"281";"281";"100,00%";"0";"0,00%";"213";"2";"0.94";"211";"99,06%";"0.94";0.940
"MULTIPOLYGON (((-58.3750571032533 -34.6256420810194,-58.3739658520324 -34.6255579794093,-58.3738923945761 -34.6266961332443,-58.3738658936913 -34.6267808350979,-58.3745605590305 -34.6267993677996,-58.3755729247856 -34.6273015907834,-58.375692114184 -34.627138360535,-58.3761762357584 -34.6263630450741,-58.3762245532227 -34.6262695550662,-58.3750571032533 -34.6256420810194)))";;"158";1_26_9;COMUNA 1;"26";"9";"739";"325";"414";"78,50%";"398";"398";"100,00%";"0";"0,00%";"316";"26";"8.23";"290";"91,77%";"8.23";8.230
"MULTIPOLYGON (((-58.3843498495022 -34.6270099990304,-58.384088139188 -34.626997999263,-58.3831488884659 -34.6269630934001,-58.38284073864 -34.626959582074,-58.3828315115432 -34.6272533887077,-58.3828247447245 -34.6274690957308,-58.3843411709606 -34.6275415605789,-58.384346237827 -34.6272268349743,-58.3843498495022 -34.6270099990304)))";;"159";1_27_1;COMUNA 1;"27";"1";"596";"257";"339";"75,81%";"310";"307";"99,03%";"3";"0,98%";"234";"2";"0.85";"232";"99,15%";"0.85";0.850
"MULTIPOLYGON (((-58.3780062655349 -34.6256555027427,-58.3767505462915 -34.6251141836173,-58.3762245532227 -34.6262695550662,-58.3772623391135 -34.6268273473385,-58.3780062655349 -34.6256555027427)))";;"160";1_27_10;COMUNA 1;"27";"10";"513";"242";"271";"89,30%";"366";"366";"100,00%";"0";"0,00%";"248";"23";"9.27";"225";"90,73%";"9.27";9.270
"MULTIPOLYGON (((-58.3843411709606 -34.6275415605789,-58.3828247447245 -34.6274690957308,-58.3828212288161 -34.6275818436825,-58.3828094589756 -34.6278617749161,-58.384151301547 -34.6281389936542,-58.384328307028 -34.6281750242032,-58.3846131516363 -34.6282329552938,-58.3854477677525 -34.6283894074385,-58.3856826236471 -34.6284250500972,-58.3858967797251 -34.6284575101519,-58.3870245297271 -34.6286528694125,-58.3870414499305 -34.6285027340569,-58.3871731783964 -34.6273598197092,-58.3871817465486 -34.627118197185,-58.3869515559086 -34.6271084766678,-58.3857290355687 -34.6270635549466,-58.3846696610586 -34.6270245707142,-58.3843498495022 -34.6270099990304,-58.384346237827 -34.6272268349743,-58.3843411709606 -34.6275415605789)))";;"161";1_27_2;COMUNA 1;"27";"2";"780";"429";"351";"122,22%";"199";"188";"94,47%";"11";"5,85%";"275";"80";"29.09";"195";"70,91%";"29.09";29.090
"MULTIPOLYGON (((-58.3856826236471 -34.6284250500972,-58.3854477677525 -34.6283894074385,-58.3846131516363 -34.6282329552938,-58.384328307028 -34.6281750242032,-58.3843226124642 -34.6283417162488,-58.3842583378136 -34.6291040946858,-58.3842104323239 -34.6296726038652,-58.3841955390098 -34.6298360504001,-58.3843689945226 -34.6298457396973,-58.3854141335825 -34.6299310570917,-58.3855911614669 -34.6299475781266,-58.3858272271339 -34.6299696292664,-58.386868291187 -34.6300423255818,-58.3870245297271 -34.6286528694125,-58.3858967797251 -34.6284575101519,-58.3856826236471 -34.6284250500972)))";;"162";1_27_3;COMUNA 1;"27";"3";"888";"413";"475";"86,95%";"337";"333";"98,81%";"4";"1,20%";"293";"106";"36.18";"187";"63,82%";"36.18";36.180
"MULTIPOLYGON (((-58.3855911614669 -34.6299475781266,-58.3854141335825 -34.6299310570917,-58.3843689945226 -34.6298457396973,-58.3841955390098 -34.6298360504001,-58.3841760837815 -34.6300486505478,-58.3841053296461 -34.6309934248919,-58.3840933364057 -34.6311529294555,-58.383990006691 -34.6323967768547,-58.3854169064102 -34.6328208721581,-58.3855216612584 -34.6311197559678,-58.3855331657981 -34.6309329965328,-58.385586163795 -34.6301003265016,-58.3855911614669 -34.6299475781266)))";;"163";1_27_4;COMUNA 1;"27";"4";"802";"360";"442";"81,45%";"360";"359";"99,72%";"1";"0,28%";"325";"148";"45.54";"177";"54,46%";"45.54";45.540
"MULTIPOLYGON (((-58.3841053296461 -34.6309934248919,-58.3839082788741 -34.6309758323964,-58.3828477192718 -34.6308778155371,-58.3826625962602 -34.6308610035108,-58.3826323482796 -34.6314838914659,-58.3826253942721 -34.631627483163,-58.3826205559686 -34.6317316518978,-58.3833915497326 -34.6322205383677,-58.383990006691 -34.6323967768547,-58.3840933364057 -34.6311529294555,-58.3841053296461 -34.6309934248919)))";;"164";1_27_5;COMUNA 1;"27";"5";"641";"298";"343";"86,88%";"364";"364";"100,00%";"0";"0,00%";"288";"51";"17.71";"237";"82,29%";"17.71";17.710
"MULTIPOLYGON (((-58.3827166061947 -34.6297139587987,-58.3827005802944 -34.6300779039954,-58.3826938873974 -34.6302160027617,-58.3826625962602 -34.6308610035108,-58.3828477192718 -34.6308778155371,-58.3839082788741 -34.6309758323964,-58.3841053296461 -34.6309934248919,-58.3841760837815 -34.6300486505478,-58.3841955390098 -34.6298360504001,-58.3842104323239 -34.6296726038652,-58.3842583378136 -34.6291040946858,-58.3843226124642 -34.6283417162488,-58.384328307028 -34.6281750242032,-58.384151301547 -34.6281389936542,-58.3828094589756 -34.6278617749161,-58.3827589162095 -34.6288608596255,-58.3827498747305 -34.6290494515194,-58.3827166061947 -34.6297139587987)))";;"165";1_27_6;COMUNA 1;"27";"6";"929";"437";"492";"88,82%";"384";"383";"99,74%";"1";"0,26%";"359";"224";"62.4";"135";"37,60%";"62.4";62.400
"MULTIPOLYGON (((-58.3821641162637 -34.6278386032948,-58.3817921703867 -34.6278150465112,-58.3814320546872 -34.6278041729561,-58.3813958673946 -34.6288303802396,-58.381390249162 -34.6290001004466,-58.3813534043624 -34.6301751148118,-58.3813363235034 -34.6307407558824,-58.3813263761351 -34.630900099656,-58.3815452508065 -34.6310417799532,-58.3822180095486 -34.6314895314205,-58.3826212940051 -34.6317579525394,-58.3826205559686 -34.6317316518978,-58.3826253942721 -34.631627483163,-58.3826323482796 -34.6314838914659,-58.3826625962602 -34.6308610035108,-58.3826938873974 -34.6302160027617,-58.3827005802944 -34.6300779039954,-58.3827166061947 -34.6297139587987,-58.3827498747305 -34.6290494515194,-58.3827589162095 -34.6288608596255,-58.3828094589756 -34.6278617749161,-58.3824304260917 -34.6278542018866,-58.3821641162637 -34.6278386032948)))";;"166";1_27_7;COMUNA 1;"27";"7";"866";"440";"426";"103,29%";"252";"249";"98,81%";"3";"1,20%";"265";"123";"46.42";"142";"53,58%";"46.42";46.420
"MULTIPOLYGON (((-58.3772623391135 -34.6268273473385,-58.3762245532227 -34.6262695550662,-58.3761762357584 -34.6263630450741,-58.375692114184 -34.627138360535,-58.3755729247856 -34.6273015907834,-58.3765898354166 -34.6278736409418,-58.3777037247305 -34.6284932441549,-58.3779265013996 -34.6286202924449,-58.3790823902279 -34.6293181340523,-58.3789812080657 -34.6295596832813,-58.3787620597622 -34.6301051173774,-58.3787355750786 -34.6301775663302,-58.3786602218901 -34.6303834367224,-58.3786227784576 -34.6304859311263,-58.3790425731869 -34.6312753912409,-58.379470863213 -34.6320342580394,-58.3795256915635 -34.63216077845,-58.3795100492231 -34.6322114032403,-58.3795776185334 -34.6322920153203,-58.3796357411639 -34.6323620572037,-58.380092152435 -34.632632164715,-58.3801133520331 -34.6327338725287,-58.3801433035535 -34.6330317194103,-58.3802922329228 -34.6330354822156,-58.3810683969082 -34.6330622726181,-58.3812503808197 -34.633070070587,-58.3812806430156 -34.6323566168151,-58.3813241729846 -34.6311173371413,-58.3813263761351 -34.630900099656,-58.3813363235034 -34.6307407558824,-58.3813534043624 -34.6301751148118,-58.381390249162 -34.6290001004466,-58.3813958673946 -34.6288303802396,-58.3814320546872 -34.6278041729561,-58.3817921703867 -34.6278150465112,-58.3821641162637 -34.6278386032948,-58.3824304260917 -34.6278542018866,-58.3828094589756 -34.6278617749161,-58.3828212288161 -34.6275818436825,-58.3828247447245 -34.6274690957308,-58.3828315115432 -34.6272533887077,-58.38284073864 -34.626959582074,-58.382230244483 -34.6269400252844,-58.3821380022315 -34.6269144001584,-58.3801817641964 -34.6263711728379,-58.3800360521899 -34.6266573514096,-58.3799371441459 -34.6269108139809,-58.3797660609828 -34.627349092758,-58.3797295037983 -34.6274427330045,-58.3796528623768 -34.6276638854309,-58.3785417919174 -34.6273489584728,-58.3784934293913 -34.6274890002055,-58.3772623391135 -34.6268273473385)))";;"167";1_27_8;COMUNA 1;"27";"8";"694";"332";"362";"91,71%";"363";"357";"98,35%";"6";"1,68%";"255";"50";"19.61";"205";"80,39%";"19.61";19.610
"MULTIPOLYGON (((-58.3790090846087 -34.6260845896253,-58.3780062655349 -34.6256555027427,-58.3772623391135 -34.6268273473385,-58.3784934293913 -34.6274890002055,-58.3785417919174 -34.6273489584728,-58.3796528623768 -34.6276638854309,-58.3797295037983 -34.6274427330045,-58.3797660609828 -34.627349092758,-58.3799371441459 -34.6269108139809,-58.3800360521899 -34.6266573514096,-58.3801817641964 -34.6263711728379,-58.3800548541066 -34.626340170385,-58.3790090846087 -34.6260845896253)))";;"168";1_27_9;COMUNA 1;"27";"9";"723";"353";"370";"95,41%";"344";"344";"100,00%";"0";"0,00%";"324";"115";"35.49";"209";"64,51%";"35.49";35.490
"MULTIPOLYGON (((-58.3898874815497 -34.6226357463088,-58.3886508256198 -34.6225599993125,-58.3882995158767 -34.6225385172147,-58.3875458725623 -34.6224898141381,-58.387179570464 -34.6224675449031,-58.3871738961905 -34.6227126202262,-58.3871762986831 -34.6233519393898,-58.387177815418 -34.6237465312779,-58.3884653912666 -34.6238688750867,-58.3895162400198 -34.6239686683803,-58.3897555347742 -34.6239819811733,-58.3900239641047 -34.623996930632,-58.3911494544483 -34.6239868209749,-58.3914313558814 -34.6239884649247,-58.3914573948442 -34.6234255031454,-58.391488484532 -34.622733807443,-58.3898874815497 -34.6226357463088)))";;"169";1_28_1;COMUNA 1;"28";"1";"512";"226";"286";"79,02%";"277";"275";"99,28%";"2";"0,73%";"220";"39";"17.73";"181";"82,27%";"17.73";17.730
"MULTIPOLYGON (((-58.3843627613596 -34.6260532145544,-58.3843537307119 -34.6267783035974,-58.3843498495022 -34.6270099990304,-58.3846696610586 -34.6270245707142,-58.3857290355687 -34.6270635549466,-58.3869515559086 -34.6271084766678,-58.3871817465486 -34.627118197185,-58.3871906637903 -34.6268673492044,-58.3872033380747 -34.6263249444187,-58.3872067124361 -34.6261737442239,-58.3870122227408 -34.6261622148638,-58.3859900055265 -34.6261216453775,-58.3857512985541 -34.62611163554,-58.3857822763391 -34.6247627361755,-58.3855394843223 -34.6247523712234,-58.3843794426087 -34.6247112080097,-58.3843777732093 -34.6248558597357,-58.3843627613596 -34.6260532145544)))";;"170";1_28_10;COMUNA 1;"28";"10";"909";"435";"474";"91,77%";"413";"412";"99,76%";"1";"0,24%";"353";"97";"27.48";"256";"72,52%";"27.48";27.480
"MULTIPOLYGON (((-58.3871870376647 -34.6248513633388,-58.3869752595757 -34.624836724519,-58.3859253106448 -34.6247688828277,-58.3857822763391 -34.6247627361755,-58.3857512985541 -34.62611163554,-58.3859900055265 -34.6261216453775,-58.3870122227408 -34.6261622148638,-58.3872067124361 -34.6261737442239,-58.3872111512178 -34.6259760642412,-58.3871870376647 -34.6248513633388)))";;"171";1_28_11;COMUNA 1;"28";"11";"610";"310";"300";"103,33%";"251";"250";"99,60%";"1";"0,40%";"249";"153";"61.45";"96";"38,55%";"61.45";61.450
"MULTIPOLYGON (((-58.3883890416032 -34.6249392171506,-58.3881795675234 -34.6249198633551,-58.3871870376647 -34.6248513633388,-58.3872111512178 -34.6259760642412,-58.3872067124361 -34.6261737442239,-58.3873385058301 -34.626177346965,-58.3883076605599 -34.6262037173941,-58.3883890416032 -34.6249392171506)))";;"172";1_28_12;COMUNA 1;"28";"12";"573";"276";"297";"92,93%";"264";"263";"99,62%";"1";"0,38%";"235";"75";"31.91";"160";"68,09%";"31.91";31.910
"MULTIPOLYGON (((-58.3913289998849 -34.6252285881317,-58.389652949535 -34.6250663933131,-58.3895660977295 -34.6259850343583,-58.3895338681032 -34.6262087549815,-58.3883076605599 -34.6262037173941,-58.3873385058301 -34.626177346965,-58.3872067124361 -34.6261737442239,-58.3872033380747 -34.6263249444187,-58.3871906637903 -34.6268673492044,-58.3871817465486 -34.627118197185,-58.3872894301632 -34.6271227005743,-58.3875025823972 -34.6271316352774,-58.3882954718177 -34.6271646578056,-58.388684121648 -34.627180810283,-58.3888113153691 -34.627185253741,-58.3892637776351 -34.627200950035,-58.3894377419194 -34.6272078154353,-58.3896704043105 -34.6272169693416,-58.3902481919317 -34.627230835481,-58.3911698240387 -34.627252999868,-58.3911862757667 -34.6270440588288,-58.3912186621831 -34.6266327259355,-58.3912422628717 -34.6263328000708,-58.3913289998849 -34.6252285881317)))";;"173";1_28_13;COMUNA 1;"28";"13";"652";"330";"322";"102,48%";"277";"276";"99,64%";"1";"0,36%";"261";"113";"43.3";"148";"56,70%";"43.3";43.300
"MULTIPOLYGON (((-58.3914313558814 -34.6239884649247,-58.3911494544483 -34.6239868209749,-58.3900239641047 -34.623996930632,-58.3897555347742 -34.6239819811733,-58.389652949535 -34.6250663933131,-58.3913289998849 -34.6252285881317,-58.3914031582974 -34.6242858529578,-58.3914313558814 -34.6239884649247)))";;"174";1_28_2;COMUNA 1;"28";"2";"753";"365";"388";"94,07%";"371";"371";"100,00%";"0";"0,00%";"345";"168";"48.7";"177";"51,30%";"48.7";48.700
"MULTIPOLYGON (((-58.3897555347742 -34.6239819811733,-58.3895162400198 -34.6239686683803,-58.3884653912666 -34.6238688750867,-58.387177815418 -34.6237465312779,-58.3871790093703 -34.6240272458197,-58.3871797344086 -34.6242613387523,-58.3871837682426 -34.6246986800716,-58.3871870376647 -34.6248513633388,-58.3881795675234 -34.6249198633551,-58.3883890416032 -34.6249392171506,-58.3883076605599 -34.6262037173941,-58.3895338681032 -34.6262087549815,-58.3895660977295 -34.6259850343583,-58.389652949535 -34.6250663933131,-58.3897555347742 -34.6239819811733)))";;"175";1_28_3;COMUNA 1;"28";"3";"677";"308";"369";"83,47%";"264";"260";"98,48%";"4";"1,54%";"241";"74";"30.71";"167";"69,29%";"30.71";30.710
"MULTIPOLYGON (((-58.387179570464 -34.6224675449031,-58.3868594396584 -34.6224480498555,-58.3858297861835 -34.6223912766704,-58.38582729003 -34.6226038176061,-58.3858137382436 -34.6232572821595,-58.3858069601558 -34.6235863032185,-58.3857997400015 -34.62393271894,-58.3857852045638 -34.6246361140019,-58.3857822763391 -34.6247627361755,-58.3859253106448 -34.6247688828277,-58.3869752595757 -34.624836724519,-58.3871870376647 -34.6248513633388,-58.3871837682426 -34.6246986800716,-58.3871797344086 -34.6242613387523,-58.3871790093703 -34.6240272458197,-58.387177815418 -34.6237465312779,-58.3871762986831 -34.6233519393898,-58.3871738961905 -34.6227126202262,-58.387179570464 -34.6224675449031)))";;"176";1_28_4;COMUNA 1;"28";"4";"661";"281";"380";"73,95%";"323";"320";"99,07%";"3";"0,94%";"280";"62";"22.14";"218";"77,86%";"22.14";22.140
"MULTIPOLYGON (((-58.3858297861835 -34.6223912766704,-58.3847714261386 -34.6223329975354,-58.3843912357831 -34.6223145140024,-58.3832501544623 -34.6222591968118,-58.3829611161054 -34.6222438668531,-58.3829507425486 -34.6239151848604,-58.3830959877721 -34.623923871573,-58.3843877738973 -34.6240045696026,-58.3843937051371 -34.623494767285,-58.3858069601558 -34.6235863032185,-58.3858137382436 -34.6232572821595,-58.38582729003 -34.6226038176061,-58.3858297861835 -34.6223912766704)))";;"177";1_28_5;COMUNA 1;"28";"5";"805";"373";"432";"86,34%";"460";"460";"100,00%";"0";"0,00%";"354";"26";"7.34";"328";"92,66%";"7.34";7.340
"MULTIPOLYGON (((-58.3858069601558 -34.6235863032185,-58.3843937051371 -34.623494767285,-58.3843877738973 -34.6240045696026,-58.3843794426087 -34.6247112080097,-58.3855394843223 -34.6247523712234,-58.3857822763391 -34.6247627361755,-58.3857852045638 -34.6246361140019,-58.3857997400015 -34.62393271894,-58.3858069601558 -34.6235863032185)))";;"178";1_28_6;COMUNA 1;"28";"6";"632";"304";"328";"92,68%";"320";"320";"100,00%";"0";"0,00%";"281";"122";"43.42";"159";"56,58%";"43.42";43.420
"MULTIPOLYGON (((-58.3829507425486 -34.6239151848604,-58.3829611161054 -34.6222438668531,-58.3814269908217 -34.6221629220712,-58.3814378939378 -34.6223390621433,-58.3814443857735 -34.622933100912,-58.3814518133062 -34.6236160869425,-58.38144608188 -34.6238150335705,-58.3814419362062 -34.6239603174488,-58.3814223684139 -34.6246320878171,-58.3821076697213 -34.624655315164,-58.3824874223575 -34.6246675123075,-58.382926750946 -34.6246821670926,-58.3841444867929 -34.6247028876352,-58.3843794426087 -34.6247112080097,-58.3843877738973 -34.6240045696026,-58.3830959877721 -34.623923871573,-58.3829507425486 -34.6239151848604)))";;"179";1_28_7;COMUNA 1;"28";"7";"727";"348";"379";"91,82%";"347";"347";"100,00%";"0";"0,00%";"314";"77";"24.52";"237";"75,48%";"24.52";24.520
"MULTIPOLYGON (((-58.3814223684139 -34.6246320878171,-58.3808895537574 -34.6246474363945,-58.380347108283 -34.626046273634,-58.3801817641964 -34.6263711728379,-58.3821380022315 -34.6269144001584,-58.382230244483 -34.6269400252844,-58.38284073864 -34.626959582074,-58.3828474175465 -34.6267466215456,-58.3828765116071 -34.6259906996399,-58.382926750946 -34.6246821670926,-58.3824874223575 -34.6246675123075,-58.3821076697213 -34.624655315164,-58.3814223684139 -34.6246320878171)))";;"180";1_28_8;COMUNA 1;"28";"8";"306";"161";"145";"111,03%";"96";"93";"96,88%";"3";"3,23%";"110";"20";"18.18";"90";"81,82%";"18.18";18.180
"MULTIPOLYGON (((-58.3828765116071 -34.6259906996399,-58.3828474175465 -34.6267466215456,-58.38284073864 -34.626959582074,-58.3831488884659 -34.6269630934001,-58.384088139188 -34.626997999263,-58.3843498495022 -34.6270099990304,-58.3843537307119 -34.6267783035974,-58.3843627613596 -34.6260532145544,-58.3843777732093 -34.6248558597357,-58.3843794426087 -34.6247112080097,-58.3841444867929 -34.6247028876352,-58.382926750946 -34.6246821670926,-58.3828765116071 -34.6259906996399)))";;"181";1_28_9;COMUNA 1;"28";"9";"741";"376";"365";"103,01%";"304";"300";"98,68%";"4";"1,33%";"262";"67";"25.57";"195";"74,43%";"25.57";25.570
"MULTIPOLYGON (((-58.3911698240387 -34.627252999868,-58.3902481919317 -34.627230835481,-58.3896704043105 -34.6272169693416,-58.3894377419194 -34.6272078154353,-58.3894258960916 -34.6274057022881,-58.3893691970475 -34.6281330165234,-58.3893129280756 -34.6288545560634,-58.3892931641991 -34.6290457477217,-58.3900482446701 -34.6291764858308,-58.3909253131393 -34.6293283481459,-58.3910614930745 -34.6281994468917,-58.3911698240387 -34.627252999868)))";;"182";1_29_1;COMUNA 1;"29";"1";"1123";"524";"599";"87,48%";"454";"453";"99,78%";"1";"0,22%";"420";"141";"33.57";"279";"66,43%";"33.57";33.570
"MULTIPOLYGON (((-58.3888113153691 -34.627185253741,-58.388684121648 -34.627180810283,-58.3882954718177 -34.6271646578056,-58.3875025823972 -34.6271316352774,-58.3872894301632 -34.6271227005743,-58.3871817465486 -34.627118197185,-58.3871731783964 -34.6273598197092,-58.3870414499305 -34.6285027340569,-58.3870245297271 -34.6286528694125,-58.3880947855536 -34.6288381827583,-58.3892931641991 -34.6290457477217,-58.3893129280756 -34.6288545560634,-58.3893691970475 -34.6281330165234,-58.3894258960916 -34.6274057022881,-58.3894377419194 -34.6272078154353,-58.3892637776351 -34.627200950035,-58.3888113153691 -34.627185253741)))";;"183";1_29_2;COMUNA 1;"29";"2";"624";"312";"312";"100,00%";"250";"250";"100,00%";"0";"0,00%";"266";"142";"53.38";"124";"46,62%";"53.38";53.380
"MULTIPOLYGON (((-58.3880947855536 -34.6288381827583,-58.3870245297271 -34.6286528694125,-58.386868291187 -34.6300423255818,-58.3879413898656 -34.630117286246,-58.3880947855536 -34.6288381827583)))";;"184";1_29_3;COMUNA 1;"29";"3";"817";"391";"426";"91,78%";"300";"299";"99,67%";"1";"0,33%";"276";"124";"44.93";"152";"55,07%";"44.93";44.930
"MULTIPOLYGON (((-58.3879413898656 -34.630117286246,-58.3879273114603 -34.6302351688416,-58.387826786054 -34.6311728141803,-58.3878047564736 -34.6313209745466,-58.3879811922729 -34.6313365057998,-58.3890296706179 -34.6314285550399,-58.3891624722398 -34.630202538384,-58.3891842907867 -34.6300007842917,-58.3892807039218 -34.6291667301641,-58.3892931641991 -34.6290457477217,-58.3880947855536 -34.6288381827583,-58.3879413898656 -34.630117286246)))";;"185";1_29_4;COMUNA 1;"29";"4";"723";"341";"382";"89,27%";"295";"294";"99,66%";"1";"0,34%";"272";"71";"26.1";"201";"73,90%";"26.1";26.100
"MULTIPOLYGON (((-58.3900482446701 -34.6291764858308,-58.3892931641991 -34.6290457477217,-58.3892807039218 -34.6291667301641,-58.3891842907867 -34.6300007842917,-58.3891624722398 -34.630202538384,-58.3890296706179 -34.6314285550399,-58.3892327725947 -34.6314463541812,-58.3906624480134 -34.6315298857156,-58.3907830275837 -34.6305183742185,-58.3908900448041 -34.6296206610456,-58.3909253131393 -34.6293283481459,-58.3900482446701 -34.6291764858308)))";;"186";1_29_5;COMUNA 1;"29";"5";"804";"385";"419";"91,89%";"335";"334";"99,70%";"1";"0,30%";"306";"114";"37.25";"192";"62,75%";"37.25";37.250
"MULTIPOLYGON (((-58.3906624480134 -34.6315298857156,-58.3892327725947 -34.6314463541812,-58.3890296706179 -34.6314285550399,-58.3879811922729 -34.6313365057998,-58.3878047564736 -34.6313209745466,-58.3877858981568 -34.6314480798226,-58.3877180108628 -34.6324703251573,-58.3879189054189 -34.632481927742,-58.3887315998258 -34.6325293966738,-58.3889030988566 -34.6325424587289,-58.3905268471557 -34.6326661808509,-58.3905573140608 -34.6324116835041,-58.3906624480134 -34.6315298857156)))";;"187";1_29_6;COMUNA 1;"29";"6";"990";"493";"497";"99,20%";"349";"349";"100,00%";"0";"0,00%";"323";"15";"4.64";"308";"95,36%";"4.64";4.640
"MULTIPOLYGON (((-58.3905268471557 -34.6326661808509,-58.3889030988566 -34.6325424587289,-58.3887315998258 -34.6325293966738,-58.3879189054189 -34.632481927742,-58.3877180108628 -34.6324703251573,-58.3876524529162 -34.6334586269479,-58.3885568217639 -34.6337120051837,-58.3887636517506 -34.6337595266455,-58.3895154144318 -34.6339320983137,-58.3903526218416 -34.6341243645838,-58.3905268471557 -34.6326661808509)))";;"188";1_29_7;COMUNA 1;"29";"7";"916";"405";"511";"79,26%";"388";"386";"99,48%";"2";"0,52%";"328";"58";"17.68";"270";"82,32%";"17.68";17.680
"MULTIPOLYGON (((-58.3879413898656 -34.630117286246,-58.386868291187 -34.6300423255818,-58.3867351531535 -34.6312267888767,-58.3866030424654 -34.6324016746564,-58.3865198914028 -34.6331412947909,-58.3872677718033 -34.6333557806715,-58.3876524529162 -34.6334586269479,-58.3877180108628 -34.6324703251573,-58.3877858981568 -34.6314480798226,-58.3878047564736 -34.6313209745466,-58.387826786054 -34.6311728141803,-58.3879273114603 -34.6302351688416,-58.3879413898656 -34.630117286246)))";;"189";1_29_8;COMUNA 1;"29";"8";"648";"300";"348";"86,21%";"279";"279";"100,00%";"0";"0,00%";"260";"103";"39.62";"157";"60,38%";"39.62";39.620
"MULTIPOLYGON (((-58.386868291187 -34.6300423255818,-58.3858272271339 -34.6299696292664,-58.3855911614669 -34.6299475781266,-58.385586163795 -34.6301003265016,-58.3855331657981 -34.6309329965328,-58.3855216612584 -34.6311197559678,-58.3854169064102 -34.6328208721581,-58.3865198914028 -34.6331412947909,-58.3866030424654 -34.6324016746564,-58.3867351531535 -34.6312267888767,-58.386868291187 -34.6300423255818)))";;"190";1_29_9;COMUNA 1;"29";"9";"923";"434";"489";"88,75%";"433";"432";"99,77%";"1";"0,23%";"376";"64";"17.02";"312";"82,98%";"17.02";17.020
"MULTIPOLYGON (((-58.3818446741824 -34.5915925656913,-58.3815570817364 -34.5916010371192,-58.3816152390959 -34.5928350678892,-58.3819664431288 -34.5928347373379,-58.3822100887598 -34.5928345461565,-58.3828364480172 -34.5928339717242,-58.3830152861462 -34.5928338069307,-58.3844431021733 -34.5928255756163,-58.3844356903732 -34.5927377505194,-58.3843319163423 -34.5915193261771,-58.3831483350795 -34.5915541251538,-58.3830824196833 -34.5915560540762,-58.3828931044783 -34.5915616348677,-58.3827323185218 -34.5915663889598,-58.3821649688806 -34.5915830587915,-58.3820625188788 -34.5915860898522,-58.3818446741824 -34.5915925656913)))";;"191";1_5_1;COMUNA 1;"5";"1";"631";"261";"370";"70,54%";"362";"362";"100,00%";"0";"0,00%";"257";"1";"0.39";"256";"99,61%";"0.39";0.390
"MULTIPOLYGON (((-58.3828364480172 -34.5928339717242,-58.3822100887598 -34.5928345461565,-58.3819664431288 -34.5928347373379,-58.3816152390959 -34.5928350678892,-58.3816234993212 -34.5930107844817,-58.3815924718022 -34.5941796123109,-58.3817049598645 -34.5941913071945,-58.3820224130748 -34.5942243356621,-58.3824171862842 -34.5942653722526,-58.3824898848808 -34.5943852838793,-58.3825846012851 -34.5946350741226,-58.3826710764389 -34.5944210380303,-58.3827710007555 -34.5943022256541,-58.3829523787315 -34.5943210774435,-58.3844135773131 -34.5944319574497,-58.3844164117185 -34.5943155462848,-58.3844666844659 -34.5931058834051,-58.3844431021733 -34.5928255756163,-58.3830152861462 -34.5928338069307,-58.3828364480172 -34.5928339717242)))";;"192";1_5_2;COMUNA 1;"5";"2";"533";"232";"301";"77,08%";"430";"430";"100,00%";"0";"0,00%";"240";"2";"0.83";"238";"99,17%";"0.83";0.830
"MULTIPOLYGON (((-58.3865040818596 -34.5928256122097,-58.3862516744825 -34.5928151018307,-58.3844431021733 -34.5928255756163,-58.3844666844659 -34.5931058834051,-58.3844164117185 -34.5943155462848,-58.3844135773131 -34.5944319574497,-58.3858200007729 -34.5945639130469,-58.3858279341508 -34.5944570829002,-58.3860795778347 -34.5931713458874,-58.3865040818596 -34.5928256122097)))";;"193";1_5_3;COMUNA 1;"5";"3";"928";"362";"566";"63,96%";"643";"640";"99,53%";"3";"0,47%";"405";"3";"0.74";"402";"99,26%";"0.74";0.740
"MULTIPOLYGON (((-58.38756654533 -34.5928304260636,-58.3870289222642 -34.5928326996121,-58.3867047984975 -34.5928340475541,-58.3865040818596 -34.5928256122097,-58.3860795778347 -34.5931713458874,-58.3858279341508 -34.5944570829002,-58.3858200007729 -34.5945639130469,-58.3859126506156 -34.5945717181619,-58.3871397055971 -34.5946319934707,-58.3872901768753 -34.5946445518222,-58.3873092570493 -34.5945461795004,-58.38756654533 -34.5928304260636)))";;"194";1_5_4;COMUNA 1;"5";"4";"1200";"497";"703";"70,70%";"698";"697";"99,86%";"1";"0,14%";"490";"4";"0.82";"486";"99,18%";"0.82";0.820
"MULTIPOLYGON (((-58.3872901768753 -34.5946445518222,-58.3871397055971 -34.5946319934707,-58.3859126506156 -34.5945717181619,-58.3858200007729 -34.5945639130469,-58.3857541154417 -34.5954543286439,-58.3857480316609 -34.595679333527,-58.3859901391245 -34.5956938527145,-58.3871562567267 -34.5957282434639,-58.3871783904446 -34.5955498699697,-58.3872704117887 -34.5947468675315,-58.3872901768753 -34.5946445518222)))";;"195";1_5_5;COMUNA 1;"5";"5";"637";"275";"362";"75,97%";"389";"387";"99,49%";"2";"0,52%";"242";"0";"0";"242";"100,00%";"0";0.000
"MULTIPOLYGON (((-58.3858200007729 -34.5945639130469,-58.3844135773131 -34.5944319574497,-58.3844103918098 -34.5945594955807,-58.3843152066893 -34.5954376375936,-58.3842999872437 -34.5955924929721,-58.3857480316609 -34.595679333527,-58.3857541154417 -34.5954543286439,-58.3858200007729 -34.5945639130469)))";;"196";1_5_6;COMUNA 1;"5";"6";"888";"435";"453";"96,03%";"641";"638";"99,53%";"3";"0,47%";"365";"3";"0.82";"362";"99,18%";"0.82";0.820
"MULTIPOLYGON (((-58.3844135773131 -34.5944319574497,-58.3829523787315 -34.5943210774435,-58.3827710007555 -34.5943022256541,-58.3826710764389 -34.5944210380303,-58.3825846012851 -34.5946350741226,-58.3824898848808 -34.5943852838793,-58.3824171862842 -34.5942653722526,-58.3820224130748 -34.5942243356621,-58.3817049598645 -34.5941913071945,-58.3815924718022 -34.5941796123109,-58.38149277784 -34.5951978250144,-58.3814845274893 -34.5953620512418,-58.3819723041552 -34.5954033624055,-58.3820230574513 -34.5954076919115,-58.3824112865245 -34.59544055486,-58.3827174248311 -34.5954664611197,-58.3842999872437 -34.5955924929721,-58.3843152066893 -34.5954376375936,-58.3844103918098 -34.5945594955807,-58.3844135773131 -34.5944319574497)))";;"197";1_5_7;COMUNA 1;"5";"7";"597";"253";"344";"73,55%";"563";"563";"100,00%";"0";"0,00%";"270";"1";"0.37";"269";"99,63%";"0.37";0.370
"MULTIPOLYGON (((-58.3809054173487 -34.5892778341573,-58.3795393494004 -34.5900213770799,-58.3794497097895 -34.59007483921,-58.3801431737102 -34.5913446562106,-58.3801378725373 -34.5914522624964,-58.3800738303147 -34.5927448051243,-58.3800778893377 -34.5928598123755,-58.3814241377984 -34.5928352224641,-58.3816152390959 -34.5928350678892,-58.3815570817364 -34.5916010371192,-58.3815460674703 -34.5913677811722,-58.3815462244799 -34.5905932436656,-58.3814365889015 -34.5903682322362,-58.3809054173487 -34.5892778341573)))";;"198";1_6_1;COMUNA 1;"6";"1";"948";"444";"504";"88,10%";"513";"509";"99,22%";"4";"0,79%";"326";"1";"0.31";"325";"99,69%";"0.31";0.310
"MULTIPOLYGON (((-58.3800338139019 -34.594111098987,-58.3799724123871 -34.5941106348254,-58.3799585379609 -34.5947048034565,-58.3799502646671 -34.59506093843,-58.379953931157 -34.595228200922,-58.3812259924647 -34.5953401174959,-58.3814845274893 -34.5953620512418,-58.38149277784 -34.5951978250144,-58.3815924718022 -34.5941796123109,-58.3813900614997 -34.5941585613045,-58.3801637704181 -34.5941121729064,-58.3800338139019 -34.594111098987)))";;"199";1_6_10;COMUNA 1;"6";"10";"415";"184";"231";"79,65%";"354";"352";"99,44%";"2";"0,57%";"193";"1";"0.52";"192";"99,48%";"0.52";0.520
"MULTIPOLYGON (((-58.3801378725373 -34.5914522624964,-58.3800297290096 -34.5914431044202,-58.3795893699345 -34.5914423123375,-58.3794611498824 -34.591497438389,-58.3793955379024 -34.5915366205144,-58.3793342523281 -34.5915924963574,-58.3793018536742 -34.591630503886,-58.3787708206609 -34.592285165557,-58.3787139076304 -34.5923109020607,-58.3786591343535 -34.5923259353661,-58.3785715690599 -34.5923461575171,-58.3785809024331 -34.5928871006335,-58.3800778893377 -34.5928598123755,-58.3800738303147 -34.5927448051243,-58.3801378725373 -34.5914522624964)))";;"200";1_6_2;COMUNA 1;"6";"2";"641";"291";"350";"83,14%";"425";"423";"99,53%";"2";"0,47%";"210";"0";"0";"210";"100,00%";"0";0.000
"MULTIPOLYGON (((-58.3794497097895 -34.59007483921,-58.3794523588356 -34.5900710928065,-58.3787492046658 -34.590492615319,-58.3778553805852 -34.5910789921712,-58.3785715690599 -34.5923461575171,-58.3786591343535 -34.5923259353661,-58.3787139076304 -34.5923109020607,-58.3787708206609 -34.592285165557,-58.3793018536742 -34.591630503886,-58.3793342523281 -34.5915924963574,-58.3793955379024 -34.5915366205144,-58.3794611498824 -34.591497438389,-58.3795893699345 -34.5914423123375,-58.3800297290096 -34.5914431044202,-58.3801378725373 -34.5914522624964,-58.3801431737102 -34.5913446562106,-58.3794497097895 -34.59007483921)))";;"201";1_6_3;COMUNA 1;"6";"3";"1160";"543";"617";"88,01%";"685";"684";"99,85%";"1";"0,15%";"426";"0";"0";"426";"100,00%";"0";0.000
"MULTIPOLYGON (((-58.3778553805852 -34.5910789921712,-58.3771294215245 -34.5915552646306,-58.3766700174054 -34.5918546012996,-58.377086767309 -34.5928730328827,-58.3778555998267 -34.5928737811154,-58.3785809024331 -34.5928871006335,-58.3785715690599 -34.5923461575171,-58.3778553805852 -34.5910789921712)))";;"202";1_6_4;COMUNA 1;"6";"4";"789";"350";"439";"79,73%";"704";"704";"100,00%";"0";"0,00%";"397";"2";"0.5";"395";"99,50%";"0.5";0.500
"MULTIPOLYGON (((-58.3766700174054 -34.5918546012996,-58.3754398956107 -34.5926562241598,-58.3752870137716 -34.5927549918542,-58.3751480221788 -34.5928448253097,-58.375041072634 -34.5929139061661,-58.3755081905292 -34.5929045925474,-58.3756936750988 -34.5929008515427,-58.377086767309 -34.5928730328827,-58.3766700174054 -34.5918546012996)))";;"203";1_6_5;COMUNA 1;"6";"5";"332";"146";"186";"78,49%";"331";"330";"99,70%";"1";"0,30%";"169";"1";"0.59";"168";"99,41%";"0.59";0.590
"MULTIPOLYGON (((-58.377086767309 -34.5928730328827,-58.3756936750988 -34.5929008515427,-58.3759491485583 -34.5932377367175,-58.3757342606208 -34.5933442780742,-58.3766680924528 -34.5944654061594,-58.3768647225133 -34.5945582947072,-58.3770314924923 -34.5945374251671,-58.377249001985 -34.5945334930044,-58.3774712905638 -34.5946031581997,-58.377634235384 -34.594742291377,-58.3776588451166 -34.5948281569317,-58.3776884026758 -34.5949058565962,-58.377685296917 -34.5950286056715,-58.378501172884 -34.5951003712845,-58.3785040351729 -34.5949645229214,-58.3785164586136 -34.5946371244185,-58.3785368442409 -34.5940990189639,-58.3785770866098 -34.5930397800317,-58.3785809024331 -34.5928871006335,-58.3778555998267 -34.5928737811154,-58.377086767309 -34.5928730328827)))";;"204";1_6_6;COMUNA 1;"6";"6";"569";"245";"324";"75,62%";"396";"396";"100,00%";"0";"0,00%";"252";"2";"0.79";"250";"99,21%";"0.79";0.790
"MULTIPOLYGON (((-58.3799724123871 -34.5941106348254,-58.3785368442409 -34.5940990189639,-58.3785164586136 -34.5946371244185,-58.3785040351729 -34.5949645229214,-58.378501172884 -34.5951003712845,-58.379953931157 -34.595228200922,-58.3799502646671 -34.59506093843,-58.3799585379609 -34.5947048034565,-58.3799724123871 -34.5941106348254)))";;"205";1_6_7;COMUNA 1;"6";"7";"498";"220";"278";"79,14%";"387";"387";"100,00%";"0";"0,00%";"227";"1";"0.44";"226";"99,56%";"0.44";0.440
"MULTIPOLYGON (((-58.3800778893377 -34.5928598123755,-58.3785809024331 -34.5928871006335,-58.3785770866098 -34.5930397800317,-58.3785368442409 -34.5940990189639,-58.3799724123871 -34.5941106348254,-58.3800338139019 -34.594111098987,-58.3800817828602 -34.5929699601673,-58.3800778893377 -34.5928598123755)))";;"206";1_6_8;COMUNA 1;"6";"8";"730";"354";"376";"94,15%";"511";"505";"98,83%";"6";"1,19%";"296";"3";"1.01";"293";"98,99%";"1.01";1.010
"MULTIPOLYGON (((-58.3816152390959 -34.5928350678892,-58.3814241377984 -34.5928352224641,-58.3800778893377 -34.5928598123755,-58.3800817828602 -34.5929699601673,-58.3800338139019 -34.594111098987,-58.3801637704181 -34.5941121729064,-58.3813900614997 -34.5941585613045,-58.3815924718022 -34.5941796123109,-58.3816234993212 -34.5930107844817,-58.3816152390959 -34.5928350678892)))";;"207";1_6_9;COMUNA 1;"6";"9";"1046";"462";"584";"79,11%";"602";"602";"100,00%";"0";"0,00%";"419";"2";"0.48";"417";"99,52%";"0.48";0.480
"MULTIPOLYGON (((-58.379953931157 -34.595228200922,-58.378501172884 -34.5951003712845,-58.378496703385 -34.5953098129355,-58.378435974129 -34.5962451592833,-58.3784378090979 -34.5963677709128,-58.3799007063823 -34.5965132849125,-58.3799579206478 -34.5954132812198,-58.379953931157 -34.595228200922)))";;"208";1_7_1;COMUNA 1;"7";"1";"669";"326";"343";"95,04%";"620";"618";"99,68%";"2";"0,32%";"264";"2";"0.76";"262";"99,24%";"0.76";0.760
"MULTIPOLYGON (((-58.3783619848694 -34.5976591766372,-58.3775716823936 -34.5976232039677,-58.3769003593709 -34.5975851267133,-58.3768865919108 -34.5977221645388,-58.3768386085398 -34.5986665330977,-58.3768389737292 -34.5988082289015,-58.3782790462545 -34.5989090262371,-58.3783619848694 -34.5976591766372)))";;"209";1_7_10;COMUNA 1;"7";"10";"384";"179";"205";"87,32%";"853";"852";"99,88%";"1";"0,12%";"232";"1";"0.43";"231";"99,57%";"0.43";0.430
"MULTIPOLYGON (((-58.3769003593709 -34.5975851267133,-58.3754015306869 -34.5974999759114,-58.3752579498464 -34.5974918446311,-58.3742540021368 -34.5974252734921,-58.374248099271 -34.5975305549397,-58.3742276723295 -34.5979200620895,-58.3741996854946 -34.5984511888546,-58.3741872396636 -34.5986225948192,-58.3753681616938 -34.5987052798189,-58.3768389737292 -34.5988082289015,-58.3768386085398 -34.5986665330977,-58.3768865919108 -34.5977221645388,-58.3769003593709 -34.5975851267133)))";;"210";1_7_11;COMUNA 1;"7";"11";"213";"110";"103";"106,80%";"362";"362";"100,00%";"0";"0,00%";"140";"2";"1.43";"138";"98,57%";"1.43";1.430
"MULTIPOLYGON (((-58.3742540021368 -34.5974252734921,-58.3730696031006 -34.5973467302431,-58.3729544768077 -34.5973304478223,-58.3728799049945 -34.5978534411576,-58.3728702864915 -34.5979276622689,-58.3728630723375 -34.5979835745893,-58.3727942793841 -34.5985170654278,-58.3741872396636 -34.5986225948192,-58.3741996854946 -34.5984511888546,-58.3742276723295 -34.5979200620895,-58.374248099271 -34.5975305549397,-58.3742540021368 -34.5974252734921)))";;"211";1_7_12;COMUNA 1;"7";"12";"507";"268";"239";"112,13%";"404";"400";"99,01%";"4";"1,00%";"175";"2";"1.14";"173";"98,86%";"1.14";1.140
"MULTIPOLYGON (((-58.373352468591 -34.5944970773453,-58.3730404868817 -34.5945189605752,-58.3739092713493 -34.5936450178906,-58.3726689705868 -34.5921496845595,-58.372625425209 -34.5920971855809,-58.3721891715766 -34.5917628356132,-58.3704784770947 -34.595927632361,-58.3699823316135 -34.5971355422882,-58.3695123426162 -34.5983212859799,-58.3709301292087 -34.5983810951126,-58.3710855510717 -34.5983876205955,-58.3712375608943 -34.5983990730885,-58.371337623327 -34.5984066835472,-58.3714799249247 -34.5984174946423,-58.3727942793841 -34.5985170654278,-58.3728630723375 -34.5979835745893,-58.3728702864915 -34.5979276622689,-58.3728799049945 -34.5978534411576,-58.3729544768077 -34.5973304478223,-58.3731009580777 -34.5963025582119,-58.3731182096405 -34.5961781998889,-58.3731376075648 -34.5960377157539,-58.3732865572936 -34.5950862389204,-58.3732970251396 -34.5950134972939,-58.373352468591 -34.5944970773453)))";;"212";1_7_13;COMUNA 1;"7";"13";"1425";"922";"503";"183,30%";"254";"249";"98,03%";"5";"2,01%";"64";"2";"3.13";"62";"96,88%";"3.13";3.130
"MULTIPOLYGON (((-58.3756936750988 -34.5929008515427,-58.3755081905292 -34.5929045925474,-58.375041072634 -34.5929139061661,-58.3751480221788 -34.5928448253097,-58.3752870137716 -34.5927549918542,-58.3754398956107 -34.5926562241597,-58.3744314436999 -34.5914279155347,-58.3741530451682 -34.5911121801702,-58.3739745417299 -34.5911309739871,-58.3737502692039 -34.5911535188844,-58.3736907626257 -34.5911648295761,-58.3734114545195 -34.5912970897962,-58.372623878948 -34.5916825496944,-58.3726119195164 -34.5915127160526,-58.3724897640821 -34.5915465708107,-58.3723505411043 -34.5915345659399,-58.3722898663127 -34.5916141782274,-58.3721891715766 -34.5917628356131,-58.372625425209 -34.5920971855809,-58.3726689705868 -34.5921496845595,-58.3739092713493 -34.5936450178906,-58.3744418433906 -34.5944782535244,-58.3743994982184 -34.5950599355905,-58.374346892319 -34.595781142451,-58.3743200800904 -34.5961487229899,-58.3743175981488 -34.5962406261433,-58.3744158724366 -34.5962457678997,-58.3754134891839 -34.5962450066417,-58.375413272397 -34.596248047682,-58.3755750943042 -34.5964997916859,-58.3757356345084 -34.5965150797714,-58.3758635362495 -34.5964537160418,-58.3762594007173 -34.5962706801784,-58.376586513027 -34.5962748552696,-58.3769541631137 -34.5962795509523,-58.377060360216 -34.596282442538,-58.3783125446794 -34.5963552895073,-58.3784378090979 -34.5963677709128,-58.378435974129 -34.5962451592833,-58.378496703385 -34.5953098129355,-58.378501172884 -34.5951003712845,-58.377685296917 -34.5950286056715,-58.3776884026758 -34.5949058565962,-58.3776588451166 -34.5948281569316,-58.377634235384 -34.594742291377,-58.3774712905637 -34.5946031581997,-58.377249001985 -34.5945334930044,-58.3770314924923 -34.594537425167,-58.3768647225133 -34.5945582947072,-58.3766680924528 -34.5944654061594,-58.3757342606208 -34.5933442780742,-58.3759491485583 -34.5932377367174,-58.3756936750988 -34.5929008515427)))";;"213";1_7_2;COMUNA 1;"7";"2";"770";"430";"340";"126,47%";"281";"277";"98,58%";"4";"1,44%";"117";"0";"0";"117";"100,00%";"0";0.000
"MULTIPOLYGON (((-58.3739092713493 -34.5936450178906,-58.3730404868817 -34.5945189605752,-58.373352468591 -34.5944970773453,-58.3732970251396 -34.5950134972939,-58.3732865572936 -34.5950862389204,-58.3731376075648 -34.5960377157539,-58.3731182096405 -34.5961781998889,-58.3743175981488 -34.5962406261433,-58.3743200800905 -34.5961487229899,-58.374346892319 -34.595781142451,-58.3743994982184 -34.5950599355906,-58.3744418433907 -34.5944782535244,-58.3739092713493 -34.5936450178906)))";;"214";1_7_3;COMUNA 1;"7";"3";"261";"142";"119";"119,33%";"295";"293";"99,32%";"2";"0,68%";"126";"1";"0.79";"125";"99,21%";"0.79";0.790
"MULTIPOLYGON (((-58.3743175981488 -34.5962406261433,-58.3731182096405 -34.5961781998889,-58.3731009580777 -34.5963025582119,-58.3729544768077 -34.5973304478223,-58.3730696031006 -34.5973467302431,-58.3742540021368 -34.5974252734921,-58.3743152915281 -34.5963278109305,-58.3743175981488 -34.5962406261433)))";;"215";1_7_4;COMUNA 1;"7";"4";"560";"265";"295";"89,83%";"597";"595";"99,66%";"2";"0,34%";"278";"4";"1.44";"274";"98,56%";"1.44";1.440
"MULTIPOLYGON (((-58.3754134891839 -34.5962450066417,-58.3744158724366 -34.5962457678997,-58.3743175981488 -34.5962406261433,-58.3743152915281 -34.5963278109305,-58.3742540021368 -34.5974252734921,-58.3752579498464 -34.5974918446311,-58.3754015306869 -34.5974999759114,-58.3754034396306 -34.597384832016,-58.375413272397 -34.596248047682,-58.3754134891839 -34.5962450066417)))";;"216";1_7_5;COMUNA 1;"7";"5";"403";"200";"203";"98,52%";"457";"455";"99,56%";"2";"0,44%";"147";"2";"1.36";"145";"98,64%";"1.36";1.360
"MULTIPOLYGON (((-58.3758635362495 -34.5964537160418,-58.3757356345084 -34.5965150797714,-58.3755750943042 -34.5964997916859,-58.375413272397 -34.596248047682,-58.3754034396306 -34.597384832016,-58.3754015306869 -34.5974999759114,-58.3769003593709 -34.5975851267133,-58.3769103401824 -34.5974863271245,-58.3769541631137 -34.5962795509523,-58.376586513027 -34.5962748552696,-58.3762594007173 -34.5962706801784,-58.3758635362495 -34.5964537160418)))";;"217";1_7_6;COMUNA 1;"7";"6";"300";"148";"152";"97,37%";"400";"398";"99,50%";"2";"0,50%";"80";"0";"0";"80";"100,00%";"0";0.000
"MULTIPOLYGON (((-58.3784378090979 -34.5963677709128,-58.3783125446794 -34.5963552895073,-58.377060360216 -34.596282442538,-58.3769541631137 -34.5962795509523,-58.3769103401824 -34.5974863271245,-58.3769003593709 -34.5975851267133,-58.3775716823936 -34.5976232039677,-58.3783619848694 -34.5976591766372,-58.3784396445696 -34.5964898895633,-58.3784378090979 -34.5963677709128)))";;"218";1_7_7;COMUNA 1;"7";"7";"592";"264";"328";"80,49%";"641";"639";"99,69%";"2";"0,31%";"249";"2";"0.8";"247";"99,20%";"0.8";0.800
"MULTIPOLYGON (((-58.3799007063823 -34.5965132849125,-58.3784378090979 -34.5963677709128,-58.3784396445696 -34.5964898895633,-58.3783619848694 -34.5976591766372,-58.3798340953963 -34.5977261736519,-58.379894889233 -34.5966252571114,-58.3799007063823 -34.5965132849125)))";;"219";1_7_8;COMUNA 1;"7";"8";"597";"281";"316";"88,92%";"469";"467";"99,57%";"2";"0,43%";"240";"4";"1.67";"236";"98,33%";"1.67";1.670
"MULTIPOLYGON (((-58.3798340953963 -34.5977261736519,-58.3783619848694 -34.5976591766372,-58.3782790462545 -34.5989090262371,-58.3797420702885 -34.5989715812894,-58.3797521128766 -34.5988074269235,-58.3798288041738 -34.5978229343317,-58.3798340953963 -34.5977261736519)))";;"220";1_7_9;COMUNA 1;"7";"9";"330";"147";"183";"80,33%";"571";"570";"99,82%";"1";"0,18%";"183";"2";"1.09";"181";"98,91%";"1.09";1.090
"MULTIPOLYGON (((-58.3871562567267 -34.5957282434639,-58.3859901391245 -34.5956938527145,-58.3857480316609 -34.595679333527,-58.3857427405618 -34.5958758870961,-58.3856692759398 -34.5968560898678,-58.3856493259762 -34.5969714338299,-58.3858046605242 -34.5969787151883,-58.3869226514007 -34.5970420226156,-58.3870628229592 -34.5970535184703,-58.3870614854001 -34.596931893237,-58.387130691734 -34.5959337989747,-58.3871562567267 -34.5957282434639)))";;"221";1_8_1;COMUNA 1;"8";"1";"352";"148";"204";"72,55%";"364";"363";"99,73%";"1";"0,28%";"188";"1";"0.53";"187";"99,47%";"0.53";0.530
"MULTIPOLYGON (((-58.3813404806201 -34.5978440227855,-58.3799201090843 -34.5977301054203,-58.3798340953963 -34.5977261736519,-58.3798288041738 -34.5978229343317,-58.3797521128766 -34.5988074269235,-58.3797420702885 -34.5989715812894,-58.3810205523774 -34.599020544196,-58.3812498973238 -34.5990312612813,-58.3813312370286 -34.5979781766938,-58.3813404806201 -34.5978440227855)))";;"222";1_8_10;COMUNA 1;"8";"10";"445";"215";"230";"93,48%";"395";"392";"99,24%";"3";"0,77%";"186";"0";"0";"186";"100,00%";"0";0.000
"MULTIPOLYGON (((-58.3857480316609 -34.595679333527,-58.3842999872437 -34.5955924929721,-58.3841799481662 -34.5968151390858,-58.3841740748346 -34.5969023921892,-58.3854414468024 -34.5969617245592,-58.3856493259762 -34.5969714338299,-58.3856692759398 -34.5968560898678,-58.3857427405618 -34.5958758870961,-58.3857480316609 -34.595679333527)))";;"223";1_8_2;COMUNA 1;"8";"2";"1324";"599";"725";"82,62%";"908";"907";"99,89%";"1";"0,11%";"567";"3";"0.53";"564";"99,47%";"0.53";0.530
"MULTIPOLYGON (((-58.3813312370286 -34.5979781766938,-58.3812498973238 -34.5990312612813,-58.3816455665877 -34.599049624029,-58.382088927577 -34.5990702001911,-58.3825208768478 -34.5990902742679,-58.3827718537967 -34.5991019182328,-58.384028613289 -34.5991601315231,-58.3840414836121 -34.5989687944897,-58.3840884038053 -34.5981625967088,-58.3840939317432 -34.5980805548726,-58.3841740748346 -34.5969023921892,-58.3841799481662 -34.5968151390858,-58.3842999872437 -34.5955924929721,-58.3827174248311 -34.5954664611197,-58.3824112865245 -34.59544055486,-58.3820230574513 -34.5954076919115,-58.3819723041552 -34.5954033624055,-58.3814845274893 -34.5953620512418,-58.3814399833757 -34.5962402949921,-58.3814172331211 -34.5966890999666,-58.3814104585393 -34.5968243119298,-58.3813404806201 -34.5978440227855,-58.3813312370286 -34.5979781766938)))";;"224";1_8_3;COMUNA 1;"8";"3";"1104";"520";"584";"89,04%";"813";"812";"99,88%";"1";"0,12%";"448";"3";"0.67";"445";"99,33%";"0.67";0.670
"MULTIPOLYGON (((-58.3814845274893 -34.5953620512418,-58.3812259924647 -34.5953401174959,-58.379953931157 -34.595228200922,-58.3799579206478 -34.5954132812198,-58.3799007063823 -34.5965132849125,-58.3800075775296 -34.5965239211684,-58.3812099603211 -34.5966701581841,-58.3814172331211 -34.5966890999666,-58.3814399833757 -34.5962402949921,-58.3814845274893 -34.5953620512418)))";;"225";1_8_4;COMUNA 1;"8";"4";"592";"249";"343";"72,59%";"704";"703";"99,86%";"1";"0,14%";"295";"4";"1.36";"291";"98,64%";"1.36";1.360
"MULTIPOLYGON (((-58.3814172331211 -34.5966890999666,-58.3812099603211 -34.5966701581841,-58.3800075775296 -34.5965239211684,-58.3799007063823 -34.5965132849125,-58.379894889233 -34.5966252571114,-58.3798340953963 -34.5977261736519,-58.3799201090843 -34.5977301054203,-58.3813404806201 -34.5978440227855,-58.3814104585393 -34.5968243119298,-58.3814172331211 -34.5966890999666)))";;"226";1_8_5;COMUNA 1;"8";"5";"589";"266";"323";"82,35%";"458";"456";"99,56%";"2";"0,44%";"214";"2";"0.93";"212";"99,07%";"0.93";0.930
"MULTIPOLYGON (((-58.3856493259762 -34.5969714338299,-58.3854414468024 -34.5969617245592,-58.3841740748346 -34.5969023921892,-58.3840939317432 -34.5980805548726,-58.385542265691 -34.5981770463078,-58.3856232968947 -34.5971217752943,-58.3856493259762 -34.5969714338299)))";;"227";1_8_6;COMUNA 1;"8";"6";"1144";"512";"632";"81,01%";"1024";"1022";"99,80%";"2";"0,20%";"572";"24";"4.2";"548";"95,80%";"4.2";4.200
"MULTIPOLYGON (((-58.3870628229592 -34.5970535184703,-58.3869226514007 -34.5970420226156,-58.3858046605242 -34.5969787151883,-58.3856493259762 -34.5969714338299,-58.3856232968947 -34.5971217752943,-58.385542265691 -34.5981770463078,-58.3856741811417 -34.5981849468491,-58.3868195934111 -34.5982683437171,-58.3869592547376 -34.5982812478773,-58.3869721230883 -34.5981783645968,-58.3870641650542 -34.5971701435116,-58.3870628229592 -34.5970535184703)))";;"228";1_8_7;COMUNA 1;"8";"7";"1334";"543";"791";"68,65%";"953";"952";"99,90%";"1";"0,11%";"561";"3";"0.53";"558";"99,47%";"0.53";0.530
"MULTIPOLYGON (((-58.3869592547376 -34.5982812478773,-58.3868195934111 -34.5982683437171,-58.3856741811417 -34.5981849468491,-58.385542265691 -34.5981770463078,-58.3855328696862 -34.5982990872955,-58.3854717123067 -34.5992276756506,-58.3868058890251 -34.5992901348243,-58.386863459811 -34.5992928467762,-58.3869438983015 -34.5984042008012,-58.3869592547376 -34.5982812478773)))";;"229";1_8_8;COMUNA 1;"8";"8";"446";"194";"252";"76,98%";"346";"345";"99,71%";"1";"0,29%";"189";"1";"0.53";"188";"99,47%";"0.53";0.530
"MULTIPOLYGON (((-58.385542265691 -34.5981770463078,-58.3840939317432 -34.5980805548726,-58.3840884038053 -34.5981625967088,-58.3840414836121 -34.5989687944897,-58.384028613289 -34.5991601315231,-58.3842030285238 -34.5991682018982,-58.3854717123067 -34.5992276756506,-58.3855328696862 -34.5982990872955,-58.385542265691 -34.5981770463078)))";;"230";1_8_9;COMUNA 1;"8";"9";"691";"270";"421";"64,13%";"481";"477";"99,17%";"4";"0,84%";"257";"0";"0";"257";"100,00%";"0";0.000
"MULTIPOLYGON (((-58.3868058890251 -34.5992901348243,-58.3854717123067 -34.5992276756506,-58.385352396084 -34.6005101840809,-58.3865661652531 -34.6005717948153,-58.3867046419448 -34.6005804025879,-58.3868058890251 -34.5992901348243)))";;"231";1_9_1;COMUNA 1;"9";"1";"292";"125";"167";"74,85%";"410";"410";"100,00%";"0";"0,00%";"161";"4";"2.48";"157";"97,52%";"2.48";2.480
"MULTIPOLYGON (((-58.3739936385399 -34.6009615570911,-58.3741023056399 -34.6009698757893,-58.3751725528857 -34.6010409325349,-58.375330362426 -34.6010497079314,-58.375339693295 -34.6009230901114,-58.3753725655251 -34.6000309671955,-58.3753635316056 -34.5998740533685,-58.3753549991424 -34.5997262951731,-58.3753587129491 -34.5989447892296,-58.3753681616938 -34.5987052798189,-58.3741872396636 -34.5986225948192,-58.3727942793841 -34.5985170654278,-58.3726669818036 -34.5996762410363,-58.3726605299186 -34.5997358160017,-58.3725899099918 -34.6008543273422,-58.3739936385399 -34.6009615570911)))";;"232";1_9_10;COMUNA 1;"9";"10";"369";"185";"184";"100,54%";"366";"360";"98,36%";"6";"1,67%";"108";"1";"0.93";"107";"99,07%";"0.93";0.930
"MULTIPOLYGON (((-58.3727942793841 -34.5985170654278,-58.3714799249247 -34.5984174946423,-58.3713958897832 -34.5994848667899,-58.3713895779765 -34.5995712737986,-58.3714967081342 -34.5995812838722,-58.3726669818036 -34.5996762410363,-58.3727942793841 -34.5985170654278)))";;"233";1_9_11;COMUNA 1;"9";"11";"422";"242";"180";"134,44%";"383";"380";"99,22%";"3";"0,79%";"116";"4";"3.45";"112";"96,55%";"3.45";3.450
"MULTIPOLYGON (((-58.3726669818036 -34.5996762410363,-58.3714967081342 -34.5995812838722,-58.3713895779765 -34.5995712737986,-58.3713805001645 -34.5996947928201,-58.3712781931101 -34.6006460902626,-58.371268891226 -34.6007406643308,-58.3713541345297 -34.6007505877019,-58.3724802212437 -34.6008459361166,-58.3725899099918 -34.6008543273422,-58.3726605299186 -34.5997358160017,-58.3726669818036 -34.5996762410363)))";;"234";1_9_12;COMUNA 1;"9";"12";"378";"196";"182";"107,69%";"238";"234";"98,32%";"4";"1,71%";"76";"2";"2.63";"74";"97,37%";"2.63";2.630
"MULTIPOLYGON (((-58.3705066392465 -34.6006540312003,-58.3706611174194 -34.6006705568897,-58.3707001201738 -34.6006747413893,-58.371268891226 -34.6007406643308,-58.3712781931101 -34.6006460902626,-58.3713805001645 -34.5996947928201,-58.3713895779765 -34.5995712737986,-58.3713958897832 -34.5994848667899,-58.3714799249247 -34.5984174946423,-58.371337623327 -34.5984066835472,-58.3712375608943 -34.5983990730885,-58.3710855510717 -34.5983876205955,-58.3709301292087 -34.5983810951126,-58.3695123426162 -34.5983212859799,-58.369129874784 -34.5992191965076,-58.3690724057256 -34.5993540871286,-58.3686314657978 -34.6004359016709,-58.3693156252249 -34.6005125568223,-58.3703436473714 -34.6006346818639,-58.3705066392465 -34.6006540312003)))";;"235";1_9_13;COMUNA 1;"9";"13";"590";"307";"283";"108,48%";"449";"449";"100,00%";"0";"0,00%";"201";"0";"0";"201";"100,00%";"0";0.000
"MULTIPOLYGON (((-58.3683133749384 -34.6017031685898,-58.3681857027326 -34.6028329712761,-58.3681856383424 -34.6028331793573,-58.3681856788079 -34.6028331830494,-58.369010841054 -34.6029084695901,-58.3691828693047 -34.6029241655204,-58.3699311110221 -34.6029895278527,-58.3700744459009 -34.602997101813,-58.3702634299368 -34.6030071046516,-58.3704725132662 -34.6030181787688,-58.3706149965323 -34.6030257514505,-58.3710940506202 -34.6030573103966,-58.3711688234735 -34.6020550754326,-58.3711771220439 -34.6019436690218,-58.3713059743857 -34.601952991301,-58.3723926627997 -34.6020304230061,-58.3725218569326 -34.6020389695774,-58.3725281988156 -34.6019238290922,-58.372583410872 -34.6009574954519,-58.3725899099918 -34.6008543273422,-58.3724802212437 -34.6008459361166,-58.3713541345297 -34.6007505877018,-58.371268891226 -34.6007406643308,-58.3707001201738 -34.6006747413893,-58.3706611174194 -34.6006705568897,-58.3705066392465 -34.6006540312003,-58.3703436473714 -34.6006346818639,-58.3693156252248 -34.6005125568223,-58.3686314657978 -34.6004359016709,-58.3683895118626 -34.601029540133,-58.3683133749384 -34.6017031685898)))";;"236";1_9_14;COMUNA 1;"9";"14";"253";"128";"125";"102,40%";"435";"435";"100,00%";"0";"0,00%";"148";"26";"17.57";"122";"82,43%";"17.57";17.570
"MULTIPOLYGON (((-58.375330362426 -34.6010497079314,-58.3751725528857 -34.6010409325349,-58.3741023056399 -34.6009698757893,-58.3739936385399 -34.6009615570911,-58.3725899099918 -34.6008543273422,-58.372583410872 -34.6009574954519,-58.3725281988157 -34.6019238290922,-58.3725218569326 -34.6020389695774,-58.373906117496 -34.6021309741001,-58.3751227772311 -34.6022118564133,-58.375266278869 -34.6022220301263,-58.3753200807245 -34.6011896354286,-58.375330362426 -34.6010497079314)))";;"237";1_9_15;COMUNA 1;"9";"15";"238";"124";"114";"108,77%";"608";"607";"99,84%";"1";"0,16%";"118";"13";"11.02";"105";"88,98%";"11.02";11.020
"MULTIPOLYGON (((-58.38110181727 -34.6013561097404,-58.3808860899763 -34.6013485706412,-58.3797131966522 -34.601285452286,-58.3795931126315 -34.6012803703679,-58.3781764629315 -34.6012204513872,-58.3780453926735 -34.6012149377842,-58.376873967688 -34.6011358770639,-58.3767509049484 -34.6011290296238,-58.375330362426 -34.6010497079314,-58.3753200807245 -34.6011896354286,-58.375266278869 -34.6022220301263,-58.3754089289113 -34.6022321326361,-58.3767027666535 -34.6023028427331,-58.3779725046942 -34.602372184301,-58.3781146470174 -34.6023796071384,-58.3795372636284 -34.6024542497702,-58.3796651834276 -34.6024609568553,-58.3808196288764 -34.6025060344477,-58.3810354405358 -34.6025174471067,-58.3810462022955 -34.6023125170284,-58.38110181727 -34.6013561097404)))";;"238";1_9_16;COMUNA 1;"9";"16";"997";"513";"484";"105,99%";"647";"636";"98,30%";"11";"1,73%";"337";"124";"36.8";"213";"63,20%";"36.8";36.800
"MULTIPOLYGON (((-58.3795372636284 -34.6024542497702,-58.3781146470174 -34.6023796071384,-58.3781083092373 -34.6024982691733,-58.3780710188837 -34.6034915199651,-58.3794711579487 -34.6035772749528,-58.3809751183048 -34.6036694217223,-58.3810229422068 -34.6027561801004,-58.3810354405358 -34.6025174471067,-58.3808196288764 -34.6025060344477,-58.3796651834276 -34.6024609568553,-58.3795372636284 -34.6024542497702)))";;"239";1_9_17;COMUNA 1;"9";"17";"360";"170";"190";"89,47%";"516";"516";"100,00%";"0";"0,00%";"207";"24";"11.59";"183";"88,41%";"11.59";11.590
"MULTIPOLYGON (((-58.3766534463462 -34.6034047137968,-58.3766949810912 -34.6023024172822,-58.3754089289113 -34.6022321326361,-58.375266278869 -34.6022220301263,-58.3751227772311 -34.6022118564133,-58.373906117496 -34.6021309741001,-58.3725218569326 -34.6020389695774,-58.3723926627997 -34.6020304230061,-58.3713059743857 -34.601952991301,-58.3711771220439 -34.6019436690218,-58.3711688234735 -34.6020550754326,-58.3710940506202 -34.6030573103966,-58.3712742602673 -34.6030691361363,-58.3724606131028 -34.603147205272,-58.3725751605567 -34.6031547550013,-58.3738497535087 -34.6032328757761,-58.3752163283306 -34.6033166128095,-58.3766534463462 -34.6034047137968)))";;"240";1_9_19;COMUNA 1;"9";"19";"119";"55";"64";"85,94%";"405";"405";"100,00%";"0";"0,00%";"61";"6";"9.84";"55";"90,16%";"9.84";9.840
"MULTIPOLYGON (((-58.3851326494337 -34.6039115811284,-58.3863422007972 -34.6039824875315,-58.3865223305709 -34.6039930934744,-58.3865909744838 -34.6039985590492,-58.3866402980305 -34.6027745298481,-58.386678555953 -34.6018221938856,-58.3866937847189 -34.6016535350341,-58.3867904021844 -34.600585667435,-58.3867046419448 -34.6005804025879,-58.3865661652531 -34.6005717948153,-58.385352396084 -34.6005101840809,-58.3852846512147 -34.6014665153542,-58.3852796458225 -34.6015371486494,-58.3852764523208 -34.6015826412989,-58.3851978317353 -34.6026922810755,-58.3850321011917 -34.602679147037,-58.3837979347678 -34.6026301139626,-58.3837719159753 -34.6028541900584,-58.3837123788803 -34.6036663650656,-58.383711459096 -34.6038282015075,-58.3851326494337 -34.6039115811284)))";;"241";1_9_2;COMUNA 1;"9";"2";"388";"169";"219";"77,17%";"742";"742";"100,00%";"0";"0,00%";"193";"4";"2.07";"189";"97,93%";"2.07";2.070
"MULTIPOLYGON (((-58.382088927577 -34.5990702001911,-58.3816455665877 -34.599049624029,-58.3812498973238 -34.5990312612813,-58.3812330768965 -34.5992492161093,-58.3811828838329 -34.6000638614668,-58.3811733681953 -34.6002144242056,-58.3811115183173 -34.6011904057423,-58.38110181727 -34.6013561097404,-58.3810462022955 -34.6023125170284,-58.3810354405358 -34.6025174471067,-58.3810229422068 -34.6027561801004,-58.3809751183048 -34.6036694217223,-58.3811732246622 -34.6036732163594,-58.3812698882648 -34.6038024925778,-58.3813588761753 -34.6038058966159,-58.3814478624643 -34.6038109729291,-58.3818368203459 -34.6038276777867,-58.3820012059012 -34.6037362339015,-58.3822055302283 -34.6037398196994,-58.383711459096 -34.6038282015075,-58.3837123788803 -34.6036663650656,-58.3837719159753 -34.6028541900584,-58.3837979347678 -34.6026301139626,-58.3850321011917 -34.602679147037,-58.3851978317353 -34.6026922810755,-58.3852764523208 -34.6015826412989,-58.3852796458225 -34.6015371486494,-58.3852846512147 -34.6014665153542,-58.385352396084 -34.6005101840809,-58.3854717123067 -34.5992276756506,-58.3842030285238 -34.5991682018982,-58.384028613289 -34.5991601315231,-58.3827718537967 -34.5991019182328,-58.3825208768478 -34.5990902742679,-58.382088927577 -34.5990702001911)))";;"242";1_9_3;COMUNA 1;"9";"3";"449";"251";"198";"126,77%";"715";"713";"99,72%";"2";"0,28%";"195";"13";"6.67";"182";"93,33%";"6.67";6.670
"MULTIPOLYGON (((-58.3812498973238 -34.5990312612813,-58.3810205523774 -34.599020544196,-58.3797420702885 -34.5989715812894,-58.3797304685268 -34.5991620031966,-58.3796672453509 -34.6001324900577,-58.3797920195406 -34.6001299691669,-58.3810050045834 -34.600199663157,-58.3811733681953 -34.6002144242056,-58.3811828838329 -34.6000638614668,-58.3812330768965 -34.5992492161093,-58.3812498973238 -34.5990312612813)))";;"243";1_9_4;COMUNA 1;"9";"4";"256";"119";"137";"86,86%";"567";"567";"100,00%";"0";"0,00%";"134";"2";"1.49";"132";"98,51%";"1.49";1.490
"MULTIPOLYGON (((-58.3811733681953 -34.6002144242056,-58.3810050045834 -34.600199663157,-58.3797920195406 -34.6001299691669,-58.3796672453509 -34.6001324900577,-58.3796602391228 -34.6002405879829,-58.379651161141 -34.6003765024518,-58.3795984200683 -34.6011678345209,-58.3795931126315 -34.6012803703679,-58.3797131966522 -34.601285452286,-58.3808860899763 -34.6013485706412,-58.38110181727 -34.6013561097404,-58.3811115183173 -34.6011904057423,-58.3811733681953 -34.6002144242056)))";;"244";1_9_5;COMUNA 1;"9";"5";"409";"205";"204";"100,49%";"455";"455";"100,00%";"0";"0,00%";"192";"28";"14.58";"164";"85,42%";"14.58";14.580
"MULTIPOLYGON (((-58.3790558397948 -34.6001142549023,-58.3783277657806 -34.6000842454842,-58.3782079410777 -34.6000771904768,-58.3780644410476 -34.6000687104285,-58.3769433028575 -34.5999687689537,-58.3767990411279 -34.5999559205191,-58.3767509049484 -34.6011290296238,-58.376873967688 -34.6011358770639,-58.3780453926735 -34.6012149377842,-58.3781764629315 -34.6012204513872,-58.3795931126315 -34.6012803703679,-58.3795984200683 -34.6011678345209,-58.379651161141 -34.6003765024518,-58.3796602391228 -34.6002405879829,-58.3796672453509 -34.6001324900577,-58.3795551614455 -34.600134808193,-58.3790558397948 -34.6001142549023)))";;"245";1_9_6;COMUNA 1;"9";"6";"354";"168";"186";"90,32%";"558";"556";"99,64%";"2";"0,36%";"175";"5";"2.86";"170";"97,14%";"2.86";2.860
"MULTIPOLYGON (((-58.3797420702885 -34.5989715812894,-58.3782790462545 -34.5989090262371,-58.378265900099 -34.5991074049858,-58.3782174188839 -34.5998851474953,-58.3782079410777 -34.6000771904768,-58.3783277657806 -34.6000842454842,-58.3790558397948 -34.6001142549023,-58.3795551614455 -34.600134808193,-58.3796672453509 -34.6001324900577,-58.3797304685268 -34.5991620031966,-58.3797420702885 -34.5989715812894)))";;"246";1_9_7;COMUNA 1;"9";"7";"588";"282";"306";"92,16%";"868";"864";"99,54%";"4";"0,46%";"288";"19";"6.6";"269";"93,40%";"6.6";6.600
"MULTIPOLYGON (((-58.3782790462545 -34.5989090262371,-58.3768389737292 -34.5988082289015,-58.3768394014753 -34.5989718974145,-58.3767990411279 -34.5999559205191,-58.3769433028575 -34.5999687689537,-58.3780644410476 -34.6000687104285,-58.3782079410777 -34.6000771904768,-58.3782174188839 -34.5998851474953,-58.378265900099 -34.5991074049858,-58.3782790462545 -34.5989090262371)))";;"247";1_9_8;COMUNA 1;"9";"8";"261";"132";"129";"102,33%";"405";"405";"100,00%";"0";"0,00%";"149";"2";"1.34";"147";"98,66%";"1.34";1.340
"MULTIPOLYGON (((-58.3768389737292 -34.5988082289015,-58.3753681616938 -34.5987052798189,-58.3753587129491 -34.5989447892296,-58.3753549991424 -34.5997262951731,-58.3753635316056 -34.5998740533685,-58.3753725655251 -34.6000309671955,-58.375339693295 -34.6009230901114,-58.375330362426 -34.6010497079314,-58.3767509049484 -34.6011290296238,-58.3767990411279 -34.5999559205191,-58.3768394014753 -34.5989718974145,-58.3768389737292 -34.5988082289015)))";;"248";1_9_9;COMUNA 1;"9";"9";"628";"347";"281";"123,49%";"851";"848";"99,65%";"3";"0,35%";"237";"3";"1.27";"234";"98,73%";"1.27";1.270
"MULTIPOLYGON (((-58.386863459811 -34.5992928467762,-58.3868058890251 -34.5992901348243,-58.3867046419448 -34.6005804025879,-58.3867904021844 -34.600585667435,-58.3869772521886 -34.6005971924153,-58.3880963243065 -34.6006495034246,-58.388101697719 -34.6005455591034,-58.3881472200179 -34.5993546261138,-58.3879515997437 -34.5993438018046,-58.386863459811 -34.5992928467762)))";;"249";1_10_1;COMUNA 1;"10";"1";"318";"132";"186";"70,97%";"524";"523";"99,81%";"1";"0,19%";"120";"3";"2.5";"117";"97,50%";"2.5";2.500
"MULTIPOLYGON (((-58.3908967183755 -34.6018895401924,-58.3896638608064 -34.601814087346,-58.3895287084527 -34.6017997100595,-58.3894591678761 -34.6030114745381,-58.3896049697655 -34.6030245202018,-58.3908473084091 -34.6030892745961,-58.3911803989024 -34.6031066540339,-58.3912859073425 -34.6020343515162,-58.3912989565959 -34.6019135799461,-58.391165671682 -34.6019060368093,-58.3908967183755 -34.6018895401924)))";;"250";1_10_10;COMUNA 1;"10";"10";"680";"304";"376";"80,85%";"617";"617";"100,00%";"0";"0,00%";"296";"11";"3.72";"285";"96,28%";"3.72";3.720
"MULTIPOLYGON (((-58.3925922899731 -34.6019867270033,-58.3912989565959 -34.6019135799461,-58.3912859073425 -34.6020343515162,-58.3911803989024 -34.6031066540339,-58.3921502032159 -34.6031572205034,-58.392387066655 -34.6031553853221,-58.3925729312706 -34.6021178475887,-58.3925922899731 -34.6019867270033)))";;"251";1_10_11;COMUNA 1;"10";"11";"612";"269";"343";"78,43%";"725";"725";"100,00%";"0";"0,00%";"351";"2";"0.57";"349";"99,43%";"0.57";0.570
"MULTIPOLYGON (((-58.3911803989024 -34.6031066540339,-58.3908473084091 -34.6030892745961,-58.3908194919917 -34.6043340935721,-58.3922863350328 -34.604436079428,-58.392387066655 -34.6031553853221,-58.3921502032159 -34.6031572205034,-58.3911803989024 -34.6031066540339)))";;"252";1_10_12;COMUNA 1;"10";"12";"584";"271";"313";"86,58%";"606";"605";"99,83%";"1";"0,17%";"291";"11";"3.78";"280";"96,22%";"3.78";3.780
"MULTIPOLYGON (((-58.3894591678761 -34.6030114745381,-58.3893074897105 -34.6029978617644,-58.3879512147743 -34.60291048589,-58.3879430897868 -34.6030431619513,-58.3879011550899 -34.6039319723732,-58.3879015978507 -34.6041031058027,-58.3892271315165 -34.604205605128,-58.3893916732244 -34.6042188736038,-58.3908194919917 -34.6043340935721,-58.3908473084091 -34.6030892745961,-58.3896049697655 -34.6030245202018,-58.3894591678761 -34.6030114745381)))";;"253";1_10_13;COMUNA 1;"10";"13";"678";"300";"378";"79,37%";"798";"795";"99,62%";"3";"0,38%";"339";"18";"5.31";"321";"94,69%";"5.31";5.310
"MULTIPOLYGON (((-58.3879512147743 -34.60291048589,-58.3878123937155 -34.6029015271954,-58.3866402980305 -34.6027745298481,-58.3865909744838 -34.6039985590492,-58.3879015978507 -34.6041031058027,-58.3879011550899 -34.6039319723732,-58.3879430897868 -34.6030431619513,-58.3879512147743 -34.60291048589)))";;"254";1_10_14;COMUNA 1;"10";"14";"218";"109";"109";"100,00%";"537";"537";"100,00%";"0";"0,00%";"111";"3";"2.7";"108";"97,30%";"2.7";2.700
"MULTIPOLYGON (((-58.3896641498178 -34.5994408284322,-58.3894802834475 -34.599428675529,-58.3881472200179 -34.5993546261138,-58.388101697719 -34.6005455591034,-58.3880963243065 -34.6006495034246,-58.3882089129035 -34.6006547836747,-58.389591068118 -34.6007132978666,-58.3896641498178 -34.5994408284322)))";;"255";1_10_2;COMUNA 1;"10";"2";"504";"220";"284";"77,46%";"570";"568";"99,65%";"2";"0,35%";"278";"0";"0";"278";"100,00%";"0";0.000
"MULTIPOLYGON (((-58.3901402099307 -34.5994721699684,-58.3896641498178 -34.5994408284322,-58.389591068118 -34.6007132978666,-58.3897917188196 -34.6007217985214,-58.3899892221165 -34.6007259306079,-58.3909916431716 -34.6007469471314,-58.3912707370292 -34.60075281527,-58.3914239526631 -34.6007568486757,-58.391552893462 -34.5995643433433,-58.3913754982052 -34.5995534647226,-58.3901402099307 -34.5994721699684)))";;"256";1_10_3;COMUNA 1;"10";"3";"980";"448";"532";"84,21%";"839";"838";"99,88%";"1";"0,12%";"515";"26";"5.05";"489";"94,95%";"5.05";5.050
"MULTIPOLYGON (((-58.3929308478483 -34.5996371135758,-58.391552893462 -34.5995643433433,-58.3914239526631 -34.6007568486757,-58.3915697587899 -34.6007606662944,-58.3927655783273 -34.6008070634803,-58.3929308478483 -34.5996371135758)))";;"257";1_10_4;COMUNA 1;"10";"4";"427";"171";"256";"66,80%";"422";"422";"100,00%";"0";"0,00%";"223";"1";"0.45";"222";"99,55%";"0.45";0.450
"MULTIPOLYGON (((-58.3914239526631 -34.6007568486757,-58.3912707370292 -34.60075281527,-58.3909916431716 -34.6007469471314,-58.3908967183755 -34.6018895401924,-58.391165671682 -34.6019060368093,-58.3912989565959 -34.6019135799461,-58.3925922899731 -34.6019867270033,-58.3927474149045 -34.6009353677959,-58.3927655783273 -34.6008070634803,-58.3915697587899 -34.6007606662944,-58.3914239526631 -34.6007568486757)))";;"258";1_10_5;COMUNA 1;"10";"5";"507";"237";"270";"87,78%";"455";"455";"100,00%";"0";"0,00%";"236";"10";"4.24";"226";"95,76%";"4.24";4.240
"MULTIPOLYGON (((-58.3899892221165 -34.6007259306079,-58.3897917188196 -34.6007217985214,-58.389591068118 -34.6007132978666,-58.3895287084527 -34.6017997100595,-58.3896638608064 -34.601814087346,-58.3908967183755 -34.6018895401924,-58.3909916431716 -34.6007469471314,-58.3899892221165 -34.6007259306079)))";;"259";1_10_6;COMUNA 1;"10";"6";"541";"256";"285";"89,82%";"605";"605";"100,00%";"0";"0,00%";"265";"12";"4.53";"253";"95,47%";"4.53";4.530
"MULTIPOLYGON (((-58.389591068118 -34.6007132978666,-58.3882089129035 -34.6006547836747,-58.3880963243065 -34.6006495034246,-58.3880486499469 -34.6015787348014,-58.3880318365888 -34.601712884511,-58.389398580683 -34.6017858990434,-58.3895287084527 -34.6017997100595,-58.389591068118 -34.6007132978666)))";;"260";1_10_7;COMUNA 1;"10";"7";"312";"149";"163";"91,41%";"442";"442";"100,00%";"0";"0,00%";"159";"28";"17.61";"131";"82,39%";"17.61";17.610
"MULTIPOLYGON (((-58.3880963243065 -34.6006495034246,-58.3869772521886 -34.6005971924153,-58.3867904021844 -34.600585667435,-58.3866937847189 -34.6016535350341,-58.386678555953 -34.6018221938856,-58.3866402980305 -34.6027745298481,-58.3878123937155 -34.6029015271954,-58.3879512147743 -34.60291048589,-58.3880168245461 -34.6018327390037,-58.3880318365888 -34.601712884511,-58.3880486499469 -34.6015787348014,-58.3880963243065 -34.6006495034246)))";;"261";1_10_8;COMUNA 1;"10";"8";"279";"140";"139";"100,72%";"716";"716";"100,00%";"0";"0,00%";"153";"2";"1.31";"151";"98,69%";"1.31";1.310
"MULTIPOLYGON (((-58.3895287084527 -34.6017997100595,-58.389398580683 -34.6017858990434,-58.3880318365888 -34.601712884511,-58.3880168245461 -34.6018327390037,-58.3879512147743 -34.60291048589,-58.3893074897105 -34.6029978617644,-58.3894591678761 -34.6030114745381,-58.3895287084527 -34.6017997100595)))";;"262";1_10_9;COMUNA 1;"10";"9";"341";"170";"171";"99,42%";"660";"659";"99,85%";"1";"0,15%";"161";"7";"4.35";"154";"95,65%";"4.35";4.350
"MULTIPOLYGON (((-58.3922863350328 -34.604436079428,-58.3908194919917 -34.6043340935721,-58.3908150617966 -34.6045331829028,-58.3907935101071 -34.605425879512,-58.3907869444959 -34.6055330627248,-58.3908932362038 -34.6055392523137,-58.3919836382357 -34.6056331320626,-58.3921939210968 -34.605647057087,-58.3922056406931 -34.6054862128105,-58.3922863350328 -34.604436079428)))";;"263";1_11_1;COMUNA 1;"11";"1";"512";"239";"273";"87,55%";"385";"379";"98,44%";"6";"1,58%";"219";"44";"20.09";"175";"79,91%";"20.09";20.090
"MULTIPOLYGON (((-58.3893074454134 -34.6066301097646,-58.3879394418995 -34.6065433605423,-58.3878119489995 -34.606527788826,-58.3878089090747 -34.6065932823389,-58.387735509076 -34.6077073628459,-58.3878766352876 -34.6077192104702,-58.3891576057245 -34.6078084432684,-58.3892673912539 -34.6078159744565,-58.3892732570732 -34.6077321016625,-58.389304722696 -34.60672363271,-58.3893074454134 -34.6066301097646)))";;"264";1_11_10;COMUNA 1;"11";"10";"621";"308";"313";"98,40%";"453";"449";"99,12%";"4";"0,89%";"272";"44";"16.18";"228";"83,82%";"16.18";16.180
"MULTIPOLYGON (((-58.3878119489995 -34.606527788826,-58.3877128162727 -34.6065156852414,-58.3865344899949 -34.6064405864166,-58.3863766643457 -34.6064369665352,-58.3863667428641 -34.6065750640247,-58.3863082260692 -34.6075068223234,-58.3863094085717 -34.6076107001248,-58.387632283402 -34.6076987075136,-58.387735509076 -34.6077073628459,-58.3878089090747 -34.6065932823389,-58.3878119489995 -34.606527788826)))";;"265";1_11_11;COMUNA 1;"11";"11";"266";"111";"155";"71,61%";"180";"180";"100,00%";"0";"0,00%";"126";"12";"9.52";"114";"90,48%";"9.52";9.520
"MULTIPOLYGON (((-58.3892673912539 -34.6078159744565,-58.3891576057245 -34.6078084432684,-58.3878766352876 -34.6077192104702,-58.387735509076 -34.6077073628459,-58.387632283402 -34.6076987075136,-58.3863094085717 -34.6076107001248,-58.3862757948893 -34.6087855109042,-58.3872294601497 -34.6088563888026,-58.3873177724097 -34.6088747539271,-58.3876564810355 -34.6089209503251,-58.3878011787048 -34.6089417442214,-58.3881732862814 -34.6089780297425,-58.3885075776671 -34.6090117558347,-58.388679876259 -34.6090291146393,-58.3891722434631 -34.60907878036,-58.3892673912539 -34.6078159744565)))";;"266";1_11_12;COMUNA 1;"11";"12";"933";"414";"519";"79,77%";"535";"533";"99,63%";"2";"0,38%";"407";"61";"14.99";"346";"85,01%";"14.99";14.990
"MULTIPOLYGON (((-58.3906705024983 -34.6079110396823,-58.3905659961217 -34.607905273506,-58.3892673912539 -34.6078159744565,-58.3891722434631 -34.60907878036,-58.3895555084103 -34.6091174628427,-58.3897581279972 -34.6091378665783,-58.3905527865388 -34.6091937636371,-58.3906705024983 -34.6079110396823)))";;"267";1_11_13;COMUNA 1;"11";"13";"666";"324";"342";"94,74%";"437";"433";"99,08%";"4";"0,92%";"291";"7";"2.41";"284";"97,59%";"2.41";2.410
"MULTIPOLYGON (((-58.3920335154173 -34.6079865577954,-58.3906705024983 -34.6079110396823,-58.3905527865388 -34.6091937636371,-58.3914098776477 -34.609254058373,-58.3919516607575 -34.6092921215986,-58.3919606234097 -34.6091693054037,-58.3920335154173 -34.6079865577954)))";;"268";1_11_14;COMUNA 1;"11";"14";"774";"322";"452";"71,24%";"506";"503";"99,41%";"3";"0,60%";"289";"3";"1.04";"286";"98,96%";"1.04";1.040
"MULTIPOLYGON (((-58.3908194919917 -34.6043340935721,-58.3893916732244 -34.6042188736038,-58.3893386265692 -34.6053630392923,-58.3893388067142 -34.6054487468115,-58.3907869444959 -34.6055330627248,-58.3907935101071 -34.605425879512,-58.3908150617966 -34.6045331829028,-58.3908194919917 -34.6043340935721)))";;"269";1_11_2;COMUNA 1;"11";"2";"428";"203";"225";"90,22%";"655";"655";"100,00%";"0";"0,00%";"284";"20";"7.04";"264";"92,96%";"7.04";7.040
"MULTIPOLYGON (((-58.3893916732244 -34.6042188736038,-58.3892271315165 -34.604205605128,-58.3879015978507 -34.6041031058027,-58.387901978678 -34.6042483227286,-58.3878998659936 -34.6052746272801,-58.3878916093711 -34.6053637804617,-58.3880226013297 -34.6053696355672,-58.3892056868675 -34.6054409903582,-58.3893388067142 -34.6054487468115,-58.3893386265692 -34.6053630392923,-58.3893916732244 -34.6042188736038)))";;"270";1_11_3;COMUNA 1;"11";"3";"354";"187";"167";"111,98%";"321";"320";"99,69%";"1";"0,31%";"198";"106";"53.54";"92";"46,46%";"53.54";53.540
"MULTIPOLYGON (((-58.3865909744838 -34.6039985590492,-58.3865223305709 -34.6039930934744,-58.3864951041146 -34.6051737542899,-58.3864759318777 -34.6052759292113,-58.3864507682089 -34.6054100734026,-58.3863766643457 -34.6064369665352,-58.3865344899949 -34.6064405864166,-58.3877128162727 -34.6065156852414,-58.3878119489995 -34.606527788826,-58.3878175043827 -34.6064117316057,-58.3878814599578 -34.605474060026,-58.3878916093711 -34.6053637804617,-58.3878998659936 -34.6052746272801,-58.387901978678 -34.6042483227286,-58.3879015978507 -34.6041031058027,-58.3865909744838 -34.6039985590492)))";;"271";1_11_4;COMUNA 1;"11";"4";"667";"323";"344";"93,90%";"984";"982";"99,80%";"2";"0,20%";"336";"55";"16.37";"281";"83,63%";"16.37";16.370
"MULTIPOLYGON (((-58.3893388067142 -34.6054487468115,-58.3892056868675 -34.6054409903582,-58.3880226013297 -34.6053696355672,-58.3878916093711 -34.6053637804617,-58.3878814599578 -34.605474060026,-58.3878175043827 -34.6064117316057,-58.3878119489995 -34.606527788826,-58.3879394418995 -34.6065433605423,-58.3893074454134 -34.6066301097646,-58.3893389608463 -34.6055640328772,-58.3893388067142 -34.6054487468115)))";;"272";1_11_5;COMUNA 1;"11";"5";"529";"254";"275";"92,36%";"481";"480";"99,79%";"1";"0,21%";"251";"90";"35.86";"161";"64,14%";"35.86";35.860
"MULTIPOLYGON (((-58.3907869444959 -34.6055330627248,-58.3893388067142 -34.6054487468115,-58.3893389608463 -34.6055640328772,-58.3893074454134 -34.6066301097646,-58.3894420144618 -34.6066386416533,-58.3906110764275 -34.606697157019,-58.3907431783771 -34.6067025168837,-58.39077614632 -34.6057086966866,-58.3907869444959 -34.6055330627248)))";;"273";1_11_6;COMUNA 1;"11";"6";"447";"199";"248";"80,24%";"522";"520";"99,62%";"2";"0,38%";"209";"3";"1.44";"206";"98,56%";"1.44";1.440
"MULTIPOLYGON (((-58.3921939210968 -34.605647057087,-58.3919836382357 -34.6056331320626,-58.3908932362038 -34.6055392523137,-58.3907869444959 -34.6055330627248,-58.39077614632 -34.6057086966866,-58.3907431783771 -34.6067025168837,-58.39089163335 -34.6067085904823,-58.391916323527 -34.606769332318,-58.3921121248773 -34.606788671816,-58.3921219608754 -34.6066397283369,-58.3921939210968 -34.605647057087)))";;"274";1_11_7;COMUNA 1;"11";"7";"525";"253";"272";"93,01%";"497";"497";"100,00%";"0";"0,00%";"296";"38";"12.84";"258";"87,16%";"12.84";12.840
"MULTIPOLYGON (((-58.3921121248773 -34.606788671816,-58.391916323527 -34.606769332318,-58.39089163335 -34.6067085904823,-58.3907431783771 -34.6067025168837,-58.3907387201651 -34.6068349839384,-58.3906705024983 -34.6079110396823,-58.3920335154173 -34.6079865577954,-58.3920423175351 -34.6078518396288,-58.3921121248773 -34.606788671816)))";;"275";1_11_8;COMUNA 1;"11";"8";"817";"382";"435";"87,82%";"609";"608";"99,84%";"1";"0,16%";"353";"2";"0.57";"351";"99,43%";"0.57";0.570
"MULTIPOLYGON (((-58.3907431783771 -34.6067025168837,-58.3906110764275 -34.606697157019,-58.3894420144618 -34.6066386416533,-58.3893074454134 -34.6066301097646,-58.389304722696 -34.60672363271,-58.3892732570732 -34.6077321016625,-58.3892673912539 -34.6078159744565,-58.3905659961217 -34.607905273506,-58.3906705024983 -34.6079110396823,-58.3907387201651 -34.6068349839384,-58.3907431783771 -34.6067025168837)))";;"276";1_11_9;COMUNA 1;"11";"9";"455";"209";"246";"84,96%";"431";"431";"100,00%";"0";"0,00%";"219";"1";"0.46";"218";"99,54%";"0.46";0.460
"MULTIPOLYGON (((-58.5302211192263 -34.6135141010713,-58.5304887731818 -34.6133001589448,-58.5293631166574 -34.610902756054,-58.5290912614676 -34.6111046826951,-58.5285526305763 -34.6115047583786,-58.5285536687689 -34.611506984484,-58.528159429371 -34.611799038196,-58.5277569267286 -34.6120937007563,-58.5273484619647 -34.6123927314903,-58.5269437400732 -34.61268894187,-58.5265373977744 -34.6129863489685,-58.5268047717559 -34.6131938922994,-58.5271383731403 -34.6134528103717,-58.5276310228175 -34.6138351685305,-58.5281784829729 -34.6142601024262,-58.5287256078072 -34.6146848227387,-58.5291209544431 -34.6143779774645,-58.5295170643611 -34.6140705670769,-58.5296915799349 -34.6139351144137,-58.5296923456613 -34.6139367572971,-58.5302211192263 -34.6135141010713)))";;"277";10_1_1;COMUNA 10;"1";"1";"641";"301";"340";"88,53%";"300";"300";"100,00%";"0";"0,00%";"250";"7";"2.8";"243";"97,20%";"2.8";2.800
"MULTIPOLYGON (((-58.5262712091784 -34.614890711139,-58.5253790921551 -34.6155832396585,-58.5264006315633 -34.6164893624398,-58.5273659644106 -34.6157401660352,-58.5287256078072 -34.6146848227387,-58.5281784829729 -34.6142601024262,-58.5276310228175 -34.6138351685305,-58.5271383731403 -34.6134528103717,-58.5268047717559 -34.6131938922994,-58.5265373977744 -34.6129863489685,-58.525848490776 -34.6134906692789,-58.5257160210151 -34.613587924363,-58.5256143697948 -34.6136624865428,-58.5254256145003 -34.6137870248209,-58.5251141778505 -34.6140012767303,-58.5252724476786 -34.6141156363777,-58.5254048136432 -34.6142183889997,-58.5257816279379 -34.6145108108457,-58.5262712091784 -34.614890711139)))";;"278";10_1_2;COMUNA 10;"1";"2";"883";"384";"499";"76,95%";"404";"404";"100,00%";"0";"0,00%";"353";"2";"0.57";"351";"99,43%";"0.57";0.570
"MULTIPOLYGON (((-58.5231198684356 -34.6155085317027,-58.5219581566675 -34.6163884285417,-58.5220808195929 -34.6165031617004,-58.5223442915856 -34.6167335342958,-58.5225752037194 -34.6169354705868,-58.5226964139606 -34.6170416119752,-58.5230741111439 -34.6173723528241,-58.5232213209225 -34.6175012280943,-58.5241002447232 -34.6182746189544,-58.5252440652335 -34.617386964409,-58.5264006315633 -34.6164893624398,-58.5253790921551 -34.6155832396585,-58.5262712091784 -34.614890711139,-58.5257816279379 -34.6145108108457,-58.5254048136432 -34.6142183889997,-58.5252724476786 -34.6141156363777,-58.5251141778505 -34.6140012767303,-58.5250604838913 -34.6139625704053,-58.5242703753686 -34.6145997550717,-58.5241211378687 -34.6147200458614,-58.5231198684356 -34.6155085317027)))";;"279";10_1_3;COMUNA 10;"1";"3";"927";"454";"473";"95,98%";"397";"397";"100,00%";"0";"0,00%";"341";"2";"0.59";"339";"99,41%";"0.59";0.590
"MULTIPOLYGON (((-58.5212051257949 -34.6188229623598,-58.5213548159981 -34.618966487063,-58.5216746569952 -34.6192732450177,-58.5221840035255 -34.6197617471963,-58.5231682279513 -34.6189978563292,-58.5241002447232 -34.6182746189544,-58.5232213209225 -34.6175012280943,-58.5230741111439 -34.6173723528241,-58.5226964139606 -34.6170416119752,-58.5225752037194 -34.6169354705868,-58.5223442915856 -34.6167335342958,-58.5220808195929 -34.6165031617004,-58.5219581566675 -34.6163884285417,-58.5210132778787 -34.6171096135966,-58.5208904203156 -34.6172034079683,-58.5201224521296 -34.6177959054421,-58.5202735802795 -34.6179299938692,-58.5205109815177 -34.6181558754705,-58.5206755028714 -34.6183152396225,-58.5208453088612 -34.618478051855,-58.5212051257949 -34.6188229623598)))";;"280";10_1_4;COMUNA 10;"1";"4";"837";"380";"457";"83,15%";"344";"343";"99,71%";"1";"0,29%";"294";"1";"0.34";"293";"99,66%";"0.34";0.340
"MULTIPOLYGON (((-58.5193412749724 -34.6183971368646,-58.5188995512881 -34.6187335501514,-58.5186737498318 -34.6189056318306,-58.5185393921764 -34.6190076688112,-58.5190435192072 -34.6194916793231,-58.51911282225 -34.6195582693427,-58.5195332458504 -34.6199619615464,-58.5200130895472 -34.620422739035,-58.520513372715 -34.6208671663176,-58.5213445213066 -34.6203171730042,-58.5221840035255 -34.6197617471963,-58.5216746569952 -34.6192732450177,-58.5213548159981 -34.618966487063,-58.5212051257949 -34.6188229623598,-58.5208453088612 -34.618478051855,-58.5206755028714 -34.6183152396225,-58.5205109815177 -34.6181558754705,-58.5202735802795 -34.6179299938692,-58.5201224521296 -34.6177959054421,-58.5194803133054 -34.6182912234374,-58.5193412749724 -34.6183971368646)))";;"281";10_1_5;COMUNA 10;"1";"5";"695";"349";"346";"100,87%";"279";"279";"100,00%";"0";"0,00%";"258";"1";"0.39";"257";"99,61%";"0.39";0.390
"MULTIPOLYGON (((-58.5221840035255 -34.6197617471963,-58.5213445213066 -34.6203171730042,-58.520513372715 -34.6208671663176,-58.5208410661204 -34.6210671583704,-58.5209429129944 -34.6211316894922,-58.5216770821139 -34.6214971945073,-58.5221763658361 -34.6211163051024,-58.5222897768374 -34.6210297678814,-58.5228477191571 -34.6206055356696,-58.5229681961094 -34.6205143462783,-58.5230988898769 -34.6204154049602,-58.5234803263681 -34.6201263322101,-58.5238801507475 -34.6198233753111,-58.5240043715022 -34.6197291547337,-58.5249486615072 -34.6190130177201,-58.5259801165004 -34.6182306990552,-58.5260981174098 -34.6181411276006,-58.5259942053596 -34.6180497698933,-58.5256722412413 -34.6177664758344,-58.5253455910075 -34.6174790986667,-58.5252440652335 -34.617386964409,-58.5241002447232 -34.6182746189544,-58.5231682279513 -34.6189978563292,-58.5221840035255 -34.6197617471963)))";;"282";10_1_6;COMUNA 10;"1";"6";"811";"377";"434";"86,87%";"315";"315";"100,00%";"0";"0,00%";"309";"0";"0";"309";"100,00%";"0";0.000
"MULTIPOLYGON (((-58.5234803263681 -34.6201263322101,-58.5230988898769 -34.6204154049602,-58.5229681961094 -34.6205143462783,-58.5228477191571 -34.6206055356696,-58.5222897768374 -34.6210297678814,-58.5221763658361 -34.6211163051024,-58.5216770821139 -34.6214971945073,-58.5218192282986 -34.6215661421756,-58.5221994831129 -34.6217563159978,-58.5227653518264 -34.6220392879069,-58.5237772116538 -34.6212922103589,-58.5239050977726 -34.6211978472187,-58.5243229818683 -34.6208893867088,-58.5248705347296 -34.6204851511851,-58.525824035517 -34.6197813271629,-58.5259548968827 -34.6196847067137,-58.5269870489998 -34.6189241405858,-58.5265429211382 -34.6185316840023,-58.5260981174098 -34.6181411276006,-58.5259801165004 -34.6182306990552,-58.5249486615072 -34.6190130177201,-58.5240043715022 -34.6197291547337,-58.5238801507475 -34.6198233753111,-58.5234803263681 -34.6201263322101)))";;"283";10_1_7;COMUNA 10;"1";"7";"754";"362";"392";"92,35%";"306";"306";"100,00%";"0";"0,00%";"258";"9";"3.49";"249";"96,51%";"3.49";3.490
"MULTIPOLYGON (((-58.5177414986481 -34.6196138977069,-58.5169501498522 -34.6202151886697,-58.517431834985 -34.6206456223112,-58.5179075591967 -34.6210721129168,-58.5182918241999 -34.6214161757018,-58.5183947101147 -34.6215081037901,-58.5188890260358 -34.6219498642317,-58.5193814717947 -34.6223898628804,-58.519896086232 -34.6228497793779,-58.520288635877 -34.62320052225,-58.5206947428767 -34.6235634409086,-58.5208490327821 -34.6234507579603,-58.5216308616119 -34.6228762785314,-58.5217752714085 -34.6227701486941,-58.5227653518264 -34.6220392879069,-58.5221994831129 -34.6217563159978,-58.5218192282986 -34.6215661421756,-58.5216770821139 -34.6214971945073,-58.5209429129944 -34.6211316894922,-58.5208410661204 -34.6210671583704,-58.520513372715 -34.6208671663176,-58.5200130895472 -34.620422739035,-58.5195332458504 -34.6199619615464,-58.51911282225 -34.6195582693427,-58.5190435192072 -34.6194916793231,-58.5185393921764 -34.6190076688112,-58.5182082648246 -34.6192593076146,-58.5177414986481 -34.6196138977069)))";;"284";10_1_8;COMUNA 10;"1";"8";"976";"466";"510";"91,37%";"442";"442";"100,00%";"0";"0,00%";"353";"5";"1.42";"348";"98,58%";"1.42";1.420
"MULTIPOLYGON (((-58.4961437500783 -34.6214181313694,-58.4971213851501 -34.6222261973371,-58.4976630197086 -34.621796873491,-58.4978565079335 -34.6216435026998,-58.4982009015837 -34.6213705061531,-58.4972209658125 -34.6205620268247,-58.4963191075876 -34.6198178160465,-58.4954464091607 -34.6190977464602,-58.4949070798327 -34.6195245951689,-58.4944917422676 -34.6198533776118,-58.4943692781101 -34.6199507368183,-58.4945784824229 -34.6201237869793,-58.4947902441145 -34.6202990192786,-58.4950000467176 -34.6204726319489,-58.4951253151279 -34.6205762643084,-58.4952406134474 -34.6206715890481,-58.4954796473868 -34.6208692080032,-58.4956910719118 -34.6210439458319,-58.495903349531 -34.6212194577315,-58.4961437500783 -34.6214181313694)))";;"285";10_10_1;COMUNA 10;"10";"1";"745";"358";"387";"92,51%";"333";"333";"100,00%";"0";"0,00%";"281";"0";"0";"281";"100,00%";"0";0.000
"MULTIPOLYGON (((-58.4880430417819 -34.6234566326644,-58.4878986753932 -34.62357061016,-58.4870895349456 -34.6242094585624,-58.4869711455444 -34.62430864051,-58.4859240993454 -34.6251438025322,-58.4865847610363 -34.6253800914892,-58.4872524131619 -34.6256189107489,-58.4879168543204 -34.6250876302997,-58.4880365226575 -34.6249918980035,-58.4889911353035 -34.6242324446159,-58.4895288212353 -34.6238047072132,-58.4896322184598 -34.623722428077,-58.4900718672745 -34.6233724590115,-58.4891351029764 -34.622593624622,-58.4889203890125 -34.6227635359932,-58.4885857535677 -34.6230278419455,-58.4880430417819 -34.6234566326644)))";;"286";10_10_10;COMUNA 10;"10";"10";"726";"318";"408";"77,94%";"292";"292";"100,00%";"0";"0,00%";"262";"4";"1.53";"258";"98,47%";"1.53";1.530
"MULTIPOLYGON (((-58.4891351029764 -34.622593624622,-58.4896621322252 -34.6221766638497,-58.4902123219741 -34.6217413850568,-58.4894676428984 -34.6211202615131,-58.4893317282472 -34.6210049351277,-58.4884776473985 -34.6202799524244,-58.4883373895334 -34.6201603299073,-58.4882038459049 -34.6202666292244,-58.4872641767527 -34.6210161440045,-58.4861843838075 -34.6218774429602,-58.4851125748277 -34.6227323221019,-58.4852314443143 -34.6228335008866,-58.48610384416 -34.6235751932172,-58.4871740359692 -34.6227230523823,-58.4879107907012 -34.6233484169007,-58.4880430417819 -34.6234566326644,-58.4885857535677 -34.6230278419455,-58.4889203890125 -34.6227635359932,-58.4891351029764 -34.622593624622)))";;"287";10_10_11;COMUNA 10;"10";"11";"810";"380";"430";"88,37%";"342";"342";"100,00%";"0";"0,00%";"304";"22";"7.24";"282";"92,76%";"7.24";7.240
"MULTIPOLYGON (((-58.48610384416 -34.6235751932172,-58.4852314443143 -34.6228335008866,-58.4851125748277 -34.6227323221019,-58.4849705056881 -34.6228456618993,-58.4840382745839 -34.6235922627438,-58.4834266299192 -34.6240821033661,-58.4833681140265 -34.6241289458901,-58.484722144334 -34.6246752770091,-58.4855646307429 -34.625015204069,-58.4859240993454 -34.6251438025322,-58.4869711455444 -34.62430864051,-58.4870895349456 -34.6242094585624,-58.4878986753932 -34.62357061016,-58.4880430417819 -34.6234566326644,-58.4879107907012 -34.6233484169007,-58.4871740359692 -34.6227230523823,-58.48610384416 -34.6235751932172)))";;"288";10_10_12;COMUNA 10;"10";"12";"900";"410";"490";"83,67%";"438";"438";"100,00%";"0";"0,00%";"346";"6";"1.73";"340";"98,27%";"1.73";1.730
"MULTIPOLYGON (((-58.4934414590151 -34.6191777075894,-58.4942435002618 -34.619846610828,-58.4943692781101 -34.6199507368183,-58.4944917422676 -34.6198533776118,-58.4949070798327 -34.6195245951689,-58.4954464091607 -34.6190977464602,-58.4946578319759 -34.6184469467522,-58.4945163756632 -34.6183271907688,-58.4937929947961 -34.617714538728,-58.493634412812 -34.6175793629891,-58.4927782835051 -34.6168496216051,-58.4926364061189 -34.6167283141618,-58.4915617498776 -34.6175887445078,-58.4906161805046 -34.6183457518704,-58.4904887745644 -34.618447263413,-58.4906141205738 -34.6185540695498,-58.4914833707408 -34.6192934710491,-58.4915906540538 -34.6193847869257,-58.4923649036286 -34.6200332153996,-58.493313203341 -34.6192791518565,-58.4934414590151 -34.6191777075894)))";;"289";10_10_2;COMUNA 10;"10";"2";"1127";"452";"675";"66,96%";"424";"423";"99,76%";"1";"0,24%";"350";"11";"3.14";"339";"96,86%";"3.14";3.140
"MULTIPOLYGON (((-58.4956910719118 -34.6210439458319,-58.4954796473868 -34.6208692080032,-58.4952406134474 -34.6206715890481,-58.4951253151279 -34.6205762643084,-58.4950000467176 -34.6204726319489,-58.4947902441145 -34.6202990192786,-58.4945784824229 -34.6201237869793,-58.4943692781101 -34.6199507368183,-58.4942435002618 -34.619846610828,-58.4934414590151 -34.6191777075894,-58.493313203341 -34.6192791518565,-58.4923649036286 -34.6200332153996,-58.4925031211632 -34.6201490308356,-58.4932955329346 -34.6208046322284,-58.4935053337003 -34.6209782474559,-58.4937165839868 -34.6211529887487,-58.4939268125618 -34.621326884832,-58.4941655896717 -34.6215244359819,-58.4944060722849 -34.6217234651389,-58.4946174115654 -34.6218982752511,-58.4948301152468 -34.6220742818571,-58.4950700896677 -34.6222727464203,-58.4960449976383 -34.6230793427006,-58.4971213851501 -34.6222261973371,-58.4961437500783 -34.6214181313694,-58.495903349531 -34.6212194577315,-58.4956910719118 -34.6210439458319)))";;"290";10_10_3;COMUNA 10;"10";"3";"967";"462";"505";"91,49%";"342";"342";"100,00%";"0";"0,00%";"318";"10";"3.14";"308";"96,86%";"3.14";3.140
"MULTIPOLYGON (((-58.4939268125618 -34.621326884832,-58.4937165839868 -34.6211529887487,-58.4935053337003 -34.6209782474559,-58.4932955329346 -34.6208046322284,-58.4931438544563 -34.6209253081859,-58.492211716762 -34.6216683095832,-58.4923181470963 -34.6217457512685,-58.4924279898214 -34.6218360093747,-58.492639495219 -34.6220096960713,-58.4928508310906 -34.6221833120129,-58.492994079804 -34.6223009566563,-58.4930902895077 -34.6223805129465,-58.4933306015402 -34.6225792625383,-58.4935419407119 -34.6227540040643,-58.493755240782 -34.6229303644938,-58.4939948742383 -34.6231285495313,-58.4942344235887 -34.6233265932631,-58.4944444030442 -34.6235002067552,-58.4946548094986 -34.6236742423184,-58.4949678215773 -34.6239330420617,-58.4955076046973 -34.6235052777384,-58.4960449976383 -34.6230793427006,-58.4950700896677 -34.6222727464203,-58.4948301152468 -34.6220742818571,-58.4946174115654 -34.6218982752511,-58.4944060722849 -34.6217234651389,-58.4941655896717 -34.6215244359819,-58.4939268125618 -34.621326884832)))";;"291";10_10_4;COMUNA 10;"10";"4";"780";"377";"403";"93,55%";"328";"328";"100,00%";"0";"0,00%";"284";"5";"1.76";"279";"98,24%";"1.76";1.760
"MULTIPOLYGON (((-58.4893317282472 -34.6210049351277,-58.4894676428984 -34.6211202615131,-58.4902123219741 -34.6217413850568,-58.4896621322252 -34.6221766638497,-58.4891351029764 -34.622593624622,-58.4900718672745 -34.6233724590115,-58.4906028137131 -34.6229499297769,-58.4911444007477 -34.6225188038761,-58.4912808399571 -34.6224102471017,-58.492211716762 -34.6216683095832,-58.4931438544563 -34.6209253081859,-58.4932955329346 -34.6208046322284,-58.4925031211632 -34.6201490308356,-58.4923649036286 -34.6200332153996,-58.4915906540538 -34.6193847869257,-58.4914833707408 -34.6192934710491,-58.4906141205738 -34.6185540695498,-58.4904887745644 -34.618447263413,-58.4894124543483 -34.6193042945728,-58.4883373895334 -34.6201603299073,-58.4884776473985 -34.6202799524244,-58.4893317282472 -34.6210049351277)))";;"292";10_10_5;COMUNA 10;"10";"5";"889";"412";"477";"86,37%";"350";"349";"99,71%";"1";"0,29%";"313";"7";"2.24";"306";"97,76%";"2.24";2.240
"MULTIPOLYGON (((-58.4928508310906 -34.6221833120129,-58.492639495219 -34.6220096960713,-58.4924279898214 -34.6218360093747,-58.4923181470963 -34.6217457512685,-58.492211716762 -34.6216683095832,-58.4912808399571 -34.6224102471017,-58.4911444007477 -34.6225188038761,-58.4912573114861 -34.622613076533,-58.4913530085031 -34.6226919300599,-58.4915605089267 -34.6228630138197,-58.4917748275109 -34.6230397295939,-58.49201428592 -34.6232371438869,-58.4922546828523 -34.6234353321504,-58.4924662774184 -34.6236097937537,-58.4926804294069 -34.6237863671049,-58.4929201477604 -34.6239839908053,-58.493158929819 -34.6241807691622,-58.493370954291 -34.6243556516162,-58.4935817013353 -34.6245294072207,-58.4938924972894 -34.624785604525,-58.4940567866529 -34.6246551354027,-58.4942014869738 -34.6245403758803,-58.4949270267645 -34.6239653779005,-58.4949678215773 -34.6239330420617,-58.4946548094986 -34.6236742423184,-58.4944444030442 -34.6235002067552,-58.4942344235887 -34.6233265932631,-58.4939948742383 -34.6231285495313,-58.493755240782 -34.6229303644938,-58.4935419407119 -34.6227540040643,-58.4933306015402 -34.6225792625383,-58.4930902895077 -34.6223805129465,-58.492994079804 -34.6223009566563,-58.4928508310906 -34.6221833120129)))";;"293";10_10_6;COMUNA 10;"10";"6";"908";"425";"483";"87,99%";"338";"338";"100,00%";"0";"0,00%";"314";"6";"1.91";"308";"98,09%";"1.91";1.910
"MULTIPOLYGON (((-58.4923817967909 -34.624412447551,-58.4918446326779 -34.6248399860844,-58.4928169814294 -34.625640411041,-58.4933552531515 -34.6252126567288,-58.4938924972894 -34.624785604525,-58.4935817013353 -34.6245294072207,-58.493370954291 -34.6243556516162,-58.493158929819 -34.6241807691622,-58.4929201477604 -34.6239839908053,-58.4926804294069 -34.6237863671049,-58.4924662774184 -34.6236097937537,-58.4922546828523 -34.6234353321504,-58.49201428592 -34.6232371438869,-58.4917748275109 -34.6230397295939,-58.4915605089267 -34.6228630138197,-58.4913530085031 -34.6226919300599,-58.4912573114861 -34.622613076533,-58.4911444007477 -34.6225188038761,-58.4906028137131 -34.6229499297769,-58.4914747428068 -34.6236667237679,-58.4923817967909 -34.624412447551)))";;"294";10_10_7;COMUNA 10;"10";"7";"824";"387";"437";"88,56%";"349";"349";"100,00%";"0";"0,00%";"308";"2";"0.65";"306";"99,35%";"0.65";0.650
"MULTIPOLYGON (((-58.4898636605779 -34.6249500245179,-58.4899689884227 -34.6250366941237,-58.4903155663333 -34.6253219780188,-58.4907695213594 -34.6256956195487,-58.4917412731432 -34.6264952784311,-58.4927564255124 -34.6256885262083,-58.4928169814294 -34.625640411041,-58.4918446326779 -34.6248399860844,-58.4923817967909 -34.624412447551,-58.4914747428068 -34.6236667237679,-58.4906028137131 -34.6229499297769,-58.4900718672745 -34.6233724590115,-58.4896322184598 -34.623722428077,-58.4895288212353 -34.6238047072132,-58.4889911353035 -34.6242324446159,-58.4891104364634 -34.6243300278287,-58.4894259046818 -34.6245896863363,-58.4898636605779 -34.6249500245179)))";;"295";10_10_8;COMUNA 10;"10";"8";"733";"328";"405";"80,99%";"285";"285";"100,00%";"0";"0,00%";"254";"8";"3.15";"246";"96,85%";"3.15";3.150
"MULTIPOLYGON (((-58.4903155663333 -34.6253219780188,-58.4899689884227 -34.6250366941237,-58.4898636605779 -34.6249500245179,-58.4894259046818 -34.6245896863363,-58.4891104364634 -34.6243300278287,-58.4889911353035 -34.6242324446159,-58.4880365226575 -34.6249918980035,-58.4879168543204 -34.6250876302997,-58.4872524131619 -34.6256189107489,-58.4878601707846 -34.6258363295327,-58.488225866355 -34.6259671030823,-58.4884769626262 -34.6260550110199,-58.4891168472293 -34.6262788958255,-58.4897557128096 -34.6265024253668,-58.4910956681478 -34.6270110112956,-58.4913562962295 -34.6268036898004,-58.4917412731432 -34.6264952784311,-58.4907695213594 -34.6256956195487,-58.4903155663333 -34.6253219780188)))";;"296";10_10_9;COMUNA 10;"10";"9";"957";"425";"532";"79,89%";"404";"404";"100,00%";"0";"0,00%";"350";"3";"0.86";"347";"99,14%";"0.86";0.860
"MULTIPOLYGON (((-58.4897557128096 -34.6265024253668,-58.4891168472293 -34.6262788958255,-58.4884769626262 -34.6260550110199,-58.4877063886089 -34.6266689246785,-58.4877662884267 -34.626693420258,-58.4876601153029 -34.6269128860922,-58.4876039207967 -34.6270290282741,-58.4874080957766 -34.6274524627089,-58.4873616935199 -34.6275529684541,-58.4871936227456 -34.6279169582696,-58.4867902980363 -34.6287905891255,-58.4867328254826 -34.6289150412615,-58.4862537104666 -34.629952141278,-58.4861760560515 -34.6301188519553,-58.4869460553879 -34.6303097640361,-58.4877176909741 -34.6296956440463,-58.4880833599961 -34.629404643269,-58.4882339538879 -34.629284748667,-58.4892859697167 -34.6284475239732,-58.490221701753 -34.6277027842996,-58.4910956681478 -34.6270110112956,-58.4897557128096 -34.6265024253668)))";;"297";10_11_1;COMUNA 10;"11";"1";"850";"416";"434";"95,85%";"406";"406";"100,00%";"0";"0,00%";"309";"7";"2.27";"302";"97,73%";"2.27";2.270
"MULTIPOLYGON (((-58.482862741153 -34.6279681752818,-58.4817071515795 -34.6276844780019,-58.481435103332 -34.6276149402744,-58.4812885519587 -34.6279368045507,-58.4808925760011 -34.6288037948536,-58.4823112011964 -34.6291583052363,-58.4827757158281 -34.6281585481676,-58.482862741153 -34.6279681752818)))";;"298";10_11_10;COMUNA 10;"11";"10";"678";"295";"383";"77,02%";"354";"354";"100,00%";"0";"0,00%";"296";"8";"2.7";"288";"97,30%";"2.7";2.700
"MULTIPOLYGON (((-58.4803694929926 -34.6273420618879,-58.4792966470756 -34.6270646679684,-58.4791269281465 -34.627020816216,-58.4781981628236 -34.6267787464434,-58.4781354840088 -34.6269146744957,-58.4776384750715 -34.6279948433385,-58.4787417422127 -34.6282690082561,-58.4798210748994 -34.6285371804264,-58.4806056999368 -34.6287321447531,-58.4808925760011 -34.6288037948536,-58.4812885519587 -34.6279368045507,-58.481435103332 -34.6276149402744,-58.4805381056173 -34.627385630371,-58.4803694929926 -34.6273420618879)))";;"299";10_11_11;COMUNA 10;"11";"11";"645";"297";"348";"85,34%";"291";"291";"100,00%";"0";"0,00%";"251";"5";"1.99";"246";"98,01%";"1.99";1.990
"MULTIPOLYGON (((-58.4864209441713 -34.6266182642066,-58.486221707381 -34.6270456412255,-58.4861754742918 -34.6271460760688,-58.4859595482917 -34.6276157812076,-58.485882321798 -34.6277837593283,-58.4855858440017 -34.6284282736572,-58.4854991638595 -34.6286137186626,-58.4849390544372 -34.6298121721055,-58.4861760560515 -34.6301188519553,-58.4862537104666 -34.629952141278,-58.4867328254826 -34.6289150412615,-58.4867902980363 -34.6287905891255,-58.4871936227456 -34.6279169582696,-58.4873616935199 -34.6275529684541,-58.4874080957766 -34.6274524627089,-58.4876039207967 -34.6270290282741,-58.4876601153029 -34.6269128860922,-58.4877662884267 -34.626693420258,-58.4877063886089 -34.6266689246785,-58.4884769626262 -34.6260550110199,-58.488225866355 -34.6259671030823,-58.4878601707846 -34.6258363295327,-58.4872524131619 -34.6256189107489,-58.4870340255785 -34.6257935379282,-58.4865524500817 -34.6261951255918,-58.4866076629466 -34.6262177211856,-58.4864209441713 -34.6266182642066)))";;"300";10_11_2;COMUNA 10;"11";"2";"1113";"531";"582";"91,24%";"503";"503";"100,00%";"0";"0,00%";"433";"39";"9.01";"394";"90,99%";"9.01";9.010
"MULTIPOLYGON (((-58.4859240993454 -34.6251438025322,-58.4855646307429 -34.625015204069,-58.484722144334 -34.6246752770091,-58.4833681140265 -34.6241289458901,-58.4827426628097 -34.6246298420969,-58.4823389109904 -34.6256292377229,-58.4836315606583 -34.6259451602959,-58.4837707774356 -34.6259787994457,-58.4849493533496 -34.6262635998662,-58.4851574133388 -34.6263138451384,-58.4862192729536 -34.6265702734584,-58.4864209441713 -34.6266182642066,-58.4866076629466 -34.6262177211856,-58.4865524500817 -34.6261951255918,-58.4870340255785 -34.6257935379282,-58.4872524131619 -34.6256189107489,-58.4865847610363 -34.6253800914892,-58.4859240993454 -34.6251438025322)))";;"301";10_11_3;COMUNA 10;"11";"3";"856";"386";"470";"82,13%";"425";"425";"100,00%";"0";"0,00%";"354";"6";"1.69";"348";"98,31%";"1.69";1.690
"MULTIPOLYGON (((-58.4802090184782 -34.6250759515734,-58.4801583517426 -34.6251887795962,-58.4798210496328 -34.625925683546,-58.4797543717612 -34.6260704865514,-58.4799672001235 -34.6261258810321,-58.4808220948433 -34.6263485815026,-58.4809774997531 -34.6263890526503,-58.4818860758455 -34.6266240619601,-58.4823389109904 -34.6256292377229,-58.4827426628097 -34.6246298420969,-58.4819203819229 -34.6242871457671,-58.4817872972144 -34.6242299111764,-58.4817331943202 -34.6242066089702,-58.4807400921833 -34.6237793508165,-58.4802090184782 -34.6250759515734)))";;"302";10_11_4;COMUNA 10;"11";"4";"1021";"497";"524";"94,85%";"427";"427";"100,00%";"0";"0,00%";"394";"39";"9.9";"355";"90,10%";"9.9";9.900
"MULTIPOLYGON (((-58.4780062810669 -34.6224877784523,-58.4778072555519 -34.6223842785486,-58.4774145872498 -34.6232230879565,-58.4770145019904 -34.6240777424719,-58.4769505460416 -34.6242175434979,-58.4779170228793 -34.6244763793161,-58.4780687594337 -34.6245160799659,-58.4791131129946 -34.6247894039965,-58.4790558879353 -34.6249170216879,-58.4786562398229 -34.625784569054,-58.4788458926155 -34.6258339824037,-58.4797543717612 -34.6260704865514,-58.4798210496328 -34.625925683546,-58.4801583517426 -34.6251887795962,-58.4802090184782 -34.6250759515734,-58.4807400921833 -34.6237793508165,-58.4797556905705 -34.623355745428,-58.4793761269296 -34.6231924119868,-58.4787991524573 -34.6229104374997,-58.4781161031468 -34.6225448792774,-58.4780062810669 -34.6224877784523)))";;"303";10_11_5;COMUNA 10;"11";"5";"944";"438";"506";"86,56%";"310";"310";"100,00%";"0";"0,00%";"301";"7";"2.33";"294";"97,67%";"2.33";2.330
"MULTIPOLYGON (((-58.4781981628236 -34.6267787464434,-58.4791269281465 -34.627020816216,-58.4792966470756 -34.6270646679684,-58.4797543717612 -34.6260704865514,-58.4788458926155 -34.6258339824037,-58.4786562398229 -34.625784569054,-58.4790558879353 -34.6249170216879,-58.4791131129946 -34.6247894039965,-58.4780687594337 -34.6245160799659,-58.4779170228793 -34.6244763793161,-58.4769505460416 -34.6242175434979,-58.4764901590307 -34.6252236168158,-58.4760364889766 -34.6262150391113,-58.4754686835695 -34.6274556349253,-58.4765906804699 -34.6277344654074,-58.4776384750715 -34.6279948433385,-58.4781354840088 -34.6269146744957,-58.4781981628236 -34.6267787464434)))";;"304";10_11_6;COMUNA 10;"11";"6";"510";"241";"269";"89,59%";"262";"262";"100,00%";"0";"0,00%";"183";"23";"12.57";"160";"87,43%";"12.57";12.570
"MULTIPOLYGON (((-58.4818860758455 -34.6266240619601,-58.4809774997531 -34.6263890526503,-58.4808220948433 -34.6263485815026,-58.4799672001235 -34.6261258810321,-58.4797543717612 -34.6260704865514,-58.4792966470756 -34.6270646679684,-58.4803694929926 -34.6273420618879,-58.4805381056173 -34.627385630371,-58.481435103332 -34.6276149402744,-58.4817071515795 -34.6276844780019,-58.482862741153 -34.6279681752818,-58.4842423360927 -34.6283068945207,-58.4846986456195 -34.6273133288363,-58.4834576039218 -34.6270156489305,-58.4833142956681 -34.6269801086479,-58.4820452305511 -34.6266652354049,-58.4818860758455 -34.6266240619601)))";;"305";10_11_7;COMUNA 10;"11";"7";"1079";"505";"574";"87,98%";"410";"410";"100,00%";"0";"0,00%";"377";"39";"10.34";"338";"89,66%";"10.34";10.340
"MULTIPOLYGON (((-58.4864209441713 -34.6266182642066,-58.4862192729536 -34.6265702734584,-58.4851574133388 -34.6263138451384,-58.4849493533496 -34.6262635998662,-58.4837707774356 -34.6259787994457,-58.4836315606583 -34.6259451602959,-58.4823389109904 -34.6256292377229,-58.4818860758455 -34.6266240619601,-58.4820452305511 -34.6266652354049,-58.4833142956681 -34.6269801086479,-58.4834576039218 -34.6270156489305,-58.4846986456195 -34.6273133288363,-58.4859595482917 -34.6276157812076,-58.4861754742918 -34.6271460760688,-58.486221707381 -34.6270456412255,-58.4864209441713 -34.6266182642066)))";;"306";10_11_8;COMUNA 10;"11";"8";"839";"394";"445";"88,54%";"390";"390";"100,00%";"0";"0,00%";"344";"36";"10.47";"308";"89,53%";"10.47";10.470
"MULTIPOLYGON (((-58.4836917522557 -34.6295028757455,-58.4849390544372 -34.6298121721055,-58.4854991638595 -34.6286137186626,-58.4855858440017 -34.6284282736572,-58.485882321798 -34.6277837593283,-58.4859595482917 -34.6276157812076,-58.4846986456195 -34.6273133288363,-58.4842423360927 -34.6283068945207,-58.482862741153 -34.6279681752818,-58.4827757158281 -34.6281585481676,-58.4823112011964 -34.6291583052363,-58.48347806141 -34.6294498823894,-58.4836917522557 -34.6295028757455)))";;"307";10_11_9;COMUNA 10;"11";"9";"1085";"529";"556";"95,14%";"391";"389";"99,49%";"2";"0,51%";"381";"45";"11.81";"336";"88,19%";"11.81";11.810
"MULTIPOLYGON (((-58.4869460553879 -34.6303097640361,-58.4861760560515 -34.6301188519553,-58.4849390544372 -34.6298121721055,-58.4836917522557 -34.6295028757455,-58.4832016101327 -34.6305596845456,-58.4834569690703 -34.6306240801226,-58.4844443259681 -34.6308706768762,-58.4856799787816 -34.631179192988,-58.4855735398785 -34.6314023894151,-58.4860277269839 -34.6310408125223,-58.486725610314 -34.6304851656142,-58.4868622386739 -34.6303764730326,-58.4869460553879 -34.6303097640361)))";;"308";10_12_1;COMUNA 10;"12";"1";"1006";"462";"544";"84,93%";"412";"411";"99,76%";"1";"0,24%";"347";"23";"6.63";"324";"93,37%";"6.63";6.630
"MULTIPOLYGON (((-58.4856799787816 -34.631179192988,-58.4844443259681 -34.6308706768762,-58.4843620686953 -34.6310466832784,-58.4839759843593 -34.6318788210801,-58.4839059024875 -34.6320298241949,-58.4835821422271 -34.6327239874744,-58.4834696502751 -34.6329627469392,-58.483469861123 -34.6329627878294,-58.4837121941874 -34.6328841216307,-58.4847315115515 -34.6320727778764,-58.4855735398785 -34.6314023894151,-58.4856799787816 -34.631179192988)))";;"309";10_12_10;COMUNA 10;"12";"10";"612";"277";"335";"82,69%";"306";"306";"100,00%";"0";"0,00%";"246";"4";"1.63";"242";"98,37%";"1.63";1.630
"MULTIPOLYGON (((-58.4836917522557 -34.6295028757455,-58.48347806141 -34.6294498823894,-58.4823112011964 -34.6291583052363,-58.4822213625204 -34.6293516359878,-58.4818251325495 -34.6302125021919,-58.4813660473822 -34.6312100008808,-58.4814987114839 -34.6312430097721,-58.4827373431993 -34.6315609217253,-58.4839759843593 -34.6318788210801,-58.4843620686953 -34.6310466832784,-58.4844443259681 -34.6308706768762,-58.4834569690703 -34.6306240801226,-58.4832016101327 -34.6305596845456,-58.4836917522557 -34.6295028757455)))";;"310";10_12_2;COMUNA 10;"12";"2";"875";"402";"473";"84,99%";"443";"442";"99,77%";"1";"0,23%";"370";"13";"3.51";"357";"96,49%";"3.51";3.510
"MULTIPOLYGON (((-58.4804087077781 -34.6298633381923,-58.480356079338 -34.6299785609399,-58.4800240407301 -34.6307094075728,-58.479956933899 -34.6308566755076,-58.4811326713047 -34.631152006276,-58.4813660473822 -34.6312100008808,-58.4818251325495 -34.6302125021919,-58.4822213625204 -34.6293516359878,-58.4823112011964 -34.6291583052363,-58.4808925760011 -34.6288037948536,-58.4804087077781 -34.6298633381923)))";;"311";10_12_3;COMUNA 10;"12";"3";"807";"371";"436";"85,09%";"295";"294";"99,66%";"1";"0,34%";"309";"85";"27.51";"224";"72,49%";"27.51";27.510
"MULTIPOLYGON (((-58.4808925760011 -34.6288037948536,-58.4806056999368 -34.6287321447531,-58.4798210748994 -34.6285371804264,-58.4787417422127 -34.6282690082561,-58.4782518860909 -34.6293297411461,-58.4781903977007 -34.6294628520223,-58.4778024702736 -34.6302971539137,-58.4788819145686 -34.6305816024356,-58.4789300319577 -34.6304771559425,-58.4793333611576 -34.6295991849585,-58.4804087077781 -34.6298633381923,-58.4808925760011 -34.6288037948536)))";;"312";10_12_4;COMUNA 10;"12";"4";"629";"282";"347";"81,27%";"300";"299";"99,67%";"1";"0,33%";"243";"31";"12.76";"212";"87,24%";"12.76";12.760
"MULTIPOLYGON (((-58.4761109368993 -34.6287844136335,-58.4756724884133 -34.6297429438999,-58.4767169841009 -34.6300119922703,-58.4768702637088 -34.6300514829216,-58.4778024702736 -34.6302971539137,-58.4781903977007 -34.6294628520223,-58.4782518860909 -34.6293297411461,-58.4787417422127 -34.6282690082561,-58.4776384750715 -34.6279948433385,-58.4765906804699 -34.6277344654074,-58.4765022785534 -34.6279287073538,-58.4761109368993 -34.6287844136335)))";;"313";10_12_5;COMUNA 10;"12";"5";"605";"291";"314";"92,68%";"239";"238";"99,58%";"1";"0,42%";"189";"12";"6.35";"177";"93,65%";"6.35";6.350
"MULTIPOLYGON (((-58.4753488408585 -34.6304503958858,-58.4763784416763 -34.6307636050664,-58.4764932966628 -34.6307985228723,-58.4774331016033 -34.6310913100389,-58.4778024702736 -34.6302971539137,-58.4768702637088 -34.6300514829216,-58.4767169841009 -34.6300119922703,-58.4756724884133 -34.6297429438999,-58.4761109368993 -34.6287844136335,-58.4765022785534 -34.6279287073538,-58.4765906804699 -34.6277344654074,-58.4754686835695 -34.6274556349253,-58.4749901195969 -34.6285012827499,-58.4745537037572 -34.6294548086684,-58.4742537259749 -34.6301103523385,-58.4752087666602 -34.6304077328519,-58.4753488408585 -34.6304503958858)))";;"314";10_12_6;COMUNA 10;"12";"6";"601";"279";"322";"86,65%";"242";"242";"100,00%";"0";"0,00%";"214";"9";"4.21";"205";"95,79%";"4.21";4.210
"MULTIPOLYGON (((-58.4788819145686 -34.6305816024356,-58.4778024702736 -34.6302971539137,-58.4774331016033 -34.6310913100389,-58.4775951611077 -34.6311417849916,-58.4784948418401 -34.6314210472779,-58.4795503703964 -34.6317486633678,-58.4795946550784 -34.6316515413484,-58.4797681307809 -34.6312709411927,-58.479956933899 -34.6308566755076,-58.4800240407301 -34.6307094075728,-58.480356079338 -34.6299785609399,-58.4804087077781 -34.6298633381923,-58.4793333611576 -34.6295991849585,-58.4789300319577 -34.6304771559425,-58.4788819145686 -34.6305816024356)))";;"315";10_12_7;COMUNA 10;"12";"7";"659";"294";"365";"80,55%";"282";"282";"100,00%";"0";"0,00%";"238";"28";"11.76";"210";"88,24%";"11.76";11.760
"MULTIPOLYGON (((-58.4797681307809 -34.6312709411927,-58.4795946550784 -34.6316515413484,-58.4795503703964 -34.6317486633678,-58.4794758526778 -34.6319121297558,-58.4794454493509 -34.6319787558565,-58.4794062741393 -34.6320646795636,-58.47938115004 -34.6321156706037,-58.4807694249716 -34.6325471772351,-58.4807957393061 -34.6324875939034,-58.4820139528763 -34.6328679125841,-58.4821172251072 -34.6329004324699,-58.4821356194349 -34.6328606394974,-58.4821976149738 -34.6327263998284,-58.482259695498 -34.6325920896865,-58.4809193847047 -34.6321805231029,-58.4809682668701 -34.6320742446727,-58.4811563854512 -34.6316654704284,-58.4813660473822 -34.6312100008808,-58.4811326713047 -34.631152006276,-58.479956933899 -34.6308566755076,-58.4797681307809 -34.6312709411927)))";;"316";10_12_8;COMUNA 10;"12";"8";"753";"352";"401";"87,78%";"352";"352";"100,00%";"0";"0,00%";"311";"2";"0.64";"309";"99,36%";"0.64";0.640
"MULTIPOLYGON (((-58.4827373431993 -34.6315609217253,-58.4814987114839 -34.6312430097721,-58.4813660473822 -34.6312100008808,-58.4811563854512 -34.6316654704284,-58.4809682668701 -34.6320742446727,-58.4809193847047 -34.6321805231029,-58.482259695498 -34.6325920896865,-58.4821976149738 -34.6327263998284,-58.4821356194349 -34.6328606394974,-58.4821172251072 -34.6329004324699,-58.4830620164266 -34.6331981051027,-58.4833201355636 -34.6332789887594,-58.483469861123 -34.6329627878294,-58.4834696502751 -34.6329627469392,-58.4835821422271 -34.6327239874744,-58.4839059024875 -34.6320298241949,-58.4839759843593 -34.6318788210801,-58.4827373431993 -34.6315609217253)))";;"317";10_12_9;COMUNA 10;"12";"9";"737";"323";"414";"78,02%";"390";"390";"100,00%";"0";"0,00%";"308";"9";"2.92";"299";"97,08%";"2.92";2.920
"MULTIPOLYGON (((-58.4947071102855 -34.6249862454389,-58.4946179674588 -34.6249076041346,-58.4942014869738 -34.6245403758803,-58.4940567866529 -34.6246551354027,-58.4938924972894 -34.624785604525,-58.4933552531515 -34.6252126567288,-58.4928169814294 -34.625640411041,-58.4927564255124 -34.6256885262083,-58.4926035351987 -34.6260203356474,-58.4938572081023 -34.6265579978941,-58.4942136382833 -34.6267108692659,-58.4950791990002 -34.6270820636086,-58.4952365820866 -34.627149136677,-58.4964285946946 -34.62765728078,-58.496532553344 -34.6277038028562,-58.4969513713066 -34.6278906641074,-58.4975089719707 -34.6274535196828,-58.496939144845 -34.626955635951,-58.4968452254319 -34.6268735468207,-58.4958886544298 -34.6260343457232,-58.4957716411457 -34.6259316979543,-58.4955771593506 -34.6257609700651,-58.4955108547074 -34.6257019013981,-58.4947757145658 -34.6250467224443,-58.4947071102855 -34.6249862454389)))";;"318";10_13_1;COMUNA 10;"13";"1";"718";"333";"385";"86,49%";"249";"248";"99,60%";"1";"0,40%";"226";"13";"5.75";"213";"94,25%";"5.75";5.750
"MULTIPOLYGON (((-58.4893344814495 -34.6338869193005,-58.4887753999706 -34.6334061088451,-58.4885105203152 -34.6331782703757,-58.4882916633093 -34.6329900004413,-58.4877903754429 -34.6325588932066,-58.4876999532873 -34.6324811627309,-58.4869938821315 -34.6318738909769,-58.4868960470536 -34.6317894710102,-58.486804433391 -34.6317104724492,-58.4864368500394 -34.6325107822521,-58.4859237371136 -34.6336276783275,-58.4863980081221 -34.6337442106427,-58.4871681203453 -34.6339135711772,-58.4873206435016 -34.6339471331333,-58.4882074902381 -34.634124562335,-58.4884320984086 -34.6341656432609,-58.4889098491806 -34.6342181488857,-58.4890776593088 -34.6340909958757,-58.4893344814495 -34.6338869193005)))";;"319";10_13_10;COMUNA 10;"13";"10";"593";"290";"303";"95,71%";"282";"281";"99,65%";"1";"0,36%";"230";"6";"2.61";"224";"97,39%";"2.61";2.610
"MULTIPOLYGON (((-58.4860277269839 -34.6310408125223,-58.4855735398785 -34.6314023894151,-58.4847315115515 -34.6320727778764,-58.4849972718593 -34.6321409712749,-58.4852031320449 -34.6321938929645,-58.4864368500394 -34.6325107822521,-58.486804433391 -34.6317104724492,-58.4860277269839 -34.6310408125223)))";;"320";10_13_11;COMUNA 10;"13";"11";"619";"264";"355";"74,37%";"344";"344";"100,00%";"0";"0,00%";"287";"3";"1.05";"284";"98,95%";"1.05";1.050
"MULTIPOLYGON (((-58.4847315115515 -34.6320727778764,-58.4837121941874 -34.6328841216307,-58.483469861123 -34.6329627878294,-58.4833201355636 -34.6332789887594,-58.4833203695867 -34.6332793319755,-58.4834659917015 -34.6333251538462,-58.4845373225551 -34.63363807561,-58.4846590013002 -34.6336736183105,-58.4857755732523 -34.6339480690613,-58.4858067388655 -34.6338807370122,-58.4858534871909 -34.6337797389222,-58.4859237371136 -34.6336276783275,-58.4864368500394 -34.6325107822521,-58.4852031320449 -34.6321938929645,-58.4849972718593 -34.6321409712749,-58.4847315115515 -34.6320727778764)))";;"321";10_13_12;COMUNA 10;"13";"12";"601";"254";"347";"73,20%";"316";"316";"100,00%";"0";"0,00%";"267";"1";"0.37";"266";"99,63%";"0.37";0.370
"MULTIPOLYGON (((-58.4942136382833 -34.6267108692659,-58.4938572081023 -34.6265579978941,-58.493794980921 -34.6266937930272,-58.493354874407 -34.6276575285807,-58.4940405610331 -34.6279504628085,-58.4947394602234 -34.6282490941139,-58.4958754163813 -34.6287343701464,-58.4962776776889 -34.628418897367,-58.4964298769789 -34.6282995555877,-58.4969513713066 -34.6278906641074,-58.496532553344 -34.6277038028562,-58.4964285946946 -34.62765728078,-58.4952365820866 -34.627149136677,-58.4950791990002 -34.6270820636086,-58.4942136382833 -34.6267108692659)))";;"322";10_13_2;COMUNA 10;"13";"2";"753";"346";"407";"85,01%";"316";"315";"99,68%";"1";"0,32%";"255";"1";"0.39";"254";"99,61%";"0.39";0.390
"MULTIPOLYGON (((-58.4940405610331 -34.6279504628085,-58.493354874407 -34.6276575285807,-58.493794980921 -34.6266937930272,-58.4938572081023 -34.6265579978941,-58.4926035351987 -34.6260203356474,-58.4927564255124 -34.6256885262083,-58.4917412731432 -34.6264952784311,-58.4913562962295 -34.6268036898004,-58.4910956681478 -34.6270110112956,-58.4918990000574 -34.6275546428524,-58.4928346005106 -34.6281877465189,-58.4930467086473 -34.6283322762643,-58.4936714475801 -34.6287577673444,-58.494083057835 -34.6290381645054,-58.4943144300355 -34.6291957860973,-58.4948747322925 -34.6295188898443,-58.4954068883418 -34.6291016216691,-58.4958754163813 -34.6287343701464,-58.4947394602234 -34.6282490941139,-58.4940405610331 -34.6279504628085)))";;"323";10_13_3;COMUNA 10;"13";"3";"725";"354";"371";"95,42%";"322";"322";"100,00%";"0";"0,00%";"261";"23";"8.81";"238";"91,19%";"8.81";8.810
"MULTIPOLYGON (((-58.4918990000574 -34.6275546428524,-58.4910956681478 -34.6270110112956,-58.490221701753 -34.6277027842996,-58.4904985458347 -34.627823922795,-58.4911674350159 -34.6281022990393,-58.4913374274516 -34.6281734588289,-58.4915748208372 -34.6282727019815,-58.4924466878433 -34.6286360258262,-58.4935677180743 -34.6290991431187,-58.4939157379466 -34.6292818129839,-58.494083057835 -34.6290381645054,-58.4936714475801 -34.6287577673444,-58.4930467086473 -34.6283322762643,-58.4928346005106 -34.6281877465189,-58.4918990000574 -34.6275546428524)))";;"324";10_13_4;COMUNA 10;"13";"4";"605";"287";"318";"90,25%";"287";"287";"100,00%";"0";"0,00%";"248";"4";"1.61";"244";"98,39%";"1.61";1.610
"MULTIPOLYGON (((-58.4946147848858 -34.6297231198917,-58.4947738023805 -34.6295974401787,-58.4948747322925 -34.6295188898443,-58.4943144300355 -34.6291957860973,-58.494083057835 -34.6290381645054,-58.4939157379466 -34.6292818129839,-58.4935677180743 -34.6290991431187,-58.4924466878433 -34.6286360258262,-58.4915748208372 -34.6282727019815,-58.4913374274516 -34.6281734588289,-58.4911674350159 -34.6281022990393,-58.4904985458347 -34.627823922795,-58.490221701753 -34.6277027842996,-58.4892859697167 -34.6284475239732,-58.4903798250649 -34.6289808197026,-58.4914075693221 -34.6294818665494,-58.492483045622 -34.6300061332589,-58.4935799244005 -34.6305408783273,-58.494349130049 -34.6299330552755,-58.4946147848858 -34.6297231198917)))";;"325";10_13_5;COMUNA 10;"13";"5";"810";"391";"419";"93,32%";"377";"376";"99,73%";"1";"0,27%";"315";"4";"1.27";"311";"98,73%";"1.27";1.270
"MULTIPOLYGON (((-58.492483045622 -34.6300061332589,-58.4914075693221 -34.6294818665494,-58.4903798250649 -34.6289808197026,-58.4892859697167 -34.6284475239732,-58.4882339538879 -34.629284748667,-58.4880833599961 -34.629404643269,-58.4892070473483 -34.6299616059809,-58.4893794320529 -34.6300470642091,-58.4902149428075 -34.630455413344,-58.491091279242 -34.6308836774702,-58.491266564968 -34.63097025914,-58.4923504132744 -34.6315058633288,-58.4925728962289 -34.6313366485059,-58.4929951979594 -34.6310029417271,-58.4935799244005 -34.6305408783273,-58.492483045622 -34.6300061332589)))";;"326";10_13_6;COMUNA 10;"13";"6";"840";"382";"458";"83,41%";"321";"320";"99,69%";"1";"0,31%";"278";"2";"0.72";"276";"99,28%";"0.72";0.720
"MULTIPOLYGON (((-58.491266564968 -34.63097025914,-58.491091279242 -34.6308836774702,-58.4902149428075 -34.630455413344,-58.489499880133 -34.6310344650483,-58.4893791827208 -34.6311311848602,-58.4885203234248 -34.6318190685471,-58.4886646926913 -34.6319446758586,-58.4893302099538 -34.6325183541347,-58.4894460308362 -34.6326181912389,-58.490154940852 -34.6332346033092,-58.4907793910431 -34.6327378955196,-58.4910180617587 -34.6325480453546,-58.4918409648114 -34.6318933932972,-58.491988748813 -34.6317810302405,-58.4921805647495 -34.6318631698464,-58.4922516073911 -34.6315810306419,-58.4923504132744 -34.6315058633288,-58.491266564968 -34.63097025914)))";;"327";10_13_7;COMUNA 10;"13";"7";"722";"307";"415";"73,98%";"299";"296";"99,00%";"3";"1,01%";"254";"13";"5.12";"241";"94,88%";"5.12";5.120
"MULTIPOLYGON (((-58.4877176909741 -34.6296956440463,-58.4869460553879 -34.6303097640361,-58.4868622386739 -34.6303764730326,-58.4877278342413 -34.6311295629872,-58.4885203234248 -34.6318190685471,-58.4893791827208 -34.6311311848602,-58.489499880133 -34.6310344650483,-58.4902149428075 -34.630455413344,-58.4893794320529 -34.6300470642091,-58.4892070473483 -34.6299616059809,-58.4880833599961 -34.629404643269,-58.4877176909741 -34.6296956440463)))";;"328";10_13_8;COMUNA 10;"13";"8";"785";"357";"428";"83,41%";"331";"331";"100,00%";"0";"0,00%";"290";"1";"0.34";"289";"99,66%";"0.34";0.340
"MULTIPOLYGON (((-58.4868622386739 -34.6303764730326,-58.486725610314 -34.6304851656142,-58.4860277269839 -34.6310408125223,-58.486804433391 -34.6317104724492,-58.4868960470536 -34.6317894710102,-58.4869938821315 -34.6318738909769,-58.4876999532873 -34.6324811627309,-58.4877903754429 -34.6325588932066,-58.4882916633093 -34.6329900004413,-58.4885105203152 -34.6331782703757,-58.4887753999706 -34.6334061088451,-58.4893344814495 -34.6338869193005,-58.489447431664 -34.6337971029094,-58.490154940852 -34.6332346033092,-58.4894460308362 -34.6326181912389,-58.4893302099538 -34.6325183541347,-58.4886646926913 -34.6319446758586,-58.4885203234248 -34.6318190685471,-58.4877278342413 -34.6311295629872,-58.4868622386739 -34.6303764730326)))";;"329";10_13_9;COMUNA 10;"13";"9";"726";"323";"403";"80,15%";"327";"326";"99,69%";"1";"0,31%";"281";"34";"12.1";"247";"87,90%";"12.1";12.100
"MULTIPOLYGON (((-58.499479936167 -34.6315813891782,-58.4999773390034 -34.6317765263235,-58.5005527175061 -34.6320035397211,-58.5010421206422 -34.632207759798,-58.5015376471394 -34.6318344921116,-58.5004175726904 -34.6308385430082,-58.5002968814948 -34.6307314640354,-58.5007991286677 -34.6303480560064,-58.5003490119709 -34.6299511402878,-58.4995452732431 -34.6292423479465,-58.4990493321998 -34.6296270166508,-58.4989306054938 -34.6297191677277,-58.4980808624232 -34.6303874676177,-58.4979285596973 -34.6302655358079,-58.4971729516117 -34.6297046062213,-58.4963983953196 -34.6302980818997,-58.4962033361626 -34.6304151817857,-58.4964035947951 -34.6305144961196,-58.4974443721033 -34.6308772443302,-58.4985863063029 -34.6312753072,-58.499271333874 -34.6315099002389,-58.499479936167 -34.6315813891782)))";;"330";10_14_1;COMUNA 10;"14";"1";"902";"420";"482";"87,14%";"389";"389";"100,00%";"0";"0,00%";"334";"8";"2.4";"326";"97,60%";"2.4";2.400
"MULTIPOLYGON (((-58.49213305337 -34.6362919177267,-58.4917755871123 -34.6362065781696,-58.4910633835943 -34.6360365995219,-58.48967145076 -34.6357042988617,-58.4894258716 -34.6356449143733,-58.4891189632188 -34.6369851654396,-58.4906823679424 -34.6373692657632,-58.4909617848673 -34.6374427952518,-58.4917119266982 -34.6376400902533,-58.4919024673356 -34.6376925112531,-58.4922708483035 -34.6377827070808,-58.493319784803 -34.6369635486664,-58.4931162336335 -34.636513373804,-58.49213305337 -34.6362919177267)))";;"331";10_14_10;COMUNA 10;"14";"10";"839";"379";"460";"82,39%";"439";"439";"100,00%";"0";"0,00%";"341";"3";"0.88";"338";"99,12%";"0.88";0.880
"MULTIPOLYGON (((-58.4894258716 -34.6356449143733,-58.4876489694852 -34.6352155585213,-58.4873360069197 -34.636343475631,-58.4873143856345 -34.6364141865088,-58.4872803363524 -34.6365257462781,-58.4881798353798 -34.6367504985206,-58.4891189632188 -34.6369851654396,-58.4894258716 -34.6356449143733)))";;"332";10_14_11;COMUNA 10;"14";"11";"709";"339";"370";"91,62%";"301";"301";"100,00%";"0";"0,00%";"267";"68";"25.47";"199";"74,53%";"25.47";25.470
"MULTIPOLYGON (((-58.4982127851749 -34.6280684079703,-58.4979194289604 -34.6278120759354,-58.4975089719707 -34.6274535196828,-58.4969513713066 -34.6278906641074,-58.4964298769789 -34.6282995555877,-58.4962776776889 -34.628418897367,-58.4958754163813 -34.6287343701464,-58.4954068883418 -34.6291016216691,-58.4948747322925 -34.6295188898443,-58.4955167164247 -34.6299870443155,-58.4956994310559 -34.6301086892202,-58.4960323071481 -34.6303303666625,-58.4962033361626 -34.6304151817857,-58.4963983953196 -34.6302980818997,-58.4971729516117 -34.6297046062213,-58.4979285596973 -34.6302655358079,-58.4980808624232 -34.6303874676177,-58.4989306054938 -34.6297191677277,-58.4990493321998 -34.6296270166508,-58.4995452732431 -34.6292423479465,-58.498336793062 -34.6281767557335,-58.4982127851749 -34.6280684079703)))";;"333";10_14_2;COMUNA 10;"14";"2";"925";"449";"476";"94,33%";"376";"376";"100,00%";"0";"0,00%";"315";"10";"3.17";"305";"96,83%";"3.17";3.170
"MULTIPOLYGON (((-58.499479936167 -34.6315813891782,-58.499271333874 -34.6315099002389,-58.4985863063029 -34.6312753072,-58.4974443721033 -34.6308772443302,-58.4964035947951 -34.6305144961196,-58.4962033361626 -34.6304151817857,-58.4960323071481 -34.6303303666625,-58.4956994310559 -34.6301086892202,-58.4955167164247 -34.6299870443155,-58.4948747322925 -34.6295188898443,-58.4947738023805 -34.6295974401787,-58.4946147848858 -34.6297231198917,-58.494349130049 -34.6299330552755,-58.4935799244005 -34.6305408783273,-58.4946572087664 -34.630820891846,-58.4947792310533 -34.6308630443152,-58.4949550217591 -34.6309237746219,-58.4953683920093 -34.6310913462314,-58.4965588326575 -34.631573995335,-58.4982762614138 -34.6322702196527,-58.4989856012842 -34.6325566398549,-58.4997008698436 -34.6319847159735,-58.4999773390034 -34.6317765263235,-58.499479936167 -34.6315813891782)))";;"334";10_14_3;COMUNA 10;"14";"3";"813";"371";"442";"83,94%";"408";"408";"100,00%";"0";"0,00%";"322";"3";"0.93";"319";"99,07%";"0.93";0.930
"MULTIPOLYGON (((-58.4945336396268 -34.6320819518539,-58.4944668833876 -34.6324140224702,-58.4943104073428 -34.6331904267023,-58.4947045720633 -34.6332409593764,-58.4957758737994 -34.6333770160657,-58.4960849185568 -34.6334162993551,-58.4972460332661 -34.6335643611578,-58.4976406274521 -34.6336146729432,-58.4983146091922 -34.6330845310405,-58.4989362864746 -34.6325954586107,-58.4989856012842 -34.6325566398549,-58.4982762614138 -34.6322702196527,-58.4965588326575 -34.631573995335,-58.4953683920093 -34.6310913462314,-58.4949550217591 -34.6309237746219,-58.4947792310533 -34.6308630443152,-58.494660943013 -34.6314494328511,-58.4946422343955 -34.6315419760285,-58.4945336396268 -34.6320819518539)))";;"335";10_14_4;COMUNA 10;"14";"4";"832";"400";"432";"92,59%";"364";"364";"100,00%";"0";"0,00%";"296";"1";"0.34";"295";"99,66%";"0.34";0.340
"MULTIPOLYGON (((-58.4947792310533 -34.6308630443152,-58.4946572087664 -34.630820891846,-58.4935799244005 -34.6305408783273,-58.4929951979594 -34.6310029417271,-58.4925728962289 -34.6313366485059,-58.4923504132744 -34.6315058633288,-58.4922516073911 -34.6315810306419,-58.4921805647495 -34.6318631698464,-58.491988748813 -34.6317810302405,-58.4918409648114 -34.6318933932972,-58.4910180617587 -34.6325480453546,-58.4907793910431 -34.6327378955196,-58.4919233608162 -34.6328845330387,-58.4928923215271 -34.6330087377437,-58.4934770905305 -34.6330836644784,-58.4943104073428 -34.6331904267023,-58.4944668833876 -34.6324140224702,-58.4945336396268 -34.6320819518539,-58.4946422343955 -34.6315419760285,-58.494660943013 -34.6314494328511,-58.4947792310533 -34.6308630443152)))";;"336";10_14_5;COMUNA 10;"14";"5";"719";"330";"389";"84,83%";"312";"312";"100,00%";"0";"0,00%";"262";"1";"0.38";"261";"99,62%";"0.38";0.380
"MULTIPOLYGON (((-58.490154940852 -34.6332346033092,-58.489447431664 -34.6337971029094,-58.4893344814495 -34.6338869193005,-58.4890776593088 -34.6340909958757,-58.4889098491806 -34.6342181488857,-58.4898032459355 -34.6343435915384,-58.491489161506 -34.6345802552388,-58.4914735038389 -34.6346375847475,-58.4914607864316 -34.634684273768,-58.4914102670939 -34.6348837033161,-58.4924312350373 -34.6350107196974,-58.4924851775586 -34.6347791070703,-58.4925762859174 -34.6343749166713,-58.492618566435 -34.634192294707,-58.4927548494351 -34.6336030165591,-58.4928923215271 -34.6330087377437,-58.4919233608162 -34.6328845330387,-58.4907793910431 -34.6327378955196,-58.490154940852 -34.6332346033092)))";;"337";10_14_6;COMUNA 10;"14";"6";"593";"283";"310";"91,29%";"243";"243";"100,00%";"0";"0,00%";"205";"2";"0.98";"203";"99,02%";"0.98";0.980
"MULTIPOLYGON (((-58.4955971301651 -34.6352102345808,-58.4955997384648 -34.6352091337512,-58.4955972623457 -34.6352101310045,-58.4955986965929 -34.6352090071329,-58.4960872784785 -34.6348405706157,-58.4963108673739 -34.6346638837318,-58.4971614334527 -34.6339917230251,-58.4976406274521 -34.6336146729432,-58.4972460332661 -34.6335643611578,-58.4960849185568 -34.6334162993551,-58.4957758737994 -34.6333770160657,-58.4947045720633 -34.6332409593764,-58.4943104073428 -34.6331904267023,-58.4934770905305 -34.6330836644784,-58.4928923215271 -34.6330087377437,-58.4927548494351 -34.6336030165591,-58.492618566435 -34.634192294707,-58.4925762859174 -34.6343749166713,-58.4924851775586 -34.6347791070703,-58.4924312350373 -34.6350107196974,-58.4924312350611 -34.6350107863617,-58.4925217315673 -34.6350215708246,-58.4938210645585 -34.6351723074585,-58.4939159000042 -34.6351807342023,-58.4940092030632 -34.6351925416573,-58.4953947878809 -34.6353687888936,-58.4955971301651 -34.6352102345808)))";;"338";10_14_7;COMUNA 10;"14";"7";"835";"385";"450";"85,56%";"301";"301";"100,00%";"0";"0,00%";"291";"18";"6.19";"273";"93,81%";"6.19";6.190
"MULTIPOLYGON (((-58.4923517801902 -34.6353473270803,-58.4923244715727 -34.6354654361451,-58.49213305337 -34.6362919177267,-58.4931162336335 -34.636513373804,-58.4936613337183 -34.6366209161785,-58.4937992061653 -34.6366467270054,-58.4945660740662 -34.6360212975711,-58.4947601126888 -34.635869129116,-58.49539690873 -34.6353697185132,-58.4953947878809 -34.6353687888936,-58.4940092030632 -34.6351925416573,-58.4939159000042 -34.6351807342023,-58.4938210645585 -34.6351723074585,-58.4925217315673 -34.6350215708246,-58.4924312350611 -34.6350107863617,-58.4923517801902 -34.6353473270803)))";;"339";10_14_8;COMUNA 10;"14";"8";"599";"282";"317";"88,96%";"310";"310";"100,00%";"0";"0,00%";"253";"10";"3.95";"243";"96,05%";"3.95";3.950
"MULTIPOLYGON (((-58.4910633835943 -34.6360365995219,-58.4917755871123 -34.6362065781696,-58.49213305337 -34.6362919177267,-58.4923244715727 -34.6354654361451,-58.4923517801902 -34.6353473270803,-58.4924312350611 -34.6350107863617,-58.4924312350373 -34.6350107196974,-58.4914102670939 -34.6348837033161,-58.4914607864316 -34.634684273768,-58.4914735038389 -34.6346375847475,-58.491489161506 -34.6345802552388,-58.4898032459355 -34.6343435915384,-58.4889098491806 -34.6342181488857,-58.4887145243621 -34.6343661532855,-58.4885961193011 -34.6344551250501,-58.4885135772272 -34.6345200038204,-58.4884252424187 -34.6345888979716,-58.4883171449081 -34.6346730783992,-58.4876489694852 -34.6352155585213,-58.4894258716 -34.6356449143733,-58.48967145076 -34.6357042988617,-58.4910633835943 -34.6360365995219)))";;"340";10_14_9;COMUNA 10;"14";"9";"887";"407";"480";"84,79%";"388";"388";"100,00%";"0";"0,00%";"337";"18";"5.34";"319";"94,66%";"5.34";5.340
"MULTIPOLYGON (((-58.501865927497 -34.6329257611295,-58.5016215338657 -34.6341286956736,-58.5028435082498 -34.6342866850553,-58.5029901523068 -34.6343056514067,-58.5041976479085 -34.6344648996439,-58.5054573000725 -34.6346384138879,-58.5051233816577 -34.6342933783962,-58.5050713803239 -34.634239662325,-58.5045741314717 -34.6337257327498,-58.5042572807627 -34.6335914705244,-58.5038875092886 -34.6334348302548,-58.5035942655553 -34.6333081642088,-58.5033955318565 -34.6332223123683,-58.5024081757741 -34.6327958632275,-58.501865927497 -34.6329257611295)))";;"341";10_15_1;COMUNA 10;"15";"1";"633";"289";"344";"84,01%";"304";"304";"100,00%";"0";"0,00%";"263";"12";"4.56";"251";"95,44%";"4.56";4.560
"MULTIPOLYGON (((-58.4999773390034 -34.6317765263235,-58.4997008698436 -34.6319847159735,-58.4989856012842 -34.6325566398549,-58.4989362864746 -34.6325954586107,-58.4987057193901 -34.6337516916137,-58.5001649014453 -34.6339403428191,-58.5016215338657 -34.6341286956736,-58.501865927497 -34.6329257611295,-58.5024081757741 -34.6327958632275,-58.5011741227085 -34.6322628608945,-58.5010421206422 -34.632207759798,-58.5005527175061 -34.6320035397211,-58.4999773390034 -34.6317765263235)))";;"342";10_15_2;COMUNA 10;"15";"2";"918";"403";"515";"78,25%";"417";"417";"100,00%";"0";"0,00%";"347";"10";"2.88";"337";"97,12%";"2.88";2.880
"MULTIPOLYGON (((-58.4989362864746 -34.6325954586107,-58.4983146091922 -34.6330845310405,-58.4976406274521 -34.6336146729432,-58.4971614334527 -34.6339917230251,-58.4963108673739 -34.6346638837318,-58.4960872784785 -34.6348405706157,-58.4955969909555 -34.635210293334,-58.4955970450241 -34.635210301297,-58.4953947878809 -34.6353687888936,-58.49539690873 -34.6353697185132,-58.4955590629609 -34.6353956616942,-58.4968487020707 -34.6355662284719,-58.4969274352913 -34.6355763475763,-58.496955237905 -34.6354321097374,-58.497759932806 -34.6354887139067,-58.4977728561472 -34.6354227925583,-58.497949155252 -34.6354489397672,-58.4979613985306 -34.6353871032346,-58.4982923505192 -34.6354291915724,-58.4982077521772 -34.6358518355704,-58.4981744227397 -34.6360183295334,-58.4982520425414 -34.6360135884697,-58.4990822603859 -34.6359669336866,-58.4996328039644 -34.6360434608388,-58.4996400288812 -34.6360039503299,-58.4997403212358 -34.636017441477,-58.4997543495037 -34.6359487025966,-58.499770929071 -34.6358691175168,-58.4999225251294 -34.6351431322987,-58.4984650256367 -34.6349521537249,-58.4984907019101 -34.6348233391831,-58.498683529432 -34.6338627581352,-58.4987057193901 -34.6337516916137,-58.4989362864746 -34.6325954586107)))";;"343";10_15_3;COMUNA 10;"15";"3";"557";"265";"292";"90,75%";"247";"247";"100,00%";"0";"0,00%";"202";"15";"7.43";"187";"92,57%";"7.43";7.430
"MULTIPOLYGON (((-58.4999225251294 -34.6351431322987,-58.499770929071 -34.6358691175168,-58.4998554584045 -34.6358826837845,-58.4999302600345 -34.6354827184316,-58.5003007526937 -34.6355345078673,-58.5002932715001 -34.635571764903,-58.5009498121141 -34.6356567748012,-58.5009629080234 -34.6356009942372,-58.5012151284286 -34.6356326764429,-58.501312440319 -34.6356502518787,-58.5013770482844 -34.6353322633456,-58.5016215338657 -34.6341286956736,-58.5001649014453 -34.6339403428191,-58.4987057193901 -34.6337516916137,-58.498683529432 -34.6338627581352,-58.4984907019101 -34.6348233391831,-58.4984650256367 -34.6349521537249,-58.4999225251294 -34.6351431322987)))";;"344";10_15_4;COMUNA 10;"15";"4";"676";"313";"363";"86,23%";"301";"301";"100,00%";"0";"0,00%";"247";"2";"0.81";"245";"99,19%";"0.81";0.810
"MULTIPOLYGON (((-58.5028435082498 -34.6342866850553,-58.5016215338657 -34.6341286956736,-58.5013770482844 -34.6353322633456,-58.501312440319 -34.6356502518787,-58.5012151284286 -34.6356326764429,-58.5009629080234 -34.6356009942372,-58.5009498121141 -34.6356567748012,-58.5002932715001 -34.635571764903,-58.5003007526937 -34.6355345078673,-58.4999302600345 -34.6354827184316,-58.4998554584045 -34.6358826837845,-58.499770929071 -34.6358691175168,-58.4997543495037 -34.6359487025966,-58.4997403212358 -34.636017441477,-58.4998266400843 -34.6360311480704,-58.4998109989869 -34.636113409013,-58.5004823733722 -34.6362078538289,-58.5006210968585 -34.6362283043961,-58.5006106389434 -34.6362773937407,-58.5010986328368 -34.636327101845,-58.5011790676902 -34.636329189239,-58.5012131502657 -34.6363300940038,-58.5012542159358 -34.6363228976988,-58.5012713499753 -34.6363396533861,-58.5017455439506 -34.6363949268247,-58.5018760011067 -34.6364110826964,-58.5022115600272 -34.6364527363615,-58.5023063192626 -34.6364752415651,-58.5023917896679 -34.6364946510266,-58.502621602024 -34.6365216895711,-58.5028082130842 -34.6365441642845,-58.5031125873637 -34.6365850510477,-58.503201980131 -34.6366098109265,-58.503554069417 -34.6366494130862,-58.5035610360459 -34.636608141816,-58.5036440311036 -34.6366177621806,-58.5036369781675 -34.6366567094659,-58.5036725097811 -34.6366583877298,-58.5037723732397 -34.6366631430275,-58.503957110399 -34.6366856166133,-58.5042891772844 -34.6367257868199,-58.5045521381084 -34.6367571063303,-58.5046213279231 -34.636762434853,-58.5048052990336 -34.6367856116648,-58.5048972408472 -34.6367948759633,-58.5049925911658 -34.6368046319841,-58.5053682872216 -34.6368502068244,-58.5054914459929 -34.6367548084917,-58.5056063112242 -34.6367699094694,-58.5056715142955 -34.6367184603674,-58.5057355158279 -34.6366679592552,-58.5058695748289 -34.63656213382,-58.506443367383 -34.6361092387041,-58.5068193910146 -34.6358124035246,-58.5065516463584 -34.6355916478618,-58.5062178409145 -34.6353157725572,-58.5058598228027 -34.6350072277778,-58.5054573000725 -34.6346384138879,-58.5041976479085 -34.6344648996439,-58.5029901523068 -34.6343056514067,-58.5028435082498 -34.6342866850553)))";;"345";10_15_5;COMUNA 10;"15";"5";"820";"425";"395";"107,59%";"357";"357";"100,00%";"0";"0,00%";"298";"0";"0";"298";"100,00%";"0";0.000
"MULTIPOLYGON (((-58.5034188296531 -34.638006755446,-58.5039392285917 -34.6380858084801,-58.5047040848042 -34.6374821478363,-58.5050376199432 -34.6372188550422,-58.5054421008646 -34.6368995487653,-58.5056063112242 -34.6367699094694,-58.5054914459929 -34.6367548084917,-58.5053682872216 -34.6368502068244,-58.5049925911658 -34.6368046319841,-58.5048972408472 -34.6367948759633,-58.5048052990336 -34.6367856116648,-58.5046213279231 -34.636762434853,-58.5045521381084 -34.6367571063303,-58.5042891772844 -34.6367257868199,-58.503957110399 -34.6366856166133,-58.5037723732397 -34.6366631430275,-58.5036725097811 -34.6366583877298,-58.5036369781675 -34.6366567094659,-58.5036440311036 -34.6366177621806,-58.5035610360459 -34.636608141816,-58.503554069417 -34.6366494130862,-58.503201980131 -34.6366098109265,-58.5031125873637 -34.6365850510477,-58.5028082130842 -34.6365441642845,-58.502621602024 -34.6365216895711,-58.5023917896679 -34.6364946510266,-58.5023063192626 -34.6364752415651,-58.5022115600272 -34.6364527363615,-58.5018760011067 -34.6364110826964,-58.5017455439506 -34.6363949268247,-58.5012713499753 -34.6363396533861,-58.5012542159358 -34.6363228976988,-58.5012131502657 -34.6363300940038,-58.5011790676902 -34.636329189239,-58.5011033236811 -34.636706690084,-58.5009209859534 -34.6376411436162,-58.5020487729879 -34.6378018464743,-58.5023972928747 -34.6378515238609,-58.5034188296531 -34.638006755446)))";;"346";10_15_6;COMUNA 10;"15";"6";"613";"273";"340";"80,29%";"324";"323";"99,69%";"1";"0,31%";"248";"10";"4.03";"238";"95,97%";"4.03";4.030
"MULTIPOLYGON (((-58.4994584912929 -34.6374338400205,-58.4996814051578 -34.637464477844,-58.5009209859534 -34.6376411436162,-58.5011033236811 -34.636706690084,-58.5011790676902 -34.636329189239,-58.5010986328368 -34.636327101845,-58.5006106389434 -34.6362773937407,-58.5006210968585 -34.6362283043961,-58.5004823733722 -34.6362078538289,-58.4998109989869 -34.636113409013,-58.4998266400843 -34.6360311480704,-58.4997403212358 -34.636017441477,-58.4996400288812 -34.6360039503299,-58.4996328039644 -34.6360434608388,-58.4990822603859 -34.6359669336866,-58.4982520425414 -34.6360135884697,-58.4981885294922 -34.6363308707494,-58.4980074249115 -34.6372344735725,-58.4994584912929 -34.6374338400205)))";;"347";10_15_7;COMUNA 10;"15";"7";"526";"254";"272";"93,38%";"285";"285";"100,00%";"0";"0,00%";"225";"15";"6.67";"210";"93,33%";"6.67";6.670
"MULTIPOLYGON (((-58.493319784803 -34.6369635486664,-58.4922708483035 -34.6377827070808,-58.4933808931887 -34.6379315926026,-58.4936188888543 -34.6379650547014,-58.4942131526478 -34.638043567093,-58.4948426104776 -34.6381281238496,-58.4963115757456 -34.6383208326335,-58.4965566210209 -34.637034948929,-58.4967401660239 -34.6370619409637,-58.4978184263627 -34.6372085413885,-58.4980074249115 -34.6372344735725,-58.4981885294922 -34.6363308707494,-58.4982520425414 -34.6360135884697,-58.4981744227397 -34.6360183295334,-58.4982077521772 -34.6358518355704,-58.4982923505192 -34.6354291915724,-58.4979613985306 -34.6353871032346,-58.497949155252 -34.6354489397672,-58.4977728561472 -34.6354227925583,-58.497759932806 -34.6354887139067,-58.496955237905 -34.6354321097374,-58.4969274352913 -34.6355763475763,-58.4968487020707 -34.6355662284719,-58.4955590629609 -34.6353956616942,-58.49539690873 -34.6353697185132,-58.4947601126888 -34.635869129116,-58.4945660740662 -34.6360212975711,-58.4937992061653 -34.6366467270054,-58.4936613337183 -34.6366209161785,-58.4931162336335 -34.636513373804,-58.493319784803 -34.6369635486664)))";;"348";10_15_8;COMUNA 10;"15";"8";"1073";"517";"556";"92,99%";"384";"383";"99,74%";"1";"0,26%";"375";"27";"7.2";"348";"92,80%";"7.2";7.200
"MULTIPOLYGON (((-58.4980074249115 -34.6372344735725,-58.4978184263627 -34.6372085413885,-58.4967401660239 -34.6370619409637,-58.4965566210209 -34.637034948929,-58.4963115757456 -34.6383208326335,-58.4977895806915 -34.6385156338593,-58.497803072592 -34.638382456705,-58.4980074249115 -34.6372344735725)))";;"349";10_15_9;COMUNA 10;"15";"9";"1223";"566";"657";"86,15%";"544";"544";"100,00%";"0";"0,00%";"459";"31";"6.75";"428";"93,25%";"6.75";6.750
"MULTIPOLYGON (((-58.5089583308736 -34.6378835087001,-58.5091353315275 -34.6371804476558,-58.5090558095391 -34.6371691083799,-58.5087988125882 -34.6371349993839,-58.5085552907771 -34.6371016802783,-58.5083069568434 -34.6370683624858,-58.5080730604857 -34.6370358343149,-58.5078314641782 -34.6370025130469,-58.5077702079397 -34.6369943889751,-58.5075802434413 -34.6369691948421,-58.5073453856085 -34.6369374611265,-58.5071037907237 -34.6369057294114,-58.506853533029 -34.6368724093583,-58.5065946121302 -34.6368367054161,-58.5063703429418 -34.6368065570064,-58.5063542769057 -34.6368050059904,-58.5062307791243 -34.6367930834355,-58.5059776347357 -34.6367597626146,-58.5057812789466 -34.6367327852045,-58.5056715142955 -34.6367184603674,-58.5056063112242 -34.6367699094694,-58.5054421008646 -34.6368995487653,-58.5050376199432 -34.6372188550422,-58.5047040848042 -34.6374821478363,-58.5039392285917 -34.6380858084801,-58.5045150175081 -34.6381733617134,-58.5046351689658 -34.6381916309044,-58.5059331569649 -34.638404494373,-58.5073497750626 -34.6386440620616,-58.5087004494923 -34.6388821592527,-58.5089583308736 -34.6378835087001)))";;"350";10_16_1;COMUNA 10;"16";"1";"671";"308";"363";"84,85%";"303";"302";"99,67%";"1";"0,33%";"270";"27";"10";"243";"90,00%";"10";10.000
"MULTIPOLYGON (((-58.510052663372 -34.6391167196365,-58.5103155566499 -34.6381183460122,-58.5104935649626 -34.637369858269,-58.5102445480707 -34.6373349098035,-58.5099971752363 -34.6373015950797,-58.5097623146526 -34.6372682750263,-58.5095178287096 -34.6372333672201,-58.5092839318633 -34.6372016368706,-58.5091353315275 -34.6371804476558,-58.5089583308736 -34.6378835087001,-58.5087004494923 -34.6388821592527,-58.5073497750626 -34.6386440620616,-58.5059331569649 -34.638404494373,-58.5057063616423 -34.6392822785887,-58.505692670384 -34.6393351724215,-58.5056939310871 -34.6393360636441,-58.5059378291135 -34.6394347933914,-58.5060442379817 -34.6394729826279,-58.5069953274525 -34.6396369693771,-58.5081375540964 -34.6398401202386,-58.5082367450922 -34.6398486225124,-58.5083321715501 -34.6398325818562,-58.5084411686754 -34.6398195378859,-58.5084413353752 -34.6398195400138,-58.5084416552922 -34.6398197100355,-58.5087502953109 -34.6399466312794,-58.5097251813224 -34.6401259628685,-58.5097885497402 -34.6400776974548,-58.5098222533481 -34.640008316044,-58.510052663372 -34.6391167196365)))";;"351";10_16_2;COMUNA 10;"16";"2";"1077";"492";"585";"84,10%";"482";"482";"100,00%";"0";"0,00%";"408";"15";"3.68";"393";"96,32%";"3.68";3.680
"MULTIPOLYGON (((-58.5059331569649 -34.638404494373,-58.5046351689658 -34.6381916309044,-58.5045150175081 -34.6381733617134,-58.5039392285917 -34.6380858084801,-58.503019170125 -34.6388081814364,-58.5042924591344 -34.6390328314436,-58.5057063616423 -34.6392822785887,-58.5059331569649 -34.638404494373)))";;"352";10_16_3;COMUNA 10;"16";"3";"778";"361";"417";"86,57%";"331";"330";"99,70%";"1";"0,30%";"282";"12";"4.26";"270";"95,74%";"4.26";4.260
"MULTIPOLYGON (((-58.505692670384 -34.6393351724215,-58.5057063616423 -34.6392822785887,-58.5042924591344 -34.6390328314436,-58.503019170125 -34.6388081814364,-58.5025943121198 -34.6391405148357,-58.5018192868282 -34.6397469119235,-58.5024715836227 -34.6403300292945,-58.5025853032965 -34.6404349250533,-58.5032048847235 -34.6410069220161,-58.5033567107024 -34.6411434955205,-58.5034847246211 -34.641026688534,-58.5043261019898 -34.6403683553111,-58.5045347904169 -34.6402191946795,-58.5047300199102 -34.6400796865194,-58.505692670384 -34.6393351724215)))";;"353";10_16_4;COMUNA 10;"16";"4";"873";"403";"470";"85,74%";"413";"413";"100,00%";"0";"0,00%";"344";"2";"0.58";"342";"99,42%";"0.58";0.580
"MULTIPOLYGON (((-58.5069953274525 -34.6396369693771,-58.5060442379817 -34.6394729826279,-58.5059378291135 -34.6394347933914,-58.5056939310871 -34.6393360636441,-58.505692670384 -34.6393351724215,-58.5047300199102 -34.6400796865194,-58.5045347904169 -34.6402191946795,-58.5046712785057 -34.6403539407813,-58.5053232617225 -34.6409420430982,-58.5060859948851 -34.6416300352375,-58.5068474618778 -34.6423168961865,-58.5069656027368 -34.6422274843675,-58.5080317523436 -34.6414156588212,-58.5092106509011 -34.6405178627024,-58.5097251813224 -34.6401259628685,-58.5087502953109 -34.6399466312794,-58.5084416552922 -34.6398197100355,-58.5084413353752 -34.6398195400138,-58.5084411686754 -34.6398195378859,-58.5083321715501 -34.6398325818562,-58.5082367450922 -34.6398486225124,-58.5081375540964 -34.6398401202386,-58.5069953274525 -34.6396369693771)))";;"354";10_16_5;COMUNA 10;"16";"5";"1051";"460";"591";"77,83%";"500";"499";"99,80%";"1";"0,20%";"389";"5";"1.29";"384";"98,71%";"1.29";1.290
"MULTIPOLYGON (((-58.5033567107024 -34.6411434955205,-58.5032297185043 -34.6412593865093,-58.5022207658356 -34.6420286150463,-58.502941996277 -34.6427396690631,-58.5037044695855 -34.6434255632393,-58.5044707065339 -34.6441148316638,-58.505659821047 -34.6432153061192,-58.5068474618778 -34.6423168961865,-58.5060859948851 -34.6416300352375,-58.5053232617225 -34.6409420430982,-58.5046712785057 -34.6403539407813,-58.5045347904169 -34.6402191946795,-58.5043261019898 -34.6403683553111,-58.5034847246211 -34.641026688534,-58.5033567107024 -34.6411434955205)))";;"355";10_16_6;COMUNA 10;"16";"6";"1006";"488";"518";"94,21%";"429";"428";"99,77%";"1";"0,23%";"356";"4";"1.12";"352";"98,88%";"1.12";1.120
"MULTIPOLYGON (((-58.5033567107024 -34.6411434955205,-58.5032048847235 -34.6410069220161,-58.5025853032965 -34.6404349250533,-58.5024715836227 -34.6403300292945,-58.5018192868282 -34.6397469119235,-58.5016618783982 -34.63987006481,-58.5011881170675 -34.6402406495175,-58.5006583887002 -34.6406551244217,-58.5002905825714 -34.6409429234847,-58.4998196200117 -34.641311318785,-58.4994888619289 -34.6415700186973,-58.4998720383576 -34.6419153358966,-58.5002556442112 -34.6422610742876,-58.5008909025203 -34.6428336414049,-58.5010159608253 -34.6429471972744,-58.5022207658356 -34.6420286150463,-58.5032297185043 -34.6412593865093,-58.5033567107024 -34.6411434955205)))";;"356";10_16_7;COMUNA 10;"16";"7";"782";"374";"408";"91,67%";"348";"347";"99,71%";"1";"0,29%";"289";"0";"0";"289";"100,00%";"0";0.000
"MULTIPOLYGON (((-58.5038435999225 -34.6445887919171,-58.5043493234065 -34.644206636588,-58.5044707065339 -34.6441148316638,-58.5037044695855 -34.6434255632393,-58.502941996277 -34.6427396690631,-58.5022207658356 -34.6420286150463,-58.5010159608253 -34.6429471972744,-58.5014544774741 -34.6433454514162,-58.5016457757154 -34.6435191987037,-58.5017680206196 -34.6436254305154,-58.5012716734823 -34.6440317983184,-58.500782221266 -34.6444325983702,-58.5002489804617 -34.6448692561018,-58.5012751815462 -34.6453507112456,-58.5022995130934 -34.6458181438034,-58.5028357309068 -34.6453797860025,-58.5033273091161 -34.6449789066397,-58.5038435999225 -34.6445887919171)))";;"357";10_16_8;COMUNA 10;"16";"8";"853";"401";"452";"88,72%";"370";"370";"100,00%";"0";"0,00%";"312";"1";"0.32";"311";"99,68%";"0.32";0.320
"MULTIPOLYGON (((-58.4984733204974 -34.6423645006747,-58.4971376351116 -34.643409424841,-58.4981861305205 -34.6439013226673,-58.4992217684553 -34.6443872996104,-58.499663267006 -34.6445944265321,-58.5002489804617 -34.6448692561018,-58.500782221266 -34.6444325983702,-58.5012716734823 -34.6440317983184,-58.5017680206196 -34.6436254305154,-58.5016457757154 -34.6435191987037,-58.5014544774741 -34.6433454514162,-58.5010159608253 -34.6429471972744,-58.5008909025203 -34.6428336414049,-58.5002556442112 -34.6422610742876,-58.4998720383576 -34.6419153358966,-58.4994888619289 -34.6415700186973,-58.4985406149924 -34.6423118736344,-58.4984733204974 -34.6423645006747)))";;"358";10_16_9;COMUNA 10;"16";"9";"953";"442";"511";"86,50%";"400";"400";"100,00%";"0";"0,00%";"338";"13";"3.85";"325";"96,15%";"3.85";3.850
"MULTIPOLYGON (((-58.5034188296531 -34.638006755446,-58.5023972928747 -34.6378515238609,-58.5020487729879 -34.6378018464743,-58.5018195503175 -34.6390378047824,-58.5006812708703 -34.6388868921555,-58.5004432558203 -34.6401392593734,-58.5002905825714 -34.6409429234847,-58.5006583887002 -34.6406551244217,-58.5011881170675 -34.6402406495175,-58.5016618783982 -34.63987006481,-58.5018192868282 -34.6397469119235,-58.5025943121198 -34.6391405148357,-58.503019170125 -34.6388081814364,-58.5039392285917 -34.6380858084801,-58.5034188296531 -34.638006755446)))";;"359";10_17_1;COMUNA 10;"17";"1";"748";"336";"412";"81,55%";"391";"391";"100,00%";"0";"0,00%";"313";"0";"0";"313";"100,00%";"0";0.000
"MULTIPOLYGON (((-58.4909546640798 -34.6425753541676,-58.490647385185 -34.6425598611041,-58.4905860526609 -34.6426194544744,-58.4908788879667 -34.6427597436686,-58.4916361224254 -34.64312267629,-58.4923317441451 -34.643455970361,-58.493665134119 -34.6440948843277,-58.4948407842989 -34.6446582595984,-58.4949640150642 -34.6446878054385,-58.4950820569547 -34.6447407335372,-58.495302206673 -34.6448479317207,-58.4953984679731 -34.6447698753652,-58.4964198607047 -34.6439708400635,-58.4966769521605 -34.6437697765428,-58.4971376351116 -34.643409424841,-58.4967593673637 -34.6433877698301,-58.4953744948243 -34.6431778604907,-58.4938905218466 -34.6429528899082,-58.4926034270778 -34.642813207924,-58.4924214899159 -34.6427866318489,-58.4909546640798 -34.6425753541676)))";;"360";10_17_10;COMUNA 10;"17";"10";"741";"346";"395";"87,59%";"326";"326";"100,00%";"0";"0,00%";"269";"6";"2.23";"263";"97,77%";"2.23";2.230
"MULTIPOLYGON (((-58.5020487729879 -34.6378018464743,-58.5009209859534 -34.6376411436162,-58.4996814051578 -34.637464477844,-58.4994584912929 -34.6374338400205,-58.4992248141332 -34.6387011339105,-58.4989898399955 -34.6399414547909,-58.5004432558203 -34.6401392593734,-58.5006812708703 -34.6388868921555,-58.5018195503175 -34.6390378047824,-58.5020487729879 -34.6378018464743)))";;"361";10_17_2;COMUNA 10;"17";"2";"844";"405";"439";"92,26%";"456";"456";"100,00%";"0";"0,00%";"372";"7";"1.88";"365";"98,12%";"1.88";1.880
"MULTIPOLYGON (((-58.4994584912929 -34.6374338400205,-58.4980074249115 -34.6372344735725,-58.497803072592 -34.638382456705,-58.4977895806915 -34.6385156338593,-58.4977748159685 -34.6386614878365,-58.4975429072855 -34.6397444761242,-58.4972810567291 -34.6409673358447,-58.4987574941799 -34.6411674075414,-58.4998196200117 -34.641311318785,-58.5002905825714 -34.6409429234847,-58.5004432558203 -34.6401392593734,-58.4989898399955 -34.6399414547909,-58.4992248141332 -34.6387011339105,-58.4994584912929 -34.6374338400205)))";;"362";10_17_3;COMUNA 10;"17";"3";"944";"437";"507";"86,19%";"436";"436";"100,00%";"0";"0,00%";"360";"4";"1.11";"356";"98,89%";"1.11";1.110
"MULTIPOLYGON (((-58.4977895806915 -34.6385156338593,-58.4963115757456 -34.6383208326335,-58.4962890417465 -34.6384348565734,-58.4960653898243 -34.6395433335919,-58.4975429072855 -34.6397444761242,-58.4977748159685 -34.6386614878365,-58.4977895806915 -34.6385156338593)))";;"363";10_17_4;COMUNA 10;"17";"4";"1083";"519";"564";"92,02%";"445";"445";"100,00%";"0";"0,00%";"378";"0";"0";"378";"100,00%";"0";0.000
"MULTIPOLYGON (((-58.4963115757456 -34.6383208326335,-58.4948426104776 -34.6381281238496,-58.4942131526478 -34.638043567093,-58.4936188888543 -34.6379650547014,-58.4933808931887 -34.6379315926026,-58.493139263409 -34.639145213076,-58.4930664046705 -34.6395972174594,-58.4926901195422 -34.6400613393931,-58.4925253866097 -34.6402336387741,-58.4924323607617 -34.6402975367524,-58.4924918399277 -34.6403058323597,-58.4928920013968 -34.640355031288,-58.4943630505166 -34.6405583970843,-58.4958214136065 -34.6407694952976,-58.4972810567291 -34.6409673358447,-58.4975429072855 -34.6397444761242,-58.4960653898243 -34.6395433335919,-58.4962890417465 -34.6384348565734,-58.4963115757456 -34.6383208326335)))";;"364";10_17_5;COMUNA 10;"17";"5";"1061";"497";"564";"88,12%";"368";"368";"100,00%";"0";"0,00%";"367";"29";"7.9";"338";"92,10%";"7.9";7.900
"MULTIPOLYGON (((-58.4914357031084 -34.6401587571661,-58.4924323607617 -34.6402975367524,-58.4925253866097 -34.6402336387741,-58.4926901195422 -34.6400613393931,-58.4930664046705 -34.6395972174594,-58.493139263409 -34.639145213076,-58.4933808931887 -34.6379315926026,-58.4922708483035 -34.6377827070808,-58.4918236342372 -34.6381319103959,-58.4909114763021 -34.6388441898345,-58.4903872425299 -34.639253618803,-58.4900592756262 -34.6395136306721,-58.4895667251618 -34.639904245545,-58.4887381020794 -34.6405613475095,-58.488231056872 -34.6409629462801,-58.4897318449167 -34.6411698125019,-58.4910320452541 -34.6413487483828,-58.4912149154505 -34.6413732840018,-58.4914357031084 -34.6401587571661)))";;"365";10_17_6;COMUNA 10;"17";"6";"872";"405";"467";"86,72%";"372";"372";"100,00%";"0";"0,00%";"308";"10";"3.25";"298";"96,75%";"3.25";3.250
"MULTIPOLYGON (((-58.490647385185 -34.6425598611041,-58.4909546640798 -34.6425753541676,-58.4924214899159 -34.6427866318489,-58.4926034270778 -34.642813207924,-58.4938905218466 -34.6429528899082,-58.4941259390154 -34.6417597639079,-58.4942730714116 -34.6410142798876,-58.4943630505166 -34.6405583970843,-58.4928920013968 -34.640355031288,-58.4924918399277 -34.6403058323597,-58.4924323607617 -34.6402975367524,-58.4914357031084 -34.6401587571661,-58.4912149154505 -34.6413732840018,-58.4910320452541 -34.6413487483828,-58.4897318449167 -34.6411698125019,-58.488231056872 -34.6409629462801,-58.4878056190125 -34.6412999466441,-58.4880444982792 -34.6414126472684,-58.4887115402422 -34.6417285026874,-58.4895440075076 -34.6421226304584,-58.489623521843 -34.6421602901693,-58.4899935669769 -34.6423354951038,-58.4901762894019 -34.6424230624539,-58.4905860526609 -34.6426194544744,-58.490647385185 -34.6425598611041)))";;"366";10_17_7;COMUNA 10;"17";"7";"875";"410";"465";"88,17%";"345";"345";"100,00%";"0";"0,00%";"289";"21";"7.27";"268";"92,73%";"7.27";7.270
"MULTIPOLYGON (((-58.4953744948243 -34.6431778604907,-58.4967593673637 -34.6433877698301,-58.4970227679476 -34.6421673057158,-58.4957658324791 -34.6419964504332,-58.4956022175793 -34.6419726206956,-58.4956291731988 -34.6418301441562,-58.4957380051322 -34.6412296028642,-58.4958214136065 -34.6407694952976,-58.4943630505166 -34.6405583970843,-58.4942730714116 -34.6410142798876,-58.4941259390154 -34.6417597639079,-58.4938905218466 -34.6429528899082,-58.4953744948243 -34.6431778604907)))";;"367";10_17_8;COMUNA 10;"17";"8";"694";"319";"375";"85,07%";"286";"286";"100,00%";"0";"0,00%";"246";"4";"1.63";"242";"98,37%";"1.63";1.630
"MULTIPOLYGON (((-58.4998196200117 -34.641311318785,-58.4987574941799 -34.6411674075414,-58.4972810567291 -34.6409673358447,-58.4958214136065 -34.6407694952976,-58.4957380051322 -34.6412296028642,-58.4956291731988 -34.6418301441562,-58.4956022175793 -34.6419726206956,-58.4957658324791 -34.6419964504332,-58.4970227679476 -34.6421673057158,-58.4967593673637 -34.6433877698301,-58.4971376351116 -34.643409424841,-58.4984733204974 -34.6423645006747,-58.4985406149924 -34.6423118736344,-58.4994888619289 -34.6415700186973,-58.4998196200117 -34.641311318785)))";;"368";10_17_9;COMUNA 10;"17";"9";"638";"306";"332";"92,17%";"258";"258";"100,00%";"0";"0,00%";"239";"2";"0.84";"237";"99,16%";"0.84";0.840
"MULTIPOLYGON (((-58.4922708483035 -34.6377827070808,-58.4919024673356 -34.6376925112531,-58.4917119266982 -34.6376400902533,-58.4909617848673 -34.6374427952518,-58.4906823679424 -34.6373692657632,-58.4891189632188 -34.6369851654396,-58.4888534914987 -34.6381677254549,-58.488818182849 -34.638334780626,-58.4887154039516 -34.6388205927765,-58.4886917467723 -34.6389187699695,-58.4886376244892 -34.6391437182462,-58.4886103930405 -34.6392568966564,-58.4885259840809 -34.6396367858092,-58.4895667251618 -34.639904245545,-58.4900592756262 -34.6395136306721,-58.4903872425299 -34.639253618803,-58.4909114763021 -34.6388441898345,-58.4918236342372 -34.6381319103959,-58.4922708483035 -34.6377827070808)))";;"369";10_18_1;COMUNA 10;"18";"1";"736";"349";"387";"90,18%";"311";"311";"100,00%";"0";"0,00%";"280";"5";"1.79";"275";"98,21%";"1.79";1.790
"MULTIPOLYGON (((-58.4796950758805 -34.6360961801051,-58.4792007940596 -34.6364926692646,-58.4789048360894 -34.6367300405619,-58.4787872702698 -34.6368242845213,-58.4785455734409 -34.6369942512248,-58.4800487519906 -34.6376825195425,-58.4804033319106 -34.6378448681736,-58.4814640121903 -34.6383305702542,-58.4817453966261 -34.6384594040048,-58.4828819361258 -34.638979730826,-58.4831059911648 -34.638807082396,-58.4833177765439 -34.6386392245102,-58.483436392334 -34.6383233492194,-58.4820283576067 -34.6376671509758,-58.4822844058572 -34.636950326482,-58.4809890649255 -34.6363853684982,-58.480889258436 -34.636634123862,-58.4796950758805 -34.6360961801051)))";;"370";10_18_10;COMUNA 10;"18";"10";"516";"239";"277";"86,28%";"212";"212";"100,00%";"0";"0,00%";"191";"14";"7.33";"177";"92,67%";"7.33";7.330
"MULTIPOLYGON (((-58.4840230685033 -34.6380801416746,-58.4833177765439 -34.6386392245102,-58.4831059911648 -34.638807082396,-58.4828819361258 -34.638979730826,-58.4839008057222 -34.6394569675567,-58.4846063353652 -34.6397903746092,-58.4848799756757 -34.6399196250345,-58.4853195404445 -34.6401272973761,-58.4855164845845 -34.6402203622352,-58.486065646452 -34.6404793509781,-58.4861291493432 -34.6402535569914,-58.4864879813051 -34.6391128878721,-58.4863034068097 -34.6390654574303,-58.4852219556654 -34.6387919912232,-58.4840230685033 -34.6380801416746)))";;"371";10_18_11;COMUNA 10;"18";"11";"663";"303";"360";"84,17%";"247";"246";"99,60%";"1";"0,41%";"224";"15";"6.7";"209";"93,30%";"6.7";6.700
"MULTIPOLYGON (((-58.4869677996662 -34.6409048220683,-58.4878056190125 -34.6412999466441,-58.488231056872 -34.6409629462801,-58.4887381020794 -34.6405613475095,-58.4895667251618 -34.639904245545,-58.4885259840809 -34.6396367858092,-58.4886103930405 -34.6392568966564,-58.4886376244892 -34.6391437182462,-58.4866990193406 -34.6384421912948,-58.4864879813051 -34.6391128878721,-58.4861291493432 -34.6402535569914,-58.486065646452 -34.6404793509781,-58.4869677996662 -34.6409048220683)))";;"372";10_18_12;COMUNA 10;"18";"12";"808";"362";"446";"81,17%";"325";"325";"100,00%";"0";"0,00%";"297";"6";"2.02";"291";"97,98%";"2.02";2.020
"MULTIPOLYGON (((-58.4891189632188 -34.6369851654396,-58.4881798353798 -34.6367504985206,-58.4872803363524 -34.6365257462781,-58.4869377101552 -34.6376475411428,-58.4868808505095 -34.6378489673498,-58.4868397377515 -34.6379946139709,-58.4866990193406 -34.6384421912948,-58.4886376244892 -34.6391437182462,-58.4886917467723 -34.6389187699695,-58.4887154039516 -34.6388205927765,-58.488818182849 -34.638334780626,-58.4888534914987 -34.6381677254549,-58.4891189632188 -34.6369851654396)))";;"373";10_18_2;COMUNA 10;"18";"2";"755";"352";"403";"87,34%";"292";"292";"100,00%";"0";"0,00%";"270";"3";"1.11";"267";"98,89%";"1.11";1.110
"MULTIPOLYGON (((-58.4862906896945 -34.6362826239858,-58.4858853720626 -34.6366039797053,-58.4849376593964 -34.6373552367463,-58.4840230685033 -34.6380801416746,-58.4852219556654 -34.6387919912232,-58.4863034068097 -34.6390654574303,-58.4864879813051 -34.6391128878721,-58.4866990193406 -34.6384421912948,-58.4868397377515 -34.6379946139709,-58.4868808505095 -34.6378489673498,-58.4869377101552 -34.6376475411428,-58.4872803363524 -34.6365257462781,-58.4873143856345 -34.6364141865088,-58.4873360069197 -34.636343475631,-58.4876489694852 -34.6352155585213,-58.4862906896945 -34.6362826239858)))";;"374";10_18_3;COMUNA 10;"18";"3";"780";"329";"451";"72,95%";"397";"397";"100,00%";"0";"0,00%";"337";"19";"5.64";"318";"94,36%";"5.64";5.640
"MULTIPOLYGON (((-58.4839048860549 -34.6370754820854,-58.483436392334 -34.6383233492194,-58.4833177765439 -34.6386392245102,-58.4840230685033 -34.6380801416746,-58.4849376593964 -34.6373552367463,-58.4858853720626 -34.6366039797053,-58.4862906896945 -34.6362826239858,-58.4876489694852 -34.6352155585213,-58.4866803001173 -34.634981519845,-58.4854361541813 -34.6346808328123,-58.4848564760897 -34.6345407940747,-58.4843714074131 -34.6358328951109,-58.4839048860549 -34.6370754820854)))";;"375";10_18_4;COMUNA 10;"18";"4";"1114";"491";"623";"78,81%";"466";"465";"99,79%";"1";"0,22%";"396";"43";"10.86";"353";"89,14%";"10.86";10.860
"MULTIPOLYGON (((-58.4866803001173 -34.634981519845,-58.4876489694852 -34.6352155585213,-58.4883171449081 -34.6346730783992,-58.4884252424187 -34.6345888979716,-58.4885135772272 -34.6345200038204,-58.4885961193011 -34.6344551250501,-58.4887145243621 -34.6343661532855,-58.4889098491806 -34.6342181488857,-58.4884320984086 -34.6341656432609,-58.4882074902381 -34.634124562335,-58.4873206435016 -34.6339471331333,-58.4871681203453 -34.6339135711772,-58.4863980081221 -34.6337442106427,-58.4859237371136 -34.6336276783275,-58.4858534871909 -34.6337797389222,-58.4858067388655 -34.6338807370122,-58.4857755732523 -34.6339480690613,-58.4846590013002 -34.6336736183105,-58.4845373225551 -34.63363807561,-58.4841862230417 -34.634378796019,-58.4848564760897 -34.6345407940747,-58.4854361541813 -34.6346808328123,-58.4866803001173 -34.634981519845)))";;"376";10_18_5;COMUNA 10;"18";"5";"779";"337";"442";"76,24%";"352";"349";"99,15%";"3";"0,86%";"277";"6";"2.17";"271";"97,83%";"2.17";2.170
"MULTIPOLYGON (((-58.4833201355636 -34.6332789887594,-58.4831078990644 -34.6333822166921,-58.4823803190309 -34.6339423963549,-58.4829388571869 -34.6340773093727,-58.4832767076375 -34.6341590160823,-58.4841862230417 -34.634378796019,-58.4845373225551 -34.63363807561,-58.4834659917015 -34.6333251538462,-58.4833203695867 -34.6332793319755,-58.4833201355636 -34.6332789887594)))";;"377";10_18_6;COMUNA 10;"18";"6";"606";"259";"347";"74,64%";"362";"362";"100,00%";"0";"0,00%";"280";"23";"8.21";"257";"91,79%";"8.21";8.210
"MULTIPOLYGON (((-58.4841862230417 -34.634378796019,-58.4832767076375 -34.6341590160823,-58.4828486841422 -34.6353702538112,-58.4828138590822 -34.6354677979418,-58.4843714074131 -34.6358328951109,-58.4848564760897 -34.6345407940747,-58.4841862230417 -34.634378796019)))";;"378";10_18_7;COMUNA 10;"18";"7";"785";"347";"438";"79,22%";"428";"428";"100,00%";"0";"0,00%";"365";"35";"9.59";"330";"90,41%";"9.59";9.590
"MULTIPOLYGON (((-58.4822844058572 -34.636950326482,-58.4820283576067 -34.6376671509758,-58.483436392334 -34.6383233492194,-58.4839048860549 -34.6370754820854,-58.4843714074131 -34.6358328951109,-58.4828138590822 -34.6354677979418,-58.4824889347385 -34.6363776693328,-58.4822844058572 -34.636950326482)))";;"379";10_18_8;COMUNA 10;"18";"8";"596";"278";"318";"87,42%";"243";"239";"98,35%";"4";"1,67%";"184";"1";"0.54";"183";"99,46%";"0.54";0.540
"MULTIPOLYGON (((-58.4829388571869 -34.6340773093727,-58.4823803190309 -34.6339423963549,-58.4810066633992 -34.6350441955515,-58.4799271362615 -34.6359100851772,-58.4796950758805 -34.6360961801051,-58.480889258436 -34.636634123862,-58.4809890649255 -34.6363853684982,-58.4822844058572 -34.636950326482,-58.4824889347385 -34.6363776693328,-58.4828138590822 -34.6354677979418,-58.4828486841422 -34.6353702538112,-58.4832767076375 -34.6341590160823,-58.4829388571869 -34.6340773093727)))";;"380";10_18_9;COMUNA 10;"18";"9";"1284";"575";"709";"81,10%";"469";"466";"99,36%";"3";"0,64%";"458";"15";"3.28";"443";"96,72%";"3.28";3.280
"MULTIPOLYGON (((-58.4807957393061 -34.6324875939034,-58.4807694249716 -34.6325471772351,-58.4803689149144 -34.6334562094926,-58.4817099051822 -34.6337803142744,-58.4823803190309 -34.6339423963549,-58.4831078990644 -34.6333822166921,-58.4833201355636 -34.6332789887594,-58.4830620164266 -34.6331981051027,-58.4821172251072 -34.6329004324699,-58.4820139528763 -34.6328679125841,-58.4807957393061 -34.6324875939034)))";;"381";10_19_1;COMUNA 10;"19";"1";"563";"247";"316";"78,16%";"310";"310";"100,00%";"0";"0,00%";"265";"46";"17.36";"219";"82,64%";"17.36";17.360
"MULTIPOLYGON (((-58.4739953390469 -34.6334138662614,-58.4728742987558 -34.6331512098091,-58.4722802512497 -34.6344758083955,-58.4733525017831 -34.6348640419979,-58.4743369974344 -34.6352204425301,-58.4743997109672 -34.6352431837499,-58.4753994769759 -34.6356636608064,-58.4757268872216 -34.6349172639555,-58.4761635670729 -34.6339219023067,-58.4750453249002 -34.6336598993469,-58.4739953390469 -34.6334138662614)))";;"382";10_19_10;COMUNA 10;"19";"10";"1008";"440";"568";"77,46%";"480";"478";"99,58%";"2";"0,42%";"400";"85";"21.25";"315";"78,75%";"21.25";21.250
"MULTIPOLYGON (((-58.4743369974344 -34.6352204425301,-58.4733525017831 -34.6348640419979,-58.4722802512497 -34.6344758083955,-58.4717559507473 -34.6356449710597,-58.4728386085648 -34.6360303913383,-58.4738894080309 -34.6364045369377,-58.4747456819295 -34.6367093243888,-58.4749141426594 -34.6367699433965,-58.4759233783615 -34.6371329484605,-58.4768890796251 -34.637480315917,-58.4762905420792 -34.6387619744937,-58.4767783772176 -34.6383759913109,-58.4775912269501 -34.637732845967,-58.4783567817334 -34.637127096792,-58.4785455734409 -34.6369942512248,-58.4773518326939 -34.6364893841598,-58.4763927774239 -34.6360837782393,-58.4753994769759 -34.6356636608064,-58.4743997109672 -34.6352431837499,-58.4743369974344 -34.6352204425301)))";;"383";10_19_11;COMUNA 10;"19";"11";"919";"450";"469";"95,95%";"400";"399";"99,75%";"1";"0,25%";"344";"14";"4.07";"330";"95,93%";"4.07";4.070
"MULTIPOLYGON (((-58.4728386085648 -34.6360303913383,-58.4717559507473 -34.6356449710597,-58.4713029364562 -34.6366551774409,-58.4724169549687 -34.6369874988765,-58.4734922971677 -34.6373083343032,-58.4744154236864 -34.6379169306752,-58.4753231333712 -34.6384744636215,-58.4760723524005 -34.6389346801881,-58.4762905420792 -34.6387619744937,-58.4768890796251 -34.637480315917,-58.4759233783615 -34.6371329484605,-58.4749141426594 -34.6367699433965,-58.4747456819295 -34.6367093243888,-58.4738894080309 -34.6364045369377,-58.4728386085648 -34.6360303913383)))";;"384";10_19_12;COMUNA 10;"19";"12";"1137";"517";"620";"83,39%";"510";"510";"100,00%";"0";"0,00%";"429";"6";"1.4";"423";"98,60%";"1.4";1.400
"MULTIPOLYGON (((-58.4783427330947 -34.6317360773238,-58.4772886581806 -34.6314103520793,-58.4767487704161 -34.6325811584197,-58.4778444255009 -34.6328460360351,-58.478930629661 -34.6331085810337,-58.4803689149144 -34.6334562094926,-58.4807694249716 -34.6325471772351,-58.47938115004 -34.6321156706037,-58.4794062741393 -34.6320646795636,-58.4783427330947 -34.6317360773238)))";;"385";10_19_2;COMUNA 10;"19";"2";"1094";"518";"576";"89,93%";"474";"474";"100,00%";"0";"0,00%";"436";"98";"22.48";"338";"77,52%";"22.48";22.480
"MULTIPOLYGON (((-58.4763784416763 -34.6307636050664,-58.4753488408585 -34.6304503958858,-58.4752087666602 -34.6304077328519,-58.4742537259749 -34.6301103523385,-58.4741036501344 -34.6304382647285,-58.4734838294236 -34.6317918167907,-58.4746045137287 -34.6320627778697,-58.4756549115864 -34.6323166933081,-58.4767487704161 -34.6325811584197,-58.4772886581806 -34.6314103520793,-58.4783427330947 -34.6317360773238,-58.4794062741393 -34.6320646795636,-58.4794454493509 -34.6319787558565,-58.4794758526778 -34.6319121297558,-58.4795503703964 -34.6317486633678,-58.4784948418401 -34.6314210472779,-58.4775951611077 -34.6311417849916,-58.4774331016033 -34.6310913100389,-58.4764932966628 -34.6307985228723,-58.4763784416763 -34.6307636050664)))";;"386";10_19_3;COMUNA 10;"19";"3";"1100";"491";"609";"80,62%";"364";"361";"99,18%";"3";"0,83%";"355";"65";"18.31";"290";"81,69%";"18.31";18.310
"MULTIPOLYGON (((-58.4767487704161 -34.6325811584197,-58.4756549115864 -34.6323166933081,-58.4746045137287 -34.6320627778697,-58.4734838294236 -34.6317918167907,-58.4728742987558 -34.6331512098091,-58.4739953390469 -34.6334138662614,-58.4750453249002 -34.6336598993469,-58.4761635670729 -34.6339219023067,-58.4767487704161 -34.6325811584197)))";;"387";10_19_4;COMUNA 10;"19";"4";"788";"361";"427";"84,54%";"416";"416";"100,00%";"0";"0,00%";"340";"36";"10.59";"304";"89,41%";"10.59";10.590
"MULTIPOLYGON (((-58.478930629661 -34.6331085810337,-58.4778444255009 -34.6328460360351,-58.4767487704161 -34.6325811584197,-58.4761635670729 -34.6339219023067,-58.4770868634407 -34.6341381420068,-58.4772467110177 -34.6341750960881,-58.4783169946982 -34.6344222957753,-58.478930629661 -34.6331085810337)))";;"388";10_19_5;COMUNA 10;"19";"5";"822";"381";"441";"86,39%";"420";"420";"100,00%";"0";"0,00%";"348";"24";"6.9";"324";"93,10%";"6.9";6.900
"MULTIPOLYGON (((-58.4803689149144 -34.6334562094926,-58.478930629661 -34.6331085810337,-58.4783169946982 -34.6344222957753,-58.4778513687556 -34.6354194292693,-58.4793350189735 -34.6357700924065,-58.4797868238187 -34.6347618281216,-58.4803689149144 -34.6334562094926)))";;"389";10_19_6;COMUNA 10;"19";"6";"858";"416";"442";"94,12%";"350";"350";"100,00%";"0";"0,00%";"347";"33";"9.51";"314";"90,49%";"9.51";9.510
"MULTIPOLYGON (((-58.4817099051822 -34.6337803142744,-58.4803689149144 -34.6334562094926,-58.4797868238187 -34.6347618281216,-58.4808068496502 -34.6349973928673,-58.4810066633992 -34.6350441955515,-58.4823803190309 -34.6339423963549,-58.4817099051822 -34.6337803142744)))";;"390";10_19_7;COMUNA 10;"19";"7";"775";"324";"451";"71,84%";"419";"419";"100,00%";"0";"0,00%";"328";"0";"0";"328";"100,00%";"0";0.000
"MULTIPOLYGON (((-58.4793350189735 -34.6357700924065,-58.4778513687556 -34.6354194292693,-58.4773518326939 -34.6364893841598,-58.4785455734409 -34.6369942512248,-58.4787872702698 -34.6368242845213,-58.4789048360894 -34.6367300405619,-58.4792007940596 -34.6364926692646,-58.4796950758805 -34.6360961801051,-58.4799271362615 -34.6359100851772,-58.4810066633992 -34.6350441955515,-58.4808068496502 -34.6349973928673,-58.4797868238187 -34.6347618281216,-58.4793350189735 -34.6357700924065)))";;"391";10_19_8;COMUNA 10;"19";"8";"512";"230";"282";"81,56%";"260";"260";"100,00%";"0";"0,00%";"215";"9";"4.19";"206";"95,81%";"4.19";4.190
"MULTIPOLYGON (((-58.4757268872216 -34.6349172639555,-58.4753994769759 -34.6356636608064,-58.4763927774239 -34.6360837782393,-58.4773518326939 -34.6364893841598,-58.4778513687556 -34.6354194292693,-58.4783169946982 -34.6344222957753,-58.4772467110177 -34.6341750960881,-58.4770868634407 -34.6341381420068,-58.4761635670729 -34.6339219023067,-58.4757268872216 -34.6349172639555)))";;"392";10_19_9;COMUNA 10;"19";"9";"729";"354";"375";"94,40%";"327";"325";"99,39%";"2";"0,62%";"276";"25";"9.06";"251";"90,94%";"9.06";9.060
"MULTIPOLYGON (((-58.5287256078072 -34.6146848227387,-58.5273659644106 -34.6157401660352,-58.5278501049644 -34.6161158372891,-58.5283041611554 -34.6164681416682,-58.5287798716145 -34.6168372641883,-58.5292862721249 -34.617230101313,-58.5297009599316 -34.6175519278715,-58.530121958611 -34.6178785384145,-58.5303716468089 -34.6178803635067,-58.5303439071601 -34.6181340725584,-58.5311990556357 -34.6190233350656,-58.5312482989515 -34.6181944711387,-58.5315187528629 -34.615493660087,-58.5304887731818 -34.6133001589448,-58.5302211192263 -34.6135141010713,-58.5296923456613 -34.6139367572971,-58.5296915799349 -34.6139351144137,-58.5295170643611 -34.6140705670769,-58.5291209544431 -34.6143779774645,-58.5287256078072 -34.6146848227387)))";;"393";10_2_1;COMUNA 10;"2";"1";"930";"434";"496";"87,50%";"402";"402";"100,00%";"0";"0,00%";"353";"1";"0.28";"352";"99,72%";"0.28";0.280
"MULTIPOLYGON (((-58.5278501049644 -34.6161158372891,-58.5273659644106 -34.6157401660352,-58.5264006315633 -34.6164893624398,-58.5268415096763 -34.6168803424628,-58.5272646611032 -34.6172556254684,-58.5276027417674 -34.6175555270772,-58.5277079347315 -34.6176494180391,-58.5280601709283 -34.6179638183673,-58.5281651079804 -34.61805594844,-58.5285766749318 -34.6184173593051,-58.5286828065813 -34.6185105446549,-58.5289685545669 -34.6187629338288,-58.530121958611 -34.6178785384145,-58.5297009599316 -34.6175519278715,-58.5292862721249 -34.617230101313,-58.5287798716145 -34.6168372641883,-58.5283041611554 -34.6164681416682,-58.5278501049644 -34.6161158372891)))";;"394";10_2_2;COMUNA 10;"2";"2";"600";"273";"327";"83,49%";"291";"291";"100,00%";"0";"0,00%";"257";"0";"0";"257";"100,00%";"0";0.000
"MULTIPOLYGON (((-58.5289685545669 -34.6187629338288,-58.5286828065813 -34.6185105446549,-58.5285766749318 -34.6184173593051,-58.5281651079804 -34.61805594844,-58.5280601709283 -34.6179638183673,-58.5277079347315 -34.6176494180391,-58.5276027417674 -34.6175555270772,-58.5272646611032 -34.6172556254684,-58.5268415096763 -34.6168803424628,-58.5264006315633 -34.6164893624398,-58.5252440652335 -34.617386964409,-58.5253455910075 -34.6174790986667,-58.5256722412413 -34.6177664758344,-58.5259942053596 -34.6180497698933,-58.5260981174098 -34.6181411276006,-58.5265429211382 -34.6185316840023,-58.5269870489998 -34.6189241405858,-58.5273041678231 -34.6192093351567,-58.5274135414512 -34.6193092806816,-58.5275038196977 -34.6193918412781,-58.5277988652049 -34.6196602851146,-58.5279305721137 -34.6195587323448,-58.5289685545669 -34.6187629338288)))";;"395";10_2_3;COMUNA 10;"2";"3";"702";"337";"365";"92,33%";"279";"279";"100,00%";"0";"0,00%";"245";"2";"0.82";"243";"99,18%";"0.82";0.820
"MULTIPOLYGON (((-58.5290056621889 -34.6207552366507,-58.5296717320983 -34.6213585556856,-58.5301271443446 -34.6217626849861,-58.5301281423702 -34.6217462089376,-58.5309948478574 -34.622366168396,-58.5310088935474 -34.6221083331219,-58.531111740601 -34.6204737823156,-58.5311527617771 -34.6198025387706,-58.5311990556357 -34.6190233350656,-58.5303439071601 -34.6181340725584,-58.5303716468089 -34.6178803635067,-58.530121958611 -34.6178785384145,-58.5289685545669 -34.6187629338288,-58.5279305721137 -34.6195587323448,-58.5277988652049 -34.6196602851146,-58.5280410579948 -34.6198806562776,-58.5285356773793 -34.6203306172851,-58.5286615913372 -34.62044407434,-58.5287660226068 -34.6205381760289,-58.5290056621889 -34.6207552366507)))";;"396";10_2_4;COMUNA 10;"2";"4";"875";"433";"442";"97,96%";"338";"338";"100,00%";"0";"0,00%";"303";"1";"0.33";"302";"99,67%";"0.33";0.330
"MULTIPOLYGON (((-58.5286836909578 -34.6239332671666,-58.5295506419089 -34.6247142302407,-58.5299474207574 -34.6250715595205,-58.5299482996849 -34.6250482505487,-58.5308020518428 -34.6258152336267,-58.5308264893094 -34.6254310135291,-58.5309127095833 -34.6238739404985,-58.5309948478574 -34.622366168396,-58.5301281423702 -34.6217462089376,-58.5301271443446 -34.6217626849861,-58.5296717320983 -34.6213585556856,-58.5290056621889 -34.6207552366507,-58.5287660226068 -34.6205381760289,-58.5286615913372 -34.62044407434,-58.52752559289 -34.6213189389854,-58.526586415915 -34.6220422763466,-58.5275979150312 -34.6229550132919,-58.5277252810983 -34.6230699494142,-58.5286836909578 -34.6239332671666)))";;"397";10_2_5;COMUNA 10;"2";"5";"839";"390";"449";"86,86%";"350";"350";"100,00%";"0";"0,00%";"297";"12";"4.04";"285";"95,96%";"4.04";4.040
"MULTIPOLYGON (((-58.525824035517 -34.6197813271629,-58.5248705347296 -34.6204851511851,-58.5243229818683 -34.6208893867088,-58.5239050977726 -34.6211978472187,-58.5237772116538 -34.6212922103589,-58.5227653518264 -34.6220392879069,-58.5231912898548 -34.6222522538064,-58.5233550016957 -34.6223346401472,-58.5239444009942 -34.6226311164457,-58.5250793220732 -34.6232023920092,-58.5261661275014 -34.6237770623919,-58.5263819201711 -34.6238885030405,-58.5269058078268 -34.6241590123223,-58.526502083099 -34.6237962488618,-58.5275979150312 -34.6229550132919,-58.526586415915 -34.6220422763466,-58.52752559289 -34.6213189389854,-58.5286615913372 -34.62044407434,-58.5285356773793 -34.6203306172851,-58.5280410579948 -34.6198806562776,-58.5277988652049 -34.6196602851146,-58.5275038196977 -34.6193918412781,-58.5274135414512 -34.6193092806816,-58.5273041678231 -34.6192093351567,-58.5269870489998 -34.6189241405858,-58.5259548968827 -34.6196847067137,-58.525824035517 -34.6197813271629)))";;"398";10_2_6;COMUNA 10;"2";"6";"1108";"526";"582";"90,38%";"458";"458";"100,00%";"0";"0,00%";"393";"1";"0.25";"392";"99,75%";"0.25";0.250
"MULTIPOLYGON (((-58.5258421986163 -34.624304009068,-58.5252839083847 -34.6247313535995,-58.5258443566893 -34.6250160744745,-58.5263473656449 -34.625271525973,-58.5268441561128 -34.6255238799584,-58.5278565815524 -34.6260380791222,-58.5283608813149 -34.6262942258273,-58.5288647580303 -34.6265501593896,-58.529376308541 -34.6268099600334,-58.529810221295 -34.627035645179,-58.5298104745669 -34.6270317778803,-58.5306764521414 -34.6274341004718,-58.5307363182879 -34.6268487174155,-58.5308020518428 -34.6258152336267,-58.5299482996849 -34.6250482505487,-58.5299474207574 -34.6250715595205,-58.5295506419089 -34.6247142302407,-58.5286836909578 -34.6239332671666,-58.5277252810983 -34.6230699494142,-58.5275979150312 -34.6229550132919,-58.526502083099 -34.6237962488618,-58.5269058078268 -34.6241590123223,-58.5263819201711 -34.6238885030405,-58.5258421986163 -34.624304009068)))";;"399";10_2_7;COMUNA 10;"2";"7";"973";"464";"509";"91,16%";"395";"395";"100,00%";"0";"0,00%";"340";"0";"0";"340";"100,00%";"0";0.000
"MULTIPOLYGON (((-58.5216308616119 -34.6228762785314,-58.5208490327821 -34.6234507579603,-58.5206947428767 -34.6235634409086,-58.5211766371788 -34.6239940002573,-58.5216367132115 -34.6244050605043,-58.5228320776185 -34.6234862062394,-58.5230343131334 -34.6235888563819,-58.5233276535598 -34.6237378005564,-58.5236164781774 -34.6238844926782,-58.5239625747341 -34.6240602408641,-58.5241062636077 -34.6241331992818,-58.5241700117732 -34.6241655626478,-58.5252839083847 -34.6247313535995,-58.5258421986163 -34.624304009068,-58.5263819201711 -34.6238885030405,-58.5261661275014 -34.6237770623919,-58.5250793220732 -34.6232023920092,-58.5239444009942 -34.6226311164457,-58.5233550016957 -34.6223346401472,-58.5231912898548 -34.6222522538064,-58.5227653518264 -34.6220392879069,-58.5217752714085 -34.6227701486941,-58.5216308616119 -34.6228762785314)))";;"400";10_2_8;COMUNA 10;"2";"8";"868";"411";"457";"89,93%";"362";"362";"100,00%";"0";"0,00%";"316";"0";"0";"316";"100,00%";"0";0.000
"MULTIPOLYGON (((-58.5252839083847 -34.6247313535995,-58.5241700117732 -34.6241655626478,-58.5237318917158 -34.6255990708961,-58.5233643861457 -34.6268014075864,-58.5245728189072 -34.6270548936808,-58.5251800196336 -34.6271812785798,-58.5255481840346 -34.6259813306159,-58.5258443566893 -34.6250160744745,-58.5252839083847 -34.6247313535995)))";;"401";10_3_1;COMUNA 10;"3";"1";"612";"282";"330";"85,45%";"278";"278";"100,00%";"0";"0,00%";"222";"3";"1.35";"219";"98,65%";"1.35";1.350
"MULTIPOLYGON (((-58.529376308541 -34.6268099600334,-58.5288647580303 -34.6265501593896,-58.5283608813149 -34.6262942258273,-58.5278565815524 -34.6260380791222,-58.5268441561128 -34.6255238799584,-58.5263473656449 -34.625271525973,-58.5258443566893 -34.6250160744745,-58.5255481840346 -34.6259813306159,-58.5251800196336 -34.6271812785798,-58.5257277450769 -34.627294169617,-58.5262736843298 -34.6274089605952,-58.5268203914165 -34.6275231853239,-58.5273675260349 -34.6276374777976,-58.5279138100741 -34.627751627419,-58.5284549829155 -34.6278646505478,-58.5284901623428 -34.6277480783724,-58.5285411513827 -34.627584876368,-58.5291075446814 -34.6277010521093,-58.5290642938777 -34.6278445311656,-58.5290218901302 -34.6279820236266,-58.5297472074458 -34.6281333927453,-58.5297462659379 -34.6281479711103,-58.5306603896975 -34.6283160506732,-58.5306403858178 -34.6277867601619,-58.5306764521414 -34.6274341004718,-58.5298104745669 -34.6270317778803,-58.529810221295 -34.627035645179,-58.529376308541 -34.6268099600334)))";;"402";10_3_2;COMUNA 10;"3";"2";"836";"408";"428";"95,33%";"340";"340";"100,00%";"0";"0,00%";"290";"0";"0";"290";"100,00%";"0";0.000
"MULTIPOLYGON (((-58.5273675260349 -34.6276374777976,-58.5268203914165 -34.6275231853239,-58.5262736843298 -34.6274089605952,-58.5257277450769 -34.627294169617,-58.5251800196336 -34.6271812785798,-58.5247546344149 -34.6285674276073,-58.524754560472 -34.6285675986283,-58.5253017849102 -34.6286826749742,-58.5258489256049 -34.6287976784804,-58.5263947896241 -34.6289123984965,-58.5269419333278 -34.6290273970922,-58.5274872039079 -34.6291420421011,-58.5280333280761 -34.629256825062,-58.5285920602987 -34.6293680775203,-58.529127199121 -34.6294856785065,-58.5296969701322 -34.6289112632482,-58.5296974887273 -34.6289032334374,-58.5306639805498 -34.6289798082991,-58.5306728650351 -34.6286461370246,-58.5306603896975 -34.6283160506732,-58.5297462659379 -34.6281479711103,-58.5297472074458 -34.6281333927453,-58.5290218901302 -34.6279820236266,-58.5290642938777 -34.6278445311656,-58.5291075446814 -34.6277010521093,-58.5285411513827 -34.627584876368,-58.5284901623428 -34.6277480783724,-58.5284549829155 -34.6278646505478,-58.5279138100741 -34.627751627419,-58.5273675260349 -34.6276374777976)))";;"403";10_3_3;COMUNA 10;"3";"3";"803";"371";"432";"85,88%";"345";"345";"100,00%";"0";"0,00%";"293";"1";"0.34";"292";"99,66%";"0.34";0.340
"MULTIPOLYGON (((-58.5258489256049 -34.6287976784804,-58.5253017849102 -34.6286826749742,-58.524754560472 -34.6285675986283,-58.5247308479456 -34.6286449372194,-58.5243702244617 -34.6298201592611,-58.5243273007226 -34.6299575798886,-58.5248773449538 -34.6300722341336,-58.5254241526532 -34.6301862537357,-58.5259695983908 -34.6302999194656,-58.5265174316244 -34.6304141449033,-58.5270618583251 -34.63052829925,-58.5276120838117 -34.6306472369687,-58.527733683938 -34.6306732998195,-58.5279362364286 -34.6307155169978,-58.5288083916931 -34.6298141020608,-58.5290079333973 -34.6296078601377,-58.529127199121 -34.6294856785065,-58.5285920602987 -34.6293680775203,-58.5280333280761 -34.629256825062,-58.5274872039079 -34.6291420421011,-58.5269419333278 -34.6290273970922,-58.5263947896241 -34.6289123984965,-58.5258489256049 -34.6287976784804)))";;"404";10_3_4;COMUNA 10;"3";"4";"588";"272";"316";"86,08%";"246";"246";"100,00%";"0";"0,00%";"218";"1";"0.46";"217";"99,54%";"0.46";0.460
"MULTIPOLYGON (((-58.5279362364286 -34.6307155169978,-58.527434217199 -34.6312343931482,-58.5273115420308 -34.6313611525137,-58.5273970118394 -34.6313790655469,-58.5272150004247 -34.6321190454601,-58.5271122605769 -34.6330172277899,-58.5284331394946 -34.6331156108236,-58.5294420766701 -34.6331895019522,-58.5294412574547 -34.6332025919341,-58.5304022399128 -34.6332175156261,-58.5304323907505 -34.6327816187688,-58.5304768463055 -34.6322335479487,-58.5305237081929 -34.6318163250991,-58.5305860751012 -34.631293315441,-58.5306300277161 -34.6307575690633,-58.5306565101098 -34.6302171138914,-58.5306527979052 -34.6297394944797,-58.5306600518173 -34.6291273573987,-58.5306639805498 -34.6289798082991,-58.5296974887273 -34.6289032334374,-58.5296969701322 -34.6289112632482,-58.529127199121 -34.6294856785065,-58.5290079333973 -34.6296078601377,-58.5288083916931 -34.6298141020608,-58.5279362364286 -34.6307155169978)))";;"405";10_3_5;COMUNA 10;"3";"5";"806";"382";"424";"90,09%";"322";"322";"100,00%";"0";"0,00%";"283";"3";"1.06";"280";"98,94%";"1.06";1.060
"MULTIPOLYGON (((-58.5284331394946 -34.6331156108236,-58.5271122605769 -34.6330172277899,-58.5269985117141 -34.6340055594855,-58.5269258947977 -34.6346377309605,-58.5269207322236 -34.6346829464131,-58.5270770478121 -34.6347502605574,-58.5282066665269 -34.6348423381437,-58.5282967677861 -34.634849730915,-58.5285644415964 -34.6348555061408,-58.5287532888529 -34.6348613941458,-58.5293364511795 -34.6348264694432,-58.5299704671487 -34.634806345694,-58.5302572009712 -34.6347978712735,-58.5303700369875 -34.6347945362188,-58.5303744938939 -34.634719671755,-58.5303546296349 -34.6339705739502,-58.5303845578463 -34.6334731467813,-58.5304022399128 -34.6332175156261,-58.5294412574547 -34.6332025919341,-58.5294420766701 -34.6331895019522,-58.5284331394946 -34.6331156108236)))";;"406";10_3_6;COMUNA 10;"3";"6";"717";"310";"407";"76,17%";"328";"327";"99,70%";"1";"0,31%";"278";"4";"1.44";"274";"98,56%";"1.44";1.440
"MULTIPOLYGON (((-58.5258027172429 -34.6329196696821,-58.5254867783889 -34.6332453363318,-58.5249006131469 -34.633851008535,-58.5243003911798 -34.6344706995058,-58.5256048581313 -34.6345857416799,-58.5269207322236 -34.6346829464131,-58.5269258947977 -34.6346377309605,-58.5269985117141 -34.6340055594855,-58.5271122605769 -34.6330172277899,-58.5272150004247 -34.6321190454601,-58.5273970118394 -34.6313790655469,-58.5273115420308 -34.6313611525137,-58.527434217199 -34.6312343931482,-58.5279362364286 -34.6307155169978,-58.527733683938 -34.6306732998195,-58.5276120838117 -34.6306472369687,-58.5270618583251 -34.63052829925,-58.5265174316244 -34.6304141449033,-58.5259695983908 -34.6302999194656,-58.5254241526532 -34.6301862537357,-58.5249772673989 -34.6316470239728,-58.5251837415216 -34.6316911451834,-58.5260749125645 -34.6318788606042,-58.526039825054 -34.6320109958513,-58.5258027172429 -34.6329196696821)))";;"407";10_3_7;COMUNA 10;"3";"7";"910";"432";"478";"90,38%";"428";"428";"100,00%";"0";"0,00%";"342";"9";"2.63";"333";"97,37%";"2.63";2.630
"MULTIPOLYGON (((-58.5222862670885 -34.6325657223949,-58.5215914490683 -34.6329281139806,-58.5207481211079 -34.6332198659579,-58.5208143941617 -34.6334016977844,-58.5207883669932 -34.6334861393459,-58.5207883270721 -34.6334862219766,-58.5207690537954 -34.6335481840267,-58.5207329753879 -34.6336710890641,-58.5207069204924 -34.6337624370327,-58.5206868709371 -34.6338222298508,-58.5210163661614 -34.6338220727547,-58.521082668193 -34.6338237016825,-58.5221685802326 -34.6339654030594,-58.5223448839622 -34.6339916558566,-58.5230379628642 -34.6341614613411,-58.5232745289547 -34.6342193741382,-58.5242316195141 -34.6344538322626,-58.5243003911798 -34.6344706995058,-58.5249006131469 -34.633851008535,-58.5254867783889 -34.6332453363318,-58.5258027172429 -34.6329196696821,-58.526039825054 -34.6320109958513,-58.5260749125645 -34.6318788606042,-58.5251837415216 -34.6316911451834,-58.5249772673989 -34.6316470239728,-58.5254241526532 -34.6301862537357,-58.5248773449538 -34.6300722341336,-58.5243273007226 -34.6299575798886,-58.5238732356136 -34.6314115185618,-58.5237095401682 -34.6313765993963,-58.523599785883 -34.631354329565,-58.5235076166675 -34.631495084417,-58.5234288791647 -34.6315951269425,-58.5232157916631 -34.6318284799722,-58.5231390819201 -34.6319059149216,-58.5230317180113 -34.6320086475104,-58.5229917849624 -34.6320448656302,-58.5228560578343 -34.6321602181275,-58.5227945786037 -34.6322101092275,-58.522719729712 -34.632269725505,-58.5226700851842 -34.6323083427414,-58.5226216312509 -34.632343931104,-58.522544478948 -34.6323997454626,-58.522475754963 -34.6324464708365,-58.52237585918 -34.63250997254,-58.5222862670885 -34.6325657223949)))";;"408";10_3_8;COMUNA 10;"3";"8";"1006";"466";"540";"86,30%";"434";"433";"99,77%";"1";"0,23%";"344";"8";"2.33";"336";"97,67%";"2.33";2.330
"MULTIPOLYGON (((-58.5230343131334 -34.6235888563819,-58.5228320776185 -34.6234862062394,-58.5216367132115 -34.6244050605043,-58.5206192831946 -34.6251871942072,-58.5200951064191 -34.625590131719,-58.5195372050143 -34.6260188581947,-58.5201680648821 -34.6261308903623,-58.5209456674452 -34.6262931326749,-58.5221550234179 -34.6265476986841,-58.5233643861457 -34.6268014075864,-58.5237318917158 -34.6255990708961,-58.5241700117732 -34.6241655626478,-58.5241062636077 -34.6241331992818,-58.5239625747341 -34.6240602408641,-58.5236164781774 -34.6238844926782,-58.5233276535598 -34.6237378005564,-58.5230343131334 -34.6235888563819)))";;"409";10_4_1;COMUNA 10;"4";"1";"1036";"472";"564";"83,69%";"427";"427";"100,00%";"0";"0,00%";"370";"2";"0.54";"368";"99,46%";"0.54";0.540
"MULTIPOLYGON (((-58.5241492202302 -34.6284379872982,-58.5242207017668 -34.628394393654,-58.5242873081244 -34.6283750702421,-58.5243840353495 -34.6283691099748,-58.5244788906552 -34.6283766845514,-58.524608776832 -34.6284203318726,-58.5246867210294 -34.6284632276477,-58.5247546344149 -34.6285674276073,-58.5251800196336 -34.6271812785798,-58.5245728189072 -34.6270548936808,-58.5233643861457 -34.6268014075864,-58.5221550234179 -34.6265476986841,-58.5209456674452 -34.6262931326749,-58.5201680648821 -34.6261308903623,-58.5195372050143 -34.6260188581947,-58.518975637184 -34.6264515980035,-58.5184692419708 -34.6268419141887,-58.5185809137737 -34.6269395424353,-58.5188262572643 -34.6271623246358,-58.5186570605908 -34.6272931110027,-58.519298252403 -34.6274268337721,-58.5205197177279 -34.6276814103218,-58.521730454158 -34.6279337966461,-58.5229407718168 -34.6281860302954,-58.5241492202302 -34.6284379872982)))";;"410";10_4_2;COMUNA 10;"4";"2";"1105";"519";"586";"88,57%";"477";"477";"100,00%";"0";"0,00%";"402";"3";"0.75";"399";"99,25%";"0.75";0.750
"MULTIPOLYGON (((-58.5188262572643 -34.6271623246358,-58.5185809137737 -34.6269395424353,-58.5184692419708 -34.6268419141887,-58.5179557743365 -34.627237654171,-58.5174130942302 -34.6276559410448,-58.5169616939729 -34.6280038304309,-58.5174848500646 -34.628464597965,-58.5174359788086 -34.6285133539328,-58.5188855607825 -34.6288158035677,-58.5200941786295 -34.629067925357,-58.5211184078889 -34.6292816011945,-58.5213030601099 -34.6293210914028,-58.5214756977671 -34.6293580518254,-58.5225133996165 -34.6295774842826,-58.523723490596 -34.6298333722877,-58.5238817292095 -34.6298668152599,-58.524182696009 -34.6299274405928,-58.5243273007226 -34.6299575798886,-58.5243702244617 -34.6298201592611,-58.5247308479456 -34.6286449372194,-58.524754560472 -34.6285675986283,-58.5247546344149 -34.6285674276073,-58.5246867210294 -34.6284632276477,-58.524608776832 -34.6284203318726,-58.5244788906552 -34.6283766845514,-58.5243840353495 -34.6283691099748,-58.5242873081244 -34.6283750702421,-58.5242207017668 -34.628394393654,-58.5241492202302 -34.6284379872982,-58.5229407718168 -34.6281860302954,-58.521730454158 -34.6279337966461,-58.5205197177279 -34.6276814103218,-58.519298252403 -34.6274268337721,-58.5186570605908 -34.6272931110027,-58.5188262572643 -34.6271623246358)))";;"411";10_4_3;COMUNA 10;"4";"3";"879";"393";"486";"80,86%";"341";"339";"99,41%";"2";"0,59%";"300";"0";"0";"300";"100,00%";"0";0.000
"MULTIPOLYGON (((-58.5196448226146 -34.6305320579289,-58.5192883700614 -34.63169367068,-58.5202409936535 -34.6327972049484,-58.520240990117 -34.6327972164433,-58.5203406721281 -34.6329106988005,-58.5203889306522 -34.6329687986306,-58.5205285842098 -34.6330043484914,-58.5207481211079 -34.6332198659579,-58.5215914490683 -34.6329281139806,-58.5222862670885 -34.6325657223949,-58.52237585918 -34.63250997254,-58.522475754963 -34.6324464708365,-58.522544478948 -34.6323997454626,-58.5226216312509 -34.632343931104,-58.5226700851842 -34.6323083427414,-58.522719729712 -34.632269725505,-58.5227945786037 -34.6322101092275,-58.5228560578343 -34.6321602181275,-58.5229917849624 -34.6320448656302,-58.5230317180113 -34.6320086475104,-58.5231390819201 -34.6319059149216,-58.5232157916631 -34.6318284799722,-58.5234288791647 -34.6315951269425,-58.5235076166675 -34.631495084417,-58.523599785883 -34.631354329565,-58.5237095401682 -34.6313765993963,-58.5238732356136 -34.6314115185618,-58.5243273007226 -34.6299575798886,-58.524182696009 -34.6299274405928,-58.5238817292095 -34.6298668152599,-58.523723490596 -34.6298333722877,-58.5225133996165 -34.6295774842826,-58.5214756977671 -34.6293580518254,-58.5213030601099 -34.6293210914028,-58.5211184078889 -34.6292816011945,-58.5200941786295 -34.629067925357,-58.5200609408336 -34.6291763248927,-58.5196448226146 -34.6305320579289)))";;"412";10_4_4;COMUNA 10;"4";"4";"814";"372";"442";"84,16%";"332";"332";"100,00%";"0";"0,00%";"288";"1";"0.35";"287";"99,65%";"0.35";0.350
"MULTIPOLYGON (((-58.5200941786295 -34.629067925357,-58.5188855607825 -34.6288158035677,-58.5174359788086 -34.6285133539328,-58.5174848500646 -34.628464597965,-58.5169616939729 -34.6280038304309,-58.5163823020055 -34.6284502989554,-58.5159146283928 -34.6288107272171,-58.5156480906228 -34.6290169768646,-58.5162328597291 -34.6293691981837,-58.5164015287285 -34.6294648314595,-58.517209168045 -34.6299228687609,-58.5173483493786 -34.6300016119212,-58.5182925395812 -34.6305362030079,-58.5192883700614 -34.63169367068,-58.5196448226146 -34.6305320579289,-58.5200609408336 -34.6291763248927,-58.5200941786295 -34.629067925357)))";;"413";10_4_5;COMUNA 10;"4";"5";"789";"387";"402";"96,27%";"334";"334";"100,00%";"0";"0,00%";"286";"1";"0.35";"285";"99,65%";"0.35";0.350
"MULTIPOLYGON (((-58.5146536725811 -34.6308128867855,-58.5150913365646 -34.6312081352074,-58.5154105919832 -34.6314940634511,-58.5161708464686 -34.6321750226008,-58.5172188019038 -34.6313652362241,-58.517746518917 -34.6309575209405,-58.5181165223053 -34.6306715692816,-58.5182925395812 -34.6305362030079,-58.5173483493786 -34.6300016119212,-58.517209168045 -34.6299228687609,-58.5164015287285 -34.6294648314595,-58.5162328597291 -34.6293691981837,-58.5156480906228 -34.6290169768646,-58.5152484517352 -34.6293261036724,-58.5151270181946 -34.6294201027248,-58.5149077380977 -34.6295886531018,-58.5140378474717 -34.6302574952917,-58.514152674261 -34.6303603376509,-58.5146536725811 -34.6308128867855)))";;"414";10_4_6;COMUNA 10;"4";"6";"655";"329";"326";"100,92%";"253";"253";"100,00%";"0";"0,00%";"235";"1";"0.43";"234";"99,57%";"0.43";0.430
"MULTIPOLYGON (((-58.5172188019038 -34.6313652362241,-58.5161708464686 -34.6321750226008,-58.5170622947681 -34.63298586278,-58.5170929294324 -34.6330137269439,-58.5181720913083 -34.6330038039818,-58.5183802384721 -34.6330018780921,-58.5188034340802 -34.632997951648,-58.5188882947028 -34.6329971379111,-58.5190825651118 -34.6330117670526,-58.5192540755709 -34.6330100678767,-58.5194253259584 -34.6330018190703,-58.519746695441 -34.63298371085,-58.5198962988276 -34.6329673022233,-58.5200677381262 -34.6329462453124,-58.5201736161655 -34.632912449445,-58.5202376799322 -34.6328033133341,-58.520240990117 -34.6327972164433,-58.5202409936535 -34.6327972049484,-58.5192883700614 -34.63169367068,-58.5182925395812 -34.6305362030079,-58.5181165223053 -34.6306715692816,-58.517746518917 -34.6309575209405,-58.5172188019038 -34.6313652362241)))";;"415";10_4_7;COMUNA 10;"4";"7";"775";"349";"426";"81,92%";"352";"352";"100,00%";"0";"0,00%";"301";"0";"0";"301";"100,00%";"0";0.000
"MULTIPOLYGON (((-58.5134258409365 -34.6330227017868,-58.5139131230102 -34.6334577941036,-58.5140736096968 -34.6334014571649,-58.5149118777418 -34.6332043341983,-58.5153693838328 -34.6331573753983,-58.5159327886532 -34.6330995232832,-58.5168208462029 -34.6330937097492,-58.5168333086193 -34.6330950701922,-58.5170622947681 -34.63298586278,-58.5161708464686 -34.6321750226008,-58.5154105919832 -34.6314940634511,-58.5150913365646 -34.6312081352074,-58.5146536725811 -34.6308128867855,-58.514152674261 -34.6303603376509,-58.5140378474717 -34.6302574952917,-58.5130233406981 -34.6310375918289,-58.5129079481751 -34.6311263042905,-58.5120449235782 -34.6317898474223,-58.5126662844592 -34.632344612748,-58.5134258409365 -34.6330227017868)))";;"416";10_4_8;COMUNA 10;"4";"8";"717";"348";"369";"94,31%";"324";"324";"100,00%";"0";"0,00%";"264";"4";"1.52";"260";"98,48%";"1.52";1.520
"MULTIPOLYGON (((-58.5101048138156 -34.633281370138,-58.5092044416872 -34.6339735703741,-58.509086827086 -34.634064674473,-58.5086815189852 -34.634378781849,-58.508388369859 -34.6345993921542,-58.5087636323814 -34.6346460130901,-58.5092229873229 -34.6346853470665,-58.5094052468205 -34.6347009821455,-58.5095979024296 -34.6347187256998,-58.5106707596029 -34.6348174666058,-58.5113275121671 -34.6345277604941,-58.5114466817436 -34.6344761619495,-58.5118646685666 -34.6342952840641,-58.5125329965063 -34.6339989468392,-58.5126230332772 -34.633960880609,-58.5133229662282 -34.6336648782254,-58.5139131230102 -34.6334577941036,-58.5134258409365 -34.6330227017868,-58.5126662844592 -34.632344612748,-58.5120449235782 -34.6317898474223,-58.5110429836382 -34.6325601331694,-58.5101048138156 -34.633281370138)))";;"417";10_4_9;COMUNA 10;"4";"9";"774";"363";"411";"88,32%";"355";"355";"100,00%";"0";"0,00%";"305";"0";"0";"305";"100,00%";"0";0.000
"MULTIPOLYGON (((-58.5183947101147 -34.6215081037901,-58.5182918241999 -34.6214161757018,-58.5179075591967 -34.6210721129168,-58.5169080184807 -34.6218444893468,-58.5167944311743 -34.621932218859,-58.5164626912902 -34.622184909458,-58.5165601211406 -34.6222725455641,-58.5173440786022 -34.6229677138421,-58.5174472198093 -34.6230578819675,-58.5175618686794 -34.6231579747481,-58.5184657766618 -34.6239544936263,-58.518784486373 -34.6237067333909,-58.5189076957016 -34.623611532573,-58.5193151414561 -34.6239445245829,-58.5197003787282 -34.6243121042385,-58.5201545862354 -34.6247454270793,-58.5206192831946 -34.6251871942072,-58.5216367132115 -34.6244050605043,-58.5211766371788 -34.6239940002573,-58.5206947428767 -34.6235634409086,-58.520288635877 -34.62320052225,-58.519896086232 -34.6228497793779,-58.5193814717947 -34.6223898628804,-58.5188890260358 -34.6219498642317,-58.5183947101147 -34.6215081037901)))";;"418";10_5_1;COMUNA 10;"5";"1";"700";"307";"393";"78,12%";"263";"263";"100,00%";"0";"0,00%";"243";"7";"2.88";"236";"97,12%";"2.88";2.880
"MULTIPOLYGON (((-58.5136883878736 -34.6243139202759,-58.5135838815705 -34.6242163549398,-58.5127520984634 -34.6234339961681,-58.5122098425394 -34.6238516261564,-58.5121152367146 -34.6239244839163,-58.5116515703906 -34.6242786266542,-58.5117764429308 -34.624388509819,-58.5124897170087 -34.6250205663116,-58.5126173179286 -34.6251303770626,-58.512713125374 -34.625212805418,-58.5135618620337 -34.6259662829317,-58.5136729311588 -34.6260649018892,-58.5141076613369 -34.6264479014523,-58.5144396785712 -34.6267404470339,-58.5145619160951 -34.6268482156696,-58.5148466948506 -34.6266633697024,-58.5156750492477 -34.6261248255256,-58.5151370858213 -34.6256510277948,-58.5146246971853 -34.6251940483272,-58.5138022709819 -34.6244201438609,-58.5136883878736 -34.6243139202759)))";;"419";10_5_10;COMUNA 10;"5";"10";"805";"377";"428";"88,08%";"327";"326";"99,69%";"1";"0,31%";"296";"4";"1.35";"292";"98,65%";"1.35";1.350
"MULTIPOLYGON (((-58.5157025837306 -34.6244090509199,-58.5147961372208 -34.623469479619,-58.5139053962907 -34.6225460925783,-58.5137850775098 -34.6226383293034,-58.5132948598477 -34.6230159409838,-58.5127520984634 -34.6234339961681,-58.5135838815705 -34.6242163549398,-58.5136883878736 -34.6243139202759,-58.5138022709819 -34.6244201438609,-58.5146246971853 -34.6251940483272,-58.5151370858213 -34.6256510277948,-58.5156750492477 -34.6261248255256,-58.5161162243911 -34.6257816637442,-58.516215851679 -34.6257031667069,-58.5166159768691 -34.6253879797969,-58.5167248001158 -34.6253032104554,-58.5157025837306 -34.6244090509199)))";;"420";10_5_11;COMUNA 10;"5";"11";"703";"345";"358";"96,37%";"296";"296";"100,00%";"0";"0,00%";"248";"3";"1.21";"245";"98,79%";"1.21";1.210
"MULTIPOLYGON (((-58.5142807415591 -34.6222584597299,-58.5139053962907 -34.6225460925783,-58.5147961372208 -34.623469479619,-58.5157025837306 -34.6244090509199,-58.5167248001158 -34.6253032104554,-58.5171331869583 -34.6249906238933,-58.5172576769157 -34.6248938044152,-58.5176617138713 -34.6245796686613,-58.5177915670295 -34.6244786911442,-58.5169109284089 -34.6236991998374,-58.516774457222 -34.6235789041682,-58.5157868641233 -34.6227081812356,-58.5156292568406 -34.6225691604199,-58.5149629448877 -34.6219767511801,-58.5148163362829 -34.6218478657796,-58.5146869937002 -34.621947149756,-58.5142807415591 -34.6222584597299)))";;"421";10_5_12;COMUNA 10;"5";"12";"767";"348";"419";"83,05%";"305";"305";"100,00%";"0";"0,00%";"265";"4";"1.51";"261";"98,49%";"1.51";1.510
"MULTIPOLYGON (((-58.5175055461025 -34.6259923222141,-58.5183411180018 -34.6267297858114,-58.5184692419708 -34.6268419141887,-58.518975637184 -34.6264515980035,-58.5195372050143 -34.6260188581947,-58.5200951064191 -34.625590131719,-58.5206192831946 -34.6251871942072,-58.5201545862354 -34.6247454270793,-58.5197003787282 -34.6243121042385,-58.5193151414561 -34.6239445245829,-58.5189076957016 -34.623611532573,-58.518784486373 -34.6237067333909,-58.5184657766618 -34.6239544936263,-58.5183481013622 -34.6240459589465,-58.5177915670295 -34.6244786911442,-58.5176617138713 -34.6245796686613,-58.5172576769157 -34.6248938044152,-58.5171331869583 -34.6249906238933,-58.5167248001158 -34.6253032104554,-58.5175055461025 -34.6259923222141)))";;"422";10_5_13;COMUNA 10;"5";"13";"820";"388";"432";"89,81%";"333";"333";"100,00%";"0";"0,00%";"288";"8";"2.78";"280";"97,22%";"2.78";2.780
"MULTIPOLYGON (((-58.5179557743365 -34.627237654171,-58.5184692419708 -34.6268419141887,-58.5183411180018 -34.6267297858114,-58.5175055461025 -34.6259923222141,-58.5167248001158 -34.6253032104554,-58.5166159768691 -34.6253879797969,-58.516215851679 -34.6257031667069,-58.5161162243911 -34.6257816637442,-58.5156750492477 -34.6261248255256,-58.5148466948506 -34.6266633697024,-58.5145619160951 -34.6268482156696,-58.5146787836144 -34.6269511975751,-58.5154226162532 -34.6276058300007,-58.5155471578301 -34.6277154981091,-58.5163823020055 -34.6284502989554,-58.5169616939729 -34.6280038304309,-58.5174130942302 -34.6276559410448,-58.5179557743365 -34.627237654171)))";;"423";10_5_14;COMUNA 10;"5";"14";"737";"358";"379";"94,46%";"332";"332";"100,00%";"0";"0,00%";"269";"4";"1.49";"265";"98,51%";"1.49";1.490
"MULTIPOLYGON (((-58.517431834985 -34.6206456223112,-58.5169501498522 -34.6202151886697,-58.5168376707553 -34.6203005937271,-58.515937746832 -34.6209874925519,-58.5158113016227 -34.6210840298943,-58.5154926763084 -34.6213286837323,-58.5148163362829 -34.6218478657796,-58.5149629448877 -34.6219767511801,-58.5156292568406 -34.6225691604199,-58.5157868641233 -34.6227081812356,-58.516774457222 -34.6235789041682,-58.5169109284089 -34.6236991998374,-58.5177915670295 -34.6244786911442,-58.5183481013622 -34.6240459589465,-58.5184657766618 -34.6239544936263,-58.5175618686794 -34.6231579747481,-58.5174472198093 -34.6230578819675,-58.5173440786022 -34.6229677138421,-58.5165601211406 -34.6222725455641,-58.5164626912902 -34.622184909458,-58.5167944311743 -34.621932218859,-58.5169080184807 -34.6218444893468,-58.5179075591967 -34.6210721129168,-58.517431834985 -34.6206456223112)))";;"424";10_5_2;COMUNA 10;"5";"2";"723";"331";"392";"84,44%";"348";"348";"100,00%";"0";"0,00%";"292";"3";"1.03";"289";"98,97%";"1.03";1.030
"MULTIPOLYGON (((-58.5165271135399 -34.6198376868261,-58.5164123838422 -34.6197353394512,-58.5156957982584 -34.6190958417279,-58.5150137437962 -34.618487171075,-58.5144738342211 -34.6189093176403,-58.5139414120856 -34.6193255429443,-58.5128810647967 -34.6201545338288,-58.5130612483471 -34.6203106622093,-58.5131547498136 -34.6203918235875,-58.5135598698501 -34.620746315598,-58.5141759522311 -34.6212855829771,-58.5142865889727 -34.6213827227121,-58.5146804680976 -34.6217285534203,-58.5148163362829 -34.6218478657796,-58.5154926763084 -34.6213286837323,-58.5158113016227 -34.6210840298943,-58.515937746832 -34.6209874925519,-58.5168376707553 -34.6203005937271,-58.5169501498522 -34.6202151886697,-58.5165271135399 -34.6198376868261)))";;"425";10_5_3;COMUNA 10;"5";"3";"936";"432";"504";"85,71%";"425";"425";"100,00%";"0";"0,00%";"355";"10";"2.82";"345";"97,18%";"2.82";2.820
"MULTIPOLYGON (((-58.5136507727683 -34.617270803608,-58.5130467346976 -34.6167316690861,-58.5126582991586 -34.6170321915308,-58.5125307499884 -34.6171308387375,-58.5122984707731 -34.617311644015,-58.5121753487934 -34.61740754247,-58.5118953858634 -34.6176258324138,-58.5117415248092 -34.6177457577509,-58.5110128281568 -34.6183126882102,-58.5109046042357 -34.6183969593399,-58.5115080543749 -34.6189534291089,-58.5121564133396 -34.6195210047904,-58.5127800634031 -34.6200669666421,-58.5128810647967 -34.6201545338288,-58.5139414120856 -34.6193255429443,-58.5144738342211 -34.6189093176403,-58.5150137437962 -34.618487171075,-58.514943936441 -34.6184248044297,-58.5143333187091 -34.6178799043541,-58.5136507727683 -34.617270803608)))";;"426";10_5_4;COMUNA 10;"5";"4";"921";"409";"512";"79,88%";"364";"363";"99,73%";"1";"0,28%";"323";"1";"0.31";"322";"99,69%";"0.31";0.310
"MULTIPOLYGON (((-58.5109046042357 -34.6183969593399,-58.5104665120313 -34.6187377070232,-58.5103389573767 -34.61883585894,-58.5098484931328 -34.6192174713252,-58.5094435125949 -34.6195262295399,-58.5091854171195 -34.6197235181641,-58.5090835750515 -34.6198013061284,-58.5088320336599 -34.6199918307049,-58.5086727973268 -34.6201124584113,-58.5084052432762 -34.6203116504064,-58.5083010146601 -34.6203897907296,-58.5081490142717 -34.6205037950908,-58.5078712386487 -34.6207097505097,-58.5077561059978 -34.6207901479994,-58.5083774712176 -34.6213992338801,-58.5090238688963 -34.621967460543,-58.5100136938073 -34.6212064908863,-58.5101170678554 -34.6211246873435,-58.5104547776996 -34.6208574336413,-58.5111649319591 -34.6202953030082,-58.511259788796 -34.6202202626687,-58.5116087326179 -34.6199468742884,-58.5120491241205 -34.6196019665649,-58.5121564133396 -34.6195210047904,-58.5115080543749 -34.6189534291089,-58.5109046042357 -34.6183969593399)))";;"427";10_5_5;COMUNA 10;"5";"5";"826";"374";"452";"82,74%";"345";"345";"100,00%";"0";"0,00%";"299";"4";"1.34";"295";"98,66%";"1.34";1.340
"MULTIPOLYGON (((-58.5080569325327 -34.6227102439313,-58.5085621295995 -34.6231959872833,-58.508647792845 -34.6232782113991,-58.5096458133172 -34.6225140726723,-58.5090238688963 -34.621967460543,-58.5083774712176 -34.6213992338801,-58.5077561059978 -34.6207901479994,-58.5076124625041 -34.6209223182448,-58.5069586395488 -34.6214179265455,-58.5068398466706 -34.6215074093122,-58.5066844362674 -34.6216245117621,-58.5062859025726 -34.6219251581851,-58.5069284602203 -34.6225004397753,-58.5075746065377 -34.6230789561512,-58.5080569325327 -34.6227102439313)))";;"428";10_5_6;COMUNA 10;"5";"6";"853";"378";"475";"79,58%";"399";"399";"100,00%";"0";"0,00%";"339";"2";"0.59";"337";"99,41%";"0.59";0.590
"MULTIPOLYGON (((-58.508647792845 -34.6232782113991,-58.5085621295995 -34.6231959872833,-58.5080569325327 -34.6227102439313,-58.5075746065377 -34.6230789561512,-58.508804278174 -34.6241798734599,-58.5101845118595 -34.6254155833921,-58.5105631129392 -34.6251152139257,-58.51073572209 -34.6249782399968,-58.5112126804249 -34.6246138838752,-58.5116515703906 -34.6242786266542,-58.5112789149985 -34.6239503840977,-58.511026445283 -34.6237281528086,-58.5109545914069 -34.623664939646,-58.5105963464114 -34.6233496474596,-58.5104994340893 -34.6232644008492,-58.51040610184 -34.6231823218836,-58.5102687887592 -34.6230616671256,-58.5099362898681 -34.6227694623131,-58.5096458133172 -34.6225140726723,-58.508647792845 -34.6232782113991)))";;"429";10_5_7;COMUNA 10;"5";"7";"855";"404";"451";"89,58%";"366";"365";"99,73%";"1";"0,27%";"306";"21";"6.86";"285";"93,14%";"6.86";6.860
"MULTIPOLYGON (((-58.5126102758043 -34.621479268475,-58.5128301348086 -34.621309454124,-58.5135598698501 -34.620746315598,-58.5131547498136 -34.6203918235875,-58.5130612483471 -34.6203106622093,-58.5128810647967 -34.6201545338288,-58.5127800634031 -34.6200669666421,-58.5121564133396 -34.6195210047904,-58.5120491241205 -34.6196019665649,-58.5116087326179 -34.6199468742884,-58.511259788796 -34.6202202626687,-58.5111649319591 -34.6202953030082,-58.5104547776996 -34.6208574336413,-58.5101170678554 -34.6211246873435,-58.5100136938073 -34.6212064908863,-58.5090238688963 -34.621967460543,-58.5096458133172 -34.6225140726723,-58.5099362898681 -34.6227694623131,-58.5102687887592 -34.6230616671256,-58.51040610184 -34.6231823218836,-58.511500238303 -34.6223369303653,-58.5126102758043 -34.621479268475)))";;"430";10_5_8;COMUNA 10;"5";"8";"962";"466";"496";"93,95%";"407";"407";"100,00%";"0";"0,00%";"357";"9";"2.52";"348";"97,48%";"2.52";2.520
"MULTIPOLYGON (((-58.511500238303 -34.6223369303653,-58.51040610184 -34.6231823218836,-58.5104994340893 -34.6232644008492,-58.5105963464114 -34.6233496474596,-58.5109545914069 -34.623664939646,-58.511026445283 -34.6237281528086,-58.5112789149985 -34.6239503840977,-58.5116515703906 -34.6242786266542,-58.5121152367146 -34.6239244839163,-58.5122098425394 -34.6238516261564,-58.5127520984634 -34.6234339961681,-58.5132948598477 -34.6230159409838,-58.5137850775098 -34.6226383293034,-58.5139053962907 -34.6225460925783,-58.5142807415591 -34.6222584597299,-58.5146869937002 -34.621947149756,-58.5148163362829 -34.6218478657796,-58.5146804680976 -34.6217285534203,-58.5142865889727 -34.6213827227121,-58.5141759522311 -34.6212855829771,-58.5135598698501 -34.620746315598,-58.5128301348086 -34.621309454124,-58.5126102758043 -34.621479268475,-58.511500238303 -34.6223369303653)))";;"431";10_5_9;COMUNA 10;"5";"9";"693";"322";"371";"86,79%";"314";"313";"99,68%";"1";"0,32%";"263";"8";"3.04";"255";"96,96%";"3.04";3.040
"MULTIPOLYGON (((-58.5103071706264 -34.6180692246476,-58.509693751344 -34.6185409579699,-58.5089715868964 -34.6190963943788,-58.5090843475808 -34.6191993129155,-58.5093264893754 -34.6194192987451,-58.5094435125949 -34.6195262295399,-58.5098484931328 -34.6192174713252,-58.5103389573767 -34.61883585894,-58.5104665120313 -34.6187377070232,-58.5109046042357 -34.6183969593399,-58.5110128281568 -34.6183126882102,-58.5117415248092 -34.6177457577509,-58.5118953858634 -34.6176258324138,-58.5121753487934 -34.61740754247,-58.5122984707731 -34.617311644015,-58.5125307499884 -34.6171308387375,-58.5126582991586 -34.6170321915308,-58.5130467346976 -34.6167316690861,-58.5125738737806 -34.6164518533793,-58.5121374874334 -34.6161927964365,-58.5116778403144 -34.6159199439529,-58.5113518644655 -34.6162553680061,-58.5110458914486 -34.6165682472343,-58.5107188883385 -34.6169037403948,-58.5106019974477 -34.6170235793264,-58.5098380723621 -34.6178121442108,-58.5103071706264 -34.6180692246476)))";;"432";10_6_1;COMUNA 10;"6";"1";"662";"312";"350";"89,14%";"270";"270";"100,00%";"0";"0,00%";"231";"7";"3.03";"224";"96,97%";"3.03";3.030
"MULTIPOLYGON (((-58.5028442005655 -34.61520398996,-58.5019329136309 -34.6146807465462,-58.5018092088523 -34.6148225519098,-58.5010782999798 -34.6156714763546,-58.5009606373668 -34.6158067294055,-58.5008255206857 -34.6159619885089,-58.5000996099856 -34.6167935808173,-58.5012011553876 -34.6173744559426,-58.5024287387223 -34.6180216204505,-58.50321282404 -34.6172008406045,-58.5033122706613 -34.6170972827429,-58.5034336837771 -34.6169708997553,-58.503789832105 -34.6165994291071,-58.5042305218823 -34.6161397564942,-58.504319663801 -34.6160465537833,-58.5035210048313 -34.6155907510335,-58.5029992781131 -34.6152930265246,-58.5028442005655 -34.61520398996)))";;"433";10_6_10;COMUNA 10;"6";"10";"1100";"492";"608";"80,92%";"450";"450";"100,00%";"0";"0,00%";"422";"36";"8.53";"386";"91,47%";"8.53";8.530
"MULTIPOLYGON (((-58.507022774626 -34.6162654686367,-58.5069143024361 -34.6162054354382,-58.5064514416973 -34.6159447479536,-58.5063013878999 -34.6158609958717,-58.5051253377705 -34.6152044152351,-58.5050335583822 -34.6153004364642,-58.5047703086002 -34.6155756077765,-58.504319663801 -34.6160465537833,-58.5042305218823 -34.6161397564942,-58.503789832105 -34.6165994291071,-58.5034336837771 -34.6169708997553,-58.5033122706613 -34.6170972827429,-58.5035478702122 -34.617221785964,-58.5038011072264 -34.617352902739,-58.5042458928674 -34.6175831827648,-58.5044425511691 -34.6176800204679,-58.5046742302649 -34.6177941703635,-58.5050023690728 -34.6179632883484,-58.5051180831144 -34.6180234615615,-58.5054967539423 -34.6182206602111,-58.5056866858281 -34.618318272932,-58.5059788208353 -34.6180456248206,-58.5066827129706 -34.6173890822784,-58.5068174107692 -34.6172633953911,-58.5074565797065 -34.6166641976729,-58.5075625819074 -34.6165647890117,-58.5073867080039 -34.6164683712596,-58.507145136207 -34.6163331730081,-58.507022774626 -34.6162654686367)))";;"434";10_6_11;COMUNA 10;"6";"11";"786";"356";"430";"82,79%";"317";"317";"100,00%";"0";"0,00%";"280";"0";"0";"280";"100,00%";"0";0.000
"MULTIPOLYGON (((-58.5066827129706 -34.6173890822784,-58.5059788208353 -34.6180456248206,-58.5056866858281 -34.618318272932,-58.5058757661055 -34.6184155335318,-58.5067346048724 -34.6188665100305,-58.5069160205789 -34.6189634900746,-58.5079049096307 -34.6194918785862,-58.5080461074393 -34.6195672513597,-58.5088320336599 -34.6199918307049,-58.5090835750515 -34.6198013061284,-58.5091854171195 -34.6197235181641,-58.5094435125949 -34.6195262295399,-58.5093264893754 -34.6194192987451,-58.5090843475808 -34.6191993129155,-58.5089715868964 -34.6190963943788,-58.509693751344 -34.6185409579699,-58.5103071706264 -34.6180692246476,-58.5098380723621 -34.6178121442108,-58.5088202114433 -34.6172542036654,-58.5080280020981 -34.6168199077226,-58.5075625819074 -34.6165647890117,-58.5074565797065 -34.6166641976729,-58.5068174107692 -34.6172633953911,-58.5066827129706 -34.6173890822784)))";;"435";10_6_12;COMUNA 10;"6";"12";"717";"324";"393";"82,44%";"317";"315";"99,37%";"2";"0,63%";"266";"3";"1.13";"263";"98,87%";"1.13";1.130
"MULTIPOLYGON (((-58.5069160205789 -34.6189634900746,-58.5067346048724 -34.6188665100305,-58.5058757661055 -34.6184155335318,-58.5056866858281 -34.618318272932,-58.5054967539423 -34.6182206602111,-58.5051180831144 -34.6180234615615,-58.5050023690728 -34.6179632883484,-58.5046742302649 -34.6177941703635,-58.5044425511691 -34.6176800204679,-58.5042458928674 -34.6175831827648,-58.5038011072264 -34.617352902739,-58.5035478702122 -34.617221785964,-58.5033122706613 -34.6170972827429,-58.50321282404 -34.6172008406045,-58.5024287387223 -34.6180216204505,-58.5030496504257 -34.6183447379264,-58.5035275861561 -34.6185934609173,-58.504362638432 -34.6190279121873,-58.5045995222234 -34.6191512156715,-58.5047538378221 -34.6192313766555,-58.5059687744397 -34.6198621006574,-58.5068940064571 -34.6203424900008,-58.5077561059978 -34.6207901479994,-58.5078712386487 -34.6207097505097,-58.5081490142717 -34.6205037950908,-58.5083010146601 -34.6203897907296,-58.5084052432762 -34.6203116504064,-58.5086727973268 -34.6201124584113,-58.5088320336599 -34.6199918307049,-58.5080461074393 -34.6195672513597,-58.5079049096307 -34.6194918785862,-58.5069160205789 -34.6189634900746)))";;"436";10_6_13;COMUNA 10;"6";"13";"1043";"476";"567";"83,95%";"479";"478";"99,79%";"1";"0,21%";"395";"0";"0";"395";"100,00%";"0";0.000
"MULTIPOLYGON (((-58.5108412960787 -34.6154215971817,-58.510703590772 -34.6153383386105,-58.510575855564 -34.6152608508246,-58.5104286062974 -34.6151707644556,-58.5103444153027 -34.615119246226,-58.5101381127864 -34.6149913642982,-58.5100183889197 -34.6149192251125,-58.5097440900604 -34.614754114013,-58.5095807397496 -34.6146583283903,-58.5087193089235 -34.6154795307979,-58.5085889594061 -34.6156018377818,-58.5075625819074 -34.6165647890117,-58.5080280020981 -34.6168199077226,-58.5088202114433 -34.6172542036654,-58.5098380723621 -34.6178121442108,-58.5106019974477 -34.6170235793264,-58.5107188883385 -34.6169037403948,-58.5110458914486 -34.6165682472343,-58.5113518644655 -34.6162553680061,-58.5116778403144 -34.6159199439529,-58.5112506626707 -34.6156664436941,-58.5110036285098 -34.6155197759579,-58.5108412960787 -34.6154215971817)))";;"437";10_6_2;COMUNA 10;"6";"2";"682";"328";"354";"92,66%";"299";"299";"100,00%";"0";"0,00%";"247";"18";"7.29";"229";"92,71%";"7.29";7.290
"MULTIPOLYGON (((-58.5061711647716 -34.6141095007904,-58.505640762605 -34.6146647789744,-58.5051253377705 -34.6152044152351,-58.5063013878999 -34.6158609958717,-58.5064514416973 -34.6159447479536,-58.5069143024361 -34.6162054354382,-58.507022774626 -34.6162654686367,-58.507145136207 -34.6163331730081,-58.5073867080039 -34.6164683712596,-58.5075625819074 -34.6165647890117,-58.5085889594061 -34.6156018377818,-58.5087193089235 -34.6154795307979,-58.5095807397496 -34.6146583283903,-58.509205896211 -34.6144387456713,-58.5090561812935 -34.6143517572749,-58.5088477568613 -34.6142307051847,-58.5087249694798 -34.6141601152299,-58.5084677216559 -34.6140122489454,-58.5083084647935 -34.6139196996237,-58.5080156001469 -34.6137495913673,-58.5078681034367 -34.61366443173,-58.5076250029036 -34.6135240234742,-58.5075218146791 -34.6134631437408,-58.5070547002468 -34.613187529869,-58.5069412153674 -34.6133051105254,-58.5066073156884 -34.6136537648354,-58.5062825227826 -34.6139929075757,-58.5061711647716 -34.6141095007904)))";;"438";10_6_3;COMUNA 10;"6";"3";"1071";"480";"591";"81,22%";"429";"429";"100,00%";"0";"0,00%";"388";"3";"0.77";"385";"99,23%";"0.77";0.770
"MULTIPOLYGON (((-58.5037216802868 -34.6112240474055,-58.5034081272674 -34.6110363991103,-58.5032532259876 -34.6109441233871,-58.5031020740332 -34.6108540998275,-58.5023694099685 -34.6104193947906,-58.502261802801 -34.6105437300479,-58.5016700473181 -34.6112371852227,-58.5015435398666 -34.6113867380515,-58.5022998102098 -34.6118364408624,-58.5024639142684 -34.6119343487906,-58.5035041009129 -34.6125548024829,-58.5036886569582 -34.6126642516228,-58.5039123231564 -34.6127968571281,-58.5044017483833 -34.6130840251426,-58.5045597209918 -34.6131753827934,-58.5047475162428 -34.613283913682,-58.5060027898093 -34.6140055428473,-58.5061711647716 -34.6141095007904,-58.5062825227826 -34.6139929075757,-58.5066073156884 -34.6136537648354,-58.5069412153674 -34.6133051105254,-58.5070547002468 -34.613187529869,-58.5055644196997 -34.6123083124561,-58.5054122451915 -34.612227236126,-58.5052496761716 -34.6121407404987,-58.5046650738263 -34.6117874794534,-58.5045270401037 -34.6117044956693,-58.5042788356775 -34.611555208884,-58.5041395251989 -34.6114725772185,-58.5038606494954 -34.6113072430676,-58.5037216802868 -34.6112240474055)))";;"439";10_6_4;COMUNA 10;"6";"4";"868";"400";"468";"85,47%";"386";"386";"100,00%";"0";"0,00%";"319";"4";"1.25";"315";"98,75%";"1.25";1.250
"MULTIPOLYGON (((-58.5026798991927 -34.6138205435709,-58.502549045431 -34.6139703100791,-58.5020390797041 -34.6145589474282,-58.5019329136309 -34.6146807465462,-58.5028442005655 -34.61520398996,-58.5029992781131 -34.6152930265246,-58.5035210048313 -34.6155907510335,-58.504319663801 -34.6160465537833,-58.5047703086002 -34.6155756077765,-58.5050335583822 -34.6153004364642,-58.5051253377705 -34.6152044152351,-58.505640762605 -34.6146647789744,-58.5061711647716 -34.6141095007904,-58.5060027898093 -34.6140055428473,-58.5047475162428 -34.613283913682,-58.5045597209918 -34.6131753827934,-58.5044017483833 -34.6130840251426,-58.5039123231564 -34.6127968571281,-58.5036886569582 -34.6126642516228,-58.5035501453301 -34.6128238813158,-58.5026798991927 -34.6138205435709)))";;"440";10_6_5;COMUNA 10;"6";"5";"876";"411";"465";"88,39%";"394";"394";"100,00%";"0";"0,00%";"353";"5";"1.42";"348";"98,58%";"1.42";1.420
"MULTIPOLYGON (((-58.5026798991927 -34.6138205435709,-58.5035501453301 -34.6128238813158,-58.5036886569582 -34.6126642516228,-58.5035041009129 -34.6125548024829,-58.5024639142684 -34.6119343487906,-58.5022998102098 -34.6118364408624,-58.5015435398666 -34.6113867380515,-58.5013934966824 -34.6112975571294,-58.5006018769865 -34.6108265208372,-58.5004775775476 -34.6109642404678,-58.4995448936575 -34.6119991408136,-58.4987681644909 -34.6128610942804,-58.4996271829141 -34.6133567002806,-58.4997930744634 -34.6134519350831,-58.5007992527975 -34.6140296740019,-58.5019329136309 -34.6146807465462,-58.5020390797041 -34.6145589474282,-58.502549045431 -34.6139703100791,-58.5026798991927 -34.6138205435709)))";;"441";10_6_6;COMUNA 10;"6";"6";"851";"419";"432";"96,99%";"351";"351";"100,00%";"0";"0,00%";"298";"2";"0.67";"296";"99,33%";"0.67";0.670
"MULTIPOLYGON (((-58.4993513720599 -34.6100803967446,-58.4984438950537 -34.6111102106427,-58.4982997567096 -34.6112759630502,-58.4981585125336 -34.6114384748875,-58.4975330776257 -34.6121496668153,-58.4986095173046 -34.6127695884717,-58.4987681644909 -34.6128610942804,-58.4995448936575 -34.6119991408136,-58.5004775775476 -34.6109642404678,-58.5006018769865 -34.6108265208372,-58.5013934966824 -34.6112975571294,-58.5015435398666 -34.6113867380515,-58.5016700473181 -34.6112371852227,-58.502261802801 -34.6105437300479,-58.5023694099685 -34.6104193947906,-58.5022070985256 -34.6103231059069,-58.5014599583937 -34.609877484161,-58.5013273842551 -34.6097984388005,-58.500192507164 -34.6091257399437,-58.4993513720599 -34.6100803967446)))";;"442";10_6_7;COMUNA 10;"6";"7";"831";"394";"437";"90,16%";"350";"349";"99,71%";"1";"0,29%";"284";"1";"0.35";"283";"99,65%";"0.35";0.350
"MULTIPOLYGON (((-58.4965604258976 -34.6132638542038,-58.4964396941071 -34.6134023433545,-58.4955730166701 -34.6143910662566,-58.4968014514954 -34.6150432876844,-58.497775582879 -34.6139624797519,-58.4980058027999 -34.6140964322514,-58.498659314729 -34.614469423803,-58.4988490652315 -34.614579794225,-58.4989588946337 -34.6144489822903,-58.4996654536692 -34.6136031764526,-58.4997930744634 -34.6134519350831,-58.4996271829141 -34.6133567002806,-58.4987681644909 -34.6128610942804,-58.4986095173046 -34.6127695884717,-58.4975330776257 -34.6121496668153,-58.4974040899233 -34.6122963286118,-58.4965604258976 -34.6132638542038)))";;"443";10_6_8;COMUNA 10;"6";"8";"866";"388";"478";"81,17%";"392";"392";"100,00%";"0";"0,00%";"339";"2";"0.59";"337";"99,41%";"0.59";0.590
"MULTIPOLYGON (((-58.4988490652315 -34.614579794225,-58.498659314729 -34.614469423803,-58.4980058027999 -34.6140964322514,-58.497775582879 -34.6139624797519,-58.4968014514954 -34.6150432876844,-58.4979458949145 -34.6156508010549,-58.499056954859 -34.6162407073163,-58.499916588589 -34.6166970136374,-58.5000996099856 -34.6167935808173,-58.5008255206857 -34.6159619885089,-58.5009606373668 -34.6158067294055,-58.5010782999798 -34.6156714763546,-58.5018092088523 -34.6148225519098,-58.5019329136309 -34.6146807465462,-58.5007992527975 -34.6140296740019,-58.4997930744634 -34.6134519350831,-58.4996654536692 -34.6136031764526,-58.4989588946337 -34.6144489822903,-58.4988490652315 -34.614579794225)))";;"444";10_6_9;COMUNA 10;"6";"9";"965";"442";"523";"84,51%";"459";"459";"100,00%";"0";"0,00%";"357";"5";"1.4";"352";"98,60%";"1.4";1.400
"MULTIPOLYGON (((-58.508804278174 -34.6241798734599,-58.5086962138229 -34.6242623818695,-58.5079870212043 -34.6248056235449,-58.5068559594603 -34.6237814256549,-58.5067642483515 -34.6236983573724,-58.5057695930728 -34.6244587386814,-58.504762145412 -34.6252287644203,-58.5058695252675 -34.6262691876003,-58.5059626036329 -34.6263564815303,-58.5071780953975 -34.6274963646332,-58.5072937592861 -34.6275943538772,-58.5081810580616 -34.6269288629614,-58.5083128022969 -34.6268308527082,-58.5092561231607 -34.6261296274968,-58.5093623157589 -34.6260483165555,-58.5100827506526 -34.6254963299362,-58.5101845118595 -34.6254155833921,-58.508804278174 -34.6241798734599)))";;"445";10_7_1;COMUNA 10;"7";"1";"1142";"509";"633";"80,41%";"438";"436";"99,54%";"2";"0,46%";"381";"3";"0.79";"378";"99,21%";"0.79";0.790
"MULTIPOLYGON (((-58.5020542720081 -34.6220214591921,-58.5016602661974 -34.622936053905,-58.5015809367524 -34.6230844646153,-58.501754257637 -34.6231712432277,-58.5026973029711 -34.6236425031874,-58.5034920834946 -34.6240323942434,-58.5040302156817 -34.6236264949421,-58.5044567832945 -34.6233047893102,-58.5054796299132 -34.6225342674838,-58.5058530474257 -34.622251661403,-58.5050518145853 -34.621893690368,-58.5039163985217 -34.6213863151807,-58.5037631083297 -34.6213189701687,-58.5025727533131 -34.6207961778298,-58.5021168186502 -34.6218764339718,-58.5020542720081 -34.6220214591921)))";;"446";10_7_10;COMUNA 10;"7";"10";"1115";"531";"584";"90,92%";"439";"439";"100,00%";"0";"0,00%";"402";"4";"1";"398";"99,00%";"1";1.000
"MULTIPOLYGON (((-58.5069284602203 -34.6225004397753,-58.5062859025726 -34.6219251581851,-58.5058530474257 -34.622251661403,-58.5054796299132 -34.6225342674838,-58.5044567832945 -34.6233047893102,-58.5040302156817 -34.6236264949421,-58.5034920834946 -34.6240323942434,-58.5046699217866 -34.6251420326626,-58.504762145412 -34.6252287644203,-58.5057695930728 -34.6244587386814,-58.5067642483515 -34.6236983573724,-58.5068559594603 -34.6237814256549,-58.5079870212043 -34.6248056235449,-58.5086962138229 -34.6242623818695,-58.508804278174 -34.6241798734599,-58.5075746065377 -34.6230789561512,-58.5069284602203 -34.6225004397753)))";;"447";10_7_2;COMUNA 10;"7";"2";"1068";"490";"578";"84,78%";"521";"521";"100,00%";"0";"0,00%";"407";"3";"0.74";"404";"99,26%";"0.74";0.740
"MULTIPOLYGON (((-58.50426859857 -34.6202386909075,-58.5031871498126 -34.6197636858839,-58.5030386314938 -34.6196916903083,-58.502629935794 -34.6206607318698,-58.5025727533131 -34.6207961778298,-58.5037631083297 -34.6213189701687,-58.5039163985217 -34.6213863151807,-58.5050518145853 -34.621893690368,-58.5058530474257 -34.622251661403,-58.5062859025726 -34.6219251581851,-58.5066844362674 -34.6216245117621,-58.5068398466706 -34.6215074093122,-58.5069586395488 -34.6214179265455,-58.5076124625041 -34.6209223182448,-58.5077561059978 -34.6207901479994,-58.5068940064571 -34.6203424900008,-58.5059687744397 -34.6198621006574,-58.5047538378221 -34.6192313766555,-58.5046596044272 -34.6193697238159,-58.5044358971009 -34.6198732688986,-58.5043305520375 -34.620110355438,-58.50426859857 -34.6202386909075)))";;"448";10_7_3;COMUNA 10;"7";"3";"1223";"519";"704";"73,72%";"522";"521";"99,81%";"1";"0,19%";"471";"18";"3.82";"453";"96,18%";"3.82";3.820
"MULTIPOLYGON (((-58.5012649132953 -34.6202208035506,-58.5014455511054 -34.6203010308067,-58.5020747172672 -34.6205773883027,-58.5025727533131 -34.6207961778298,-58.502629935794 -34.6206607318698,-58.5030386314938 -34.6196916903083,-58.5031871498126 -34.6197636858839,-58.50426859857 -34.6202386909075,-58.5043305520375 -34.620110355438,-58.5044358971009 -34.6198732688986,-58.5046596044272 -34.6193697238159,-58.5047538378221 -34.6192313766555,-58.5045995222234 -34.6191512156715,-58.504362638432 -34.6190279121873,-58.5035275861561 -34.6185934609173,-58.5030496504257 -34.6183447379264,-58.5024287387223 -34.6180216204505,-58.5012011553876 -34.6173744559426,-58.5000996099856 -34.6167935808173,-58.4994118130367 -34.6173516968482,-58.500318870512 -34.6181002498116,-58.5013000857767 -34.6189100422515,-58.5004761946527 -34.6195694782364,-58.5003614018987 -34.6196602915594,-58.5002323874669 -34.6197623067248,-58.5012649132953 -34.6202208035506)))";;"449";10_7_4;COMUNA 10;"7";"4";"1133";"511";"622";"82,15%";"533";"531";"99,62%";"2";"0,38%";"434";"4";"0.92";"430";"99,08%";"0.92";0.920
"MULTIPOLYGON (((-58.4994118130367 -34.6173516968482,-58.5000996099856 -34.6167935808173,-58.499916588589 -34.6166970136374,-58.499056954859 -34.6162407073163,-58.4979458949145 -34.6156508010549,-58.4968014514954 -34.6150432876844,-58.4955730166701 -34.6143910662566,-58.4947856553692 -34.6150160165976,-58.4956239755269 -34.6157347626141,-58.4957797443478 -34.6158654293676,-58.4965267256207 -34.6164918665804,-58.4966755945113 -34.6166157732821,-58.4976015380306 -34.6173818066968,-58.4984723639412 -34.6181041152183,-58.4985960990726 -34.6182061951529,-58.4993765232249 -34.6188490842702,-58.5003614018987 -34.6196602915594,-58.5004761946527 -34.6195694782364,-58.5013000857767 -34.6189100422515,-58.500318870512 -34.6181002498116,-58.4994118130367 -34.6173516968482)))";;"450";10_7_5;COMUNA 10;"7";"5";"843";"380";"463";"82,07%";"444";"444";"100,00%";"0";"0,00%";"366";"13";"3.55";"353";"96,45%";"3.55";3.550
"MULTIPOLYGON (((-58.4959821562226 -34.6186737133169,-58.4965275208407 -34.6182419987992,-58.4955986786824 -34.6174693381695,-58.4965590983721 -34.6167075694962,-58.4966755945113 -34.6166157732821,-58.4965267256207 -34.6164918665804,-58.4957797443478 -34.6158654293676,-58.4956239755269 -34.6157347626141,-58.4947856553692 -34.6150160165976,-58.4938293260526 -34.6157731224229,-58.4937100182548 -34.6158686491746,-58.4926364061189 -34.6167283141618,-58.4927782835051 -34.6168496216051,-58.493634412812 -34.6175793629891,-58.4937929947961 -34.617714538728,-58.4945163756632 -34.6183271907688,-58.4946578319759 -34.6184469467522,-58.4954464091607 -34.6190977464602,-58.4959821562226 -34.6186737133169)))";;"451";10_7_6;COMUNA 10;"7";"6";"960";"452";"508";"88,98%";"412";"411";"99,76%";"1";"0,24%";"342";"4";"1.17";"338";"98,83%";"1.17";1.170
"MULTIPOLYGON (((-58.4976015380306 -34.6173818066968,-58.4966755945113 -34.6166157732821,-58.4965590983721 -34.6167075694962,-58.4955986786824 -34.6174693381695,-58.4965275208407 -34.6182419987992,-58.4973971542571 -34.6189653715998,-58.4975122827734 -34.619061187241,-58.4982950937229 -34.6197084488555,-58.4993765232249 -34.6188490842702,-58.4985960990726 -34.6182061951529,-58.4984723639412 -34.6181041152183,-58.4976015380306 -34.6173818066968)))";;"452";10_7_7;COMUNA 10;"7";"7";"1514";"697";"817";"85,31%";"556";"555";"99,82%";"1";"0,18%";"515";"2";"0.39";"513";"99,61%";"0.39";0.390
"MULTIPOLYGON (((-58.4963191075876 -34.6198178160465,-58.4972209658125 -34.6205620268247,-58.4982009015837 -34.6213705061531,-58.4991515492499 -34.6206170305434,-58.499275371546 -34.6205190323159,-58.5002323874669 -34.6197623067248,-58.5003614018987 -34.6196602915594,-58.4993765232249 -34.6188490842702,-58.4982950937229 -34.6197084488555,-58.4975122827734 -34.619061187241,-58.4973971542571 -34.6189653715998,-58.4965275208407 -34.6182419987992,-58.4959821562226 -34.6186737133169,-58.4954464091607 -34.6190977464602,-58.4963191075876 -34.6198178160465)))";;"453";10_7_8;COMUNA 10;"7";"8";"1047";"490";"557";"87,97%";"419";"418";"99,76%";"1";"0,24%";"384";"0";"0";"384";"100,00%";"0";0.000
"MULTIPOLYGON (((-58.5002700494297 -34.6224280217262,-58.5015809367524 -34.6230844646153,-58.5016602661974 -34.622936053905,-58.5020542720081 -34.6220214591921,-58.5021168186502 -34.6218764339718,-58.5025727533131 -34.6207961778298,-58.5020747172672 -34.6205773883027,-58.5014455511054 -34.6203010308067,-58.5012649132953 -34.6202208035506,-58.5002323874669 -34.6197623067248,-58.499275371546 -34.6205190323159,-58.4991515492499 -34.6206170305434,-58.4982009015837 -34.6213705061531,-58.4991731427412 -34.621878124299,-58.4993439025519 -34.621964132446,-58.5002700494297 -34.6224280217262)))";;"454";10_7_9;COMUNA 10;"7";"9";"959";"453";"506";"89,53%";"395";"395";"100,00%";"0";"0,00%";"339";"14";"4.13";"325";"95,87%";"4.13";4.130
"MULTIPOLYGON (((-58.5112857702294 -34.6257726266765,-58.5111375112142 -34.6258840978756,-58.5116845809891 -34.6263777694085,-58.5122696748818 -34.6269056495078,-58.5124307950794 -34.6267880447405,-58.5128659559239 -34.6271820347952,-58.5129419067093 -34.6272502452747,-58.5133676083809 -34.6276324060192,-58.5134722016851 -34.6277263093527,-58.5138340603963 -34.6280509578502,-58.5142135675044 -34.6283913729808,-58.5143034156812 -34.628472534909,-58.5154226162532 -34.6276058300007,-58.5146787836144 -34.6269511975751,-58.5145619160951 -34.6268482156696,-58.5144396785712 -34.6267404470339,-58.5141076613369 -34.6264479014523,-58.5136729311588 -34.6260649018892,-58.5135618620337 -34.6259662829317,-58.512713125374 -34.625212805418,-58.5126173179286 -34.6251303770626,-58.5124897170087 -34.6250205663116,-58.5117764429308 -34.624388509819,-58.5116515703906 -34.6242786266542,-58.5112126804249 -34.6246138838752,-58.51073572209 -34.6249782399968,-58.5105631129392 -34.6251152139257,-58.5106968558597 -34.6252431234832,-58.5112857702294 -34.6257726266765)))";;"455";10_8_1;COMUNA 10;"8";"1";"1085";"503";"582";"86,43%";"468";"468";"100,00%";"0";"0,00%";"406";"5";"1.23";"401";"98,77%";"1.23";1.230
"MULTIPOLYGON (((-58.5138340603963 -34.6280509578502,-58.5134722016851 -34.6277263093527,-58.5133676083809 -34.6276324060192,-58.5132499995453 -34.627710767311,-58.5121276890862 -34.6285458327624,-58.5120151076144 -34.6286295431078,-58.5111083164958 -34.6293045063951,-58.5100908841196 -34.6300617621709,-58.511099731914 -34.6309534379111,-58.5119314614992 -34.6316884814739,-58.5120449235782 -34.6317898474223,-58.5129079481751 -34.6311263042905,-58.5130233406981 -34.6310375918289,-58.5140378474717 -34.6302574952917,-58.5149077380977 -34.6295886531018,-58.5151270181946 -34.6294201027248,-58.5152484517352 -34.6293261036724,-58.5156480906228 -34.6290169768646,-58.5159146283928 -34.6288107272171,-58.5163823020055 -34.6284502989554,-58.5155471578301 -34.6277154981091,-58.5154226162532 -34.6276058300007,-58.5143034156812 -34.628472534909,-58.5142135675044 -34.6283913729808,-58.5138340603963 -34.6280509578502)))";;"456";10_8_2;COMUNA 10;"8";"2";"1208";"578";"630";"91,75%";"489";"487";"99,59%";"2";"0,41%";"428";"11";"2.57";"417";"97,43%";"2.57";2.570
"MULTIPOLYGON (((-58.5122696748818 -34.6269056495078,-58.5116845809891 -34.6263777694085,-58.5111375112142 -34.6258840978756,-58.5112857702294 -34.6257726266765,-58.5106968558597 -34.6252431234832,-58.5105631129392 -34.6251152139257,-58.5101845118595 -34.6254155833921,-58.5100827506526 -34.6254963299362,-58.5093623157589 -34.6260483165555,-58.5094941790658 -34.6261673545907,-58.5100686893331 -34.6266881364151,-58.5102979839864 -34.6268959415133,-58.5106200213089 -34.6271877971202,-58.5107050913967 -34.6272649493742,-58.5111852527482 -34.6276974501021,-58.511707358155 -34.6281676093842,-58.5120353712658 -34.6284630504579,-58.5121276890862 -34.6285458327624,-58.5132499995453 -34.627710767311,-58.5133676083809 -34.6276324060192,-58.5129419067093 -34.6272502452747,-58.5128659559239 -34.6271820347952,-58.5124307950794 -34.6267880447405,-58.5122696748818 -34.6269056495078)))";;"457";10_8_3;COMUNA 10;"8";"3";"800";"363";"437";"83,07%";"362";"362";"100,00%";"0";"0,00%";"319";"3";"0.94";"316";"99,06%";"0.94";0.940
"MULTIPOLYGON (((-58.5106200213089 -34.6271877971202,-58.5102979839864 -34.6268959415133,-58.5100686893331 -34.6266881364151,-58.5094941790658 -34.6261673545907,-58.5093623157589 -34.6260483165555,-58.5092561231607 -34.6261296274968,-58.5083128022969 -34.6268308527082,-58.5081810580616 -34.6269288629614,-58.5072937592861 -34.6275943538772,-58.5081645289023 -34.6283323671269,-58.5082569280493 -34.6284153636089,-58.5091531412347 -34.6292205455343,-58.5096200075107 -34.6296400287425,-58.5100025736648 -34.6299836952582,-58.5100908841196 -34.6300617621709,-58.5111083164958 -34.6293045063951,-58.5120151076144 -34.6286295431078,-58.5121276890862 -34.6285458327624,-58.5120353712658 -34.6284630504579,-58.511707358155 -34.6281676093842,-58.5111852527482 -34.6276974501021,-58.5107050913967 -34.6272649493742,-58.5106200213089 -34.6271877971202)))";;"458";10_8_4;COMUNA 10;"8";"4";"1021";"509";"512";"99,41%";"458";"457";"99,78%";"1";"0,22%";"367";"11";"3";"356";"97,00%";"3";3.000
"MULTIPOLYGON (((-58.5096200075107 -34.6296400287425,-58.5091531412347 -34.6292205455343,-58.5082569280493 -34.6284153636089,-58.5081645289023 -34.6283323671269,-58.5072937592861 -34.6275943538772,-58.507160991151 -34.6276939831645,-58.5063044990207 -34.6283241726988,-58.5072426324591 -34.6291717494731,-58.5080195946223 -34.6298737402407,-58.5081391012821 -34.6299800373513,-58.5090804188071 -34.6308175278025,-58.5099744449541 -34.6316127742877,-58.5101021397904 -34.6317259679049,-58.5110429836382 -34.6325601331694,-58.5120449235782 -34.6317898474223,-58.5119314614992 -34.6316884814739,-58.511099731914 -34.6309534379111,-58.5100908841196 -34.6300617621709,-58.5100025736648 -34.6299836952582,-58.5096200075107 -34.6296400287425)))";;"459";10_8_5;COMUNA 10;"8";"5";"848";"403";"445";"90,56%";"327";"327";"100,00%";"0";"0,00%";"302";"6";"1.99";"296";"98,01%";"1.99";1.990
"MULTIPOLYGON (((-58.5101048138156 -34.633281370138,-58.5110429836382 -34.6325601331694,-58.5101021397904 -34.6317259679049,-58.5099744449541 -34.6316127742877,-58.5090804188071 -34.6308175278025,-58.5081391012821 -34.6299800373513,-58.5073149609086 -34.6305952916211,-58.5071987099408 -34.6306821679575,-58.5080298138893 -34.6314316754998,-58.5081350023995 -34.6315256535556,-58.5071037232643 -34.6323016223295,-58.508153912061 -34.6332349985595,-58.5082562896196 -34.6333258788364,-58.509086827086 -34.634064674473,-58.5092044416872 -34.6339735703741,-58.5101048138156 -34.633281370138)))";;"460";10_8_6;COMUNA 10;"8";"6";"882";"421";"461";"91,32%";"326";"326";"100,00%";"0";"0,00%";"290";"1";"0.34";"289";"99,66%";"0.34";0.340
"MULTIPOLYGON (((-58.5061591687307 -34.6314593995134,-58.5059814244866 -34.6315922840093,-58.5050154463715 -34.632314055223,-58.5059430519047 -34.63317185668,-58.5069936872623 -34.6323844819678,-58.5071037232643 -34.6323016223295,-58.5081350023995 -34.6315256535556,-58.5080298138893 -34.6314316754998,-58.5071987099408 -34.6306821679575,-58.5073149609086 -34.6305952916211,-58.5081391012821 -34.6299800373513,-58.5080195946223 -34.6298737402407,-58.5072426324591 -34.6291717494731,-58.5063044990207 -34.6283241726988,-58.5053570368907 -34.6290212916558,-58.504316045219 -34.6297873106643,-58.5044300928308 -34.6298906554297,-58.5051666360582 -34.6305585220511,-58.505267644345 -34.6306503208792,-58.5055953900972 -34.63094824412,-58.5060408556776 -34.631353874738,-58.5061591687307 -34.6314593995134)))";;"461";10_8_7;COMUNA 10;"8";"7";"1154";"539";"615";"87,64%";"487";"485";"99,59%";"2";"0,41%";"425";"6";"1.41";"419";"98,59%";"1.41";1.410
"MULTIPOLYGON (((-58.5025070604416 -34.631118169969,-58.5021701264144 -34.6313661045793,-58.5020523354299 -34.6314530469254,-58.5016418962385 -34.6317560055754,-58.5015376471394 -34.6318344921116,-58.5010421206422 -34.632207759798,-58.5011741227085 -34.6322628608945,-58.5024081757741 -34.6327958632275,-58.5033955318565 -34.6332223123683,-58.5035942655553 -34.6333081642088,-58.5038875092886 -34.6334348302548,-58.5042572807627 -34.6335914705244,-58.5045741314717 -34.6337257327498,-58.5039234842934 -34.6331299489484,-58.5050154463715 -34.632314055223,-58.5059814244866 -34.6315922840093,-58.5061591687307 -34.6314593995134,-58.5060408556776 -34.631353874738,-58.5055953900972 -34.63094824412,-58.505267644345 -34.6306503208792,-58.5051666360582 -34.6305585220511,-58.5044300928308 -34.6298906554297,-58.504316045219 -34.6297873106643,-58.5031795598357 -34.6306234251803,-58.5025070604416 -34.631118169969)))";;"462";10_8_8;COMUNA 10;"8";"8";"1121";"504";"617";"81,69%";"469";"468";"99,79%";"1";"0,21%";"408";"11";"2.7";"397";"97,30%";"2.7";2.700
"MULTIPOLYGON (((-58.508153912061 -34.6332349985595,-58.5071037232643 -34.6323016223295,-58.5069936872623 -34.6323844819678,-58.5059430519047 -34.63317185668,-58.5050154463715 -34.632314055223,-58.5039234842934 -34.6331299489484,-58.5045741314717 -34.6337257327498,-58.5050713803239 -34.634239662325,-58.5051233816577 -34.6342933783962,-58.5054573000725 -34.6346384138879,-58.5058598228027 -34.6350072277778,-58.5062178409145 -34.6353157725572,-58.5065516463584 -34.6355916478618,-58.5068193910146 -34.6358124035246,-58.5069617248584 -34.6358909460463,-58.5070924292531 -34.6358909689676,-58.5076516293724 -34.6358911162732,-58.5082759223893 -34.6357287666623,-58.5085456338081 -34.6356435219764,-58.5088305084002 -34.6355534116465,-58.5095422443848 -34.6352893994284,-58.5099778738435 -34.6351035210903,-58.5106707596029 -34.6348174666058,-58.5095979024296 -34.6347187256998,-58.5094052468205 -34.6347009821455,-58.5092229873229 -34.6346853470665,-58.5087636323814 -34.6346460130901,-58.508388369859 -34.6345993921542,-58.5086815189852 -34.634378781849,-58.509086827086 -34.634064674473,-58.5082562896196 -34.6333258788364,-58.508153912061 -34.6332349985595)))";;"463";10_8_9;COMUNA 10;"8";"9";"800";"360";"440";"81,82%";"333";"327";"98,20%";"6";"1,83%";"264";"2";"0.76";"262";"99,24%";"0.76";0.760
"MULTIPOLYGON (((-58.5049633117943 -34.6271228437105,-58.5045032615314 -34.6274785776307,-58.5041558792699 -34.6277472263702,-58.5040432926427 -34.6278345210436,-58.5045178836171 -34.6282644441563,-58.5046162457344 -34.6283531457712,-58.5053570368907 -34.6290212916558,-58.5063044990207 -34.6283241726988,-58.507160991151 -34.6276939831645,-58.5072937592861 -34.6275943538772,-58.5071780953975 -34.6274963646332,-58.5059626036329 -34.6263564815303,-58.5058695252675 -34.6262691876003,-58.504762145412 -34.6252287644203,-58.5037277677311 -34.6260194253134,-58.5048428753445 -34.6270149944084,-58.5049633117943 -34.6271228437105)))";;"464";10_9_1;COMUNA 10;"9";"1";"838";"389";"449";"86,64%";"403";"403";"100,00%";"0";"0,00%";"329";"5";"1.52";"324";"98,48%";"1.52";1.520
"MULTIPOLYGON (((-58.5014544165615 -34.6291090758092,-58.5013319347742 -34.6289963644071,-58.5006630191693 -34.6283761310724,-58.5005078949063 -34.628232301176,-58.4993775459516 -34.6271760613685,-58.4992511572382 -34.6272722997421,-58.498334955086 -34.6268669233151,-58.4970941936748 -34.6263179650735,-58.4958458649368 -34.6257656158162,-58.4957716411457 -34.6259316979543,-58.4958886544298 -34.6260343457232,-58.4968452254319 -34.6268735468207,-58.496939144845 -34.626955635951,-58.4975089719707 -34.6274535196828,-58.4979194289604 -34.6278120759354,-58.4982127851749 -34.6280684079703,-58.498336793062 -34.6281767557335,-58.4995452732431 -34.6292423479465,-58.5003490119709 -34.6299511402878,-58.5007991286677 -34.6303480560064,-58.5009108709688 -34.6302626660973,-58.5018874098164 -34.6295075423532,-58.5014544165615 -34.6291090758092)))";;"465";10_9_10;COMUNA 10;"9";"10";"801";"394";"407";"96,81%";"298";"298";"100,00%";"0";"0,00%";"279";"4";"1.43";"275";"98,57%";"1.43";1.430
"MULTIPOLYGON (((-58.5019672585636 -34.6252053291155,-58.5015107803719 -34.62555274057,-58.5018812734078 -34.6258784078665,-58.5028126861778 -34.6267199646947,-58.5029089991466 -34.6268069781859,-58.503630075189 -34.6274602111545,-58.5040432926427 -34.6278345210436,-58.5041558792699 -34.6277472263702,-58.5045032615314 -34.6274785776307,-58.5049633117943 -34.6271228437105,-58.5048428753445 -34.6270149944084,-58.5037277677311 -34.6260194253134,-58.504762145412 -34.6252287644203,-58.5046699217866 -34.6251420326626,-58.5034920834946 -34.6240323942434,-58.5033317243444 -34.6241532969791,-58.5026514551418 -34.6246791734833,-58.5024237316745 -34.6248552397882,-58.5021982214505 -34.6250295443231,-58.5020816330238 -34.6251183174437,-58.5019672585636 -34.6252053291155)))";;"466";10_9_2;COMUNA 10;"9";"2";"899";"413";"486";"84,98%";"363";"363";"100,00%";"0";"0,00%";"321";"5";"1.56";"316";"98,44%";"1.56";1.560
"MULTIPOLYGON (((-58.499842079578 -34.6234528360314,-58.4996655271043 -34.6233757743294,-58.4986239418636 -34.6229200838807,-58.4985340539564 -34.623093426158,-58.498351060078 -34.6234877187128,-58.4981542758395 -34.6239115934581,-58.4980895914954 -34.6240578848705,-58.4991518938334 -34.6245223062975,-58.4993333904385 -34.6246015504163,-58.5004252744135 -34.6250781353351,-58.5005731152002 -34.6251428100429,-58.5015107803719 -34.62555274057,-58.5019672585636 -34.6252053291155,-58.5020816330238 -34.6251183174437,-58.5021982214505 -34.6250295443231,-58.5024237316745 -34.6248552397882,-58.5026514551418 -34.6246791734833,-58.5033317243444 -34.6241532969791,-58.5034920834946 -34.6240323942434,-58.5026973029711 -34.6236425031874,-58.501754257637 -34.6231712432277,-58.5015809367524 -34.6230844646153,-58.5011540682356 -34.6238835710837,-58.5010992585358 -34.6240016205717,-58.499842079578 -34.6234528360314)))";;"467";10_9_3;COMUNA 10;"9";"3";"831";"396";"435";"91,03%";"349";"349";"100,00%";"0";"0,00%";"303";"2";"0.66";"301";"99,34%";"0.66";0.660
"MULTIPOLYGON (((-58.4982009015837 -34.6213705061531,-58.4978565079335 -34.6216435026998,-58.4976630197086 -34.621796873491,-58.4971213851501 -34.6222261973371,-58.4973752291816 -34.6223707079155,-58.4978654254619 -34.6225881807511,-58.4986239418636 -34.6229200838807,-58.4996655271043 -34.6233757743294,-58.499842079578 -34.6234528360314,-58.5010992585358 -34.6240016205717,-58.5011540682356 -34.6238835710837,-58.5015809367524 -34.6230844646153,-58.5002700494297 -34.6224280217262,-58.4993439025519 -34.621964132446,-58.4991731427412 -34.621878124299,-58.4982009015837 -34.6213705061531)))";;"468";10_9_4;COMUNA 10;"9";"4";"840";"390";"450";"86,67%";"360";"358";"99,44%";"2";"0,56%";"310";"3";"0.97";"307";"99,03%";"0.97";0.970
"MULTIPOLYGON (((-58.498351060078 -34.6234877187128,-58.4985340539564 -34.623093426158,-58.4986239418636 -34.6229200838807,-58.4978654254619 -34.6225881807511,-58.4973752291816 -34.6223707079155,-58.4971213851501 -34.6222261973371,-58.4960449976383 -34.6230793427006,-58.4955076046973 -34.6235052777384,-58.4949678215773 -34.6239330420617,-58.4949270267645 -34.6239653779005,-58.4951108326726 -34.6240814599516,-58.4953010144093 -34.624161341594,-58.4963502725062 -34.6246370588928,-58.4965114029094 -34.6247100450061,-58.497425527863 -34.6251155063,-58.4975901526433 -34.6251874336131,-58.4986594537653 -34.6256546742341,-58.4988342211756 -34.6257320195906,-58.4993333904385 -34.6246015504163,-58.4991518938334 -34.6245223062975,-58.4980895914954 -34.6240578848705,-58.4981542758395 -34.6239115934581,-58.498351060078 -34.6234877187128)))";;"469";10_9_5;COMUNA 10;"9";"5";"1001";"460";"541";"85,03%";"354";"350";"98,87%";"4";"1,14%";"302";"3";"0.99";"299";"99,01%";"0.99";0.990
"MULTIPOLYGON (((-58.5003777441391 -34.626414956101,-58.5016782905131 -34.6274130319498,-58.5017920717547 -34.6275072944958,-58.5018955404087 -34.6275928979842,-58.5025206415441 -34.6281586300744,-58.5026049380886 -34.6282352248212,-58.5029354776297 -34.6285358305666,-58.5030289802529 -34.6286206616914,-58.5031456568397 -34.6285299862134,-58.5040432926427 -34.6278345210436,-58.503630075189 -34.6274602111545,-58.5029089991466 -34.6268069781859,-58.5028126861778 -34.6267199646947,-58.5018812734078 -34.6258784078665,-58.5015107803719 -34.62555274057,-58.5005731152002 -34.6251428100429,-58.5004252744135 -34.6250781353351,-58.4993333904385 -34.6246015504163,-58.4988342211756 -34.6257320195906,-58.5000734515084 -34.6262803268295,-58.5003777441391 -34.626414956101)))";;"470";10_9_6;COMUNA 10;"9";"6";"992";"469";"523";"89,67%";"384";"384";"100,00%";"0";"0,00%";"343";"15";"4.37";"328";"95,63%";"4.37";4.370
"MULTIPOLYGON (((-58.5007991286677 -34.6303480560064,-58.5002968814948 -34.6307314640354,-58.5004175726904 -34.6308385430082,-58.5015376471394 -34.6318344921116,-58.5016418962385 -34.6317560055754,-58.5020523354299 -34.6314530469254,-58.5021701264144 -34.6313661045793,-58.5025070604416 -34.631118169969,-58.5031795598357 -34.6306234251803,-58.504316045219 -34.6297873106643,-58.5053570368907 -34.6290212916558,-58.5046162457344 -34.6283531457712,-58.5045178836171 -34.6282644441563,-58.5040432926427 -34.6278345210436,-58.5031456568397 -34.6285299862134,-58.5030289802529 -34.6286206616914,-58.5020014489016 -34.6294193337005,-58.5018874098164 -34.6295075423532,-58.5009108709688 -34.6302626660973,-58.5007991286677 -34.6303480560064)))";;"471";10_9_7;COMUNA 10;"9";"7";"885";"407";"478";"85,15%";"361";"361";"100,00%";"0";"0,00%";"312";"14";"4.49";"298";"95,51%";"4.49";4.490
"MULTIPOLYGON (((-58.5006630191693 -34.6283761310724,-58.5013319347742 -34.6289963644071,-58.5014544165615 -34.6291090758092,-58.5018874098164 -34.6295075423532,-58.5020014489016 -34.6294193337005,-58.5030289802529 -34.6286206616914,-58.5029354776297 -34.6285358305666,-58.5026049380886 -34.6282352248212,-58.5025206415441 -34.6281586300744,-58.5018955404087 -34.6275928979842,-58.5017920717547 -34.6275072944958,-58.5016782905131 -34.6274130319498,-58.5003777441391 -34.626414956101,-58.5000734515084 -34.6262803268295,-58.4988342211756 -34.6257320195906,-58.4987686855216 -34.6258802834697,-58.498334955086 -34.6268669233151,-58.4992511572382 -34.6272722997421,-58.4993775459516 -34.6271760613685,-58.5005078949063 -34.628232301176,-58.5006630191693 -34.6283761310724)))";;"472";10_9_8;COMUNA 10;"9";"8";"737";"355";"382";"92,93%";"300";"299";"99,67%";"1";"0,33%";"259";"6";"2.32";"253";"97,68%";"2.32";2.320
"MULTIPOLYGON (((-58.4951108326726 -34.6240814599516,-58.4949270267645 -34.6239653779005,-58.4942014869738 -34.6245403758803,-58.4946179674588 -34.6249076041346,-58.4947071102855 -34.6249862454389,-58.4947757145658 -34.6250467224443,-58.4955108547074 -34.6257019013981,-58.4955771593506 -34.6257609700651,-58.4957716411457 -34.6259316979543,-58.4958458649368 -34.6257656158162,-58.4970941936748 -34.6263179650735,-58.498334955086 -34.6268669233151,-58.4987686855216 -34.6258802834697,-58.4988342211756 -34.6257320195906,-58.4986594537653 -34.6256546742341,-58.4975901526433 -34.6251874336131,-58.497425527863 -34.6251155063,-58.4965114029094 -34.6247100450061,-58.4963502725062 -34.6246370588928,-58.4953010144093 -34.624161341594,-58.4951108326726 -34.6240814599516)))";;"473";10_9_9;COMUNA 10;"9";"9";"685";"337";"348";"96,84%";"286";"286";"100,00%";"0";"0,00%";"250";"1";"0.4";"249";"99,60%";"0.4";0.400
"MULTIPOLYGON (((-58.5171828266724 -34.5857326534588,-58.5174322472819 -34.5854834196112,-58.5154566419065 -34.5812726695817,-58.5151051230341 -34.5813046446155,-58.5151041457097 -34.5813025380219,-58.5150289247326 -34.5813099491376,-58.5149696783243 -34.5813145043852,-58.5146967636712 -34.5815589789978,-58.5145715665768 -34.5816841235324,-58.5139210361742 -34.5823983008886,-58.5138138189016 -34.5825160971538,-58.513272541256 -34.5831174036351,-58.5124680561184 -34.5840112215865,-58.5123572615229 -34.5841343703327,-58.511810258914 -34.5847377852701,-58.5131471437929 -34.5855626256593,-58.5138051053293 -34.5848347167194,-58.5151420105148 -34.5856580562922,-58.5158094507196 -34.5860690519399,-58.5164714454776 -34.5864767363129,-58.516698053866 -34.586232541886,-58.5166931115654 -34.5862219960385,-58.5171828266724 -34.5857326534588)))";;"474";11_1_1;COMUNA 11;"1";"1";"1032";"472";"560";"84,29%";"370";"369";"99,73%";"1";"0,27%";"324";"0";"0";"324";"100,00%";"0";0.000
"MULTIPOLYGON (((-58.5041168446016 -34.5932415424554,-58.5034718395455 -34.593953548201,-58.5040063924217 -34.5942781699025,-58.5051230867174 -34.5938630522266,-58.5059108540145 -34.5935702291238,-58.5062578579753 -34.593441145291,-58.5062579909788 -34.5934412274057,-58.5065453551993 -34.5933344301595,-58.5073935645943 -34.5930185466567,-58.5067623144703 -34.5926283382879,-58.5074121306088 -34.591907510083,-58.5060719641456 -34.59108176381,-58.5054223118677 -34.5918000496095,-58.5052848561924 -34.5919520754992,-58.5047686476714 -34.5925219249444,-58.5041168446016 -34.5932415424554)))";;"475";11_1_10;COMUNA 11;"1";"10";"822";"385";"437";"88,10%";"416";"416";"100,00%";"0";"0,00%";"340";"1";"0.29";"339";"99,71%";"0.29";0.290
"MULTIPOLYGON (((-58.5035437890607 -34.5944500929057,-58.5035437824006 -34.5944501177618,-58.5031812070856 -34.5945822209649,-58.5047790118837 -34.5948204929448,-58.5050921066883 -34.5948773401541,-58.5066238575542 -34.5950828507356,-58.5072553097654 -34.595179949558,-58.5084530630381 -34.5953642318741,-58.509627444008 -34.5955330239208,-58.5092595966351 -34.5953135468406,-58.5092753752061 -34.5953158907485,-58.5087832963217 -34.5949997976208,-58.5074463882475 -34.5941746290583,-58.5062579909788 -34.5934412274057,-58.5062578579753 -34.593441145291,-58.5059108540145 -34.5935702291238,-58.5051230867174 -34.5938630522266,-58.5040063924217 -34.5942781699025,-58.5034718395455 -34.593953548201,-58.5030835374687 -34.5943822152499,-58.5035437890607 -34.5944500929057)))";;"476";11_1_11;COMUNA 11;"1";"11";"895";"390";"505";"77,23%";"494";"494";"100,00%";"0";"0,00%";"402";"1";"0.25";"401";"99,75%";"0.25";0.250
"MULTIPOLYGON (((-58.5116603388246 -34.5958284278669,-58.5116460953059 -34.5957326017646,-58.5116451003232 -34.5956932174508,-58.5115971315757 -34.5956139102233,-58.5115960836092 -34.5956121776077,-58.5113794706808 -34.5943732721792,-58.5113292276058 -34.5940858161638,-58.5111616515009 -34.5930991539376,-58.5110586807628 -34.5924926215903,-58.5109268292178 -34.5917160937855,-58.5106740361301 -34.5917968304183,-58.5096621227572 -34.5921736473575,-58.5090497766484 -34.5924017073673,-58.5085290414594 -34.5925957145017,-58.5073935645943 -34.5930185466567,-58.5065453551993 -34.5933344301595,-58.5062579909788 -34.5934412274057,-58.5074463882475 -34.5941746290583,-58.5087832963217 -34.5949997976208,-58.5092753752061 -34.5953158907485,-58.5092595966351 -34.5953135468406,-58.509627444008 -34.5955330239208,-58.5096518368158 -34.595536529736,-58.5100846205221 -34.5958042602057,-58.5116792588202 -34.5959966662535,-58.5116603388246 -34.5958284278669)))";;"477";11_1_12;COMUNA 11;"1";"12";"676";"301";"375";"80,27%";"353";"350";"99,15%";"3";"0,86%";"266";"5";"1.88";"261";"98,12%";"1.88";1.880
"MULTIPOLYGON (((-58.5188824389165 -34.5893456165858,-58.5192030976681 -34.5892573693276,-58.5174322472819 -34.5854834196112,-58.5171828266724 -34.5857326534588,-58.5166931115654 -34.5862219960385,-58.516698053866 -34.586232541886,-58.5164714454776 -34.5864767363129,-58.5158172426392 -34.5872070522534,-58.5157152138912 -34.587320974444,-58.5151651549095 -34.5879336311515,-58.514581559372 -34.5885836250232,-58.5145347556075 -34.5886357596756,-58.5145156086079 -34.5886571066895,-58.5144802930111 -34.5886964894528,-58.515260660411 -34.5903050933226,-58.5153726777773 -34.5903591316849,-58.5166676171848 -34.589995452862,-58.5178143837016 -34.5896511238335,-58.5178861842458 -34.5896701766543,-58.5182708567778 -34.5895649274851,-58.5182509008875 -34.5895213432821,-58.5182501112159 -34.589519634035,-58.5188824389165 -34.5893456165858)))";;"478";11_1_2;COMUNA 11;"1";"2";"933";"420";"513";"81,87%";"392";"392";"100,00%";"0";"0,00%";"339";"1";"0.29";"338";"99,71%";"0.29";0.290
"MULTIPOLYGON (((-58.5158094507196 -34.5860690519399,-58.5151420105148 -34.5856580562922,-58.5138051053293 -34.5848347167194,-58.5131471437929 -34.5855626256593,-58.5124918938735 -34.5862874311472,-58.5134070495694 -34.5868525701583,-58.5136802442131 -34.5870212659724,-58.513832217986 -34.5871146568675,-58.5137576726911 -34.5871973674662,-58.5144368942906 -34.5886094621179,-58.5145156086079 -34.5886571066895,-58.5145347556075 -34.5886357596756,-58.514581559372 -34.5885836250232,-58.5151651549095 -34.5879336311515,-58.5157152138912 -34.587320974444,-58.5158172426392 -34.5872070522534,-58.5164714454776 -34.5864767363129,-58.5158094507196 -34.5860690519399)))";;"479";11_1_3;COMUNA 11;"1";"3";"720";"325";"395";"82,28%";"287";"286";"99,65%";"1";"0,35%";"247";"1";"0.4";"246";"99,60%";"0.4";0.400
"MULTIPOLYGON (((-58.5097882910732 -34.5869719825545,-58.5090218557351 -34.5878196339544,-58.5103590190486 -34.5886464058376,-58.5111261292169 -34.5877980416363,-58.5117283006692 -34.5871321405988,-58.5118302501404 -34.5870193485732,-58.5124918938735 -34.5862874311472,-58.5131471437929 -34.5855626256593,-58.511810258914 -34.5847377852701,-58.5111544070748 -34.5854613866881,-58.5110406295898 -34.5855868594337,-58.5104927579023 -34.5861928744144,-58.5097882910732 -34.5869719825545)))";;"480";11_1_4;COMUNA 11;"1";"4";"846";"399";"447";"89,26%";"371";"371";"100,00%";"0";"0,00%";"316";"3";"0.95";"313";"99,05%";"0.95";0.950
"MULTIPOLYGON (((-58.5134070495694 -34.5868525701583,-58.5124918938735 -34.5862874311472,-58.5118302501404 -34.5870193485732,-58.5117283006692 -34.5871321405988,-58.5111261292169 -34.5877980416363,-58.5103590190486 -34.5886464058376,-58.5111388231229 -34.5891285125011,-58.5117030239255 -34.5894773857202,-58.5118080402589 -34.5893617050845,-58.5124694458306 -34.5886273936866,-58.5131734743398 -34.5878458760053,-58.5132784009587 -34.5877294194333,-58.5137576726911 -34.5871973674662,-58.513832217986 -34.5871146568675,-58.5136802442131 -34.5870212659724,-58.5134070495694 -34.5868525701583)))";;"481";11_1_5;COMUNA 11;"1";"5";"587";"272";"315";"86,35%";"268";"268";"100,00%";"0";"0,00%";"221";"8";"3.62";"213";"96,38%";"3.62";3.620
"MULTIPOLYGON (((-58.5134906442382 -34.5905860652318,-58.513880052944 -34.5908281656884,-58.5148296538856 -34.590545780715,-58.5153726777773 -34.5903591316849,-58.515260660411 -34.5903050933226,-58.5144802930111 -34.5886964894528,-58.5145156086079 -34.5886571066895,-58.5144368942906 -34.5886094621179,-58.5137576726911 -34.5871973674662,-58.5132784009587 -34.5877294194333,-58.5131734743398 -34.5878458760053,-58.5124694458306 -34.5886273936866,-58.5118080402589 -34.5893617050845,-58.5117030239255 -34.5894773857202,-58.5122138158245 -34.5897931780781,-58.5123680934474 -34.5898885417273,-58.5124888068085 -34.5899632138273,-58.5130322336272 -34.5903011029693,-58.5134906442382 -34.5905860652318)))";;"482";11_1_6;COMUNA 11;"1";"6";"802";"384";"418";"91,87%";"322";"322";"100,00%";"0";"0,00%";"278";"1";"0.36";"277";"99,64%";"0.36";0.360
"MULTIPOLYGON (((-58.5101870634801 -34.5911483332088,-58.5107775113989 -34.591511567137,-58.5110341959004 -34.5916818246015,-58.5113740053006 -34.5915733049684,-58.5124337999627 -34.5912582173123,-58.513880052944 -34.5908281656884,-58.5134906442382 -34.5905860652318,-58.5130322336272 -34.5903011029693,-58.5124888068085 -34.5899632138273,-58.5123680934474 -34.5898885417273,-58.5122138158245 -34.5897931780781,-58.5117030239255 -34.5894773857202,-58.5111388231229 -34.5891285125011,-58.5103606357583 -34.5899863883503,-58.5096219216671 -34.5908007210968,-58.5101870634801 -34.5911483332088)))";;"483";11_1_7;COMUNA 11;"1";"7";"720";"323";"397";"81,36%";"336";"335";"99,70%";"1";"0,30%";"252";"1";"0.4";"251";"99,60%";"0.4";0.400
"MULTIPOLYGON (((-58.5103606357583 -34.5899863883503,-58.5111388231229 -34.5891285125011,-58.5103590190486 -34.5886464058376,-58.5090218557351 -34.5878196339544,-58.5082440006785 -34.5886798204058,-58.5075041724639 -34.5894979438963,-58.5088437305864 -34.5903219846822,-58.5096219216671 -34.5908007210968,-58.5103606357583 -34.5899863883503)))";;"484";11_1_8;COMUNA 11;"1";"8";"675";"336";"339";"99,12%";"367";"367";"100,00%";"0";"0,00%";"295";"1";"0.34";"294";"99,66%";"0.34";0.340
"MULTIPOLYGON (((-58.5088437305864 -34.5903219846822,-58.5075041724639 -34.5894979438963,-58.5067238179889 -34.5903608679403,-58.5060719641456 -34.59108176381,-58.5074121306088 -34.591907510083,-58.5067623144703 -34.5926283382879,-58.5073935645943 -34.5930185466567,-58.5085290414594 -34.5925957145017,-58.5090497766484 -34.5924017073673,-58.5096621227572 -34.5921736473575,-58.5106740361301 -34.5917968304183,-58.5109268292178 -34.5917160937855,-58.5110341959004 -34.5916818246015,-58.5107775113989 -34.591511567137,-58.5101870634801 -34.5911483332088,-58.5096219216671 -34.5908007210968,-58.5088437305864 -34.5903219846822)))";;"485";11_1_9;COMUNA 11;"1";"9";"781";"356";"425";"83,76%";"401";"401";"100,00%";"0";"0,00%";"304";"2";"0.66";"302";"99,34%";"0.66";0.660
"MULTIPOLYGON (((-58.4947157690319 -34.5969476847742,-58.4934177131758 -34.5970333738599,-58.4929088631432 -34.5970674458697,-58.4927587961159 -34.5972877731567,-58.4927179078173 -34.5973477825806,-58.4920290486514 -34.5983587667761,-58.4915071566968 -34.5991248360867,-58.4926042614903 -34.5997778366659,-58.4926912616131 -34.5996620362263,-58.4931616699098 -34.5990328814587,-58.4939402201001 -34.5979916585853,-58.4947157690319 -34.5969476847742)))";;"486";11_10_1;COMUNA 11;"10";"1";"724";"324";"400";"81,00%";"372";"371";"99,73%";"1";"0,27%";"315";"1";"0.32";"314";"99,68%";"0.32";0.320
"MULTIPOLYGON (((-58.48078026076 -34.5988311813768,-58.4803223590066 -34.5990285094817,-58.4797472749255 -34.5992762767636,-58.4788312891424 -34.599670923493,-58.4785428374752 -34.5997349778267,-58.4777284926517 -34.5999109326568,-58.4772643435182 -34.6000112040496,-58.4769147405461 -34.6000867411281,-58.4763923362789 -34.6001995516651,-58.4761046471211 -34.6002616986633,-58.4764033590396 -34.6002003979251,-58.4764557546868 -34.6002388990073,-58.4767320205023 -34.6003916331075,-58.4770020148014 -34.6004475193933,-58.4780296161202 -34.6005114737537,-58.4791262363199 -34.6005898630137,-58.4791168921464 -34.6007138830964,-58.4792018972373 -34.6007463376594,-58.4799212106178 -34.600628346431,-58.4804168151862 -34.600659473854,-58.4808567193636 -34.6006894807611,-58.4816215486529 -34.6007415496502,-58.4818493879918 -34.6007945443017,-58.4820415238555 -34.6007703581452,-58.4838060869712 -34.6008904928195,-58.4843795412521 -34.6009294782799,-58.4846047118196 -34.6008652102619,-58.4846208421124 -34.6006678758844,-58.4846740561286 -34.6006049061604,-58.4835867706536 -34.6005276997938,-58.4834206000334 -34.6005025158929,-58.4831351094032 -34.6004827745493,-58.482942880363 -34.6004699187739,-58.4833449681846 -34.6001504025606,-58.4843614301196 -34.5997325342841,-58.4838559292845 -34.5989475223788,-58.4828564282476 -34.5993882014746,-58.4824172270494 -34.5987029651713,-58.4821273837689 -34.5982507406932,-58.48078026076 -34.5988311813768)))";;"487";11_10_10;COMUNA 11;"10";"10";"713";"344";"369";"93,22%";"324";"324";"100,00%";"0";"0,00%";"281";"5";"1.78";"276";"98,22%";"1.78";1.780
"MULTIPOLYGON (((-58.4895267678338 -34.5972965549806,-58.4885444896067 -34.5973639526769,-58.4892123979585 -34.5977572753246,-58.4903575959662 -34.5984404278079,-58.4905159523321 -34.5985349024986,-58.4915071566968 -34.5991248360867,-58.4920290486514 -34.5983587667761,-58.4927179078173 -34.5973477825806,-58.4927587961159 -34.5972877731567,-58.4929088631432 -34.5970674458697,-58.4924899440056 -34.5970954600485,-58.4912175193545 -34.5971808854079,-58.490186189137 -34.5972500684051,-58.4895267678338 -34.5972965549806)))";;"488";11_10_2;COMUNA 11;"10";"2";"956";"434";"522";"83,14%";"474";"473";"99,79%";"1";"0,21%";"384";"2";"0.52";"382";"99,48%";"0.52";0.520
"MULTIPOLYGON (((-58.4915071566968 -34.5991248360867,-58.4905159523321 -34.5985349024986,-58.4903575959662 -34.5984404278079,-58.4892123979585 -34.5977572753246,-58.4886062918777 -34.5986454679605,-58.4897531147812 -34.59932700589,-58.4909031934542 -34.6000104336891,-58.4914051776402 -34.5992744433329,-58.4915071566968 -34.5991248360867)))";;"489";11_10_3;COMUNA 11;"10";"3";"715";"314";"401";"78,30%";"406";"406";"100,00%";"0";"0,00%";"317";"2";"0.63";"315";"99,37%";"0.63";0.630
"MULTIPOLYGON (((-58.49069065708 -34.600902206859,-58.4907905627485 -34.6009087334461,-58.4916059060855 -34.6009622070396,-58.4917076866001 -34.6009715494404,-58.4919584781574 -34.6006376035792,-58.4926042614903 -34.5997778366659,-58.4915071566968 -34.5991248360867,-58.4914051776402 -34.5992744433329,-58.4909031934542 -34.6000104336891,-58.4897531147812 -34.59932700589,-58.4896509620872 -34.5994768934055,-58.4892667795219 -34.600040520392,-58.4887095225178 -34.6008579252174,-58.4882714883655 -34.6008279462305,-58.4884048019692 -34.6009055972409,-58.4889837180897 -34.6012427402956,-58.4900148887616 -34.6013128686123,-58.490073457288 -34.6012270071463,-58.4901985109219 -34.6010437326064,-58.4902531631457 -34.6009635059506,-58.490311986596 -34.6008773626069,-58.49069065708 -34.600902206859)))";;"490";11_10_4;COMUNA 11;"10";"4";"956";"423";"533";"79,36%";"428";"427";"99,77%";"1";"0,23%";"364";"1";"0.27";"363";"99,73%";"0.27";0.270
"MULTIPOLYGON (((-58.4886062918777 -34.5986454679605,-58.4876514012617 -34.5980779689926,-58.4874611910924 -34.5979641300985,-58.4869753546534 -34.5986758748977,-58.4881202910825 -34.5993577806741,-58.4874453754993 -34.6003468305606,-58.4882714883655 -34.6008279462305,-58.4887095225178 -34.6008579252174,-58.4892667795219 -34.600040520392,-58.4896509620872 -34.5994768934055,-58.4897531147812 -34.59932700589,-58.4886062918777 -34.5986454679605)))";;"491";11_10_5;COMUNA 11;"10";"5";"942";"423";"519";"81,50%";"496";"494";"99,60%";"2";"0,40%";"386";"6";"1.55";"380";"98,45%";"1.55";1.550
"MULTIPOLYGON (((-58.4877982844636 -34.5974162935576,-58.4873536438493 -34.5974474417419,-58.4871433743308 -34.5974629071753,-58.4866811047486 -34.5974969438747,-58.4864869309628 -34.5975112077831,-58.4861305197001 -34.5975374045113,-58.485821322666 -34.5979886077023,-58.4869753546534 -34.5986758748977,-58.4874611910924 -34.5979641300985,-58.4876514012617 -34.5980779689926,-58.4886062918777 -34.5986454679605,-58.4892123979585 -34.5977572753246,-58.4885444896067 -34.5973639526769,-58.4877982844636 -34.5974162935576)))";;"492";11_10_6;COMUNA 11;"10";"6";"982";"445";"537";"82,87%";"570";"570";"100,00%";"0";"0,00%";"458";"1";"0.22";"457";"99,78%";"0.22";0.220
"MULTIPOLYGON (((-58.4881202910825 -34.5993577806741,-58.4869753546534 -34.5986758748977,-58.485821322666 -34.5979886077023,-58.485132512947 -34.5989937046099,-58.4855226411854 -34.5992211762299,-58.4862954932167 -34.5996718211937,-58.4865125372468 -34.5997983331813,-58.4872651277858 -34.600241933388,-58.4874453754993 -34.6003468305606,-58.4881202910825 -34.5993577806741)))";;"493";11_10_7;COMUNA 11;"10";"7";"982";"454";"528";"85,98%";"417";"417";"100,00%";"0";"0,00%";"401";"1";"0.25";"400";"99,75%";"0.25";0.250
"MULTIPOLYGON (((-58.4830370154053 -34.5977712781813,-58.4829152619249 -34.5979112334022,-58.4821273837689 -34.5982507406932,-58.4824172270494 -34.5987029651713,-58.4828564282476 -34.5993882014746,-58.4838559292845 -34.5989475223788,-58.4843614301196 -34.5997325342841,-58.4855226411854 -34.5992211762299,-58.485132512947 -34.5989937046099,-58.485821322666 -34.5979886077023,-58.4861305197001 -34.5975374045113,-58.4848551523516 -34.5976346231837,-58.4848534848842 -34.5976347594716,-58.4830370154053 -34.5977712781813)))";;"494";11_10_8;COMUNA 11;"10";"8";"748";"322";"426";"75,59%";"406";"403";"99,26%";"3";"0,74%";"318";"1";"0.31";"317";"99,69%";"0.31";0.310
"MULTIPOLYGON (((-58.4874453754993 -34.6003468305606,-58.4872651277858 -34.600241933388,-58.4865125372468 -34.5997983331813,-58.4862954932167 -34.5996718211937,-58.4855226411854 -34.5992211762299,-58.4843614301196 -34.5997325342841,-58.4833449681846 -34.6001504025606,-58.482942880363 -34.6004699187739,-58.4831351094032 -34.6004827745493,-58.4834206000334 -34.6005025158929,-58.4835867706536 -34.6005276997938,-58.4846740561286 -34.6006049061604,-58.4846208421124 -34.6006678758844,-58.4846047118196 -34.6008652102619,-58.4843795412521 -34.6009294782799,-58.4863727951922 -34.6010650989599,-58.4884155401135 -34.6012040570653,-58.4889837180897 -34.6012427402956,-58.4884048019692 -34.6009055972409,-58.4882714883655 -34.6008279462305,-58.4874453754993 -34.6003468305606)))";;"495";11_10_9;COMUNA 11;"10";"9";"757";"376";"381";"98,69%";"401";"401";"100,00%";"0";"0,00%";"319";"2";"0.63";"317";"99,37%";"0.63";0.630
"MULTIPOLYGON (((-58.4808567193636 -34.6006894807611,-58.4804168151862 -34.600659473854,-58.4799212106178 -34.600628346431,-58.4805910633316 -34.6010215045108,-58.4810682435765 -34.6013017259919,-58.4812748068728 -34.6014229669488,-58.4817325700863 -34.6016906530788,-58.4818922001226 -34.6017838710591,-58.4825893202177 -34.6021529283778,-58.4826198245825 -34.6022087705925,-58.4829238478426 -34.602764798004,-58.4838163431839 -34.6043972436309,-58.4839599914275 -34.6042472834691,-58.484691321388 -34.6034217002022,-58.4850183674067 -34.6030525423649,-58.4851259064828 -34.6029320251313,-58.4850049988177 -34.6027464064632,-58.4844934247592 -34.6019544970312,-58.4840784809347 -34.6013122220497,-58.4838714373995 -34.6009916121188,-58.4838060869712 -34.6008904928195,-58.4820415238555 -34.6007703581452,-58.4818493879918 -34.6007945443017,-58.4816215486529 -34.6007415496502,-58.4808567193636 -34.6006894807611)))";;"496";11_11_1;COMUNA 11;"11";"1";"827";"376";"451";"83,37%";"295";"295";"100,00%";"0";"0,00%";"293";"0";"0";"293";"100,00%";"0";0.000
"MULTIPOLYGON (((-58.4838163431839 -34.6043972436309,-58.4829238478426 -34.602764798004,-58.4826198245825 -34.6022087705925,-58.4825893202177 -34.6021529283778,-58.4818922001226 -34.6017838710591,-58.4817941123439 -34.6019069897202,-58.4810511206756 -34.6028331951987,-58.4804665757188 -34.603561689532,-58.4803256533106 -34.6037373504,-58.4815894228594 -34.6044277506859,-58.4812451641934 -34.6048549322177,-58.4811489451817 -34.6049758668343,-58.4819395930591 -34.6052739249158,-58.4827283767988 -34.6055888097799,-58.4832863719502 -34.6049810885157,-58.4836548162664 -34.6045796727005,-58.4838163431839 -34.6043972436309)))";;"497";11_11_2;COMUNA 11;"11";"2";"888";"425";"463";"91,79%";"361";"361";"100,00%";"0";"0,00%";"309";"1";"0.32";"308";"99,68%";"0.32";0.320
"MULTIPOLYGON (((-58.4799212106178 -34.600628346431,-58.4792018972373 -34.6007463376594,-58.479075623329 -34.600908262264,-58.4786381310942 -34.6014691866536,-58.4780553666171 -34.6022162616231,-58.4791712236658 -34.6028388861892,-58.4804665757188 -34.603561689532,-58.4810511206756 -34.6028331951987,-58.4817941123439 -34.6019069897202,-58.4818922001226 -34.6017838710591,-58.4817325700863 -34.6016906530788,-58.4812748068728 -34.6014229669488,-58.4810682435765 -34.6013017259919,-58.4805910633316 -34.6010215045108,-58.4799212106178 -34.600628346431)))";;"498";11_11_3;COMUNA 11;"11";"3";"953";"471";"482";"97,72%";"332";"332";"100,00%";"0";"0,00%";"325";"9";"2.77";"316";"97,23%";"2.77";2.770
"MULTIPOLYGON (((-58.4769245483033 -34.602662964927,-58.4774728471933 -34.6029631928391,-58.4779478214257 -34.6023541676679,-58.4780553666171 -34.6022162616231,-58.4786381310942 -34.6014691866536,-58.479075623329 -34.600908262264,-58.4792018972373 -34.6007463376594,-58.4791168921464 -34.6007138830964,-58.4791262363199 -34.6005898630137,-58.4780296161202 -34.6005114737537,-58.4770020148014 -34.6004475193933,-58.4767320205023 -34.6003916331075,-58.4774987858523 -34.6008250802265,-58.4769714632744 -34.6015839043735,-58.4763816195979 -34.6023656917925,-58.4769245483033 -34.602662964927)))";;"499";11_11_4;COMUNA 11;"11";"4";"294";"141";"153";"92,16%";"119";"119";"100,00%";"0";"0,00%";"102";"1";"0.98";"101";"99,02%";"0.98";0.980
"MULTIPOLYGON (((-58.4798865335735 -34.6042846871808,-58.4803256533106 -34.6037373504,-58.4804665757188 -34.603561689532,-58.4791712236658 -34.6028388861892,-58.4780553666171 -34.6022162616231,-58.4779478214257 -34.6023541676679,-58.4774728471933 -34.6029631928391,-58.4771410939732 -34.6033917698856,-58.4768072925575 -34.6038164728519,-58.4777435981016 -34.6043320142309,-58.4779304856277 -34.6044339667127,-58.4772817853909 -34.6052704153872,-58.4771740638184 -34.6054036022161,-58.4778643803209 -34.6057778985788,-58.4784386834008 -34.6060893163605,-58.4792075342975 -34.6051310098997,-58.4798865335735 -34.6042846871808)))";;"500";11_11_5;COMUNA 11;"11";"5";"952";"450";"502";"89,64%";"373";"373";"100,00%";"0";"0,00%";"335";"0";"0";"335";"100,00%";"0";0.000
"MULTIPOLYGON (((-58.4803256533106 -34.6037373504,-58.4798865335735 -34.6042846871808,-58.4792075342975 -34.6051310098997,-58.4798385704945 -34.605475442842,-58.4803274397285 -34.6057422845873,-58.4804765130098 -34.6058292380415,-58.4812245903205 -34.6061768862234,-58.4817235107483 -34.606408719512,-58.4818997564827 -34.606491371043,-58.4823865763054 -34.6059612032685,-58.4827283767988 -34.6055888097799,-58.4819395930591 -34.6052739249158,-58.4811489451817 -34.6049758668343,-58.4812451641934 -34.6048549322177,-58.4815894228594 -34.6044277506859,-58.4803256533106 -34.6037373504)))";;"501";11_11_6;COMUNA 11;"11";"6";"1017";"472";"545";"86,61%";"417";"417";"100,00%";"0";"0,00%";"396";"11";"2.78";"385";"97,22%";"2.78";2.780
"MULTIPOLYGON (((-58.4818997564827 -34.606491371043,-58.4817235107483 -34.606408719512,-58.4812245903205 -34.6061768862234,-58.4804765130098 -34.6058292380415,-58.4803274397285 -34.6057422845873,-58.4798385704945 -34.605475442842,-58.4792075342975 -34.6051310098997,-58.4784386834008 -34.6060893163605,-58.4774647574992 -34.6073030044186,-58.4776184246659 -34.6073596779721,-58.4787234763467 -34.6077037055486,-58.4789451160996 -34.6077623403856,-58.4792037245995 -34.6078307589194,-58.4796692361893 -34.6079449950716,-58.4798081658732 -34.607979061439,-58.4802068120884 -34.6080768958368,-58.480410309393 -34.6081267274675,-58.48055294413 -34.6079583905913,-58.480996011123 -34.6074758422845,-58.4815178408837 -34.6069074319461,-58.4818997564827 -34.606491371043)))";;"502";11_11_7;COMUNA 11;"11";"7";"878";"401";"477";"84,07%";"345";"345";"100,00%";"0";"0,00%";"305";"2";"0.66";"303";"99,34%";"0.66";0.660
"MULTIPOLYGON (((-58.4760506929742 -34.6047863127863,-58.4752187111724 -34.6058527789653,-58.4751116676718 -34.6059908232281,-58.4752638028911 -34.6060820786718,-58.4762018364194 -34.6066506616548,-58.4763647073281 -34.6067493795938,-58.4768953958147 -34.6070265124169,-58.4773289785823 -34.6072528780665,-58.4774647574992 -34.6073030044186,-58.4784386834008 -34.6060893163605,-58.4778643803209 -34.6057778985788,-58.4771740638184 -34.6054036022161,-58.4772817853909 -34.6052704153872,-58.4779304856277 -34.6044339667127,-58.4777435981016 -34.6043320142309,-58.4768072925575 -34.6038164728519,-58.4766587841354 -34.60400684922,-58.4760506929742 -34.6047863127863)))";;"503";11_11_8;COMUNA 11;"11";"8";"867";"385";"482";"79,88%";"372";"372";"100,00%";"0";"0,00%";"315";"6";"1.9";"309";"98,10%";"1.9";1.900
"MULTIPOLYGON (((-58.4743412837126 -34.6055128531169,-58.4749539959486 -34.6058961173162,-58.4751116676718 -34.6059908232281,-58.4752187111724 -34.6058527789653,-58.4760506929742 -34.6047863127863,-58.4766587841354 -34.60400684922,-58.4768072925575 -34.6038164728519,-58.4771410939732 -34.6033917698856,-58.4774728471933 -34.6029631928391,-58.4769245483033 -34.602662964927,-58.4763816195979 -34.6023656917925,-58.4757363218796 -34.6031708633645,-58.4757052403253 -34.6032096709656,-58.4749324498392 -34.6041740126235,-58.4740166585734 -34.6053111155374,-58.4741623179435 -34.6054008940368,-58.4743412837126 -34.6055128531169)))";;"504";11_11_9;COMUNA 11;"11";"9";"906";"397";"509";"78,00%";"313";"313";"100,00%";"0";"0,00%";"296";"1";"0.34";"295";"99,66%";"0.34";0.340
"MULTIPOLYGON (((-58.4907409394331 -34.6022659795928,-58.4913202042189 -34.6014909604511,-58.4899558944962 -34.6013994343963,-58.4900148887616 -34.6013128686123,-58.4889837180897 -34.6012427402956,-58.4884155401135 -34.6012040570653,-58.4863727951922 -34.6010650989599,-58.4866479379582 -34.6012243471186,-58.4878049119494 -34.6018937879364,-58.4889821788816 -34.6025749743457,-58.4891915674458 -34.6026961308383,-58.4899996533905 -34.603165336669,-58.4907409394331 -34.6022659795928)))";;"505";11_12_1;COMUNA 11;"12";"1";"580";"261";"319";"81,82%";"279";"279";"100,00%";"0";"0,00%";"233";"2";"0.86";"231";"99,14%";"0.86";0.860
"MULTIPOLYGON (((-58.4844021867929 -34.6077682525737,-58.4834286398755 -34.608865575083,-58.4836734546768 -34.6089258171567,-58.4840571178412 -34.6090202611258,-58.4843544914793 -34.6090935212686,-58.4846545914906 -34.6091674140212,-58.4849931949001 -34.6092508063976,-58.48564586209 -34.6084508671776,-58.4857568951599 -34.6083147848808,-58.4863642518624 -34.6075774582076,-58.4851586624114 -34.6069146332908,-58.4850392828615 -34.6070500827763,-58.4844021867929 -34.6077682525737)))";;"506";11_12_10;COMUNA 11;"12";"10";"604";"273";"331";"82,48%";"312";"312";"100,00%";"0";"0,00%";"261";"2";"0.77";"259";"99,23%";"0.77";0.770
"MULTIPOLYGON (((-58.4889821788816 -34.6025749743457,-58.4878049119494 -34.6018937879364,-58.4866479379582 -34.6012243471186,-58.4858365249336 -34.6021351721172,-58.4869946135917 -34.6028091275182,-58.4881721435972 -34.6034944062481,-58.4889821788816 -34.6025749743457)))";;"507";11_12_2;COMUNA 11;"12";"2";"587";"259";"328";"78,96%";"263";"263";"100,00%";"0";"0,00%";"236";"0";"0";"236";"100,00%";"0";0.000
"MULTIPOLYGON (((-58.4851259064828 -34.6029320251313,-58.4850183674067 -34.6030525423649,-58.484691321388 -34.6034217002022,-58.4854451261107 -34.6038607335097,-58.4858718992263 -34.6040777740624,-58.48601382859 -34.6041925400792,-58.4870345391844 -34.604785532085,-58.4881721435972 -34.6034944062481,-58.4869946135917 -34.6028091275182,-58.4858365249336 -34.6021351721172,-58.4866479379582 -34.6012243471186,-58.4863727951922 -34.6010650989599,-58.4843795412521 -34.6009294782799,-58.4838060869712 -34.6008904928195,-58.4838714373995 -34.6009916121188,-58.4840784809347 -34.6013122220497,-58.4844934247592 -34.6019544970312,-58.4850049988177 -34.6027464064632,-58.4851259064828 -34.6029320251313)))";;"508";11_12_3;COMUNA 11;"12";"3";"1009";"484";"525";"92,19%";"425";"424";"99,76%";"1";"0,24%";"360";"5";"1.39";"355";"98,61%";"1.39";1.390
"MULTIPOLYGON (((-58.4899996533905 -34.603165336669,-58.4891915674458 -34.6026961308383,-58.4889821788816 -34.6025749743457,-58.4881721435972 -34.6034944062481,-58.4870345391844 -34.604785532085,-58.4881365344693 -34.6054257538623,-58.4882199738453 -34.6053245354679,-58.4892239549879 -34.6041064587337,-58.4899996533905 -34.603165336669)))";;"509";11_12_4;COMUNA 11;"12";"4";"622";"282";"340";"82,94%";"336";"336";"100,00%";"0";"0,00%";"272";"1";"0.37";"271";"99,63%";"0.37";0.370
"MULTIPOLYGON (((-58.4861880181208 -34.6057463677614,-58.4851586624114 -34.6069146332908,-58.4863642518624 -34.6075774582076,-58.4873372944516 -34.6063961653656,-58.4881365344693 -34.6054257538623,-58.4870345391844 -34.604785532085,-58.4861880181208 -34.6057463677614)))";;"510";11_12_5;COMUNA 11;"12";"5";"655";"307";"348";"88,22%";"289";"289";"100,00%";"0";"0,00%";"245";"0";"0";"245";"100,00%";"0";0.000
"MULTIPOLYGON (((-58.4838163431839 -34.6043972436309,-58.4836548162664 -34.6045796727005,-58.4832863719502 -34.6049810885157,-58.4827283767988 -34.6055888097799,-58.4839517296275 -34.6062529938474,-58.4844526642019 -34.6056855604381,-58.4849945479935 -34.6050716368299,-58.4861880181208 -34.6057463677614,-58.4870345391844 -34.604785532085,-58.48601382859 -34.6041925400792,-58.4858718992263 -34.6040777740624,-58.4854451261107 -34.6038607335097,-58.484691321388 -34.6034217002022,-58.4839599914275 -34.6042472834691,-58.4838163431839 -34.6043972436309)))";;"511";11_12_6;COMUNA 11;"12";"6";"881";"424";"457";"92,78%";"370";"369";"99,73%";"1";"0,27%";"320";"1";"0.31";"319";"99,69%";"0.31";0.310
"MULTIPOLYGON (((-58.4849945479935 -34.6050716368299,-58.4844526642019 -34.6056855604381,-58.4839517296275 -34.6062529938474,-58.4838384798285 -34.6063812577387,-58.48357672669 -34.6066776518743,-58.4831973771424 -34.6071070279353,-58.4844021867929 -34.6077682525737,-58.4850392828615 -34.6070500827763,-58.4851586624114 -34.6069146332908,-58.4861880181208 -34.6057463677614,-58.4849945479935 -34.6050716368299)))";;"512";11_12_7;COMUNA 11;"12";"7";"664";"301";"363";"82,92%";"289";"289";"100,00%";"0";"0,00%";"259";"4";"1.54";"255";"98,46%";"1.54";1.540
"MULTIPOLYGON (((-58.4815178408837 -34.6069074319461,-58.480996011123 -34.6074758422845,-58.482265293664 -34.6081640511297,-58.4823756523349 -34.6080359300517,-58.4827273357991 -34.6076385341702,-58.4830842101827 -34.60723522067,-58.4831973771424 -34.6071070279353,-58.48357672669 -34.6066776518743,-58.4838384798285 -34.6063812577387,-58.4839517296275 -34.6062529938474,-58.4827283767988 -34.6055888097799,-58.4823865763054 -34.6059612032685,-58.4818997564827 -34.606491371043,-58.4815178408837 -34.6069074319461)))";;"513";11_12_8;COMUNA 11;"12";"8";"756";"352";"404";"87,13%";"302";"302";"100,00%";"0";"0,00%";"272";"1";"0.37";"271";"99,63%";"0.37";0.370
"MULTIPOLYGON (((-58.480996011123 -34.6074758422845,-58.48055294413 -34.6079583905913,-58.480410309393 -34.6081267274675,-58.4813189375992 -34.6083491356318,-58.4819692990742 -34.6085074207843,-58.4822136857051 -34.6085668911822,-58.4834286398755 -34.608865575083,-58.4844021867929 -34.6077682525737,-58.4831973771424 -34.6071070279353,-58.4830842101827 -34.60723522067,-58.4827273357991 -34.6076385341702,-58.4823756523349 -34.6080359300517,-58.482265293664 -34.6081640511297,-58.480996011123 -34.6074758422845)))";;"514";11_12_9;COMUNA 11;"12";"9";"596";"259";"337";"76,85%";"299";"299";"100,00%";"0";"0,00%";"240";"3";"1.25";"237";"98,75%";"1.25";1.250
"MULTIPOLYGON (((-58.4946406341168 -34.6022367805836,-58.4959926970657 -34.6030410975122,-58.4965316258538 -34.6023229643556,-58.4966410109301 -34.6021774355034,-58.4969455847765 -34.6017725463038,-58.4970064481065 -34.6016916106391,-58.4971427303413 -34.6015100864732,-58.4972049552179 -34.601427248841,-58.4953411372776 -34.6013028977519,-58.4953821676158 -34.6012482368007,-58.4950096985954 -34.6011899534898,-58.4945164644225 -34.6009203545047,-58.4943681331558 -34.6010086358931,-58.4942789731086 -34.6010409137511,-58.494195338021 -34.6010441045022,-58.4940004659846 -34.6010319006578,-58.4938803642635 -34.6009972117733,-58.4937191859522 -34.6008949954322,-58.4935712347986 -34.6010920122958,-58.4926177409552 -34.6010292896582,-58.4917076866001 -34.6009715494404,-58.4916059060855 -34.6009622070396,-58.4907905627485 -34.6009087334461,-58.49069065708 -34.600902206859,-58.490311986596 -34.6008773626069,-58.4902531631457 -34.6009635059506,-58.4901985109219 -34.6010437326064,-58.490073457288 -34.6012270071463,-58.4900148887616 -34.6013128686123,-58.4899558944962 -34.6013994343963,-58.4913202042189 -34.6014909604511,-58.4917445648361 -34.6015178111962,-58.4917809972499 -34.6015401237532,-58.4927880536738 -34.6021381632012,-58.4931165656161 -34.6016969382366,-58.4938068462297 -34.6017430752825,-58.4946406341168 -34.6022367805836)))";;"515";11_13_1;COMUNA 11;"13";"1";"709";"291";"418";"69,62%";"429";"429";"100,00%";"0";"0,00%";"346";"6";"1.73";"340";"98,27%";"1.73";1.730
"MULTIPOLYGON (((-58.4898860248101 -34.6078394805322,-58.4897526997478 -34.6077649299404,-58.4886160782389 -34.6071194484894,-58.4876274490455 -34.6082708238893,-58.4887223275844 -34.6088711104029,-58.4888854707395 -34.6089620647662,-58.4893895401473 -34.6083965121496,-58.4906514164167 -34.6091029457839,-58.4910558608356 -34.6086645264474,-58.4911604199595 -34.6085520331643,-58.4918667825775 -34.6077917678333,-58.4919911779555 -34.60765764856,-58.4918356149525 -34.6075676120472,-58.4907071555604 -34.606918274726,-58.4898860248101 -34.6078394805322)))";;"516";11_13_10;COMUNA 11;"13";"10";"656";"300";"356";"84,27%";"292";"292";"100,00%";"0";"0,00%";"250";"1";"0.4";"249";"99,60%";"0.4";0.400
"MULTIPOLYGON (((-58.4888854707395 -34.6089620647662,-58.4887223275844 -34.6088711104029,-58.4876274490455 -34.6082708238893,-58.4868876835263 -34.6091324130143,-58.4864731765381 -34.6096151178691,-58.487821218222 -34.6099414794625,-58.4879836632987 -34.6099738414612,-58.4881572675284 -34.6100083136689,-58.48865432381 -34.6101360305299,-58.4888973078153 -34.6103097173567,-58.4891421672168 -34.6104848117903,-58.4892744825292 -34.6105863360525,-58.4897161523954 -34.610110728685,-58.4901356787465 -34.6096589283552,-58.4905498363351 -34.6092130434868,-58.4906514164167 -34.6091029457839,-58.4893895401473 -34.6083965121496,-58.4888854707395 -34.6089620647662)))";;"517";11_13_11;COMUNA 11;"13";"11";"846";"394";"452";"87,17%";"399";"399";"100,00%";"0";"0,00%";"336";"4";"1.19";"332";"98,81%";"1.19";1.190
"MULTIPOLYGON (((-58.4938068462297 -34.6017430752825,-58.4931165656161 -34.6016969382366,-58.4927880536738 -34.6021381632012,-58.4941210990247 -34.6029293360634,-58.4953270634041 -34.6036450324968,-58.4954737639611 -34.603732531691,-58.4959926970657 -34.6030410975122,-58.4946406341168 -34.6022367805836,-58.4938068462297 -34.6017430752825)))";;"518";11_13_2;COMUNA 11;"13";"2";"819";"360";"459";"78,43%";"454";"454";"100,00%";"0";"0,00%";"387";"22";"5.68";"365";"94,32%";"5.68";5.680
"MULTIPOLYGON (((-58.4917809972499 -34.6015401237532,-58.4917445648361 -34.6015178111962,-58.4913202042189 -34.6014909604511,-58.4907409394331 -34.6022659795928,-58.4921025004171 -34.6030587877193,-58.4934398931787 -34.6038375015959,-58.4941210990247 -34.6029293360634,-58.4927880536738 -34.6021381632012,-58.4917809972499 -34.6015401237532)))";;"519";11_13_3;COMUNA 11;"13";"3";"717";"297";"420";"70,71%";"409";"409";"100,00%";"0";"0,00%";"321";"2";"0.62";"319";"99,38%";"0.62";0.620
"MULTIPOLYGON (((-58.4934398931787 -34.6038375015959,-58.4926697409185 -34.6047154726728,-58.4940082721953 -34.6054925600406,-58.4947977571607 -34.6046285197299,-58.4953831030164 -34.6038533352063,-58.4954737639611 -34.603732531691,-58.4953270634041 -34.6036450324968,-58.4941210990247 -34.6029293360634,-58.4934398931787 -34.6038375015959)))";;"520";11_13_4;COMUNA 11;"13";"4";"763";"335";"428";"78,27%";"447";"447";"100,00%";"0";"0,00%";"345";"7";"2.03";"338";"97,97%";"2.03";2.030
"MULTIPOLYGON (((-58.4934398931787 -34.6038375015959,-58.4921025004171 -34.6030587877193,-58.4907409394331 -34.6022659795928,-58.4899996533905 -34.603165336669,-58.4913419684352 -34.6039446358317,-58.4926697409185 -34.6047154726728,-58.4934398931787 -34.6038375015959)))";;"521";11_13_5;COMUNA 11;"13";"5";"892";"378";"514";"73,54%";"449";"449";"100,00%";"0";"0,00%";"393";"6";"1.53";"387";"98,47%";"1.53";1.530
"MULTIPOLYGON (((-58.491851208223 -34.6056352124595,-58.4907939164224 -34.6068208567923,-58.4907071555604 -34.606918274726,-58.4918356149525 -34.6075676120472,-58.4919911779555 -34.60765764856,-58.4930267686219 -34.6065404526653,-58.4931615480212 -34.6063965404937,-58.4940082721953 -34.6054925600406,-58.4926697409185 -34.6047154726728,-58.4913419684352 -34.6039446358317,-58.4899996533905 -34.603165336669,-58.4892239549879 -34.6041064587337,-58.4905437032434 -34.6048744330061,-58.491851208223 -34.6056352124595)))";;"522";11_13_6;COMUNA 11;"13";"6";"955";"384";"571";"67,25%";"436";"433";"99,31%";"3";"0,69%";"373";"2";"0.54";"371";"99,46%";"0.54";0.540
"MULTIPOLYGON (((-58.48942681728 -34.6061752947935,-58.4886160782389 -34.6071194484894,-58.4897526997478 -34.6077649299404,-58.4898860248101 -34.6078394805322,-58.4907071555604 -34.606918274726,-58.4907939164224 -34.6068208567923,-58.491851208223 -34.6056352124595,-58.4905437032434 -34.6048744330061,-58.48942681728 -34.6061752947935)))";;"523";11_13_7;COMUNA 11;"13";"7";"813";"344";"469";"73,35%";"356";"355";"99,72%";"1";"0,28%";"299";"1";"0.33";"298";"99,67%";"0.33";0.330
"MULTIPOLYGON (((-58.4905437032434 -34.6048744330061,-58.4892239549879 -34.6041064587337,-58.4882199738453 -34.6053245354679,-58.4881365344693 -34.6054257538623,-58.4873372944516 -34.6063961653656,-58.4884751731699 -34.6070394753654,-58.4886160782389 -34.6071194484894,-58.48942681728 -34.6061752947935,-58.4905437032434 -34.6048744330061)))";;"524";11_13_8;COMUNA 11;"13";"8";"712";"327";"385";"84,94%";"344";"344";"100,00%";"0";"0,00%";"281";"0";"0";"281";"100,00%";"0";0.000
"MULTIPOLYGON (((-58.4886160782389 -34.6071194484894,-58.4884751731699 -34.6070394753654,-58.4873372944516 -34.6063961653656,-58.4863642518624 -34.6075774582076,-58.4857568951599 -34.6083147848808,-58.48564586209 -34.6084508671776,-58.4849931949001 -34.6092508063976,-58.4851634764692 -34.6092927485404,-58.4853818017483 -34.6093466537945,-58.4857365063829 -34.6094341961932,-58.4860867822096 -34.6095206820314,-58.4862826201025 -34.609569026395,-58.4864731765381 -34.6096151178691,-58.4868876835263 -34.6091324130143,-58.4876274490455 -34.6082708238893,-58.4886160782389 -34.6071194484894)))";;"525";11_13_9;COMUNA 11;"13";"9";"994";"464";"530";"87,55%";"460";"460";"100,00%";"0";"0,00%";"371";"23";"6.2";"348";"93,80%";"6.2";6.200
"MULTIPOLYGON (((-58.4969419957819 -34.6085909011346,-58.4967728765511 -34.6084861558837,-58.4962400574798 -34.6081815739587,-58.4959785898769 -34.6080298793834,-58.4950755842877 -34.6092182647452,-58.4949739359041 -34.6093572404467,-58.4951611118452 -34.6094606452961,-58.4958535882614 -34.6098383602855,-58.4960153786743 -34.6099304322673,-58.4970693936059 -34.6105922768118,-58.4972830710745 -34.6107087699847,-58.497166264467 -34.6108521885556,-58.4966748549693 -34.6114554469668,-58.4965634095007 -34.6115911871149,-58.4975330776257 -34.6121496668153,-58.4981585125336 -34.6114384748875,-58.4982997567096 -34.6112759630502,-58.4984438950537 -34.6111102106427,-58.4993513720599 -34.6100803967446,-58.4992083198369 -34.6099949435453,-58.4985152071994 -34.6095625274798,-58.4983103856037 -34.6094370194424,-58.4981313802211 -34.6093273492167,-58.4969419957819 -34.6085909011346)))";;"526";11_14_1;COMUNA 11;"14";"1";"972";"451";"521";"86,56%";"421";"421";"100,00%";"0";"0,00%";"364";"3";"0.82";"361";"99,18%";"0.82";0.820
"MULTIPOLYGON (((-58.4939430274494 -34.6068528387446,-58.4937882303147 -34.606762522813,-58.493346416461 -34.6065029770377,-58.4931615480212 -34.6063965404937,-58.4930267686219 -34.6065404526653,-58.4919911779555 -34.60765764856,-58.4921612242301 -34.6077561323937,-58.4926824419 -34.6080612984101,-58.4928142374589 -34.6081374659517,-58.4935909586542 -34.6085863728586,-58.4937634780341 -34.608682670638,-58.4948296139343 -34.6092774868724,-58.4949739359041 -34.6093572404467,-58.4950755842877 -34.6092182647452,-58.4959785898769 -34.6080298793834,-58.4957522239583 -34.6078985980304,-58.4950558365121 -34.6074963754274,-58.4948903031118 -34.6074016269666,-58.4947408718713 -34.6073161701717,-58.4940977396909 -34.6069430136499,-58.4939430274494 -34.6068528387446)))";;"527";11_14_2;COMUNA 11;"14";"2";"819";"384";"435";"88,28%";"414";"414";"100,00%";"0";"0,00%";"332";"2";"0.6";"330";"99,40%";"0.6";0.600
"MULTIPOLYGON (((-58.4930631487756 -34.6096109092512,-58.4932121553875 -34.6096932694689,-58.493712255975 -34.6099748438497,-58.4938280378341 -34.6100400280225,-58.4942771080209 -34.6102887245521,-58.4944566175626 -34.6103881182188,-58.4952710223905 -34.610848695009,-58.4954494275693 -34.6109495664271,-58.4965634095007 -34.6115911871149,-58.4966748549693 -34.6114554469668,-58.497166264467 -34.6108521885556,-58.4972830710745 -34.6107087699847,-58.4970693936059 -34.6105922768118,-58.4960153786743 -34.6099304322673,-58.4958535882614 -34.6098383602855,-58.4951611118452 -34.6094606452961,-58.4949739359041 -34.6093572404467,-58.4948296139343 -34.6092774868724,-58.4937634780341 -34.608682670638,-58.4935909586542 -34.6085863728586,-58.4928142374589 -34.6081374659517,-58.4926824419 -34.6080612984101,-58.4921612242301 -34.6077561323937,-58.4919911779555 -34.60765764856,-58.4918667825775 -34.6077917678333,-58.4911604199595 -34.6085520331643,-58.4913285064578 -34.6086460113926,-58.4920239445351 -34.6090367057037,-58.4921864955178 -34.6091280783426,-58.4924923428394 -34.6092953341421,-58.4926089743281 -34.6093598150208,-58.4930631487756 -34.6096109092512)))";;"528";11_14_3;COMUNA 11;"14";"3";"1008";"490";"518";"94,59%";"413";"413";"100,00%";"0";"0,00%";"365";"1";"0.27";"364";"99,73%";"0.27";0.270
"MULTIPOLYGON (((-58.494907820032 -34.6112960612656,-58.494664831566 -34.6115953614185,-58.4943491313051 -34.611984331102,-58.4945573573896 -34.6121018868127,-58.4954841641412 -34.6126406749138,-58.4956311354863 -34.6127262722348,-58.4958185776439 -34.612835450801,-58.4961483056033 -34.6130249451684,-58.4963682102948 -34.6131513681244,-58.4965604258976 -34.6132638542038,-58.4974040899233 -34.6122963286118,-58.4975330776257 -34.6121496668153,-58.4965634095007 -34.6115911871149,-58.4954494275693 -34.6109495664271,-58.4952710223905 -34.610848695009,-58.494907820032 -34.6112960612656)))";;"529";11_14_4;COMUNA 11;"14";"4";"699";"334";"365";"91,51%";"335";"335";"100,00%";"0";"0,00%";"279";"0";"0";"279";"100,00%";"0";0.000
"MULTIPOLYGON (((-58.4920239445351 -34.6090367057037,-58.4913285064578 -34.6086460113926,-58.4911604199595 -34.6085520331643,-58.4910558608356 -34.6086645264474,-58.4906514164167 -34.6091029457839,-58.4905498363351 -34.6092130434868,-58.4901356787465 -34.6096589283552,-58.4897161523954 -34.610110728685,-58.490632674309 -34.6106198367118,-58.4910404394577 -34.6101558524564,-58.4916839172809 -34.610511207259,-58.4921848676952 -34.6107879283285,-58.492732679503 -34.6110904818145,-58.4933953411226 -34.6114563865735,-58.4936068011276 -34.6115732388528,-58.4941477216989 -34.6118706466569,-58.4943491313051 -34.611984331102,-58.494664831566 -34.6115953614185,-58.494907820032 -34.6112960612656,-58.4952710223905 -34.610848695009,-58.4944566175626 -34.6103881182188,-58.4942771080209 -34.6102887245521,-58.4938280378341 -34.6100400280225,-58.493712255975 -34.6099748438497,-58.4932121553875 -34.6096932694689,-58.4930631487756 -34.6096109092512,-58.4926089743281 -34.6093598150208,-58.4924923428394 -34.6092953341421,-58.4921864955178 -34.6091280783426,-58.4920239445351 -34.6090367057037)))";;"530";11_14_5;COMUNA 11;"14";"5";"970";"420";"550";"76,36%";"404";"403";"99,75%";"1";"0,25%";"328";"3";"0.91";"325";"99,09%";"0.91";0.910
"MULTIPOLYGON (((-58.4916839172809 -34.610511207259,-58.4910404394577 -34.6101558524564,-58.490632674309 -34.6106198367118,-58.4897161523954 -34.610110728685,-58.4892744825292 -34.6105863360525,-58.4901033136409 -34.6112222322717,-58.4902544608067 -34.6113381883729,-58.4906798719146 -34.6116603568099,-58.4907315042403 -34.6116994308871,-58.4912293412421 -34.6120763714487,-58.4916994916252 -34.6124323298621,-58.4922654155526 -34.6128608011068,-58.4930448069901 -34.6135123234318,-58.4933051768248 -34.6131936553404,-58.4937771355372 -34.6126469669641,-58.4943491313051 -34.611984331102,-58.4941477216989 -34.6118706466569,-58.4936068011276 -34.6115732388528,-58.4933953411226 -34.6114563865735,-58.492732679503 -34.6110904818145,-58.4921848676952 -34.6107879283285,-58.4916839172809 -34.610511207259)))";;"531";11_14_6;COMUNA 11;"14";"6";"1045";"476";"569";"83,66%";"487";"487";"100,00%";"0";"0,00%";"409";"5";"1.22";"404";"98,78%";"1.22";1.220
"MULTIPOLYGON (((-58.4943491313051 -34.611984331102,-58.4937771355372 -34.6126469669641,-58.4933051768248 -34.6131936553404,-58.4930448069901 -34.6135123234318,-58.4933158584371 -34.6137500107651,-58.4934384754482 -34.6138575894439,-58.494056333112 -34.6143891414769,-58.4946097786865 -34.6148652122497,-58.4947856553692 -34.6150160165976,-58.4955730166701 -34.6143910662566,-58.4964396941071 -34.6134023433545,-58.4965604258976 -34.6132638542038,-58.4963682102948 -34.6131513681244,-58.4961483056033 -34.6130249451684,-58.4958185776439 -34.612835450801,-58.4956311354863 -34.6127262722348,-58.4954841641412 -34.6126406749138,-58.4945573573896 -34.6121018868127,-58.4943491313051 -34.611984331102)))";;"532";11_14_7;COMUNA 11;"14";"7";"1649";"735";"914";"80,42%";"797";"797";"100,00%";"0";"0,00%";"696";"2";"0.29";"694";"99,71%";"0.29";0.290
"MULTIPOLYGON (((-58.4919054675249 -34.6161043141822,-58.4920389066122 -34.6162174552129,-58.4926364061189 -34.6167283141618,-58.4937100182548 -34.6158686491746,-58.4938293260526 -34.6157731224229,-58.4947856553692 -34.6150160165976,-58.4946097786865 -34.6148652122497,-58.494056333112 -34.6143891414769,-58.4934384754482 -34.6138575894439,-58.4933158584371 -34.6137500107651,-58.4930448069901 -34.6135123234318,-58.4922654155526 -34.6128608011068,-58.4912059771294 -34.6137486909427,-58.4922317936098 -34.614614323161,-58.4916993758623 -34.6150388322989,-58.4911577553146 -34.6154706654378,-58.4919054675249 -34.6161043141822)))";;"533";11_15_1;COMUNA 11;"15";"1";"990";"477";"513";"92,98%";"437";"437";"100,00%";"0";"0,00%";"349";"5";"1.43";"344";"98,57%";"1.43";1.430
"MULTIPOLYGON (((-58.4847795497703 -34.6117515001463,-58.4860384436552 -34.6124122053314,-58.4862647741629 -34.6121274331789,-58.4864529559404 -34.6118904866673,-58.4866396040323 -34.6116557233355,-58.4868378312645 -34.6114061681476,-58.4855658338514 -34.6107644883362,-58.4852262630329 -34.6105932776365,-58.4849278405247 -34.610442693055,-58.4846269485945 -34.6102909109565,-58.4842918966621 -34.6101218800085,-58.4840029335589 -34.609976080386,-58.483748132324 -34.6098475283412,-58.4834942689575 -34.6097194685775,-58.4833848864544 -34.6096642738753,-58.4829792182325 -34.6094591231669,-58.4825977347623 -34.6099356823554,-58.482487120774 -34.610073874428,-58.4822214417587 -34.6104075914267,-58.4827260203106 -34.6106736461484,-58.482977501359 -34.6108057221175,-58.4832282164673 -34.6109373047184,-58.4835155643666 -34.6110880361854,-58.4841502380854 -34.611421177843,-58.4847795497703 -34.6117515001463)))";;"534";11_15_10;COMUNA 11;"15";"10";"917";"409";"508";"80,51%";"360";"360";"100,00%";"0";"0,00%";"331";"3";"0.91";"328";"99,09%";"0.91";0.910
"MULTIPOLYGON (((-58.4860384436552 -34.6124122053314,-58.4847795497703 -34.6117515001463,-58.4841502380854 -34.611421177843,-58.4835155643666 -34.6110880361854,-58.4831146616108 -34.6115897419362,-58.4827135842458 -34.612093840811,-58.4838160535157 -34.6126733943277,-58.4839777490648 -34.6127580171891,-58.4852521503307 -34.6134017552271,-58.4865019624561 -34.6140768942623,-58.4872975284695 -34.6130750101644,-58.4881078911102 -34.6120544549878,-58.487470302988 -34.6117292221599,-58.4868378312645 -34.6114061681476,-58.4866396040323 -34.6116557233355,-58.4864529559404 -34.6118904866673,-58.4862647741629 -34.6121274331789,-58.4860384436552 -34.6124122053314)))";;"535";11_15_11;COMUNA 11;"15";"11";"1057";"519";"538";"96,47%";"429";"429";"100,00%";"0";"0,00%";"434";"50";"11.52";"384";"88,48%";"11.52";11.520
"MULTIPOLYGON (((-58.4912059771294 -34.6137486909427,-58.4906723675233 -34.6141743931635,-58.4901351757253 -34.6146029812553,-58.4891787256097 -34.6153660368432,-58.4890615420413 -34.615459586694,-58.4900830988027 -34.6163274208335,-58.490828340869 -34.6169631893961,-58.4915617498776 -34.6175887445078,-58.4926364061189 -34.6167283141618,-58.4920389066122 -34.6162174552129,-58.4919054675249 -34.6161043141822,-58.4911577553146 -34.6154706654378,-58.4916993758623 -34.6150388322989,-58.4922317936098 -34.614614323161,-58.4912059771294 -34.6137486909427)))";;"536";11_15_2;COMUNA 11;"15";"2";"914";"453";"461";"98,26%";"371";"371";"100,00%";"0";"0,00%";"324";"13";"4.01";"311";"95,99%";"4.01";4.010
"MULTIPOLYGON (((-58.4906798719146 -34.6116603568099,-58.4902544608067 -34.6113381883729,-58.4901033136409 -34.6112222322717,-58.4896287299567 -34.6118669388818,-58.4890802162448 -34.6125573654698,-58.4895389976079 -34.6128094576407,-58.4896952487283 -34.6128975249478,-58.4889656176573 -34.6138143370377,-58.4888772332768 -34.6139256276494,-58.4880800602326 -34.6149294237173,-58.4886960408364 -34.6152621228437,-58.4890615420413 -34.615459586694,-58.4891787256097 -34.6153660368432,-58.4901351757253 -34.6146029812553,-58.4906723675233 -34.6141743931635,-58.4912059771294 -34.6137486909427,-58.4922654155526 -34.6128608011068,-58.4916994916252 -34.6124323298621,-58.4912293412421 -34.6120763714487,-58.4907315042403 -34.6116994308871,-58.4906798719146 -34.6116603568099)))";;"537";11_15_3;COMUNA 11;"15";"3";"1025";"469";"556";"84,35%";"416";"416";"100,00%";"0";"0,00%";"368";"5";"1.36";"363";"98,64%";"1.36";1.360
"MULTIPOLYGON (((-58.4872975284695 -34.6130750101644,-58.4865019624561 -34.6140768942623,-58.4870123721344 -34.6143526486108,-58.4874614434252 -34.6145952430701,-58.4880800602326 -34.6149294237173,-58.4888772332768 -34.6139256276494,-58.4889656176573 -34.6138143370377,-58.4896952487283 -34.6128975249478,-58.4895389976079 -34.6128094576407,-58.4890802162448 -34.6125573654698,-58.4896287299567 -34.6118669388818,-58.4901033136409 -34.6112222322717,-58.4892744825292 -34.6105863360525,-58.4887683768832 -34.6112225248082,-58.4886485759354 -34.611373400917,-58.4881078911102 -34.6120544549878,-58.4872975284695 -34.6130750101644)))";;"538";11_15_4;COMUNA 11;"15";"4";"972";"468";"504";"92,86%";"413";"413";"100,00%";"0";"0,00%";"356";"1";"0.28";"355";"99,72%";"0.28";0.280
"MULTIPOLYGON (((-58.4892744825292 -34.6105863360525,-58.4891421672168 -34.6104848117903,-58.4888973078153 -34.6103097173567,-58.48865432381 -34.6101360305299,-58.4881572675284 -34.6100083136689,-58.4879836632987 -34.6099738414612,-58.487675941394 -34.6103513834649,-58.4875116928974 -34.6105581146836,-58.487349827711 -34.6107618169131,-58.4871863439238 -34.6109675615742,-58.4870230296074 -34.6111730242752,-58.4868378312645 -34.6114061681476,-58.487470302988 -34.6117292221599,-58.4881078911102 -34.6120544549878,-58.4886485759354 -34.611373400917,-58.4887683768832 -34.6112225248082,-58.4892744825292 -34.6105863360525)))";;"539";11_15_5;COMUNA 11;"15";"5";"794";"379";"415";"91,33%";"384";"384";"100,00%";"0";"0,00%";"329";"6";"1.82";"323";"98,18%";"1.82";1.820
"MULTIPOLYGON (((-58.4843544914793 -34.6090935212686,-58.4840571178412 -34.6090202611258,-58.4836734546768 -34.6089258171567,-58.4834286398755 -34.608865575083,-58.4829792182325 -34.6094591231669,-58.4833848864544 -34.6096642738753,-58.4834942689575 -34.6097194685775,-58.483748132324 -34.6098475283412,-58.4840029335589 -34.609976080386,-58.4842918966621 -34.6101218800085,-58.4846269485945 -34.6102909109565,-58.4849278405247 -34.610442693055,-58.4852262630329 -34.6105932776365,-58.4855658338514 -34.6107644883362,-58.4868378312645 -34.6114061681476,-58.4870230296074 -34.6111730242752,-58.4871863439238 -34.6109675615742,-58.487349827711 -34.6107618169131,-58.4875116928974 -34.6105581146836,-58.487675941394 -34.6103513834649,-58.4879836632987 -34.6099738414612,-58.487821218222 -34.6099414794625,-58.4864731765381 -34.6096151178691,-58.4862826201025 -34.609569026395,-58.4860867822096 -34.6095206820314,-58.4857365063829 -34.6094341961932,-58.4853818017483 -34.6093466537945,-58.4851634764692 -34.6092927485404,-58.4849931949001 -34.6092508063976,-58.4846545914906 -34.6091674140212,-58.4843544914793 -34.6090935212686)))";;"540";11_15_6;COMUNA 11;"15";"6";"887";"444";"443";"100,23%";"329";"329";"100,00%";"0";"0,00%";"313";"1";"0.32";"312";"99,68%";"0.32";0.320
"MULTIPOLYGON (((-58.4829792182325 -34.6094591231669,-58.4834286398755 -34.608865575083,-58.4822136857051 -34.6085668911822,-58.4819692990742 -34.6085074207843,-58.4813189375992 -34.6083491356318,-58.480410309393 -34.6081267274675,-58.4800423569261 -34.608586163499,-58.4796642671469 -34.6090596848227,-58.4798164107035 -34.6091400186462,-58.480973937497 -34.6097488168254,-58.4813499790101 -34.609276700313,-58.4825977347623 -34.6099356823554,-58.4829792182325 -34.6094591231669)))";;"541";11_15_7;COMUNA 11;"15";"7";"672";"287";"385";"74,55%";"367";"367";"100,00%";"0";"0,00%";"281";"24";"8.54";"257";"91,46%";"8.54";8.540
"MULTIPOLYGON (((-58.4813499790101 -34.609276700313,-58.480973937497 -34.6097488168254,-58.4798164107035 -34.6091400186462,-58.4796642671469 -34.6090596848227,-58.4792611369904 -34.6095646883708,-58.4805719192067 -34.6102535427797,-58.481821471652 -34.610910137937,-58.4822214417587 -34.6104075914267,-58.482487120774 -34.610073874428,-58.4825977347623 -34.6099356823554,-58.4813499790101 -34.609276700313)))";;"542";11_15_8;COMUNA 11;"15";"8";"843";"403";"440";"91,59%";"421";"421";"100,00%";"0";"0,00%";"372";"45";"12.1";"327";"87,90%";"12.1";12.100
"MULTIPOLYGON (((-58.4827260203106 -34.6106736461484,-58.4822214417587 -34.6104075914267,-58.481821471652 -34.610910137937,-58.4805719192067 -34.6102535427797,-58.4792611369904 -34.6095646883708,-58.4788595347711 -34.6100676480149,-58.4801709179517 -34.6107570699958,-58.481420474867 -34.6114140213299,-58.4827135842458 -34.612093840811,-58.4831146616108 -34.6115897419362,-58.4835155643666 -34.6110880361854,-58.4832282164673 -34.6109373047184,-58.482977501359 -34.6108057221175,-58.4827260203106 -34.6106736461484)))";;"543";11_15_9;COMUNA 11;"15";"9";"816";"381";"435";"87,59%";"418";"418";"100,00%";"0";"0,00%";"337";"4";"1.19";"333";"98,81%";"1.19";1.190
"MULTIPOLYGON (((-58.4836396541966 -34.6154309888414,-58.4835493875057 -34.6155445294903,-58.4828402744497 -34.6164363001689,-58.4841038237033 -34.6170968127545,-58.4845092594791 -34.616586300262,-58.4849069410725 -34.6160855064488,-58.4853069170803 -34.6155818234467,-58.4857055257846 -34.6150798295518,-58.4861056624538 -34.6145759325444,-58.4865019624561 -34.6140768942623,-58.4852521503307 -34.6134017552271,-58.4839777490648 -34.6127580171891,-58.4838571707172 -34.6129093112433,-58.4831791656082 -34.6137631901835,-58.4844382480987 -34.6144259539541,-58.4836396541966 -34.6154309888414)))";;"544";11_16_1;COMUNA 11;"16";"1";"897";"423";"474";"89,24%";"374";"374";"100,00%";"0";"0,00%";"319";"17";"5.33";"302";"94,67%";"5.33";5.330
"MULTIPOLYGON (((-58.4828402744497 -34.6164363001689,-58.48158211154 -34.6157745059366,-58.4814371957599 -34.6156982579479,-58.480315193679 -34.6151079814389,-58.4795135625729 -34.6161154545294,-58.4807805738086 -34.6167786772496,-58.482042578613 -34.6174392818031,-58.483305540883 -34.6181015632652,-58.4833866986543 -34.6179999262181,-58.4836565697514 -34.6176600089712,-58.4841038237033 -34.6170968127545,-58.4828402744497 -34.6164363001689)))";;"545";11_16_10;COMUNA 11;"16";"10";"666";"318";"348";"91,38%";"276";"276";"100,00%";"0";"0,00%";"236";"5";"2.12";"231";"97,88%";"2.12";2.120
"MULTIPOLYGON (((-58.481914821232 -34.6130976675934,-58.4811146764573 -34.6141032498196,-58.482380563036 -34.6147689211919,-58.4836396541966 -34.6154309888414,-58.4844382480987 -34.6144259539541,-58.4831791656082 -34.6137631901835,-58.4838571707172 -34.6129093112433,-58.4839777490648 -34.6127580171891,-58.4838160535157 -34.6126733943277,-58.4827135842458 -34.612093840811,-58.481914821232 -34.6130976675934)))";;"546";11_16_2;COMUNA 11;"16";"2";"889";"400";"489";"81,80%";"486";"486";"100,00%";"0";"0,00%";"359";"7";"1.95";"352";"98,05%";"1.95";1.950
"MULTIPOLYGON (((-58.4827135842458 -34.612093840811,-58.481420474867 -34.6114140213299,-58.480622043364 -34.6124171354601,-58.4798215488234 -34.6134228502205,-58.4800271155024 -34.6135313462448,-58.4811146764573 -34.6141032498196,-58.481914821232 -34.6130976675934,-58.4827135842458 -34.612093840811)))";;"547";11_16_3;COMUNA 11;"16";"3";"678";"319";"359";"88,86%";"331";"331";"100,00%";"0";"0,00%";"267";"5";"1.87";"262";"98,13%";"1.87";1.870
"MULTIPOLYGON (((-58.481420474867 -34.6114140213299,-58.4801709179517 -34.6107570699958,-58.4788595347711 -34.6100676480149,-58.4780606589762 -34.611068210362,-58.4782076082229 -34.611146011515,-58.4793725627126 -34.6117593309464,-58.480622043364 -34.6124171354601,-58.481420474867 -34.6114140213299)))";;"548";11_16_4;COMUNA 11;"16";"4";"667";"303";"364";"83,24%";"316";"316";"100,00%";"0";"0,00%";"252";"13";"5.16";"239";"94,84%";"5.16";5.160
"MULTIPOLYGON (((-58.4772596349548 -34.6120713733015,-58.4771612727266 -34.6121946289162,-58.4764600399616 -34.6130757983095,-58.4776115491547 -34.613685685047,-58.4777711958838 -34.6137696825456,-58.4785723999217 -34.612763910774,-58.4793725627126 -34.6117593309464,-58.4782076082229 -34.611146011515,-58.4780606589762 -34.611068210362,-58.4772596349548 -34.6120713733015)))";;"549";11_16_5;COMUNA 11;"16";"5";"769";"355";"414";"85,75%";"333";"333";"100,00%";"0";"0,00%";"288";"12";"4.17";"276";"95,83%";"4.17";4.170
"MULTIPOLYGON (((-58.4777711958838 -34.6137696825456,-58.4776115491547 -34.613685685047,-58.4764600399616 -34.6130757983095,-58.4756607664069 -34.6140800066044,-58.4769718461699 -34.6147731950733,-58.4777711958838 -34.6137696825456)))";;"550";11_16_6;COMUNA 11;"16";"6";"810";"391";"419";"93,32%";"387";"387";"100,00%";"0";"0,00%";"335";"3";"0.9";"332";"99,10%";"0.9";0.900
"MULTIPOLYGON (((-58.4785723999217 -34.612763910774,-58.4777711958838 -34.6137696825456,-58.4769718461699 -34.6147731950733,-58.4780016426238 -34.6153176672548,-58.4782210127978 -34.6154335591871,-58.4790218014315 -34.6144275735148,-58.4798215488234 -34.6134228502205,-58.480622043364 -34.6124171354601,-58.4793725627126 -34.6117593309464,-58.4785723999217 -34.612763910774)))";;"551";11_16_7;COMUNA 11;"16";"7";"838";"371";"467";"79,44%";"425";"425";"100,00%";"0";"0,00%";"350";"31";"8.86";"319";"91,14%";"8.86";8.860
"MULTIPOLYGON (((-58.4790218014315 -34.6144275735148,-58.4782210127978 -34.6154335591871,-58.4789103076428 -34.6157975670759,-58.4793575730018 -34.6160337828714,-58.4795135625729 -34.6161154545294,-58.480315193679 -34.6151079814389,-58.4811146764573 -34.6141032498196,-58.4800271155024 -34.6135313462448,-58.4798215488234 -34.6134228502205,-58.4790218014315 -34.6144275735148)))";;"552";11_16_8;COMUNA 11;"16";"8";"1016";"458";"558";"82,08%";"458";"458";"100,00%";"0";"0,00%";"393";"7";"1.78";"386";"98,22%";"1.78";1.780
"MULTIPOLYGON (((-58.482380563036 -34.6147689211919,-58.4811146764573 -34.6141032498196,-58.480315193679 -34.6151079814389,-58.4814371957599 -34.6156982579479,-58.48158211154 -34.6157745059366,-58.4828402744497 -34.6164363001689,-58.4835493875057 -34.6155445294903,-58.4836396541966 -34.6154309888414,-58.482380563036 -34.6147689211919)))";;"553";11_16_9;COMUNA 11;"16";"9";"646";"295";"351";"84,05%";"358";"358";"100,00%";"0";"0,00%";"256";"5";"1.95";"251";"98,05%";"1.95";1.950
"MULTIPOLYGON (((-58.4915617498776 -34.6175887445078,-58.490828340869 -34.6169631893961,-58.4900830988027 -34.6163274208335,-58.4890615420413 -34.615459586694,-58.4886960408364 -34.6152621228437,-58.4880800602326 -34.6149294237173,-58.4874614434252 -34.6145952430701,-58.4870634436283 -34.6150963270919,-58.4866653538851 -34.6155974802179,-58.4879915484812 -34.6163136465128,-58.4890073130791 -34.6171850824166,-58.4897531508084 -34.6178205052044,-58.4904887745644 -34.618447263413,-58.4906161805046 -34.6183457518704,-58.4915617498776 -34.6175887445078)))";;"554";11_17_1;COMUNA 11;"17";"1";"821";"391";"430";"90,93%";"341";"340";"99,71%";"1";"0,29%";"290";"0";"0";"290";"100,00%";"0";0.000
"MULTIPOLYGON (((-58.4861056624538 -34.6145759325444,-58.4857055257846 -34.6150798295518,-58.4853069170803 -34.6155818234467,-58.4849069410725 -34.6160855064488,-58.4845092594791 -34.616586300262,-58.4841038237033 -34.6170968127545,-58.4850720954526 -34.6176029950201,-58.4858606087564 -34.6180151864075,-58.4863788521795 -34.6176014103035,-58.4869168489684 -34.6171717824186,-58.4858667756816 -34.6166027407596,-58.4862663226444 -34.6160997589873,-58.4866653538851 -34.6155974802179,-58.4870634436283 -34.6150963270919,-58.4874614434252 -34.6145952430701,-58.4870123721344 -34.6143526486108,-58.4865019624561 -34.6140768942623,-58.4861056624538 -34.6145759325444)))";;"555";11_17_2;COMUNA 11;"17";"2";"815";"388";"427";"90,87%";"329";"329";"100,00%";"0";"0,00%";"286";"8";"2.8";"278";"97,20%";"2.8";2.800
"MULTIPOLYGON (((-58.4897531508084 -34.6178205052044,-58.4890073130791 -34.6171850824166,-58.4879915484812 -34.6163136465128,-58.4866653538851 -34.6155974802179,-58.4862663226444 -34.6160997589873,-58.4858667756816 -34.6166027407596,-58.4869168489684 -34.6171717824186,-58.4879331233658 -34.6180413959921,-58.4886782792979 -34.6186775296534,-58.4876037263581 -34.6195342627514,-58.4877285591576 -34.6196410015144,-58.4883373895334 -34.6201603299073,-58.4894124543483 -34.6193042945728,-58.4904887745644 -34.618447263413,-58.4897531508084 -34.6178205052044)))";;"556";11_17_3;COMUNA 11;"17";"3";"884";"412";"472";"87,29%";"378";"378";"100,00%";"0";"0,00%";"336";"5";"1.49";"331";"98,51%";"1.49";1.490
"MULTIPOLYGON (((-58.4858606087564 -34.6180151864075,-58.4852605982612 -34.6184943298508,-58.4847825437919 -34.6188760504956,-58.4857821226546 -34.6197560372423,-58.486403893421 -34.6202857253034,-58.4865284699617 -34.6203914793811,-58.4872641767527 -34.6210161440045,-58.4882038459049 -34.6202666292244,-58.4883373895334 -34.6201603299073,-58.4877285591576 -34.6196410015144,-58.4876037263581 -34.6195342627514,-58.4886782792979 -34.6186775296534,-58.4879331233658 -34.6180413959921,-58.4869168489684 -34.6171717824186,-58.4863788521795 -34.6176014103035,-58.4858606087564 -34.6180151864075)))";;"557";11_17_4;COMUNA 11;"17";"4";"933";"441";"492";"89,63%";"369";"369";"100,00%";"0";"0,00%";"324";"11";"3.4";"313";"96,60%";"3.4";3.400
"MULTIPOLYGON (((-58.4836565697514 -34.6176600089712,-58.4833866986543 -34.6179999262181,-58.483305540883 -34.6181015632652,-58.4825007653907 -34.6191098306948,-58.4837006238297 -34.6197398634535,-58.4847068446787 -34.6206133082181,-58.4848179080589 -34.6205246934864,-58.4857821226546 -34.6197560372423,-58.4847825437919 -34.6188760504956,-58.4852605982612 -34.6184943298508,-58.4858606087564 -34.6180151864075,-58.4850720954526 -34.6176029950201,-58.4841038237033 -34.6170968127545,-58.4836565697514 -34.6176600089712)))";;"558";11_17_5;COMUNA 11;"17";"5";"838";"408";"430";"94,88%";"302";"302";"100,00%";"0";"0,00%";"297";"19";"6.4";"278";"93,60%";"6.4";6.400
"MULTIPOLYGON (((-58.4832993304261 -34.6229615229281,-58.4826544665358 -34.6234741830225,-58.4834266299192 -34.6240821033661,-58.4840382745839 -34.6235922627438,-58.4849705056881 -34.6228456618993,-58.4851125748277 -34.6227323221019,-58.4861843838075 -34.6218774429602,-58.4872641767527 -34.6210161440045,-58.4865284699617 -34.6203914793811,-58.486403893421 -34.6202857253034,-58.4857821226546 -34.6197560372423,-58.4848179080589 -34.6205246934864,-58.4847068446787 -34.6206133082181,-58.4836314596812 -34.6214716964179,-58.4825585225926 -34.622328032298,-58.4832993304261 -34.6229615229281)))";;"559";11_17_6;COMUNA 11;"17";"6";"1175";"545";"630";"86,51%";"470";"469";"99,79%";"1";"0,21%";"408";"12";"2.94";"396";"97,06%";"2.94";2.940
"MULTIPOLYGON (((-58.48169690692 -34.6201154867842,-58.4808944768257 -34.6211190244511,-58.4815448082811 -34.6214611207399,-58.4825585225926 -34.622328032298,-58.4836314596812 -34.6214716964179,-58.4847068446787 -34.6206133082181,-58.4837006238297 -34.6197398634535,-58.4825007653907 -34.6191098306948,-58.4823716588637 -34.619271617836,-58.48169690692 -34.6201154867842)))";;"560";11_17_7;COMUNA 11;"17";"7";"916";"425";"491";"86,56%";"376";"376";"100,00%";"0";"0,00%";"331";"8";"2.42";"323";"97,58%";"2.42";2.420
"MULTIPOLYGON (((-58.4815448082811 -34.6214611207399,-58.4808176656861 -34.6220415327643,-58.4804700612332 -34.6223191287353,-58.4793761269296 -34.6231924119868,-58.4797556905705 -34.623355745428,-58.4807400921833 -34.6237793508165,-58.4817331943202 -34.6242066089702,-58.4817872972144 -34.6242299111764,-58.4819203819229 -34.6242871457671,-58.4827426628097 -34.6246298420969,-58.4833681140265 -34.6241289458901,-58.4834266299192 -34.6240821033661,-58.4826544665358 -34.6234741830225,-58.4832993304261 -34.6229615229281,-58.4825585225926 -34.622328032298,-58.4815448082811 -34.6214611207399)))";;"561";11_17_8;COMUNA 11;"17";"8";"847";"409";"438";"93,38%";"341";"341";"100,00%";"0";"0,00%";"322";"7";"2.17";"315";"97,83%";"2.17";2.170
"MULTIPOLYGON (((-58.4804332452953 -34.6194526960167,-58.4796339575889 -34.620452422096,-58.4794733312162 -34.6206532259547,-58.4808176656861 -34.6220415327643,-58.4815448082811 -34.6214611207399,-58.4808944768257 -34.6211190244511,-58.48169690692 -34.6201154867842,-58.4823716588637 -34.619271617836,-58.4825007653907 -34.6191098306948,-58.483305540883 -34.6181015632652,-58.482042578613 -34.6174392818031,-58.481938341099 -34.6175704296956,-58.4816397630101 -34.6179437994958,-58.4812377088415 -34.6184466255013,-58.4808369272862 -34.6189478301765,-58.4804332452953 -34.6194526960167)))";;"562";11_18_1;COMUNA 11;"18";"1";"854";"380";"474";"80,17%";"264";"263";"99,62%";"1";"0,38%";"279";"2";"0.72";"277";"99,28%";"0.72";0.720
"MULTIPOLYGON (((-58.4816397630101 -34.6179437994958,-58.481938341099 -34.6175704296956,-58.482042578613 -34.6174392818031,-58.4807805738086 -34.6167786772496,-58.4795135625729 -34.6161154545294,-58.4793575730018 -34.6160337828714,-58.4789103076428 -34.6157975670759,-58.4782210127978 -34.6154335591871,-58.4774171388535 -34.6164433427643,-58.4776095049917 -34.6165453652956,-58.4787117417401 -34.6171229926388,-58.4799762061907 -34.6177855901109,-58.4812377088415 -34.6184466255013,-58.4816397630101 -34.6179437994958)))";;"563";11_18_2;COMUNA 11;"18";"2";"813";"412";"401";"102,74%";"358";"357";"99,72%";"1";"0,28%";"303";"0";"0";"303";"100,00%";"0";0.000
"MULTIPOLYGON (((-58.4787117417401 -34.6171229926388,-58.4776095049917 -34.6165453652956,-58.4774171388535 -34.6164433427643,-58.4766184407237 -34.6174467116114,-58.4777819384432 -34.6180613134036,-58.4779110938902 -34.6181291166677,-58.4791727559594 -34.6187912297311,-58.4804332452953 -34.6194526960167,-58.4808369272862 -34.6189478301765,-58.4812377088415 -34.6184466255013,-58.4799762061907 -34.6177855901109,-58.4787117417401 -34.6171229926388)))";;"564";11_18_3;COMUNA 11;"18";"3";"880";"406";"474";"85,65%";"351";"351";"100,00%";"0";"0,00%";"310";"7";"2.26";"303";"97,74%";"2.26";2.260
"MULTIPOLYGON (((-58.4758156351891 -34.6184551461099,-58.4766284869217 -34.6188782831272,-58.4767757714921 -34.6188690766194,-58.4770711803367 -34.6191841484154,-58.4772522897158 -34.6192800122673,-58.4781256359747 -34.6197359773214,-58.478330960279 -34.6198435605949,-58.4786359658144 -34.6200033154679,-58.4791600445247 -34.6204234718622,-58.4791641686648 -34.6204264963836,-58.4794359627361 -34.6206999965087,-58.4794733312162 -34.6206532259547,-58.4796339575889 -34.620452422096,-58.4804332452953 -34.6194526960167,-58.4791727559594 -34.6187912297311,-58.4779110938902 -34.6181291166677,-58.4777819384432 -34.6180613134036,-58.4766184407237 -34.6174467116114,-58.4760963553159 -34.6181025679365,-58.4758156351891 -34.6184551461099)))";;"565";11_18_4;COMUNA 11;"18";"4";"903";"397";"506";"78,46%";"386";"386";"100,00%";"0";"0,00%";"370";"38";"10.27";"332";"89,73%";"10.27";10.270
"MULTIPOLYGON (((-58.4761689853643 -34.6157810689418,-58.4753682343813 -34.6167862609916,-58.475173537063 -34.6170306559423,-58.4745676344263 -34.6177911659072,-58.4756198588332 -34.6183497407424,-58.4758156351891 -34.6184551461099,-58.4760963553159 -34.6181025679365,-58.4766184407237 -34.6174467116114,-58.4774171388535 -34.6164433427643,-58.4782210127978 -34.6154335591871,-58.4780016426238 -34.6153176672548,-58.4769718461699 -34.6147731950733,-58.4761689853643 -34.6157810689418)))";;"566";11_18_5;COMUNA 11;"18";"5";"804";"371";"433";"85,68%";"395";"395";"100,00%";"0";"0,00%";"318";"6";"1.89";"312";"98,11%";"1.89";1.890
"MULTIPOLYGON (((-58.4740585844267 -34.616093055387,-58.4732595937252 -34.6170968248833,-58.4734232467002 -34.6171836446791,-58.4739056884734 -34.6174397371722,-58.4745676344263 -34.6177911659072,-58.475173537063 -34.6170306559423,-58.4753682343813 -34.6167862609916,-58.4761689853643 -34.6157810689418,-58.4769718461699 -34.6147731950733,-58.4756607664069 -34.6140800066044,-58.4748597702588 -34.6150864632734,-58.4740585844267 -34.616093055387)))";;"567";11_18_6;COMUNA 11;"18";"6";"1348";"647";"701";"92,30%";"704";"704";"100,00%";"0";"0,00%";"521";"4";"0.77";"517";"99,23%";"0.77";0.770
"MULTIPOLYGON (((-58.4745676344263 -34.6177911659072,-58.4739056884734 -34.6174397371722,-58.4734232467002 -34.6171836446791,-58.4732595937252 -34.6170968248833,-58.4724609245022 -34.6181003072573,-58.471621181049 -34.6191552679353,-58.4727888404095 -34.619773085999,-58.4729342663606 -34.6198482173672,-58.4741896943515 -34.6204974945297,-58.4750158764485 -34.6194597719026,-58.4761310000754 -34.6200548159588,-58.4763054816579 -34.6201467012524,-58.4770711803367 -34.6191841484154,-58.4767757714921 -34.6188690766194,-58.4766284869217 -34.6188782831272,-58.4758156351891 -34.6184551461099,-58.4756198588332 -34.6183497407424,-58.4745676344263 -34.6177911659072)))";;"568";11_18_7;COMUNA 11;"18";"7";"1009";"462";"547";"84,46%";"417";"414";"99,28%";"3";"0,72%";"324";"18";"5.56";"306";"94,44%";"5.56";5.560
"MULTIPOLYGON (((-58.478330960279 -34.6198435605949,-58.4781256359747 -34.6197359773214,-58.4772522897158 -34.6192800122673,-58.4770711803367 -34.6191841484154,-58.4763054816579 -34.6201467012524,-58.4761310000754 -34.6200548159588,-58.4750158764485 -34.6194597719026,-58.4741896943515 -34.6204974945297,-58.474509432888 -34.6206627514648,-58.4754900415845 -34.6211768958956,-58.4757455470922 -34.6213108875946,-58.476026442212 -34.6214581158819,-58.4767417617743 -34.6218301612607,-58.4775604311833 -34.620806789193,-58.4788249413501 -34.6214641163113,-58.4794353462988 -34.6207007680438,-58.4794359627361 -34.6206999965087,-58.4791641686648 -34.6204264963836,-58.4791600445247 -34.6204234718622,-58.4786359658144 -34.6200033154679,-58.478330960279 -34.6198435605949)))";;"569";11_18_8;COMUNA 11;"18";"8";"907";"425";"482";"88,17%";"366";"366";"100,00%";"0";"0,00%";"346";"50";"14.45";"296";"85,55%";"14.45";14.450
"MULTIPOLYGON (((-58.4794733312162 -34.6206532259547,-58.4794359627361 -34.6206999965087,-58.4794353462988 -34.6207007680438,-58.4788249413501 -34.6214641163113,-58.4775604311833 -34.620806789193,-58.4767417617743 -34.6218301612607,-58.4778072555519 -34.6223842785486,-58.4780062810669 -34.6224877784523,-58.4781161031468 -34.6225448792774,-58.4787991524573 -34.6229104374997,-58.4793761269296 -34.6231924119868,-58.4804700612332 -34.6223191287353,-58.4808176656861 -34.6220415327643,-58.4794733312162 -34.6206532259547)))";;"570";11_18_9;COMUNA 11;"18";"9";"815";"396";"419";"94,51%";"353";"353";"100,00%";"0";"0,00%";"304";"23";"7.57";"281";"92,43%";"7.57";7.570
"MULTIPOLYGON (((-58.4751116676718 -34.6059908232281,-58.4747436124635 -34.6064655257138,-58.4757240544964 -34.6069723452804,-58.4758856457872 -34.6070581057621,-58.4771282998839 -34.6077176375178,-58.4782834031489 -34.6083306167406,-58.4784294107006 -34.608407713531,-58.4790438549917 -34.6087320813698,-58.4796642671469 -34.6090596848227,-58.4800423569261 -34.608586163499,-58.480410309393 -34.6081267274675,-58.4802068120884 -34.6080768958368,-58.4798081658732 -34.607979061439,-58.4796692361893 -34.6079449950716,-58.4792037245995 -34.6078307589194,-58.4789451160996 -34.6077623403856,-58.4787234763467 -34.6077037055486,-58.4776184246659 -34.6073596779721,-58.4774647574992 -34.6073030044186,-58.4773289785823 -34.6072528780665,-58.4768953958147 -34.6070265124169,-58.4763647073281 -34.6067493795938,-58.4762018364194 -34.6066506616548,-58.4752638028911 -34.6060820786718,-58.4751116676718 -34.6059908232281)))";;"571";11_19_1;COMUNA 11;"19";"1";"568";"266";"302";"88,08%";"259";"259";"100,00%";"0";"0,00%";"221";"14";"6.33";"207";"93,67%";"6.33";6.330
"MULTIPOLYGON (((-58.4771282998839 -34.6077176375178,-58.4758856457872 -34.6070581057621,-58.4757240544964 -34.6069723452804,-58.4747436124635 -34.6064655257138,-58.4739642276902 -34.6074707783912,-58.474107418293 -34.6075431621403,-58.4750997969503 -34.6080709017833,-58.4761481542838 -34.6086283465574,-58.4763238047764 -34.608722203775,-58.4771282998839 -34.6077176375178)))";;"572";11_19_2;COMUNA 11;"19";"2";"871";"396";"475";"83,37%";"398";"396";"99,50%";"2";"0,51%";"322";"7";"2.17";"315";"97,83%";"2.17";2.170
"MULTIPOLYGON (((-58.4784294107006 -34.608407713531,-58.4782834031489 -34.6083306167406,-58.4771282998839 -34.6077176375178,-58.4763238047764 -34.608722203775,-58.4776233921431 -34.6094163730961,-58.4780183545121 -34.6089115872469,-58.4784294107006 -34.608407713531)))";;"573";11_19_3;COMUNA 11;"19";"3";"710";"308";"402";"76,62%";"338";"338";"100,00%";"0";"0,00%";"279";"2";"0.72";"277";"99,28%";"0.72";0.720
"MULTIPOLYGON (((-58.4790438549917 -34.6087320813698,-58.4784294107006 -34.608407713531,-58.4780183545121 -34.6089115872469,-58.4776233921431 -34.6094163730961,-58.4763238047764 -34.608722203775,-58.4761515260179 -34.608937301247,-58.4755236342074 -34.6097256373079,-58.4768257850288 -34.6104145328564,-58.4769748616278 -34.6104933916332,-58.4780606589762 -34.611068210362,-58.4788595347711 -34.6100676480149,-58.4792611369904 -34.6095646883708,-58.4796642671469 -34.6090596848227,-58.4790438549917 -34.6087320813698)))";;"574";11_19_4;COMUNA 11;"19";"4";"1022";"441";"581";"75,90%";"402";"400";"99,50%";"2";"0,50%";"339";"22";"6.49";"317";"93,51%";"6.49";6.490
"MULTIPOLYGON (((-58.4760232193787 -34.611418885192,-58.4752228486823 -34.6124204148561,-58.4764600399616 -34.6130757983095,-58.4771612727266 -34.6121946289162,-58.4772596349548 -34.6120713733015,-58.4780606589762 -34.611068210362,-58.4769748616278 -34.6104933916332,-58.4768257850288 -34.6104145328564,-58.4755236342074 -34.6097256373079,-58.4747228484162 -34.6107310373936,-58.4760232193787 -34.611418885192)))";;"575";11_19_5;COMUNA 11;"19";"5";"791";"353";"438";"80,59%";"336";"336";"100,00%";"0";"0,00%";"306";"7";"2.29";"299";"97,71%";"2.29";2.290
"MULTIPOLYGON (((-58.4752228486823 -34.6124204148561,-58.4760232193787 -34.611418885192,-58.4747228484162 -34.6107310373936,-58.4739245982915 -34.6117331922719,-58.4731255624843 -34.6127363982079,-58.4732846918265 -34.6128206833358,-58.4744211813507 -34.6134241928342,-58.4745717093134 -34.61350418117,-58.4756607664069 -34.6140800066044,-58.4764600399616 -34.6130757983095,-58.4752228486823 -34.6124204148561)))";;"576";11_19_6;COMUNA 11;"19";"6";"921";"443";"478";"92,68%";"390";"390";"100,00%";"0";"0,00%";"341";"4";"1.17";"337";"98,83%";"1.17";1.170
"MULTIPOLYGON (((-58.4744211813507 -34.6134241928342,-58.4732846918265 -34.6128206833358,-58.4731255624843 -34.6127363982079,-58.4723244633634 -34.6137420637879,-58.4722192782877 -34.6138741894829,-58.4723391437422 -34.613993128022,-58.4730803708947 -34.6151080368714,-58.4731849110702 -34.6152652166654,-58.4734435088091 -34.6157673248164,-58.4740585844267 -34.616093055387,-58.4748597702588 -34.6150864632734,-58.4756607664069 -34.6140800066044,-58.4745717093134 -34.61350418117,-58.4744211813507 -34.6134241928342)))";;"577";11_19_7;COMUNA 11;"19";"7";"916";"444";"472";"94,07%";"361";"361";"100,00%";"0";"0,00%";"319";"8";"2.51";"311";"97,49%";"2.51";2.510
"MULTIPOLYGON (((-58.4715217266544 -34.6147497663886,-58.4711226081268 -34.6152509393388,-58.4707233144332 -34.6157521109539,-58.4699233498458 -34.6167563516986,-58.4710418079384 -34.6173466534455,-58.4712217305299 -34.6174422077818,-58.4720201528982 -34.6164395081058,-58.4732595937252 -34.6170968248833,-58.4740585844267 -34.616093055387,-58.4734435088091 -34.6157673248164,-58.4731849110702 -34.6152652166654,-58.4730803708947 -34.6151080368714,-58.4723391437422 -34.613993128022,-58.4722192782877 -34.6138741894829,-58.4715217266544 -34.6147497663886)))";;"578";11_19_8;COMUNA 11;"19";"8";"837";"390";"447";"87,25%";"359";"359";"100,00%";"0";"0,00%";"301";"5";"1.66";"296";"98,34%";"1.66";1.660
"MULTIPOLYGON (((-58.4712217305299 -34.6174422077818,-58.4710418079384 -34.6173466534455,-58.4699233498458 -34.6167563516986,-58.4690936387863 -34.617797843437,-58.469339837755 -34.6179247361881,-58.4703868330932 -34.6184906806371,-58.4713995952313 -34.6190380262888,-58.471621181049 -34.6191552679353,-58.4724609245022 -34.6181003072573,-58.4732595937252 -34.6170968248833,-58.4720201528982 -34.6164395081058,-58.4712217305299 -34.6174422077818)))";;"579";11_19_9;COMUNA 11;"19";"9";"889";"387";"502";"77,09%";"399";"398";"99,75%";"1";"0,25%";"348";"31";"8.91";"317";"91,09%";"8.91";8.910
"MULTIPOLYGON (((-58.5191777245525 -34.595389529449,-58.5202906868144 -34.5960715005868,-58.5204505226075 -34.5961692457454,-58.5213603244049 -34.5967621446294,-58.52157594651 -34.596740068105,-58.5222147992588 -34.596663487641,-58.5225789335483 -34.5966207726458,-58.522579502299 -34.5966223158071,-58.522650457711 -34.5966031535245,-58.519970166451 -34.590891993986,-58.5197366086482 -34.5911680428219,-58.5192640748673 -34.5917265374117,-58.5192594104568 -34.5917167677691,-58.5186478674563 -34.5924295726325,-58.5178782292648 -34.593277851571,-58.5171146607015 -34.5941194312934,-58.5172313781175 -34.5941884664039,-58.5177745082984 -34.5945222496377,-58.5179080146887 -34.594607615184,-58.5180546419862 -34.5947013552408,-58.5191777245525 -34.595389529449)))";;"580";11_2_1;COMUNA 11;"2";"1";"836";"403";"433";"93,07%";"340";"340";"100,00%";"0";"0,00%";"286";"8";"2.8";"278";"97,20%";"2.8";2.800
"MULTIPOLYGON (((-58.5182195896729 -34.600825953007,-58.519489312282 -34.6016082857279,-58.5207556503984 -34.602388493978,-58.5214086592421 -34.6016694923752,-58.5215149540335 -34.6015524649223,-58.5220590161881 -34.6009499250873,-58.5209177707123 -34.6002495327556,-58.5207890234078 -34.6001667036298,-58.520660617179 -34.6000840854806,-58.5196639843825 -34.5994710102446,-58.5195220351375 -34.5993831857412,-58.5183337120703 -34.5986482825849,-58.5182534518288 -34.5985986693569,-58.5181937088496 -34.5986650371171,-58.5168065327582 -34.5988310185483,-58.5165085561819 -34.5988667150552,-58.515979283517 -34.5989308229899,-58.5152865014897 -34.5990148591198,-58.5156842182023 -34.5992604007192,-58.5169523607027 -34.6000435354272,-58.5181022638138 -34.6007536796383,-58.5182195896729 -34.600825953007)))";;"581";11_2_10;COMUNA 11;"2";"10";"1022";"470";"552";"85,14%";"431";"430";"99,77%";"1";"0,23%";"348";"1";"0.29";"347";"99,71%";"0.29";0.290
"MULTIPOLYGON (((-58.515979283517 -34.5989308229899,-58.5160934108737 -34.5988029512982,-58.5162568222078 -34.5986325210311,-58.5163347754206 -34.5985397367498,-58.5164282169107 -34.5984284941851,-58.5169848088508 -34.5978166750068,-58.5157152526925 -34.5970344564761,-58.5149278518482 -34.5965492842675,-58.514799484775 -34.596470175812,-58.514796757065 -34.5964687249429,-58.5144216543779 -34.5962692067324,-58.51380565966 -34.5961708010399,-58.5120409010093 -34.5959163832867,-58.5120404708746 -34.5959160279405,-58.5116603388246 -34.5958284278669,-58.5116792588202 -34.5959966662535,-58.5100846205221 -34.5958042602057,-58.5113852884877 -34.5966087090579,-58.5118171461244 -34.5968757998732,-58.5120516061783 -34.5970207813145,-58.5126895567077 -34.5974101845938,-58.5133639777087 -34.5978217533276,-58.513501488756 -34.5979088826169,-58.5136305654123 -34.5979907333768,-58.5137222397687 -34.5980487959097,-58.5144144807654 -34.5984763378675,-58.5152865014897 -34.5990148591198,-58.515979283517 -34.5989308229899)))";;"582";11_2_11;COMUNA 11;"2";"11";"837";"400";"437";"91,53%";"404";"402";"99,50%";"2";"0,50%";"328";"1";"0.3";"327";"99,70%";"0.3";0.300
"MULTIPOLYGON (((-58.5192594104568 -34.5917167677691,-58.5192640748673 -34.5917265374117,-58.5197366086482 -34.5911680428219,-58.519970166451 -34.590891993986,-58.5192030976681 -34.5892573693276,-58.5188824389165 -34.5893456165858,-58.5182501112159 -34.589519634035,-58.5182509008875 -34.5895213432821,-58.5182708567778 -34.5895649274851,-58.5178861842458 -34.5896701766543,-58.5178143837016 -34.5896511238335,-58.5166676171848 -34.589995452862,-58.5153726777773 -34.5903591316849,-58.5148296538856 -34.590545780715,-58.513880052944 -34.5908281656884,-58.5141415910412 -34.5909908086629,-58.5143329306851 -34.591107774755,-58.5154866876574 -34.5918129428967,-58.5156371384967 -34.5919050644687,-58.5169293595192 -34.5926961480279,-58.5176160322771 -34.5931164913062,-58.517747489271 -34.5931971394761,-58.5178782292648 -34.593277851571,-58.5186478674563 -34.5924295726325,-58.5192594104568 -34.5917167677691)))";;"583";11_2_2;COMUNA 11;"2";"2";"973";"450";"523";"86,04%";"404";"404";"100,00%";"0";"0,00%";"361";"3";"0.83";"358";"99,17%";"0.83";0.830
"MULTIPOLYGON (((-58.5143329306851 -34.591107774755,-58.5141415910412 -34.5909908086629,-58.513880052944 -34.5908281656884,-58.5124337999627 -34.5912582173123,-58.5113740053006 -34.5915733049684,-58.5110341959004 -34.5916818246015,-58.5113178875691 -34.5918699587959,-58.5115134005521 -34.5919910827239,-58.5128088269655 -34.5927938288159,-58.5141071748316 -34.5935982500159,-58.5148714839055 -34.5927528924256,-58.5155402948336 -34.5920131388775,-58.5156371384967 -34.5919050644687,-58.5154866876574 -34.5918129428967,-58.5143329306851 -34.591107774755)))";;"584";11_2_3;COMUNA 11;"2";"3";"739";"348";"391";"89,00%";"355";"354";"99,72%";"1";"0,28%";"286";"0";"0";"286";"100,00%";"0";0.000
"MULTIPOLYGON (((-58.5110341959004 -34.5916818246015,-58.5109268292178 -34.5917160937855,-58.5110586807628 -34.5924926215903,-58.5111616515009 -34.5930991539376,-58.5113292276058 -34.5940858161638,-58.5113794706808 -34.5943732721792,-58.5115960836092 -34.5956121776077,-58.5115971315757 -34.5956139102233,-58.5116451003232 -34.5956932174508,-58.5117812832923 -34.5957033039925,-58.5120636278346 -34.5957476988783,-58.5121516952474 -34.5957610440235,-58.5126878728737 -34.5951680559917,-58.5133399567163 -34.5944468434799,-58.5141071748316 -34.5935982500159,-58.5128088269655 -34.5927938288159,-58.5115134005521 -34.5919910827239,-58.5113178875691 -34.5918699587959,-58.5110341959004 -34.5916818246015)))";;"585";11_2_4;COMUNA 11;"2";"4";"555";"262";"293";"89,42%";"280";"280";"100,00%";"0";"0,00%";"223";"0";"0";"223";"100,00%";"0";0.000
"MULTIPOLYGON (((-58.5171146607015 -34.5941194312934,-58.5178782292648 -34.593277851571,-58.517747489271 -34.5931971394761,-58.5176160322771 -34.5931164913062,-58.5169293595192 -34.5926961480279,-58.5156371384967 -34.5919050644687,-58.5155402948336 -34.5920131388775,-58.5148714839055 -34.5927528924256,-58.5141071748316 -34.5935982500159,-58.5133399567163 -34.5944468434799,-58.5126878728737 -34.5951680559917,-58.5121516952474 -34.5957610440235,-58.5120636278346 -34.5957476988783,-58.5117812832923 -34.5957033039925,-58.5116451003232 -34.5956932174508,-58.5116460953059 -34.5957326017646,-58.5116603388246 -34.5958284278669,-58.5120404708746 -34.5959160279405,-58.5120409010093 -34.5959163832867,-58.51380565966 -34.5961708010399,-58.5144216543779 -34.5962692067324,-58.514796757065 -34.5964687249429,-58.5147968902551 -34.5964685768908,-58.5149035937872 -34.5963461946411,-58.5150386115682 -34.5961998932557,-58.5150386023879 -34.5961999274908,-58.5152176351749 -34.5962273164262,-58.515575584667 -34.5958295407695,-58.5163423647799 -34.5949776236514,-58.5171146607015 -34.5941194312934)))";;"586";11_2_5;COMUNA 11;"2";"5";"1066";"513";"553";"92,77%";"468";"468";"100,00%";"0";"0,00%";"389";"3";"0.77";"386";"99,23%";"0.77";0.770
"MULTIPOLYGON (((-58.5179080146887 -34.594607615184,-58.5177745082984 -34.5945222496377,-58.5172313781175 -34.5941884664039,-58.5171146607015 -34.5941194312934,-58.5163423647799 -34.5949776236514,-58.515575584667 -34.5958295407695,-58.5152176351749 -34.5962273164262,-58.5150386023879 -34.5961999274908,-58.5150386115682 -34.5961998932557,-58.5149035937872 -34.5963461946411,-58.5151533274944 -34.5963870173015,-58.51616494695 -34.5965367762247,-58.5169112346203 -34.5966510992952,-58.517900013562 -34.5968025633097,-58.5194717274299 -34.5970436825494,-58.5196230179415 -34.5970850728233,-58.5196218187224 -34.5970878396902,-58.5196946403656 -34.5970956229029,-58.5201635010534 -34.5973802731694,-58.5202853046073 -34.5974676606655,-58.5208025286671 -34.5974787559321,-58.5212987453131 -34.5974829062844,-58.52177508512 -34.5974942967757,-58.522074873324 -34.5975271837541,-58.5224616886005 -34.5974908637355,-58.5225276152148 -34.5975025220222,-58.5226475394806 -34.5975177454455,-58.5227811857136 -34.5975471878961,-58.5229405704045 -34.5976019705864,-58.5231578547613 -34.5976842188115,-58.522650457711 -34.5966031535245,-58.522579502299 -34.5966223158071,-58.5225789335483 -34.5966207726458,-58.5222147992588 -34.596663487641,-58.52157594651 -34.596740068105,-58.5213603244049 -34.5967621446294,-58.5204505226075 -34.5961692457454,-58.5202906868144 -34.5960715005868,-58.5191777245525 -34.595389529449,-58.5180546419862 -34.5947013552408,-58.5179080146887 -34.594607615184)))";;"587";11_2_6;COMUNA 11;"2";"6";"981";"466";"515";"90,49%";"393";"393";"100,00%";"0";"0,00%";"358";"0";"0";"358";"100,00%";"0";0.000
"MULTIPOLYGON (((-58.5163347754206 -34.5985397367498,-58.5162568222078 -34.5986325210311,-58.5160934108737 -34.5988029512982,-58.515979283517 -34.5989308229899,-58.5165085561819 -34.5988667150552,-58.5168065327582 -34.5988310185483,-58.5181937088496 -34.5986650371171,-58.5182534518288 -34.5985986693569,-58.5183337120703 -34.5986482825849,-58.5198552641001 -34.5984661639692,-58.5204098237885 -34.5983998440818,-58.5216179806584 -34.5982551766754,-58.5209237477931 -34.5978304935451,-58.5208654044937 -34.5977411762885,-58.5208379299934 -34.597674766773,-58.5208025286671 -34.5974787559321,-58.5202853046073 -34.5974676606655,-58.5201635010534 -34.5973802731694,-58.5196946403656 -34.5970956229029,-58.5196218187224 -34.5970878396902,-58.5196230179415 -34.5970850728233,-58.5194717274299 -34.5970436825494,-58.517900013562 -34.5968025633097,-58.5169112346203 -34.5966510992952,-58.51616494695 -34.5965367762247,-58.5151533274944 -34.5963870173015,-58.5149035937872 -34.5963461946411,-58.5147968902551 -34.5964685768908,-58.514796757065 -34.5964687249429,-58.514799484775 -34.596470175812,-58.5149278518482 -34.5965492842675,-58.5157152526925 -34.5970344564761,-58.5169848088508 -34.5978166750068,-58.5164282169107 -34.5984284941851,-58.5163347754206 -34.5985397367498)))";;"588";11_2_7;COMUNA 11;"2";"7";"841";"404";"437";"92,45%";"389";"388";"99,74%";"1";"0,26%";"312";"3";"0.96";"309";"99,04%";"0.96";0.960
"MULTIPOLYGON (((-58.5198552641001 -34.5984661639692,-58.5183337120703 -34.5986482825849,-58.5195220351375 -34.5993831857412,-58.5196639843825 -34.5994710102446,-58.520660617179 -34.6000840854806,-58.5207890234078 -34.6001667036298,-58.5209177707123 -34.6002495327556,-58.5220590161881 -34.6009499250873,-58.5231935494327 -34.6016462253203,-58.5233309049578 -34.6017309490897,-58.5237477308041 -34.6012704421242,-58.5237521285528 -34.6012799031828,-58.5242209302187 -34.6007586907195,-58.5244706243418 -34.60048107804,-58.5231578547613 -34.5976842188115,-58.5229405704045 -34.5976019705864,-58.5227811857136 -34.5975471878961,-58.5226475394806 -34.5975177454455,-58.5225276152148 -34.5975025220222,-58.5224616886005 -34.5974908637355,-58.522074873324 -34.5975271837541,-58.52177508512 -34.5974942967757,-58.5212987453131 -34.5974829062844,-58.5208025286671 -34.5974787559321,-58.5208379299934 -34.597674766773,-58.5208654044937 -34.5977411762885,-58.5209237477931 -34.5978304935451,-58.5216179806584 -34.5982551766754,-58.5204098237885 -34.5983998440818,-58.5198552641001 -34.5984661639692)))";;"589";11_2_8;COMUNA 11;"2";"8";"883";"417";"466";"89,48%";"338";"337";"99,70%";"1";"0,30%";"302";"28";"9.27";"274";"90,73%";"9.27";9.270
"MULTIPOLYGON (((-58.5213968595486 -34.602774843448,-58.5220474609431 -34.6031542290869,-58.5220332441575 -34.603153682936,-58.5231186588676 -34.6038445143088,-58.5232791103069 -34.6039439455272,-58.5249109990075 -34.604955204516,-58.5253264172621 -34.6046520933649,-58.5253247919911 -34.6046486467201,-58.5258858353327 -34.6042728789713,-58.526163304343 -34.6040870374537,-58.5244706243418 -34.60048107804,-58.5242209302187 -34.6007586907195,-58.5237521285528 -34.6012799031828,-58.5237477308041 -34.6012704421242,-58.5233309049578 -34.6017309490897,-58.5231935494327 -34.6016462253203,-58.5220590161881 -34.6009499250873,-58.5215149540335 -34.6015524649223,-58.5214086592421 -34.6016694923752,-58.5207556503984 -34.602388493978,-58.5213818412609 -34.6027742653395,-58.5213968595486 -34.602774843448)))";;"590";11_2_9;COMUNA 11;"2";"9";"665";"312";"353";"88,39%";"284";"283";"99,65%";"1";"0,35%";"238";"28";"11.76";"210";"88,24%";"11.76";11.760
"MULTIPOLYGON (((-58.4724385574063 -34.6052873071403,-58.4712371298382 -34.6047712509922,-58.4710815117879 -34.604704569135,-58.4703047405825 -34.6057192355226,-58.4709869290848 -34.6060108217163,-58.4716652893272 -34.6063008550093,-58.4728176044834 -34.6068912798573,-58.4729878806079 -34.6069777477093,-58.4739642276902 -34.6074707783912,-58.4747436124635 -34.6064655257138,-58.4751116676718 -34.6059908232281,-58.4749539959486 -34.6058961173162,-58.4743412837126 -34.6055128531169,-58.4741623179435 -34.6054008940368,-58.4740166585734 -34.6053111155374,-58.4730386194089 -34.6047084332354,-58.4729835082192 -34.604674352105,-58.4724385574063 -34.6052873071403)))";;"591";11_20_1;COMUNA 11;"20";"1";"895";"395";"500";"79,00%";"403";"403";"100,00%";"0";"0,00%";"356";"17";"4.78";"339";"95,22%";"4.78";4.780
"MULTIPOLYGON (((-58.467848237754 -34.6113037955939,-58.4678139982157 -34.6113486578257,-58.4683995459281 -34.6116601221059,-58.4689586910055 -34.6119575703226,-58.4697335773379 -34.6109404487681,-58.4692071465446 -34.6106613832668,-58.4687005667138 -34.6103928782738,-58.4685897446714 -34.6103319659487,-58.469350482496 -34.6093349888254,-58.4680601654655 -34.6086579146943,-58.4679536176873 -34.6087976427963,-58.4666502070047 -34.6082026699713,-58.4665162213973 -34.6081430945662,-58.465513311633 -34.6094670439084,-58.4653637450893 -34.6096528287461,-58.4651317282476 -34.609941154043,-58.4658231352581 -34.6103062925443,-58.4658808834449 -34.6102264993947,-58.4659421292717 -34.6102862887071,-58.4665609684381 -34.6106166349074,-58.467848237754 -34.6113037955939)))";;"592";11_20_10;COMUNA 11;"20";"10";"770";"364";"406";"89,66%";"332";"332";"100,00%";"0";"0,00%";"292";"6";"2.05";"286";"97,95%";"2.05";2.050
"MULTIPOLYGON (((-58.4695075327523 -34.612249593805,-58.4700380635411 -34.6125317563942,-58.4708244417313 -34.6115185711216,-58.4716063721092 -34.6105110149473,-58.4710500386039 -34.6102177336839,-58.4709463706982 -34.6101630204183,-58.470501375806 -34.6099323369925,-58.4694552556607 -34.6093899850939,-58.469350482496 -34.6093349888254,-58.4685897446714 -34.6103319659487,-58.4687005667138 -34.6103928782738,-58.4692071465446 -34.6106613832668,-58.4697335773379 -34.6109404487681,-58.4689586910055 -34.6119575703226,-58.4695075327523 -34.612249593805)))";;"593";11_20_11;COMUNA 11;"20";"11";"698";"303";"395";"76,71%";"301";"301";"100,00%";"0";"0,00%";"252";"10";"3.97";"242";"96,03%";"3.97";3.970
"MULTIPOLYGON (((-58.4696041322319 -34.6040714688382,-58.4689257150553 -34.60496210221,-58.4688298191707 -34.6050887315347,-58.4703047405825 -34.6057192355226,-58.4710815117879 -34.604704569135,-58.4712371298382 -34.6047712509922,-58.4724385574063 -34.6052873071403,-58.4729835082192 -34.604674352105,-58.4726492644898 -34.6044675410562,-58.4718035259388 -34.6039416013666,-58.4717100856447 -34.6038835075204,-58.4716096608952 -34.6038210477504,-58.4704341176867 -34.6029375029852,-58.4696961083359 -34.6039506843995,-58.4696041322319 -34.6040714688382)))";;"594";11_20_2;COMUNA 11;"20";"2";"856";"392";"464";"84,48%";"394";"394";"100,00%";"0";"0,00%";"317";"3";"0.95";"314";"99,05%";"0.95";0.950
"MULTIPOLYGON (((-58.4716652893272 -34.6063008550093,-58.4709869290848 -34.6060108217163,-58.4703047405825 -34.6057192355226,-58.4688298191707 -34.6050887315347,-58.4680582980655 -34.606107256679,-58.4672876949892 -34.6071246499384,-58.4687527599218 -34.6077498205344,-58.470116056636 -34.6083315273902,-58.4708965161981 -34.6073085522213,-58.4716652893272 -34.6063008550093)))";;"595";11_20_3;COMUNA 11;"20";"3";"1136";"549";"587";"93,53%";"408";"408";"100,00%";"0";"0,00%";"389";"43";"11.05";"346";"88,95%";"11.05";11.050
"MULTIPOLYGON (((-58.4712725623687 -34.6089199240485,-58.4714356005796 -34.6090028732896,-58.4718273537441 -34.609203556233,-58.4723950967868 -34.6094944386407,-58.4731798846756 -34.6084824350396,-58.4739642276902 -34.6074707783912,-58.4729878806079 -34.6069777477093,-58.4728176044834 -34.6068912798573,-58.4716652893272 -34.6063008550093,-58.4708965161981 -34.6073085522213,-58.470116056636 -34.6083315273902,-58.4712725623687 -34.6089199240485)))";;"596";11_20_4;COMUNA 11;"20";"4";"893";"406";"487";"83,37%";"338";"338";"100,00%";"0";"0,00%";"303";"10";"3.3";"293";"96,70%";"3.3";3.300
"MULTIPOLYGON (((-58.4763238047764 -34.608722203775,-58.4761481542838 -34.6086283465574,-58.4750997969503 -34.6080709017833,-58.474107418293 -34.6075431621403,-58.4739642276902 -34.6074707783912,-58.4731798846756 -34.6084824350396,-58.4723950967868 -34.6094944386407,-58.4725292601982 -34.6095631628282,-58.4735287233468 -34.6100956329855,-58.4745527326977 -34.6106411211712,-58.4747228484162 -34.6107310373936,-58.4755236342074 -34.6097256373079,-58.4761515260179 -34.608937301247,-58.4763238047764 -34.608722203775)))";;"597";11_20_5;COMUNA 11;"20";"5";"863";"416";"447";"93,06%";"378";"378";"100,00%";"0";"0,00%";"328";"8";"2.44";"320";"97,56%";"2.44";2.440
"MULTIPOLYGON (((-58.4719586806527 -34.6121188642866,-58.4711705220059 -34.6131343809211,-58.4713593802697 -34.6132350051064,-58.4716456927851 -34.613388792827,-58.4718214336225 -34.6134844874982,-58.4719593544273 -34.6135841285955,-58.4720936201343 -34.6137495468386,-58.4722192782877 -34.6138741894829,-58.4723244633634 -34.6137420637879,-58.4731255624843 -34.6127363982079,-58.4739245982915 -34.6117331922719,-58.4747228484162 -34.6107310373936,-58.4745527326977 -34.6106411211712,-58.4735287233468 -34.6100956329855,-58.4727418804432 -34.6111096106358,-58.4725749538456 -34.6113247025341,-58.4719586806527 -34.6121188642866)))";;"598";11_20_6;COMUNA 11;"20";"6";"711";"336";"375";"89,60%";"292";"291";"99,66%";"1";"0,34%";"267";"8";"3";"259";"97,00%";"3";3.000
"MULTIPOLYGON (((-58.4716063721092 -34.6105110149473,-58.4708244417313 -34.6115185711216,-58.4700380635411 -34.6125317563942,-58.4709440119506 -34.6130136878426,-58.4711705220059 -34.6131343809211,-58.4719586806527 -34.6121188642866,-58.4725749538456 -34.6113247025341,-58.4727418804432 -34.6111096106358,-58.4735287233468 -34.6100956329855,-58.4725292601982 -34.6095631628282,-58.4723950967868 -34.6094944386407,-58.4722294500465 -34.6097081919441,-58.4716063721092 -34.6105110149473)))";;"599";11_20_7;COMUNA 11;"20";"7";"653";"295";"358";"82,40%";"259";"259";"100,00%";"0";"0,00%";"232";"2";"0.86";"230";"99,14%";"0.86";0.860
"MULTIPOLYGON (((-58.4723950967868 -34.6094944386407,-58.4718273537441 -34.609203556233,-58.4714356005796 -34.6090028732896,-58.4712725623687 -34.6089199240485,-58.470116056636 -34.6083315273902,-58.469350482496 -34.6093349888254,-58.4694552556607 -34.6093899850939,-58.470501375806 -34.6099323369925,-58.4709463706982 -34.6101630204183,-58.4710500386039 -34.6102177336839,-58.4716063721092 -34.6105110149473,-58.4722294500465 -34.6097081919441,-58.4723950967868 -34.6094944386407)))";;"600";11_20_8;COMUNA 11;"20";"8";"502";"240";"262";"91,60%";"234";"234";"100,00%";"0";"0,00%";"191";"1";"0.52";"190";"99,48%";"0.52";0.520
"MULTIPOLYGON (((-58.470116056636 -34.6083315273902,-58.4687527599218 -34.6077498205344,-58.4672876949892 -34.6071246499384,-58.4665162213973 -34.6081430945662,-58.4666502070047 -34.6082026699713,-58.4679536176873 -34.6087976427963,-58.4680601654655 -34.6086579146943,-58.469350482496 -34.6093349888254,-58.470116056636 -34.6083315273902)))";;"601";11_20_9;COMUNA 11;"20";"9";"820";"376";"444";"84,68%";"299";"299";"100,00%";"0";"0,00%";"260";"1";"0.38";"259";"99,62%";"0.38";0.380
"MULTIPOLYGON (((-58.4704341176867 -34.6029375029852,-58.4701945190696 -34.6028061045093,-58.4692921652885 -34.602165075938,-58.4689122822032 -34.6018603659761,-58.4687660474554 -34.6018941070111,-58.467492941229 -34.6022101615869,-58.4673340151915 -34.6022495354184,-58.4660827016225 -34.6025595882901,-58.4668521519482 -34.6028902812918,-58.4682774483018 -34.6035027124194,-58.4684282069388 -34.6035674966142,-58.4696041322319 -34.6040714688382,-58.4696961083359 -34.6039506843995,-58.4704341176867 -34.6029375029852)))";;"602";11_21_1;COMUNA 11;"21";"1";"794";"342";"452";"75,66%";"376";"376";"100,00%";"0";"0,00%";"323";"20";"6.19";"303";"93,81%";"6.19";6.190
"MULTIPOLYGON (((-58.4657802839441 -34.6078273290219,-58.4654995389463 -34.6077081764395,-58.4653510749121 -34.6076452196743,-58.4651868533129 -34.607574727559,-58.4644020625737 -34.6086073144676,-58.464251722069 -34.6084473809855,-58.4640640747237 -34.6082872364613,-58.4639460185736 -34.608208009441,-58.4638844352605 -34.6081667409216,-58.4637596504477 -34.6080830065754,-58.4627046538459 -34.6073729848495,-58.4621929112938 -34.6084069657696,-58.463426363095 -34.6090508616702,-58.4651317282476 -34.609941154043,-58.4653637450893 -34.6096528287461,-58.465513311633 -34.6094670439084,-58.4665162213973 -34.6081430945662,-58.4657802839441 -34.6078273290219)))";;"603";11_21_10;COMUNA 11;"21";"10";"829";"400";"429";"93,24%";"336";"336";"100,00%";"0";"0,00%";"292";"25";"8.56";"267";"91,44%";"8.56";8.560
"MULTIPOLYGON (((-58.4651868533129 -34.607574727559,-58.4644197513301 -34.6072457144812,-58.4643034003915 -34.6071957846326,-58.4632396390474 -34.6067453546816,-58.4630517422872 -34.6066653523881,-58.4619204512827 -34.6061832901736,-58.4617706298809 -34.6061194839252,-58.460635691235 -34.6056360012242,-58.4605130340719 -34.6058858675878,-58.4615404818497 -34.6065835837754,-58.4621505024981 -34.6069978288233,-58.4625100274186 -34.6072419939201,-58.4627046538459 -34.6073729848495,-58.4637596504477 -34.6080830065754,-58.4638844352605 -34.6081667409216,-58.4639460185736 -34.608208009441,-58.4640640747237 -34.6082872364613,-58.464251722069 -34.6084473809855,-58.4644020625737 -34.6086073144676,-58.4651868533129 -34.607574727559)))";;"604";11_21_11;COMUNA 11;"21";"11";"941";"416";"525";"79,24%";"427";"427";"100,00%";"0";"0,00%";"374";"15";"4.01";"359";"95,99%";"4.01";4.010
"MULTIPOLYGON (((-58.4667313368809 -34.6055407372577,-58.4679174156701 -34.606047401394,-58.4680582980655 -34.606107256679,-58.4688298191707 -34.6050887315347,-58.4689257150553 -34.60496210221,-58.4696041322319 -34.6040714688382,-58.4684282069388 -34.6035674966142,-58.4682774483018 -34.6035027124194,-58.4675055943615 -34.6045201075457,-58.466247397362 -34.6039799894313,-58.4660852263789 -34.6039100618245,-58.4655251712689 -34.6050251180183,-58.4665798946075 -34.6054760214342,-58.4667313368809 -34.6055407372577)))";;"605";11_21_2;COMUNA 11;"21";"2";"765";"364";"401";"90,77%";"306";"306";"100,00%";"0";"0,00%";"271";"7";"2.58";"264";"97,42%";"2.58";2.580
"MULTIPOLYGON (((-58.4660827016225 -34.6025595882901,-58.465796955897 -34.602630373209,-58.4652785241911 -34.6027589112645,-58.4649457629742 -34.6028430759609,-58.4647103612332 -34.6033166895379,-58.4660852263789 -34.6039100618245,-58.466247397362 -34.6039799894313,-58.4675055943615 -34.6045201075457,-58.4682774483018 -34.6035027124194,-58.4668521519482 -34.6028902812918,-58.4660827016225 -34.6025595882901)))";;"606";11_21_3;COMUNA 11;"21";"3";"997";"432";"565";"76,46%";"469";"469";"100,00%";"0";"0,00%";"423";"26";"6.15";"397";"93,85%";"6.15";6.150
"MULTIPOLYGON (((-58.4660852263789 -34.6039100618245,-58.4647103612332 -34.6033166895379,-58.4649457629742 -34.6028430759609,-58.4643593623198 -34.6029914712455,-58.4630730210854 -34.6033169168047,-58.4629111950198 -34.6033581159325,-58.4621085353709 -34.6035625590252,-58.4628759350561 -34.6038913051317,-58.4641529322009 -34.604438359466,-58.4643421026136 -34.6045193460284,-58.4655251712689 -34.6050251180183,-58.4660852263789 -34.6039100618245)))";;"607";11_21_4;COMUNA 11;"21";"4";"756";"333";"423";"78,72%";"373";"373";"100,00%";"0";"0,00%";"318";"17";"5.35";"301";"94,65%";"5.35";5.350
"MULTIPOLYGON (((-58.4601240140233 -34.6040687495447,-58.4600209545276 -34.6040951567711,-58.4589348227102 -34.6043736597031,-58.4584739469889 -34.6044918180705,-58.4587824326416 -34.6047148649183,-58.4595130285781 -34.6052089892405,-58.4596535615486 -34.6053039963914,-58.4603105787193 -34.6057483938619,-58.4605130340719 -34.6058858675878,-58.460635691235 -34.6056360012242,-58.4611833805772 -34.6045200519043,-58.4623231620884 -34.6050056423696,-58.4628759350561 -34.6038913051317,-58.4621085353709 -34.6035625590252,-58.4615883035222 -34.6036950956092,-58.4614694028875 -34.6037253773009,-58.4605391472324 -34.6039623451416,-58.4601240140233 -34.6040687495447)))";;"608";11_21_5;COMUNA 11;"21";"5";"922";"410";"512";"80,08%";"475";"475";"100,00%";"0";"0,00%";"391";"10";"2.56";"381";"97,44%";"2.56";2.560
"MULTIPOLYGON (((-58.4636004281608 -34.6055500966558,-58.4641529322009 -34.604438359466,-58.4628759350561 -34.6038913051317,-58.4623231620884 -34.6050056423696,-58.4611833805772 -34.6045200519043,-58.460635691235 -34.6056360012242,-58.4617706298809 -34.6061194839252,-58.4619204512827 -34.6061832901736,-58.4630517422872 -34.6066653523881,-58.4631261844909 -34.6065043602356,-58.4636004281608 -34.6055500966558)))";;"609";11_21_6;COMUNA 11;"21";"6";"969";"450";"519";"86,71%";"426";"426";"100,00%";"0";"0,00%";"385";"23";"5.97";"362";"94,03%";"5.97";5.970
"MULTIPOLYGON (((-58.4636004281608 -34.6055500966558,-58.4631261844909 -34.6065043602356,-58.4630517422872 -34.6066653523881,-58.4632396390474 -34.6067453546816,-58.4643034003915 -34.6071957846326,-58.4644197513301 -34.6072457144812,-58.4649095703067 -34.606250669539,-58.4649678266213 -34.6061346077994,-58.4655251712689 -34.6050251180183,-58.4643421026136 -34.6045193460284,-58.4641529322009 -34.604438359466,-58.4636004281608 -34.6055500966558)))";;"610";11_21_7;COMUNA 11;"21";"7";"711";"323";"388";"83,25%";"325";"325";"100,00%";"0";"0,00%";"270";"1";"0.37";"269";"99,63%";"0.37";0.370
"MULTIPOLYGON (((-58.4649678266213 -34.6061346077994,-58.4649095703067 -34.606250669539,-58.4644197513301 -34.6072457144812,-58.4651868533129 -34.607574727559,-58.4659595303938 -34.6065579109881,-58.4672876949892 -34.6071246499384,-58.4680582980655 -34.606107256679,-58.4679174156701 -34.606047401394,-58.4667313368809 -34.6055407372577,-58.4665798946075 -34.6054760214342,-58.4655251712689 -34.6050251180183,-58.4649678266213 -34.6061346077994)))";;"611";11_21_8;COMUNA 11;"21";"8";"712";"344";"368";"93,48%";"313";"313";"100,00%";"0";"0,00%";"256";"6";"2.34";"250";"97,66%";"2.34";2.340
"MULTIPOLYGON (((-58.4672876949892 -34.6071246499384,-58.4659595303938 -34.6065579109881,-58.4651868533129 -34.607574727559,-58.4653510749121 -34.6076452196743,-58.4654995389463 -34.6077081764395,-58.4657802839441 -34.6078273290219,-58.4665162213973 -34.6081430945662,-58.4672876949892 -34.6071246499384)))";;"612";11_21_9;COMUNA 11;"21";"9";"537";"246";"291";"84,54%";"268";"268";"100,00%";"0";"0,00%";"218";"1";"0.46";"217";"99,54%";"0.46";0.460
"MULTIPOLYGON (((-58.463426363095 -34.6090508616702,-58.4621929112938 -34.6084069657696,-58.4616406103216 -34.6095229188694,-58.4618260417628 -34.6096256705962,-58.4626928993536 -34.6100809017146,-58.4628498836165 -34.6101635807123,-58.4627836999261 -34.6102914023642,-58.4622573749021 -34.6112860154348,-58.4624089946868 -34.6113634835062,-58.4637015224028 -34.6120410396354,-58.4644139511002 -34.6109875425948,-58.4650680170276 -34.6100203131316,-58.4651317282476 -34.609941154043,-58.463426363095 -34.6090508616702)))";;"613";11_22_1;COMUNA 11;"22";"1";"904";"402";"502";"80,08%";"379";"378";"99,74%";"1";"0,26%";"345";"16";"4.64";"329";"95,36%";"4.64";4.640
"MULTIPOLYGON (((-58.4617074414901 -34.612343304216,-58.4607082827793 -34.6117955255965,-58.4605526602413 -34.6117210132009,-58.4604853642341 -34.6118569324401,-58.4600362644989 -34.6127561814814,-58.4595438792337 -34.6137419096196,-58.4594483842544 -34.6138856446923,-58.4603934737136 -34.6142453974951,-58.4606674191903 -34.6143480116946,-58.4618649163803 -34.6147967038733,-58.4620466149754 -34.6144878910645,-58.4624533659453 -34.6138865328761,-58.4630130116172 -34.6130590380322,-58.4617074414901 -34.612343304216)))";;"614";11_22_10;COMUNA 11;"22";"10";"777";"369";"408";"90,44%";"394";"394";"100,00%";"0";"0,00%";"307";"2";"0.65";"305";"99,35%";"0.65";0.650
"MULTIPOLYGON (((-58.4649836584577 -34.615078737736,-58.4636355344041 -34.6144432397337,-58.4641982403113 -34.613708771033,-58.4630130116172 -34.6130590380322,-58.4624533659453 -34.6138865328761,-58.4620466149754 -34.6144878910645,-58.4618649163803 -34.6147967038733,-58.4630301417298 -34.615233200821,-58.4632040875209 -34.6152983434062,-58.464134812804 -34.615643630065,-58.464373160063 -34.6157287004949,-58.4644659265149 -34.6157617989626,-58.4649836584577 -34.615078737736)))";;"615";11_22_11;COMUNA 11;"22";"11";"701";"334";"367";"91,01%";"284";"283";"99,65%";"1";"0,35%";"248";"4";"1.61";"244";"98,39%";"1.61";1.610
"MULTIPOLYGON (((-58.4644139511002 -34.6109875425948,-58.4637015224028 -34.6120410396354,-58.4647980664371 -34.6126159057432,-58.4649668127646 -34.6127056947137,-58.4656507014888 -34.6118131124471,-58.4657447361023 -34.6116902183371,-58.4670352519615 -34.6123739365696,-58.4677169008195 -34.6114759200198,-58.4678139982157 -34.6113486578257,-58.467848237754 -34.6113037955939,-58.4665609684381 -34.6106166349074,-58.4659421292717 -34.6102862887071,-58.4658808834449 -34.6102264993947,-58.4658231352581 -34.6103062925443,-58.4651317282476 -34.609941154043,-58.4650680170276 -34.6100203131316,-58.4644139511002 -34.6109875425948)))";;"616";11_22_2;COMUNA 11;"22";"2";"977";"488";"489";"99,80%";"402";"401";"99,75%";"1";"0,25%";"358";"36";"10.06";"322";"89,94%";"10.06";10.060
"MULTIPOLYGON (((-58.4662604899046 -34.6133943507241,-58.4661553811065 -34.6135328798791,-58.4654875828853 -34.614413914645,-58.4655852044173 -34.6144663086267,-58.4666339191218 -34.615019961182,-58.4676787291531 -34.6155714920794,-58.4684644832589 -34.6145590972215,-58.4674069029237 -34.6140003900973,-58.4681802085185 -34.6129803209552,-58.4682831839007 -34.6128444662944,-58.4689586910055 -34.6119575703226,-58.4683995459281 -34.6116601221059,-58.4678139982157 -34.6113486578257,-58.4677169008195 -34.6114759200198,-58.4670352519615 -34.6123739365696,-58.4662604899046 -34.6133943507241)))";;"617";11_22_3;COMUNA 11;"22";"3";"996";"485";"511";"94,91%";"419";"419";"100,00%";"0";"0,00%";"360";"10";"2.78";"350";"97,22%";"2.78";2.780
"MULTIPOLYGON (((-58.4722192782877 -34.6138741894829,-58.4720936201343 -34.6137495468386,-58.4719593544273 -34.6135841285955,-58.4718214336225 -34.6134844874982,-58.4716456927851 -34.613388792827,-58.4713593802697 -34.6132350051064,-58.4711705220059 -34.6131343809211,-58.4709440119506 -34.6130136878426,-58.4700380635411 -34.6125317563942,-58.4695075327523 -34.612249593805,-58.4689586910055 -34.6119575703226,-58.4682831839007 -34.6128444662944,-58.4681802085185 -34.6129803209552,-58.469250133121 -34.6135469084165,-58.4703842179576 -34.6141474273017,-58.4715217266544 -34.6147497663886,-58.4722192782877 -34.6138741894829)))";;"618";11_22_4;COMUNA 11;"22";"4";"694";"324";"370";"87,57%";"328";"327";"99,70%";"1";"0,31%";"265";"9";"3.4";"256";"96,60%";"3.4";3.400
"MULTIPOLYGON (((-58.469250133121 -34.6135469084165,-58.4681802085185 -34.6129803209552,-58.4674069029237 -34.6140003900973,-58.4684644832589 -34.6145590972215,-58.4686490821014 -34.6146566270772,-58.46959951314 -34.6151585668804,-58.4688139375171 -34.6161706872396,-58.4699233498458 -34.6167563516986,-58.4707233144332 -34.6157521109539,-58.4711226081268 -34.6152509393388,-58.4715217266544 -34.6147497663886,-58.4703842179576 -34.6141474273017,-58.469250133121 -34.6135469084165)))";;"619";11_22_5;COMUNA 11;"22";"5";"893";"421";"472";"89,19%";"378";"377";"99,74%";"1";"0,27%";"310";"6";"1.94";"304";"98,06%";"1.94";1.940
"MULTIPOLYGON (((-58.4688139375171 -34.6161706872396,-58.46959951314 -34.6151585668804,-58.4686490821014 -34.6146566270772,-58.4684644832589 -34.6145590972215,-58.4676787291531 -34.6155714920794,-58.4667629714793 -34.6167512160106,-58.4679607959446 -34.6172697098007,-58.4686352336432 -34.6175616610453,-58.4687968379826 -34.617644895464,-58.4690936387863 -34.617797843437,-58.4699233498458 -34.6167563516986,-58.4688139375171 -34.6161706872396)))";;"620";11_22_6;COMUNA 11;"22";"6";"1032";"487";"545";"89,36%";"488";"488";"100,00%";"0";"0,00%";"409";"29";"7.09";"380";"92,91%";"7.09";7.090
"MULTIPOLYGON (((-58.4666339191218 -34.615019961182,-58.4655852044173 -34.6144663086267,-58.4654875828853 -34.614413914645,-58.4649836584577 -34.615078737736,-58.4644659265149 -34.6157617989626,-58.4645385893608 -34.6157877143089,-58.4655426727761 -34.6162229922839,-58.4656774372922 -34.616281371434,-58.4666516318934 -34.6167030489388,-58.4667629714793 -34.6167512160106,-58.4676787291531 -34.6155714920794,-58.4666339191218 -34.615019961182)))";;"621";11_22_7;COMUNA 11;"22";"7";"856";"371";"485";"76,49%";"406";"405";"99,75%";"1";"0,25%";"345";"4";"1.16";"341";"98,84%";"1.16";1.160
"MULTIPOLYGON (((-58.4670352519615 -34.6123739365696,-58.4657447361023 -34.6116902183371,-58.4656507014888 -34.6118131124471,-58.4649668127646 -34.6127056947137,-58.4647980664371 -34.6126159057432,-58.4637015224028 -34.6120410396354,-58.4630130116172 -34.6130590380322,-58.4641982403113 -34.613708771033,-58.4636355344041 -34.6144432397337,-58.4649836584577 -34.615078737736,-58.4654875828853 -34.614413914645,-58.4661553811065 -34.6135328798791,-58.4662604899046 -34.6133943507241,-58.4670352519615 -34.6123739365696)))";;"622";11_22_8;COMUNA 11;"22";"8";"865";"414";"451";"91,80%";"346";"344";"99,42%";"2";"0,58%";"269";"7";"2.6";"262";"97,40%";"2.6";2.600
"MULTIPOLYGON (((-58.4637015224028 -34.6120410396354,-58.4624089946868 -34.6113634835062,-58.4622573749021 -34.6112860154348,-58.4627836999261 -34.6102914023642,-58.4628498836165 -34.6101635807123,-58.4626928993536 -34.6100809017146,-58.4618260417628 -34.6096256705962,-58.4616406103216 -34.6095229188694,-58.4610748357344 -34.6106660531792,-58.4605526602413 -34.6117210132009,-58.4607082827793 -34.6117955255965,-58.4617074414901 -34.612343304216,-58.4630130116172 -34.6130590380322,-58.4637015224028 -34.6120410396354)))";;"623";11_22_9;COMUNA 11;"22";"9";"763";"358";"405";"88,40%";"318";"318";"100,00%";"0";"0,00%";"269";"9";"3.35";"260";"96,65%";"3.35";3.350
"MULTIPOLYGON (((-58.5126895567077 -34.5974101845938,-58.5120516061783 -34.5970207813145,-58.5118171461244 -34.5968757998732,-58.5113852884877 -34.5966087090579,-58.5107342772488 -34.597328572382,-58.5101267474797 -34.5980004556656,-58.5100328679298 -34.5981033505031,-58.5094418391137 -34.5987578617635,-58.5082669050174 -34.5980328557076,-58.5081387717592 -34.5979535342301,-58.5076319931774 -34.5985122645333,-58.5075171714141 -34.5986392130498,-58.5086746425239 -34.5993539507482,-58.5088210956443 -34.5994443919076,-58.5092951322277 -34.5997371103557,-58.5101241078603 -34.6002489936676,-58.5107452722551 -34.5995621751209,-58.5113394984687 -34.5989064275312,-58.5114298349935 -34.5988052549239,-58.51203701924 -34.5981330132567,-58.5122312418742 -34.5979190530925,-58.5126895567077 -34.5974101845938)))";;"624";11_3_1;COMUNA 11;"3";"1";"693";"328";"365";"89,86%";"337";"337";"100,00%";"0";"0,00%";"264";"2";"0.76";"262";"99,24%";"0.76";0.760
"MULTIPOLYGON (((-58.5029121117017 -34.5991671053404,-58.5022145282803 -34.5999348978673,-58.5030934720057 -34.600478785803,-58.5039097663932 -34.6003811851896,-58.5047154134351 -34.6002848504352,-58.5062805435431 -34.6000976746303,-58.5063732752703 -34.5999031974198,-58.5068960721591 -34.5993254518504,-58.5067570343604 -34.5992415552478,-58.5055919986248 -34.5985214496798,-58.5049235572796 -34.5992590350898,-58.5035823588798 -34.5984300937284,-58.5030175780414 -34.5990510097437,-58.5029121117017 -34.5991671053404)))";;"625";11_3_10;COMUNA 11;"3";"10";"773";"356";"417";"85,37%";"368";"368";"100,00%";"0";"0,00%";"317";"2";"0.63";"315";"99,37%";"0.63";0.630
"MULTIPOLYGON (((-58.5039097663932 -34.6003811851896,-58.5030934720057 -34.600478785803,-58.5034044319131 -34.6006712954522,-58.5035599974876 -34.6007673738854,-58.5036481742013 -34.600821853447,-58.5048623835146 -34.6015720318802,-58.5055437883929 -34.6019930076964,-58.5064599129327 -34.6020553610163,-58.50772133244 -34.6021411729846,-58.5083764855673 -34.6021812831345,-58.5088338270629 -34.6016756693771,-58.5075312306333 -34.6008707017524,-58.5062805435431 -34.6000976746303,-58.5047154134351 -34.6002848504352,-58.5039097663932 -34.6003811851896)))";;"626";11_3_11;COMUNA 11;"3";"11";"740";"325";"415";"78,31%";"319";"316";"99,06%";"3";"0,95%";"254";"0";"0";"254";"100,00%";"0";0.000
"MULTIPOLYGON (((-58.5080765693155 -34.6025001636856,-58.5084000597812 -34.6021828538705,-58.5083764855673 -34.6021812831345,-58.50772133244 -34.6021411729846,-58.5064599129327 -34.6020553610163,-58.5055437883929 -34.6019930076964,-58.5058160796728 -34.6021612984489,-58.5061676914151 -34.6023785058724,-58.5059782101206 -34.6025880177706,-58.505373842238 -34.6032636786808,-58.5046198157128 -34.6041065774185,-58.5037340832419 -34.6050967043583,-58.5036072455107 -34.6052409776963,-58.5037849695886 -34.6053463444584,-58.5043318613318 -34.605670044417,-58.5044453468225 -34.6057372616729,-58.5047375812448 -34.6059101959606,-58.5049193122277 -34.6060172498811,-58.5057856326729 -34.6050500095252,-58.5059075300154 -34.604912919037,-58.5060127427497 -34.6047945674439,-58.5066717683342 -34.6040640226351,-58.5073129069138 -34.6033532702035,-58.5074689349904 -34.6031825023938,-58.5080915171923 -34.6025010940563,-58.5080765693155 -34.6025001636856)))";;"627";11_3_12;COMUNA 11;"3";"12";"775";"371";"404";"91,83%";"327";"326";"99,69%";"1";"0,31%";"282";"3";"1.06";"279";"98,94%";"1.06";1.060
"MULTIPOLYGON (((-58.5100846205221 -34.5958042602057,-58.5096518368158 -34.595536529736,-58.509627444008 -34.5955330239208,-58.5084530630381 -34.5953642318741,-58.5081303168078 -34.5957204226685,-58.5075221812197 -34.5963915891389,-58.5074309506614 -34.5964930077437,-58.5087362780836 -34.5972950778024,-58.5100328679298 -34.5981033505031,-58.5101267474797 -34.5980004556656,-58.5107342772488 -34.597328572382,-58.5113852884877 -34.5966087090579,-58.5100846205221 -34.5958042602057)))";;"628";11_3_2;COMUNA 11;"3";"2";"800";"367";"433";"84,76%";"374";"372";"99,47%";"2";"0,54%";"292";"2";"0.68";"290";"99,32%";"0.68";0.680
"MULTIPOLYGON (((-58.5084530630381 -34.5953642318741,-58.5072553097654 -34.595179949558,-58.5066238575542 -34.5950828507356,-58.5050921066883 -34.5948773401541,-58.5047790118837 -34.5948204929448,-58.5031812070856 -34.5945822209649,-58.5028768752027 -34.5946979180691,-58.5028766593643 -34.5946980001235,-58.5041630992338 -34.5954939389351,-58.5054997414412 -34.5963209040191,-58.5068366657053 -34.597147995088,-58.5074309506614 -34.5964930077437,-58.5075221812197 -34.5963915891389,-58.5081303168078 -34.5957204226685,-58.5084530630381 -34.5953642318741)))";;"629";11_3_3;COMUNA 11;"3";"3";"687";"307";"380";"80,79%";"305";"303";"99,34%";"2";"0,66%";"240";"1";"0.42";"239";"99,58%";"0.42";0.420
"MULTIPOLYGON (((-58.5062143798686 -34.5978347239905,-58.5064166294848 -34.5979595156737,-58.5075171714141 -34.5986392130498,-58.5076319931774 -34.5985122645333,-58.5081387717592 -34.5979535342301,-58.5082669050174 -34.5980328557076,-58.5094418391137 -34.5987578617635,-58.5100328679298 -34.5981033505031,-58.5087362780836 -34.5972950778024,-58.5074309506614 -34.5964930077437,-58.5068366657053 -34.597147995088,-58.5054997414412 -34.5963209040191,-58.504987677522 -34.5968849072416,-58.5048754071817 -34.5970084015848,-58.5062143798686 -34.5978347239905)))";;"630";11_3_4;COMUNA 11;"3";"4";"619";"280";"339";"82,60%";"271";"269";"99,26%";"2";"0,74%";"210";"1";"0.48";"209";"99,52%";"0.48";0.480
"MULTIPOLYGON (((-58.5062805435431 -34.6000976746303,-58.5075312306333 -34.6008707017524,-58.5088338270629 -34.6016756693771,-58.5095019118431 -34.6009369361783,-58.5101241078603 -34.6002489936676,-58.5092951322277 -34.5997371103557,-58.5088210956443 -34.5994443919076,-58.5086746425239 -34.5993539507482,-58.5075171714141 -34.5986392130498,-58.5064166294848 -34.5979595156737,-58.5062143798686 -34.5978347239905,-58.5055919986248 -34.5985214496798,-58.5067570343604 -34.5992415552478,-58.5068960721591 -34.5993254518504,-58.5063732752703 -34.5999031974198,-58.5062805435431 -34.6000976746303)))";;"631";11_3_5;COMUNA 11;"3";"5";"565";"247";"318";"77,67%";"312";"311";"99,68%";"1";"0,32%";"233";"1";"0.43";"232";"99,57%";"0.43";0.430
"MULTIPOLYGON (((-58.5048754071817 -34.5970084015848,-58.504987677522 -34.5968849072416,-58.5054997414412 -34.5963209040191,-58.5041630992338 -34.5954939389351,-58.5028766593643 -34.5946980001235,-58.5027574526382 -34.59474233682,-58.5022028204826 -34.5953535978374,-58.5023302645066 -34.5954365174986,-58.5035382499069 -34.5961829792856,-58.50301187375 -34.5967633176855,-58.5029189246688 -34.5968692679566,-58.5042523388979 -34.5976934305675,-58.5055919986248 -34.5985214496798,-58.5062143798686 -34.5978347239905,-58.5048754071817 -34.5970084015848)))";;"632";11_3_6;COMUNA 11;"3";"6";"755";"358";"397";"90,18%";"349";"349";"100,00%";"0";"0,00%";"287";"0";"0";"287";"100,00%";"0";0.000
"MULTIPOLYGON (((-58.5022028204826 -34.5953535978374,-58.5015788069947 -34.5960412193998,-58.5009104347126 -34.5967777971566,-58.502121149929 -34.597519553458,-58.5022510674248 -34.5976033879006,-58.502389674817 -34.5976929238233,-58.5035823588798 -34.5984300937284,-58.5049235572796 -34.5992590350898,-58.5055919986248 -34.5985214496798,-58.5042523388979 -34.5976934305675,-58.5029189246688 -34.5968692679566,-58.50301187375 -34.5967633176855,-58.5035382499069 -34.5961829792856,-58.5023302645066 -34.5954365174986,-58.5022028204826 -34.5953535978374)))";;"633";11_3_7;COMUNA 11;"3";"7";"789";"376";"413";"91,04%";"319";"319";"100,00%";"0";"0,00%";"283";"8";"2.83";"275";"97,17%";"2.83";2.830
"MULTIPOLYGON (((-58.4983848619464 -34.5963676304009,-58.4971751147229 -34.5968173618249,-58.4980047535444 -34.5973293275663,-58.498222579274 -34.5974641991505,-58.4995434342457 -34.5982817264063,-58.5001369246445 -34.5976340559827,-58.5002418804603 -34.5975147233499,-58.5003379832639 -34.5974053937425,-58.5008049683415 -34.5968939614007,-58.5009104347126 -34.5967777971566,-58.5015788069947 -34.5960412193998,-58.5022028204826 -34.5953535978374,-58.5027574526382 -34.59474233682,-58.501792895151 -34.5951008326492,-58.5007097164842 -34.5955033736435,-58.5001263573109 -34.5957201821187,-58.4996339354819 -34.595903297026,-58.499550828959 -34.5959341684229,-58.4983848619464 -34.5963676304009)))";;"634";11_3_8;COMUNA 11;"3";"8";"757";"320";"437";"73,23%";"380";"379";"99,74%";"1";"0,26%";"299";"0";"0";"299";"100,00%";"0";0.000
"MULTIPOLYGON (((-58.5022510674248 -34.5976033879006,-58.502121149929 -34.597519553458,-58.5009104347126 -34.5967777971566,-58.5008049683415 -34.5968939614007,-58.5003379832639 -34.5974053937425,-58.5002418804603 -34.5975147233499,-58.5001369246445 -34.5976340559827,-58.4995434342457 -34.5982817264063,-58.5006429880444 -34.5989623311653,-58.5008809274643 -34.5991095865516,-58.5022145282803 -34.5999348978673,-58.5029121117017 -34.5991671053404,-58.5030175780414 -34.5990510097437,-58.5035823588798 -34.5984300937284,-58.502389674817 -34.5976929238233,-58.5022510674248 -34.5976033879006)))";;"635";11_3_9;COMUNA 11;"3";"9";"734";"340";"394";"86,29%";"359";"359";"100,00%";"0";"0,00%";"298";"3";"1.01";"295";"98,99%";"1.01";1.010
"MULTIPOLYGON (((-58.5213712156111 -34.6038936787501,-58.5220332441575 -34.603153682936,-58.5201310589369 -34.603080435363,-58.5182254687086 -34.603004976502,-58.5181469952041 -34.6030921032299,-58.5194008182483 -34.6038898854129,-58.5193308796657 -34.6039677441198,-58.5188134168889 -34.6045399764593,-58.5187340095385 -34.604627762715,-58.5181937298676 -34.6052267644072,-58.5175736924119 -34.6059142535447,-58.5188411863362 -34.6066959594968,-58.5194612185627 -34.6060076189093,-58.5200799640205 -34.6053208250573,-58.5205954639563 -34.604748588353,-58.5206716057586 -34.6046666764623,-58.5207613425322 -34.6045706859796,-58.5208661120049 -34.6044582375072,-58.5213712156111 -34.6038936787501)))";;"636";11_4_1;COMUNA 11;"4";"1";"829";"394";"435";"90,57%";"331";"331";"100,00%";"0";"0,00%";"284";"0";"0";"284";"100,00%";"0";0.000
"MULTIPOLYGON (((-58.5104628381809 -34.6050358030069,-58.5102300627298 -34.6048924378349,-58.5091944239919 -34.604250700125,-58.5083979469684 -34.6051325833493,-58.5076325232131 -34.6059800119193,-58.507780435611 -34.606071932616,-58.5081299388227 -34.6062877265128,-58.5082706944786 -34.606373874412,-58.509032366335 -34.6055239784385,-58.5091414259714 -34.6055904887556,-58.5094710792523 -34.6057958634572,-58.5096720740458 -34.6059181851719,-58.5098466562826 -34.6060244598258,-58.5102742977998 -34.6062893741191,-58.5104729974987 -34.606415639207,-58.5106451134648 -34.6065249419561,-58.5119659954422 -34.6073717711179,-58.5127845013476 -34.6064648549637,-58.5117305068561 -34.6058161039801,-58.5112447546583 -34.6055170617011,-58.5104628381809 -34.6050358030069)))";;"637";11_4_10;COMUNA 11;"4";"10";"691";"309";"382";"80,89%";"342";"342";"100,00%";"0";"0,00%";"281";"6";"2.14";"275";"97,86%";"2.14";2.140
"MULTIPOLYGON (((-58.5111974382415 -34.6082232372317,-58.5119659954422 -34.6073717711179,-58.5106451134648 -34.6065249419561,-58.5104729974987 -34.606415639207,-58.5102742977998 -34.6062893741191,-58.5098466562826 -34.6060244598258,-58.5096720740458 -34.6059181851719,-58.5094710792523 -34.6057958634572,-58.5091414259714 -34.6055904887556,-58.509032366335 -34.6055239784385,-58.5082706944786 -34.606373874412,-58.5084094907475 -34.6064588256539,-58.5087494557717 -34.6066713113519,-58.5089066574099 -34.6067680865009,-58.5080733809121 -34.6076934334954,-58.507956930494 -34.6078234111259,-58.5081321090857 -34.607926589272,-58.5086527899846 -34.6082317576598,-58.5088235417644 -34.6083361336999,-58.5102879004676 -34.6092308859559,-58.5111974382415 -34.6082232372317)))";;"638";11_4_11;COMUNA 11;"4";"11";"931";"414";"517";"80,08%";"407";"406";"99,75%";"1";"0,25%";"313";"3";"0.96";"310";"99,04%";"0.96";0.960
"MULTIPOLYGON (((-58.5076325232131 -34.6059800119193,-58.5083979469684 -34.6051325833493,-58.5091944239919 -34.604250700125,-58.5083338036748 -34.6037173430052,-58.5075396225672 -34.604599712823,-58.5067741965696 -34.6054501643671,-58.5057935567637 -34.6065395693226,-58.5060201916555 -34.606673437706,-58.5064956150895 -34.6069523628489,-58.5066636337847 -34.6070526582583,-58.5077802186704 -34.6077193177662,-58.507956930494 -34.6078234111259,-58.5080733809121 -34.6076934334954,-58.5089066574099 -34.6067680865009,-58.5087494557717 -34.6066713113519,-58.5084094907475 -34.6064588256539,-58.5082706944786 -34.606373874412,-58.5081299388227 -34.6062877265128,-58.507780435611 -34.606071932616,-58.5076325232131 -34.6059800119193)))";;"639";11_4_12;COMUNA 11;"4";"12";"883";"414";"469";"88,27%";"437";"437";"100,00%";"0";"0,00%";"352";"0";"0";"352";"100,00%";"0";0.000
"MULTIPOLYGON (((-58.5066717683342 -34.6040640226351,-58.5060127427497 -34.6047945674439,-58.5059075300154 -34.604912919037,-58.5057856326729 -34.6050500095252,-58.5049193122277 -34.6060172498811,-58.5050817884765 -34.6061129717681,-58.5055892451677 -34.6064188621739,-58.5057935567637 -34.6065395693226,-58.5067741965696 -34.6054501643671,-58.5075396225672 -34.604599712823,-58.5083338036748 -34.6037173430052,-58.5081128779813 -34.6035804484448,-58.5074689349904 -34.6031825023938,-58.5073129069138 -34.6033532702035,-58.5066717683342 -34.6040640226351)))";;"640";11_4_13;COMUNA 11;"4";"13";"795";"366";"429";"85,31%";"398";"398";"100,00%";"0";"0,00%";"327";"0";"0";"327";"100,00%";"0";0.000
"MULTIPOLYGON (((-58.5162812159551 -34.6029323218695,-58.5161746614667 -34.6030570212008,-58.5151846100488 -34.6030265344209,-58.5151828027097 -34.6029967453427,-58.5148599113316 -34.6029857566193,-58.5148551595266 -34.6030142104276,-58.5147869366805 -34.6030132536171,-58.5147185908757 -34.603088285601,-58.5155276917287 -34.6035826044913,-58.5156567783508 -34.603663185369,-58.5157765778375 -34.6037380657093,-58.5168021185465 -34.6043694699875,-58.5169260092839 -34.6044457558789,-58.5181937298676 -34.6052267644072,-58.5187340095385 -34.604627762715,-58.5188134168889 -34.6045399764593,-58.5193308796657 -34.6039677441198,-58.5194008182483 -34.6038898854129,-58.5181469952041 -34.6030921032299,-58.5182254687086 -34.603004976502,-58.5162812159551 -34.6029323218695)))";;"641";11_4_2;COMUNA 11;"4";"2";"786";"364";"422";"86,26%";"374";"374";"100,00%";"0";"0,00%";"297";"1";"0.34";"296";"99,66%";"0.34";0.340
"MULTIPOLYGON (((-58.5182195896729 -34.600825953007,-58.5181022638138 -34.6007536796383,-58.5169523607027 -34.6000435354272,-58.5163943108959 -34.6006632425073,-58.5163010305489 -34.6007641324289,-58.5162075798186 -34.6008653040533,-58.5156931139402 -34.601436754764,-58.5156138045977 -34.6015242895406,-58.5150934069287 -34.6021017499478,-58.5150103382524 -34.6021936904749,-58.5155904059537 -34.6025515525464,-58.5162028565188 -34.6029293983962,-58.5162812159551 -34.6029323218695,-58.5182254687086 -34.603004976502,-58.5201310589369 -34.603080435363,-58.5220332441575 -34.603153682936,-58.5220474609431 -34.6031542290869,-58.5213968595486 -34.602774843448,-58.5213818412609 -34.6027742653395,-58.5207556503984 -34.602388493978,-58.519489312282 -34.6016082857279,-58.5182195896729 -34.600825953007)))";;"642";11_4_3;COMUNA 11;"4";"3";"739";"308";"431";"71,46%";"278";"276";"99,28%";"2";"0,72%";"221";"1";"0.45";"220";"99,55%";"0.45";0.450
"MULTIPOLYGON (((-58.5152865014897 -34.5990148591198,-58.5144144807654 -34.5984763378675,-58.5137222397687 -34.5980487959097,-58.5136305654123 -34.5979907333768,-58.513501488756 -34.5979088826169,-58.5133639777087 -34.5978217533276,-58.5126895567077 -34.5974101845938,-58.5122312418742 -34.5979190530925,-58.51203701924 -34.5981330132567,-58.5114298349935 -34.5988052549239,-58.5113394984687 -34.5989064275312,-58.5107452722551 -34.5995621751209,-58.5116095272296 -34.6000953733002,-58.5124730265171 -34.6006282134888,-58.5137426076971 -34.6014115216474,-58.5150103382524 -34.6021936904749,-58.5150934069287 -34.6021017499478,-58.5156138045977 -34.6015242895406,-58.5156931139402 -34.601436754764,-58.5162075798186 -34.6008653040533,-58.5163010305489 -34.6007641324289,-58.5163943108959 -34.6006632425073,-58.5169523607027 -34.6000435354272,-58.5156842182023 -34.5992604007192,-58.5152865014897 -34.5990148591198)))";;"643";11_4_4;COMUNA 11;"4";"4";"948";"407";"541";"75,23%";"379";"377";"99,47%";"2";"0,53%";"296";"0";"0";"296";"100,00%";"0";0.000
"MULTIPOLYGON (((-58.5147171282246 -34.6025182647122,-58.5152092571313 -34.6025369982995,-58.5155904059537 -34.6025515525464,-58.5150103382524 -34.6021936904749,-58.5137426076971 -34.6014115216474,-58.5124730265171 -34.6006282134888,-58.5116095272296 -34.6000953733002,-58.5107452722551 -34.5995621751209,-58.5101241078603 -34.6002489936676,-58.5095019118431 -34.6009369361783,-58.5088338270629 -34.6016756693771,-58.5083764855673 -34.6021812831345,-58.5084000597812 -34.6021828538705,-58.5080765693155 -34.6025001636856,-58.5080915171923 -34.6025010940563,-58.5083613216772 -34.6025346874655,-58.5085977786786 -34.6026823458154,-58.5086637432839 -34.6026044307165,-58.5091025568726 -34.6026277162185,-58.5091174831812 -34.6026661626988,-58.509234964284 -34.6027204862021,-58.5094120955757 -34.6025246364714,-58.5095749262733 -34.6023446376423,-58.5096461697983 -34.602265874878,-58.5109163693625 -34.6023534814873,-58.5110895282881 -34.6023654556486,-58.5115521040736 -34.6023890046174,-58.5118819798286 -34.6024052811714,-58.5121802564124 -34.6024199498719,-58.5122576253917 -34.6023337180296,-58.5125880972157 -34.6023499220075,-58.5127777777035 -34.6023589291584,-58.5128723198865 -34.6023634679585,-58.5130757133386 -34.6023731732589,-58.5136051457057 -34.60239175706,-58.513751694197 -34.6024814175348,-58.5147171282246 -34.6025182647122)))";;"644";11_4_5;COMUNA 11;"4";"5";"777";"360";"417";"86,33%";"375";"375";"100,00%";"0";"0,00%";"308";"2";"0.65";"306";"99,35%";"0.65";0.650
"MULTIPOLYGON (((-58.5147185908757 -34.603088285601,-58.5147869366805 -34.6030132536171,-58.5148551595266 -34.6030142104276,-58.5148599113316 -34.6029857566193,-58.5151828027097 -34.6029967453427,-58.5151846100488 -34.6030265344209,-58.5161746614667 -34.6030570212008,-58.5162812159551 -34.6029323218695,-58.5162028565188 -34.6029293983962,-58.5155904059537 -34.6025515525464,-58.5152092571313 -34.6025369982995,-58.5147171282246 -34.6025182647122,-58.513751694197 -34.6024814175348,-58.5136051457057 -34.60239175706,-58.5130757133386 -34.6023731732589,-58.5128723198865 -34.6023634679585,-58.5127777777035 -34.6023589291584,-58.5125880972157 -34.6023499220075,-58.5122576253917 -34.6023337180296,-58.5121802564124 -34.6024199498719,-58.5118819798286 -34.6024052811714,-58.5115521040736 -34.6023890046174,-58.5110895282881 -34.6023654556486,-58.5109163693625 -34.6023534814873,-58.5096461697983 -34.602265874878,-58.5095749262733 -34.6023446376423,-58.5094120955757 -34.6025246364714,-58.509234964284 -34.6027204862021,-58.5093460621184 -34.6027826996542,-58.5097004737226 -34.6028086209738,-58.5103354495165 -34.6028523200538,-58.5104273533932 -34.6028596083603,-58.5107563837468 -34.6028839871833,-58.510839258897 -34.6028901519319,-58.5109866966481 -34.6029011504299,-58.5115988380491 -34.6029280203472,-58.512225117811 -34.6029541067784,-58.5123026524304 -34.6030024573904,-58.5129032143578 -34.6030337622568,-58.5131021772905 -34.6043068267026,-58.514371734919 -34.6050896348475,-58.5144547220496 -34.6049977652569,-58.5150377533811 -34.60435023881,-58.5163066482841 -34.6051328158165,-58.5175736924119 -34.6059142535447,-58.5181937298676 -34.6052267644072,-58.5169260092839 -34.6044457558789,-58.5168021185465 -34.6043694699875,-58.5157765778375 -34.6037380657093,-58.5156567783508 -34.603663185369,-58.5155276917287 -34.6035826044913,-58.5147185908757 -34.603088285601)))";;"645";11_4_6;COMUNA 11;"4";"6";"644";"294";"350";"84,00%";"296";"296";"100,00%";"0";"0,00%";"241";"0";"0";"241";"100,00%";"0";0.000
"MULTIPOLYGON (((-58.5162418338666 -34.6073927169923,-58.5175082311663 -34.6081754230302,-58.5181754381159 -34.607434882905,-58.5188411863362 -34.6066959594968,-58.5175736924119 -34.6059142535447,-58.5163066482841 -34.6051328158165,-58.5150377533811 -34.60435023881,-58.5144547220496 -34.6049977652569,-58.514371734919 -34.6050896348475,-58.5156405494865 -34.6058719370171,-58.5155529668165 -34.6059692321287,-58.5149726499047 -34.6066105622929,-58.5150872533986 -34.60667917766,-58.5162418338666 -34.6073927169923)))";;"646";11_4_7;COMUNA 11;"4";"7";"727";"359";"368";"97,55%";"337";"337";"100,00%";"0";"0,00%";"279";"0";"0";"279";"100,00%";"0";0.000
"MULTIPOLYGON (((-58.5142751182387 -34.6073830004255,-58.515543455176 -34.6081643879696,-58.5168133497023 -34.6089467474781,-58.5169528546911 -34.6087918206812,-58.5175082311663 -34.6081754230302,-58.5162418338666 -34.6073927169923,-58.5150872533986 -34.60667917766,-58.5149726499047 -34.6066105622929,-58.5155529668165 -34.6059692321287,-58.5156405494865 -34.6058719370171,-58.514371734919 -34.6050896348475,-58.5131021772905 -34.6043068267026,-58.5133475851916 -34.6056112809068,-58.5134380087979 -34.6061201355313,-58.5135871501635 -34.6069591186615,-58.5142751182387 -34.6073830004255)))";;"647";11_4_8;COMUNA 11;"4";"8";"700";"339";"361";"93,91%";"346";"346";"100,00%";"0";"0,00%";"282";"1";"0.35";"281";"99,65%";"0.35";0.350
"MULTIPOLYGON (((-58.5131021772905 -34.6043068267026,-58.5129032143578 -34.6030337622568,-58.5123026524304 -34.6030024573904,-58.512225117811 -34.6029541067784,-58.5115988380491 -34.6029280203472,-58.5109866966481 -34.6029011504299,-58.510839258897 -34.6028901519319,-58.5107563837468 -34.6028839871833,-58.5104273533932 -34.6028596083603,-58.5103354495165 -34.6028523200538,-58.5097004737226 -34.6028086209738,-58.5093460621184 -34.6027826996542,-58.509234964284 -34.6027204862021,-58.5091174831812 -34.6026661626988,-58.5091025568726 -34.6026277162185,-58.5086637432839 -34.6026044307165,-58.5085977786786 -34.6026823458154,-58.5083613216772 -34.6025346874655,-58.5080915171923 -34.6025010940563,-58.5074689349904 -34.6031825023938,-58.5081128779813 -34.6035804484448,-58.5083338036748 -34.6037173430052,-58.5091944239919 -34.604250700125,-58.5102300627298 -34.6048924378349,-58.5104628381809 -34.6050358030069,-58.5112447546583 -34.6055170617011,-58.5117305068561 -34.6058161039801,-58.5127845013476 -34.6064648549637,-58.5129993069402 -34.6065970954573,-58.5131685275231 -34.6067012547995,-58.5135871501635 -34.6069591186615,-58.5134380087979 -34.6061201355313,-58.5133475851916 -34.6056112809068,-58.5131021772905 -34.6043068267026)))";;"648";11_4_9;COMUNA 11;"4";"9";"828";"379";"449";"84,41%";"428";"428";"100,00%";"0";"0,00%";"309";"2";"0.65";"307";"99,35%";"0.65";0.650
"MULTIPOLYGON (((-58.5290912614676 -34.6111046826951,-58.5293631166574 -34.610902756054,-58.526163304343 -34.6040870374537,-58.5258858353327 -34.6042728789713,-58.5253247919911 -34.6046486467201,-58.5253264172621 -34.6046520933649,-58.5249109990075 -34.604955204516,-58.5240733417034 -34.6055643838227,-58.523933390491 -34.6056662184899,-58.5234705438795 -34.6060020961811,-58.5232958629852 -34.6061355682963,-58.5231958845833 -34.6062118836816,-58.5230704453808 -34.6063076582551,-58.5224356300387 -34.606771861145,-58.5233368121664 -34.6073972143986,-58.5243077948648 -34.6080598510169,-58.5257608035863 -34.6090511873661,-58.5268354557869 -34.6097844568475,-58.527243760401 -34.6100630545209,-58.5278405837687 -34.6104702873877,-58.5281773061396 -34.6106999746583,-58.5285526305763 -34.6115047583786,-58.5290912614676 -34.6111046826951)))";;"649";11_5_1;COMUNA 11;"5";"1";"704";"347";"357";"97,20%";"298";"297";"99,66%";"1";"0,34%";"242";"1";"0.41";"241";"99,59%";"0.41";0.410
"MULTIPOLYGON (((-58.5254270920124 -34.6122407007916,-58.5249228229417 -34.6118996086476,-58.5245116213094 -34.6116214977349,-58.5237192229758 -34.6122479051894,-58.5233395574531 -34.611993226117,-58.5227545956968 -34.6116006139076,-58.5226353716728 -34.611521233036,-58.5219452055937 -34.6120679983771,-58.5235142405583 -34.613014161937,-58.5238898870525 -34.6132406724088,-58.5239853329532 -34.6132982322059,-58.524464694715 -34.6135870149339,-58.524922584214 -34.6138629189299,-58.5250604838913 -34.6139625704053,-58.5251141778505 -34.6140012767303,-58.5254256145003 -34.6137870248209,-58.5256143697948 -34.6136624865428,-58.5257160210151 -34.613587924363,-58.525848490776 -34.6134906692789,-58.5265373977744 -34.6129863489685,-58.5258814234313 -34.6125479422403,-58.5254270920124 -34.6122407007916)))";;"650";11_5_10;COMUNA 11;"5";"10";"811";"355";"456";"77,85%";"412";"412";"100,00%";"0";"0,00%";"334";"0";"0";"334";"100,00%";"0";0.000
"MULTIPOLYGON (((-58.5206716057586 -34.6046666764623,-58.5205954639563 -34.604748588353,-58.5200799640205 -34.6053208250573,-58.5213485794884 -34.6061022932277,-58.5224356300387 -34.606771861145,-58.5230704453808 -34.6063076582551,-58.5231958845833 -34.6062118836816,-58.5232958629852 -34.6061355682963,-58.5234705438795 -34.6060020961811,-58.523933390491 -34.6056662184899,-58.5240733417034 -34.6055643838227,-58.5249109990075 -34.604955204516,-58.5232791103069 -34.6039439455272,-58.5231186588676 -34.6038445143088,-58.5220332441575 -34.603153682936,-58.5213712156111 -34.6038936787501,-58.5208661120049 -34.6044582375072,-58.5207613425322 -34.6045706859796,-58.5206716057586 -34.6046666764623)))";;"651";11_5_2;COMUNA 11;"5";"2";"867";"426";"441";"96,60%";"372";"372";"100,00%";"0";"0,00%";"316";"1";"0.32";"315";"99,68%";"0.32";0.320
"MULTIPOLYGON (((-58.5188411863362 -34.6066959594968,-58.5181754381159 -34.607434882905,-58.5194436423072 -34.6082167229163,-58.5200030823709 -34.6075965090147,-58.5201082795355 -34.607479694687,-58.520844516878 -34.6079352079416,-58.5216428883635 -34.607351493473,-58.5224356300387 -34.606771861145,-58.5213485794884 -34.6061022932277,-58.5200799640205 -34.6053208250573,-58.5194612185627 -34.6060076189093,-58.5188411863362 -34.6066959594968)))";;"652";11_5_3;COMUNA 11;"5";"3";"977";"472";"505";"93,47%";"380";"380";"100,00%";"0";"0,00%";"353";"1";"0.28";"352";"99,72%";"0.28";0.280
"MULTIPOLYGON (((-58.5175082311663 -34.6081754230302,-58.5169528546911 -34.6087918206812,-58.5168133497023 -34.6089467474781,-58.5179406214712 -34.6096411269251,-58.5180826724519 -34.609730079868,-58.5183242507824 -34.6097805256561,-58.5191411507667 -34.6091804901826,-58.5199947131314 -34.6085564778908,-58.520844516878 -34.6079352079416,-58.5201082795355 -34.607479694687,-58.5200030823709 -34.6075965090147,-58.5194436423072 -34.6082167229163,-58.5181754381159 -34.607434882905,-58.5175082311663 -34.6081754230302)))";;"653";11_5_4;COMUNA 11;"5";"4";"624";"268";"356";"75,28%";"306";"306";"100,00%";"0";"0,00%";"252";"3";"1.19";"249";"98,81%";"1.19";1.190
"MULTIPOLYGON (((-58.5191411507667 -34.6091804901826,-58.5183242507824 -34.6097805256561,-58.5180826724519 -34.609730079868,-58.5184431269972 -34.6099556281917,-58.519414217887 -34.6105401315699,-58.5202076481201 -34.6099044552908,-58.5210159640342 -34.6092568648334,-58.5218248632354 -34.6086087052749,-58.5225826734728 -34.6080015528023,-58.5233368121664 -34.6073972143986,-58.5224356300387 -34.606771861145,-58.5216428883635 -34.607351493473,-58.520844516878 -34.6079352079416,-58.5199947131314 -34.6085564778908,-58.5191411507667 -34.6091804901826)))";;"654";11_5_5;COMUNA 11;"5";"5";"854";"393";"461";"85,25%";"424";"424";"100,00%";"0";"0,00%";"339";"0";"0";"339";"100,00%";"0";0.000
"MULTIPOLYGON (((-58.5234312605901 -34.6108906757275,-58.5241094039729 -34.6103534153258,-58.524233694102 -34.6102572224386,-58.5243643687472 -34.6101561668646,-58.5250014697336 -34.6096529375111,-58.5251152855877 -34.6095630168989,-58.5257608035863 -34.6090511873661,-58.5243077948648 -34.6080598510169,-58.5233368121664 -34.6073972143986,-58.5225826734728 -34.6080015528023,-58.5218248632354 -34.6086087052749,-58.5227844289702 -34.609264035204,-58.5226575862483 -34.6093643125416,-58.5219741629286 -34.6099050183571,-58.5234312605901 -34.6108906757275)))";;"655";11_5_6;COMUNA 11;"5";"6";"876";"424";"452";"93,81%";"381";"381";"100,00%";"0";"0,00%";"319";"2";"0.63";"317";"99,37%";"0.63";0.630
"MULTIPOLYGON (((-58.5204065413617 -34.6111379978827,-58.5213688847706 -34.6117204473848,-58.5219452055937 -34.6120679983771,-58.5226353716728 -34.611521233036,-58.5234312605901 -34.6108906757275,-58.5219741629286 -34.6099050183571,-58.5226575862483 -34.6093643125416,-58.5227844289702 -34.609264035204,-58.5218248632354 -34.6086087052749,-58.5210159640342 -34.6092568648334,-58.5202076481201 -34.6099044552908,-58.519414217887 -34.6105401315699,-58.5202412238196 -34.6110379314789,-58.5204065413617 -34.6111379978827)))";;"656";11_5_7;COMUNA 11;"5";"7";"754";"360";"394";"91,37%";"340";"340";"100,00%";"0";"0,00%";"280";"3";"1.07";"277";"98,93%";"1.07";1.070
"MULTIPOLYGON (((-58.5233395574531 -34.611993226117,-58.5237192229758 -34.6122479051894,-58.5245116213094 -34.6116214977349,-58.5249228229417 -34.6118996086476,-58.5257149530588 -34.6112727709349,-58.5264834909839 -34.6106646734336,-58.527243760401 -34.6100630545209,-58.5268354557869 -34.6097844568475,-58.5257608035863 -34.6090511873661,-58.5251152855877 -34.6095630168989,-58.5250014697336 -34.6096529375111,-58.5243643687472 -34.6101561668646,-58.524233694102 -34.6102572224386,-58.5241094039729 -34.6103534153258,-58.5234312605901 -34.6108906757275,-58.5226353716728 -34.611521233036,-58.5227545956968 -34.6116006139076,-58.5233395574531 -34.611993226117)))";;"657";11_5_8;COMUNA 11;"5";"8";"862";"413";"449";"91,98%";"348";"348";"100,00%";"0";"0,00%";"307";"1";"0.33";"306";"99,67%";"0.33";0.330
"MULTIPOLYGON (((-58.5281773061396 -34.6106999746583,-58.5278405837687 -34.6104702873877,-58.527243760401 -34.6100630545209,-58.5264834909839 -34.6106646734336,-58.5257149530588 -34.6112727709349,-58.5249228229417 -34.6118996086476,-58.5254270920124 -34.6122407007916,-58.5258814234313 -34.6125479422403,-58.5265373977744 -34.6129863489685,-58.5269437400732 -34.61268894187,-58.5273484619647 -34.6123927314903,-58.5277569267286 -34.6120937007563,-58.528159429371 -34.611799038196,-58.5285536687689 -34.611506984484,-58.5285526305763 -34.6115047583786,-58.5281773061396 -34.6106999746583)))";;"658";11_5_9;COMUNA 11;"5";"9";"842";"381";"461";"82,65%";"326";"324";"99,39%";"2";"0,62%";"292";"5";"1.71";"287";"98,29%";"1.71";1.710
"MULTIPOLYGON (((-58.5129993069402 -34.6065970954573,-58.5127845013476 -34.6064648549637,-58.5119659954422 -34.6073717711179,-58.5126175847464 -34.6077894794735,-58.5134367031995 -34.6083145835158,-58.5141848941114 -34.607483816906,-58.5142751182387 -34.6073830004255,-58.5135871501635 -34.6069591186615,-58.5131685275231 -34.6067012547995,-58.5129993069402 -34.6065970954573)))";;"659";11_6_1;COMUNA 11;"6";"1";"698";"292";"406";"71,92%";"337";"337";"100,00%";"0";"0,00%";"317";"0";"0";"317";"100,00%";"0";0.000
"MULTIPOLYGON (((-58.5143866589494 -34.6157029031912,-58.5142698401212 -34.6157902796823,-58.5141042324499 -34.6159135229741,-58.5139867335464 -34.6160041390297,-58.5130467346976 -34.6167316690861,-58.5136507727683 -34.617270803608,-58.5143333187091 -34.6178799043541,-58.5149731085601 -34.6173986289905,-58.5152299919089 -34.6172035117533,-58.515632045517 -34.6168980454727,-58.5160286469843 -34.6165967353135,-58.5168189465062 -34.615996365976,-58.516993914332 -34.6158634666066,-58.5175898208152 -34.6154083245899,-58.5174307677144 -34.6152563483716,-58.5167152118457 -34.6145810093358,-58.5166481317592 -34.6145177268913,-58.5163767904157 -34.614201497213,-58.5155768873759 -34.6148151079293,-58.5147841110393 -34.615401526234,-58.5145198253702 -34.6156034065366,-58.5143866589494 -34.6157029031912)))";;"660";11_6_10;COMUNA 11;"6";"10";"799";"372";"427";"87,12%";"317";"317";"100,00%";"0";"0,00%";"271";"6";"2.21";"265";"97,79%";"2.21";2.210
"MULTIPOLYGON (((-58.514943936441 -34.6184248044297,-58.5150137437962 -34.618487171075,-58.5156957982584 -34.6190958417279,-58.5164123838422 -34.6197353394512,-58.5165271135399 -34.6198376868261,-58.5169501498522 -34.6202151886697,-58.5177414986481 -34.6196138977069,-58.5182082648246 -34.6192593076146,-58.516993831341 -34.6180907990149,-58.5173208677617 -34.6178376159414,-58.5166184097115 -34.6171630454446,-58.5163237401515 -34.6168796441618,-58.5160286469843 -34.6165967353135,-58.515632045517 -34.6168980454727,-58.5152299919089 -34.6172035117533,-58.5149731085601 -34.6173986289905,-58.5143333187091 -34.6178799043541,-58.514943936441 -34.6184248044297)))";;"661";11_6_11;COMUNA 11;"6";"11";"859";"415";"444";"93,47%";"357";"357";"100,00%";"0";"0,00%";"314";"3";"0.96";"311";"99,04%";"0.96";0.960
"MULTIPOLYGON (((-58.5126673873537 -34.6091687352247,-58.5134367031995 -34.6083145835158,-58.5126175847464 -34.6077894794735,-58.5119659954422 -34.6073717711179,-58.5111974382415 -34.6082232372317,-58.5102879004676 -34.6092308859559,-58.5109532883699 -34.6096375409437,-58.5117865447665 -34.6101466638098,-58.5130585606889 -34.6109239202617,-58.5136943219128 -34.6113124027261,-58.5143312820165 -34.6117015855937,-58.5144458556867 -34.6115744197634,-58.5150301251952 -34.610926400529,-58.5151675939658 -34.6107738007222,-58.5145426398326 -34.6103726447912,-58.5139167544011 -34.6099709226198,-58.5128303951941 -34.6092736017851,-58.5126673873537 -34.6091687352247)))";;"662";11_6_2;COMUNA 11;"6";"2";"967";"461";"506";"91,11%";"443";"443";"100,00%";"0";"0,00%";"351";"6";"1.71";"345";"98,29%";"1.71";1.710
"MULTIPOLYGON (((-58.5159383460576 -34.6099181539242,-58.5168133497023 -34.6089467474781,-58.515543455176 -34.6081643879696,-58.5142751182387 -34.6073830004255,-58.5141848941114 -34.607483816906,-58.5134367031995 -34.6083145835158,-58.5126673873537 -34.6091687352247,-58.5128303951941 -34.6092736017851,-58.5139167544011 -34.6099709226198,-58.5145426398326 -34.6103726447912,-58.5151675939658 -34.6107738007222,-58.5159383460576 -34.6099181539242)))";;"663";11_6_3;COMUNA 11;"6";"3";"819";"366";"453";"80,79%";"457";"457";"100,00%";"0";"0,00%";"347";"27";"7.78";"320";"92,22%";"7.78";7.780
"MULTIPOLYGON (((-58.5156058164985 -34.6124802227033,-58.5167453934274 -34.6131765089128,-58.5172899224041 -34.6135091657827,-58.5174152480759 -34.6134141766478,-58.5180616257873 -34.6129264731232,-58.5182715764098 -34.6127660901995,-58.5192338822893 -34.6120309032125,-58.5202836048271 -34.6112290451896,-58.5204065413617 -34.6111379978827,-58.5202412238196 -34.6110379314789,-58.519414217887 -34.6105401315699,-58.5184431269972 -34.6099556281917,-58.5180826724519 -34.609730079868,-58.5179406214712 -34.6096411269251,-58.5168133497023 -34.6089467474781,-58.5159383460576 -34.6099181539242,-58.5151675939658 -34.6107738007222,-58.5150301251952 -34.610926400529,-58.5144458556867 -34.6115744197634,-58.5143312820165 -34.6117015855937,-58.5149698670683 -34.612091679938,-58.5152431465238 -34.6122586812759,-58.5156058164985 -34.6124802227033)))";;"664";11_6_4;COMUNA 11;"6";"4";"916";"457";"459";"99,56%";"392";"392";"100,00%";"0";"0,00%";"333";"3";"0.9";"330";"99,10%";"0.9";0.900
"MULTIPOLYGON (((-58.5242703753686 -34.6145997550717,-58.5250604838913 -34.6139625704053,-58.524922584214 -34.6138629189299,-58.524464694715 -34.6135870149339,-58.5239853329532 -34.6132982322059,-58.5238898870525 -34.6132406724088,-58.5235142405583 -34.613014161937,-58.5219452055937 -34.6120679983771,-58.5213688847706 -34.6117204473848,-58.5204065413617 -34.6111379978827,-58.5202836048271 -34.6112290451896,-58.5192338822893 -34.6120309032125,-58.5199027205082 -34.612652585764,-58.5205137607127 -34.6131953454797,-58.5209680610047 -34.6135983832894,-58.5213250266325 -34.6139152659149,-58.5218163280932 -34.6143520867554,-58.522318714628 -34.6147974215978,-58.5229405268257 -34.615350375318,-58.5231198684356 -34.6155085317027,-58.5241211378687 -34.6147200458614,-58.5242703753686 -34.6145997550717)))";;"665";11_6_5;COMUNA 11;"6";"5";"732";"331";"401";"82,54%";"417";"417";"100,00%";"0";"0,00%";"304";"1";"0.33";"303";"99,67%";"0.33";0.330
"MULTIPOLYGON (((-58.5209680610047 -34.6135983832894,-58.5205137607127 -34.6131953454797,-58.5199027205082 -34.612652585764,-58.5192338822893 -34.6120309032125,-58.5182715764098 -34.6127660901995,-58.5189156338807 -34.6134003250355,-58.519493810464 -34.6139691622052,-58.5195944786072 -34.6140682033616,-58.5199241887804 -34.6143942580281,-58.5200235796217 -34.6144924543215,-58.5202627656 -34.614727561382,-58.5203108416168 -34.6147747938991,-58.5204021350937 -34.6148645426948,-58.5206093578646 -34.6150687475776,-58.5207342380924 -34.6151925658958,-58.5208411325182 -34.6152986455446,-58.5212032414994 -34.6156518653049,-58.5219581566675 -34.6163884285417,-58.5231198684356 -34.6155085317027,-58.5229405268257 -34.615350375318,-58.522318714628 -34.6147974215978,-58.5218163280932 -34.6143520867554,-58.5213250266325 -34.6139152659149,-58.5209680610047 -34.6135983832894)))";;"666";11_6_6;COMUNA 11;"6";"6";"855";"378";"477";"79,25%";"348";"348";"100,00%";"0";"0,00%";"306";"1";"0.33";"305";"99,67%";"0.33";0.330
"MULTIPOLYGON (((-58.5199241887804 -34.6143942580281,-58.5195944786072 -34.6140682033616,-58.519493810464 -34.6139691622052,-58.5189156338807 -34.6134003250355,-58.5182715764098 -34.6127660901995,-58.5180616257873 -34.6129264731232,-58.5174152480759 -34.6134141766478,-58.5172899224041 -34.6135091657827,-58.5166825316663 -34.6139696638575,-58.5163767904157 -34.614201497213,-58.5166481317592 -34.6145177268913,-58.5167152118457 -34.6145810093358,-58.5174307677144 -34.6152563483716,-58.5175898208152 -34.6154083245899,-58.5177397539829 -34.6155515015811,-58.5178959946115 -34.6156996757089,-58.5179910348981 -34.615789847151,-58.5181903215499 -34.6159784957765,-58.518323293367 -34.6161042143405,-58.5184433095366 -34.6162180368461,-58.5192243827303 -34.6156096276596,-58.519350815307 -34.6155125233044,-58.5203108416168 -34.6147747938991,-58.5202627656 -34.614727561382,-58.5200235796217 -34.6144924543215,-58.5199241887804 -34.6143942580281)))";;"667";11_6_7;COMUNA 11;"6";"7";"895";"411";"484";"84,92%";"333";"333";"100,00%";"0";"0,00%";"308";"5";"1.62";"303";"98,38%";"1.62";1.620
"MULTIPOLYGON (((-58.5207342380924 -34.6151925658958,-58.5206093578646 -34.6150687475776,-58.5204021350937 -34.6148645426948,-58.5203108416168 -34.6147747938991,-58.519350815307 -34.6155125233044,-58.5192243827303 -34.6156096276596,-58.5184433095366 -34.6162180368461,-58.5185374985912 -34.6163073631428,-58.5188765833074 -34.6166325711269,-58.5182512205268 -34.6171172408412,-58.5181130351933 -34.6172242793007,-58.5182390195065 -34.6173438037015,-58.5183972245115 -34.6174932438977,-58.5185061622116 -34.6175975639941,-58.5193412749724 -34.6183971368646,-58.5194803133054 -34.6182912234374,-58.5201224521296 -34.6177959054421,-58.5208904203156 -34.6172034079683,-58.5210132778787 -34.6171096135966,-58.5219581566675 -34.6163884285417,-58.5212032414994 -34.6156518653049,-58.5208411325182 -34.6152986455446,-58.5207342380924 -34.6151925658958)))";;"668";11_6_8;COMUNA 11;"6";"8";"740";"336";"404";"83,17%";"349";"349";"100,00%";"0";"0,00%";"284";"4";"1.41";"280";"98,59%";"1.41";1.410
"MULTIPOLYGON (((-58.5185061622116 -34.6175975639941,-58.5183972245115 -34.6174932438977,-58.5182390195065 -34.6173438037015,-58.5181130351933 -34.6172242793007,-58.5182512205268 -34.6171172408412,-58.5188765833074 -34.6166325711269,-58.5185374985912 -34.6163073631428,-58.5184433095366 -34.6162180368461,-58.518323293367 -34.6161042143405,-58.5181903215499 -34.6159784957765,-58.5179910348981 -34.615789847151,-58.5178959946115 -34.6156996757089,-58.5177397539829 -34.6155515015811,-58.5175898208152 -34.6154083245899,-58.516993914332 -34.6158634666066,-58.5168189465062 -34.615996365976,-58.5160286469843 -34.6165967353135,-58.5163237401515 -34.6168796441618,-58.5166184097115 -34.6171630454446,-58.5173208677617 -34.6178376159414,-58.516993831341 -34.6180907990149,-58.5182082648246 -34.6192593076146,-58.5185393921764 -34.6190076688112,-58.5186737498318 -34.6189056318306,-58.5188995512881 -34.6187335501514,-58.5193412749724 -34.6183971368646,-58.5185061622116 -34.6175975639941)))";;"669";11_6_9;COMUNA 11;"6";"9";"865";"392";"473";"82,88%";"322";"322";"100,00%";"0";"0,00%";"302";"8";"2.65";"294";"97,35%";"2.65";2.650
"MULTIPOLYGON (((-58.5130100875315 -34.6131730358347,-58.5126666094698 -34.6135572049093,-58.5125680345146 -34.613667460475,-58.5124228107561 -34.6138303425053,-58.5123213396218 -34.6139417258483,-58.5116836485228 -34.6146415156875,-58.5121567517753 -34.6149214052608,-58.5124699117666 -34.6151067070712,-58.5129314311617 -34.6153797671121,-58.5133684968879 -34.6156383279928,-58.5139867335464 -34.6160041390297,-58.5141042324499 -34.6159135229741,-58.5142698401212 -34.6157902796823,-58.5143866589494 -34.6157029031912,-58.5145198253702 -34.6156034065366,-58.5147841110393 -34.615401526234,-58.5155768873759 -34.6148151079293,-58.5163767904157 -34.614201497213,-58.5166825316663 -34.6139696638575,-58.5172899224041 -34.6135091657827,-58.5167453934274 -34.6131765089128,-58.5156058164985 -34.6124802227033,-58.5152431465238 -34.6122586812759,-58.5149698670683 -34.612091679938,-58.5143312820165 -34.6117015855937,-58.5140147982808 -34.6120531403092,-58.513605782987 -34.6125075534486,-58.5134942712171 -34.6126313367931,-58.5133061485789 -34.6128418451066,-58.5130100875315 -34.6131730358347)))";;"670";11_7_1;COMUNA 11;"7";"1";"2218";"1944";"274";"709,49%";"189";"187";"98,94%";"2";"1,07%";"171";"14";"8.19";"157";"91,81%";"8.19";8.190
"MULTIPOLYGON (((-58.5068019180195 -34.6106806291385,-58.5066464177311 -34.6105889917618,-58.5060688827233 -34.6102213680828,-58.505912529537 -34.6101243777577,-58.5057407544636 -34.6100178148567,-58.5047561214146 -34.6094025018668,-58.5046166431399 -34.6093187439717,-58.5039499808434 -34.6100566742923,-58.5032532259876 -34.6109441233871,-58.5034081272674 -34.6110363991103,-58.5037216802868 -34.6112240474055,-58.5038606494954 -34.6113072430676,-58.5041395251989 -34.6114725772185,-58.5042788356775 -34.611555208884,-58.5045270401037 -34.6117044956693,-58.5046650738263 -34.6117874794534,-58.5052496761716 -34.6121407404987,-58.5054122451915 -34.612227236126,-58.5055230873792 -34.6121042350665,-58.5056968415322 -34.6119112092083,-58.5057951685827 -34.6118021564739,-58.5058949426369 -34.611691553794,-58.506051327429 -34.6115159989906,-58.5061695741951 -34.6113849662379,-58.5062874800917 -34.6112543560402,-58.5064019808331 -34.6111283245772,-58.506489579818 -34.6110314586547,-58.5066015257898 -34.6109077519454,-58.5066931252121 -34.6108060955268,-58.5068019180195 -34.6106806291385)))";;"671";11_7_10;COMUNA 11;"7";"10";"817";"372";"445";"83,60%";"356";"356";"100,00%";"0";"0,00%";"292";"2";"0.68";"290";"99,32%";"0.68";0.680
"MULTIPOLYGON (((-58.5078355416839 -34.6123644672732,-58.507960513144 -34.6122279371587,-58.5081535008128 -34.6120130688935,-58.506489579818 -34.6110314586547,-58.5064019808331 -34.6111283245772,-58.5062874800917 -34.6112543560402,-58.5061695741951 -34.6113849662379,-58.506051327429 -34.6115159989906,-58.5058949426369 -34.611691553794,-58.5057951685827 -34.6118021564739,-58.5056968415322 -34.6119112092083,-58.5055230873792 -34.6121042350665,-58.5054122451915 -34.612227236126,-58.5055644196997 -34.6123083124561,-58.5070547002468 -34.613187529869,-58.5075218146791 -34.6134631437408,-58.5076250029036 -34.6135240234742,-58.5078681034367 -34.61366443173,-58.5080156001469 -34.6137495913673,-58.5083084647935 -34.6139196996237,-58.5084677216559 -34.6140122489454,-58.5087249694798 -34.6141601152299,-58.5095332500736 -34.6133690749564,-58.5091175105522 -34.6131230982056,-58.5086507331353 -34.6128468564767,-58.5083060628672 -34.6126428939232,-58.5078355416839 -34.6123644672732)))";;"672";11_7_11;COMUNA 11;"7";"11";"807";"367";"440";"83,41%";"415";"415";"100,00%";"0";"0,00%";"323";"4";"1.24";"319";"98,76%";"1.24";1.240
"MULTIPOLYGON (((-58.5133684968879 -34.6156383279928,-58.5129314311617 -34.6153797671121,-58.5124699117666 -34.6151067070712,-58.5121567517753 -34.6149214052608,-58.5116836485228 -34.6146415156875,-58.5112528989117 -34.6143866083134,-58.5108368083956 -34.6141404263313,-58.5103867209833 -34.6138740442183,-58.5098612250326 -34.6135631105361,-58.5095332500736 -34.6133690749564,-58.5087249694798 -34.6141601152299,-58.5088477568613 -34.6142307051847,-58.5090561812935 -34.6143517572749,-58.509205896211 -34.6144387456713,-58.5095807397496 -34.6146583283903,-58.5097440900604 -34.614754114013,-58.5100183889197 -34.6149192251125,-58.5101381127864 -34.6149913642982,-58.5103444153027 -34.615119246226,-58.5104286062974 -34.6151707644556,-58.510575855564 -34.6152608508246,-58.510703590772 -34.6153383386105,-58.5108412960787 -34.6154215971817,-58.5110036285098 -34.6155197759579,-58.5112506626707 -34.6156664436941,-58.5116778403144 -34.6159199439529,-58.5121374874334 -34.6161927964365,-58.5125738737806 -34.6164518533793,-58.5130467346976 -34.6167316690861,-58.5139867335464 -34.6160041390297,-58.5133684968879 -34.6156383279928)))";;"673";11_7_12;COMUNA 11;"7";"12";"854";"410";"444";"92,34%";"323";"323";"100,00%";"0";"0,00%";"306";"9";"2.94";"297";"97,06%";"2.94";2.940
"MULTIPOLYGON (((-58.511029359407 -34.6131772873863,-58.5105141676332 -34.6137494123916,-58.5103867209833 -34.6138740442183,-58.5108368083956 -34.6141404263313,-58.5112528989117 -34.6143866083134,-58.5116836485228 -34.6146415156875,-58.5123213396218 -34.6139417258483,-58.5124228107561 -34.6138303425053,-58.5125680345146 -34.613667460475,-58.5126666094698 -34.6135572049093,-58.5130100875315 -34.6131730358347,-58.5133061485789 -34.6128418451066,-58.5134942712171 -34.6126313367931,-58.513605782987 -34.6125075534486,-58.5140147982808 -34.6120531403092,-58.5143312820165 -34.6117015855937,-58.5136943219128 -34.6113124027261,-58.5130585606889 -34.6109239202617,-58.5127527148581 -34.6112635655167,-58.512343355954 -34.6117181859003,-58.5120314604371 -34.6120645221503,-58.5117200730847 -34.6124102939797,-58.5113749731925 -34.6127934741678,-58.511029359407 -34.6131772873863)))";;"674";11_7_2;COMUNA 11;"7";"2";"884";"424";"460";"92,17%";"377";"377";"100,00%";"0";"0,00%";"328";"1";"0.3";"327";"99,70%";"0.3";0.300
"MULTIPOLYGON (((-58.5100958010859 -34.6120370490132,-58.510012462472 -34.6121307467267,-58.5097521441381 -34.612421632578,-58.5094391298413 -34.6127714838523,-58.5092075809771 -34.6130302436526,-58.5091175105522 -34.6131230982056,-58.5095332500736 -34.6133690749564,-58.5098612250326 -34.6135631105361,-58.5103867209833 -34.6138740442183,-58.5105141676332 -34.6137494123916,-58.511029359407 -34.6131772873863,-58.5113749731925 -34.6127934741678,-58.5117200730847 -34.6124102939797,-58.5120314604371 -34.6120645221503,-58.512343355954 -34.6117181859003,-58.5127527148581 -34.6112635655167,-58.5130585606889 -34.6109239202617,-58.5117865447665 -34.6101466638098,-58.511491251867 -34.6104744702829,-58.5114141297621 -34.6105601380284,-58.511082231729 -34.6109309174124,-58.5107609713202 -34.6112897194158,-58.5106860612536 -34.6113734139162,-58.5104380918618 -34.6116522537167,-58.5100958010859 -34.6120370490132)))";;"675";11_7_3;COMUNA 11;"7";"3";"786";"373";"413";"90,31%";"371";"371";"100,00%";"0";"0,00%";"297";"1";"0.34";"296";"99,66%";"0.34";0.340
"MULTIPOLYGON (((-58.5097130012616 -34.6100755763995,-58.5094346973447 -34.6104859800049,-58.5091577528937 -34.6108951852047,-58.5088133290361 -34.6112785692623,-58.5084683912796 -34.6116625863435,-58.5081535008128 -34.6120130688935,-58.507960513144 -34.6122279371587,-58.5078355416839 -34.6123644672732,-58.5083060628672 -34.6126428939232,-58.5086507331353 -34.6128468564767,-58.5091175105522 -34.6131230982056,-58.5092075809771 -34.6130302436526,-58.5094391298413 -34.6127714838523,-58.5097521441381 -34.612421632578,-58.510012462472 -34.6121307467267,-58.5100958010859 -34.6120370490132,-58.5104380918618 -34.6116522537167,-58.5106860612536 -34.6113734139162,-58.5107609713202 -34.6112897194158,-58.511082231729 -34.6109309174124,-58.5114141297621 -34.6105601380284,-58.511491251867 -34.6104744702829,-58.5117865447665 -34.6101466638098,-58.5109532883699 -34.6096375409437,-58.5102879004676 -34.6092308859559,-58.510052493971 -34.6095743704252,-58.5097130012616 -34.6100755763995)))";;"676";11_7_4;COMUNA 11;"7";"4";"936";"433";"503";"86,08%";"372";"371";"99,73%";"1";"0,27%";"325";"1";"0.31";"324";"99,69%";"0.31";0.310
"MULTIPOLYGON (((-58.5081596693173 -34.6091090873552,-58.507590018018 -34.6097724211965,-58.5074778225252 -34.6099017629353,-58.5071552076687 -34.6102980221649,-58.5068019180195 -34.6106806291385,-58.5066931252121 -34.6108060955268,-58.5066015257898 -34.6109077519454,-58.506489579818 -34.6110314586547,-58.5081535008128 -34.6120130688935,-58.5084683912796 -34.6116625863435,-58.5088133290361 -34.6112785692623,-58.5091577528937 -34.6108951852047,-58.5094346973447 -34.6104859800049,-58.5097130012616 -34.6100755763995,-58.510052493971 -34.6095743704252,-58.5102879004676 -34.6092308859559,-58.5088235417644 -34.6083361336999,-58.5081596693173 -34.6091090873552)))";;"677";11_7_5;COMUNA 11;"7";"5";"965";"433";"532";"81,39%";"414";"413";"99,76%";"1";"0,24%";"349";"10";"2.87";"339";"97,13%";"2.87";2.870
"MULTIPOLYGON (((-58.505979641767 -34.6078099026607,-58.5052973398302 -34.6085651002204,-58.5046166431399 -34.6093187439717,-58.5047561214146 -34.6094025018668,-58.5057407544636 -34.6100178148567,-58.505912529537 -34.6101243777577,-58.5060688827233 -34.6102213680828,-58.5066464177311 -34.6105889917618,-58.5068019180195 -34.6106806291385,-58.5071552076687 -34.6102980221649,-58.5074778225252 -34.6099017629353,-58.507590018018 -34.6097724211965,-58.5081596693173 -34.6091090873552,-58.5088235417644 -34.6083361336999,-58.5086527899846 -34.6082317576598,-58.5081321090857 -34.607926589272,-58.507956930494 -34.6078234111259,-58.5077802186704 -34.6077193177662,-58.5066636337847 -34.6070526582583,-58.505979641767 -34.6078099026607)))";;"678";11_7_6;COMUNA 11;"7";"6";"791";"369";"422";"87,44%";"332";"332";"100,00%";"0";"0,00%";"291";"2";"0.69";"289";"99,31%";"0.69";0.690
"MULTIPOLYGON (((-58.5066636337847 -34.6070526582583,-58.5064956150895 -34.6069523628489,-58.5060201916555 -34.606673437706,-58.5057935567637 -34.6065395693226,-58.5055892451677 -34.6064188621739,-58.5050817884765 -34.6061129717681,-58.5049193122277 -34.6060172498811,-58.5047375812448 -34.6059101959606,-58.5044453468225 -34.6057372616729,-58.5043318613318 -34.605670044417,-58.5037849695886 -34.6053463444584,-58.5036072455107 -34.6052409776963,-58.5034698516119 -34.60539715628,-58.5030782683274 -34.6058436411896,-58.5029552590665 -34.6059835462059,-58.5028211827698 -34.6061360608382,-58.5022656346557 -34.606770491202,-58.5024469384688 -34.6068775489289,-58.502847120463 -34.6071136238563,-58.5030006506854 -34.6072044921059,-58.5035627172446 -34.6075370639645,-58.5037147154065 -34.6076270162949,-58.5044742843677 -34.6080750146005,-58.5045985729373 -34.6079373612656,-58.5050343451761 -34.6074533901293,-58.5051545456114 -34.6073199631418,-58.5053333842236 -34.6074270174257,-58.5058181820575 -34.6077117871836,-58.505979641767 -34.6078099026607,-58.5066636337847 -34.6070526582583)))";;"679";11_7_7;COMUNA 11;"7";"7";"796";"370";"426";"86,85%";"331";"331";"100,00%";"0";"0,00%";"273";"4";"1.47";"269";"98,53%";"1.47";1.470
"MULTIPOLYGON (((-58.5009599836317 -34.608254765382,-58.500192507164 -34.6091257399437,-58.5013273842551 -34.6097984388005,-58.5014599583937 -34.609877484161,-58.502112002106 -34.6091635871074,-58.5022351031783 -34.6090248097843,-58.5023531810234 -34.6088915975517,-58.5028851674364 -34.608296190292,-58.5036179842195 -34.6087275119316,-58.5037890686554 -34.6088262608894,-58.5039121689437 -34.6086925524772,-58.5043654889533 -34.6081954787832,-58.5044742843677 -34.6080750146005,-58.5037147154065 -34.6076270162949,-58.5035627172446 -34.6075370639645,-58.5030006506854 -34.6072044921059,-58.502847120463 -34.6071136238563,-58.5024469384688 -34.6068775489289,-58.5022656346557 -34.606770491202,-58.502134365421 -34.6069204688451,-58.5017353612389 -34.6073748393528,-58.5015971088912 -34.6075317203017,-58.5009599836317 -34.608254765382)))";;"680";11_7_8;COMUNA 11;"7";"8";"691";"342";"349";"97,99%";"303";"303";"100,00%";"0";"0,00%";"249";"7";"2.81";"242";"97,19%";"2.81";2.810
"MULTIPOLYGON (((-58.5037890686554 -34.6088262608894,-58.5036179842195 -34.6087275119316,-58.5028851674364 -34.608296190292,-58.5023531810234 -34.6088915975517,-58.5022351031783 -34.6090248097843,-58.502112002106 -34.6091635871074,-58.5014599583937 -34.609877484161,-58.5022070985256 -34.6103231059069,-58.5023694099685 -34.6104193947906,-58.5031020740332 -34.6108540998275,-58.5032532259876 -34.6109441233871,-58.5039499808434 -34.6100566742923,-58.5046166431399 -34.6093187439717,-58.5052973398302 -34.6085651002204,-58.505979641767 -34.6078099026607,-58.5058181820575 -34.6077117871836,-58.5053333842236 -34.6074270174257,-58.5051545456114 -34.6073199631418,-58.5050343451761 -34.6074533901293,-58.5045985729373 -34.6079373612656,-58.5044742843677 -34.6080750146005,-58.5043654889533 -34.6081954787832,-58.5039121689437 -34.6086925524772,-58.5037890686554 -34.6088262608894)))";;"681";11_7_9;COMUNA 11;"7";"9";"808";"382";"426";"89,67%";"349";"349";"100,00%";"0";"0,00%";"296";"5";"1.69";"291";"98,31%";"1.69";1.690
"MULTIPOLYGON (((-58.5005520774699 -34.6045120068172,-58.4998536869214 -34.6053377453619,-58.5008671893718 -34.60594055365,-58.5010334950673 -34.6060393080148,-58.5020822013326 -34.6066621662383,-58.5022656346557 -34.606770491202,-58.5028211827698 -34.6061360608382,-58.5029552590665 -34.6059835462059,-58.5030782683274 -34.6058436411896,-58.5034698516119 -34.60539715628,-58.5036072455107 -34.6052409776963,-58.5034249211716 -34.6051328656271,-58.5024763311599 -34.604570622266,-58.502293754433 -34.604462931127,-58.5021087074368 -34.6043536911566,-58.5013064170315 -34.6038806904179,-58.5011626075788 -34.6037967185886,-58.5010555162036 -34.6039167568158,-58.5005520774699 -34.6045120068172)))";;"682";11_8_1;COMUNA 11;"8";"1";"886";"391";"495";"78,99%";"434";"434";"100,00%";"0";"0,00%";"347";"9";"2.59";"338";"97,41%";"2.59";2.590
"MULTIPOLYGON (((-58.4998536869214 -34.6053377453619,-58.5005520774699 -34.6045120068172,-58.5010555162036 -34.6039167568158,-58.5011626075788 -34.6037967185886,-58.5010022706073 -34.6037031035271,-58.4999528421313 -34.6030781231682,-58.499796340732 -34.6029847870397,-58.4996225453752 -34.6028811738646,-58.4992641363694 -34.6026674004647,-58.4991174338994 -34.6025803283648,-58.4986079353578 -34.6031596561917,-58.4984960734753 -34.6032842712275,-58.498391106886 -34.6034012077956,-58.4977773135339 -34.6041026798121,-58.4972008831745 -34.6047613195974,-58.4978786053414 -34.6051640989262,-58.4980639897153 -34.6052743311533,-58.4991183727917 -34.6059015796546,-58.4992881720437 -34.6060084342504,-58.499738762697 -34.6054735600268,-58.4998536869214 -34.6053377453619)))";;"683";11_8_2;COMUNA 11;"8";"2";"896";"434";"462";"93,94%";"405";"405";"100,00%";"0";"0,00%";"338";"0";"0";"338";"100,00%";"0";0.000
"MULTIPOLYGON (((-58.4968462369335 -34.6035487681302,-58.4962680993365 -34.6042067702209,-58.4964261327632 -34.6043015189368,-58.4970127749069 -34.6046495374611,-58.4972008831745 -34.6047613195974,-58.4977773135339 -34.6041026798121,-58.498391106886 -34.6034012077956,-58.4984960734753 -34.6032842712275,-58.4986079353578 -34.6031596561917,-58.4991174338994 -34.6025803283648,-58.4989882814563 -34.602503673799,-58.4981856831185 -34.6020242437827,-58.4975638946702 -34.6027319146239,-58.4968462369335 -34.6035487681302)))";;"684";11_8_3;COMUNA 11;"8";"3";"519";"238";"281";"84,70%";"259";"259";"100,00%";"0";"0,00%";"210";"0";"0";"210";"100,00%";"0";0.000
"MULTIPOLYGON (((-58.4978617838892 -34.6018306682255,-58.497087056105 -34.6017818026446,-58.4969455847765 -34.6017725463038,-58.4966410109301 -34.6021774355034,-58.4965316258538 -34.6023229643556,-58.4959926970657 -34.6030410975122,-58.4954737639611 -34.603732531691,-58.4960720702491 -34.6040892843623,-58.4962680993365 -34.6042067702209,-58.4968462369335 -34.6035487681302,-58.4975638946702 -34.6027319146239,-58.4981856831185 -34.6020242437827,-58.4978617838892 -34.6018306682255)))";;"685";11_8_4;COMUNA 11;"8";"4";"724";"285";"439";"64,92%";"404";"402";"99,50%";"2";"0,50%";"329";"1";"0.3";"328";"99,70%";"0.3";0.300
"MULTIPOLYGON (((-58.4962680993365 -34.6042067702209,-58.4960720702491 -34.6040892843623,-58.4954737639611 -34.603732531691,-58.4953831030164 -34.6038533352063,-58.4947977571607 -34.6046285197299,-58.4953509118512 -34.6049514132446,-58.4955247904819 -34.6050527084161,-58.4956940690778 -34.6051512580003,-58.4962991993495 -34.6055054018948,-58.4964656680391 -34.6056014862935,-58.4966375895715 -34.6057008085046,-58.4971531004034 -34.6059970835414,-58.4974063007498 -34.6061461722727,-58.4975438666454 -34.6059638023223,-58.4979487290205 -34.6054268349969,-58.4980639897153 -34.6052743311533,-58.4978786053414 -34.6051640989262,-58.4972008831745 -34.6047613195974,-58.4970127749069 -34.6046495374611,-58.4964261327632 -34.6043015189368,-58.4962680993365 -34.6042067702209)))";;"686";11_8_5;COMUNA 11;"8";"5";"658";"296";"362";"81,77%";"331";"331";"100,00%";"0";"0,00%";"265";"1";"0.38";"264";"99,62%";"0.38";0.380
"MULTIPOLYGON (((-58.5010334950673 -34.6060393080148,-58.5008671893718 -34.60594055365,-58.4998536869214 -34.6053377453619,-58.499738762697 -34.6054735600268,-58.4992881720437 -34.6060084342504,-58.4991183727917 -34.6059015796546,-58.4980639897153 -34.6052743311533,-58.4979487290205 -34.6054268349969,-58.4975438666454 -34.6059638023223,-58.4974063007498 -34.6061461722727,-58.4976012281899 -34.6062610505303,-58.4982638788235 -34.606641155026,-58.4984071784332 -34.6067232993273,-58.4985913745792 -34.6068336719216,-58.4989823457138 -34.607067931186,-58.4991183213578 -34.607149372572,-58.4998177996447 -34.6075691773511,-58.5009599836317 -34.608254765382,-58.5015971088912 -34.6075317203017,-58.5017353612389 -34.6073748393528,-58.502134365421 -34.6069204688451,-58.5022656346557 -34.606770491202,-58.5020822013326 -34.6066621662383,-58.5010334950673 -34.6060393080148)))";;"687";11_8_6;COMUNA 11;"8";"6";"992";"470";"522";"90,04%";"433";"433";"100,00%";"0";"0,00%";"379";"0";"0";"379";"100,00%";"0";0.000
"MULTIPOLYGON (((-58.4982638788235 -34.606641155026,-58.4976012281899 -34.6062610505303,-58.4974063007498 -34.6061461722727,-58.497280481913 -34.606312974774,-58.4968378983008 -34.6068988254221,-58.4967152265317 -34.6070603445538,-58.4969010381937 -34.6071674796871,-58.4974439088495 -34.6074838169148,-58.4976206081142 -34.6075898971615,-58.4969419957819 -34.6085909011346,-58.4981313802211 -34.6093273492167,-58.4983103856037 -34.6094370194424,-58.4985152071994 -34.6095625274798,-58.4992083198369 -34.6099949435453,-58.4993513720599 -34.6100803967446,-58.500192507164 -34.6091257399437,-58.5009599836317 -34.608254765382,-58.4998177996447 -34.6075691773511,-58.4991183213578 -34.607149372572,-58.4989823457138 -34.607067931186,-58.4985913745792 -34.6068336719216,-58.4984071784332 -34.6067232993273,-58.4982638788235 -34.606641155026)))";;"688";11_8_7;COMUNA 11;"8";"7";"992";"478";"514";"93,00%";"398";"398";"100,00%";"0";"0,00%";"345";"4";"1.16";"341";"98,84%";"1.16";1.160
"MULTIPOLYGON (((-58.4948903031118 -34.6074016269666,-58.4950558365121 -34.6074963754274,-58.4957522239583 -34.6078985980304,-58.4959785898769 -34.6080298793834,-58.4962400574798 -34.6081815739587,-58.4967728765511 -34.6084861558837,-58.4969419957819 -34.6085909011346,-58.4976206081142 -34.6075898971615,-58.4974439088495 -34.6074838169148,-58.4969010381937 -34.6071674796871,-58.4967152265317 -34.6070603445538,-58.4968378983008 -34.6068988254221,-58.497280481913 -34.606312974774,-58.4974063007498 -34.6061461722727,-58.4971531004034 -34.6059970835414,-58.4966375895715 -34.6057008085046,-58.4964656680391 -34.6056014862935,-58.4962991993495 -34.6055054018948,-58.4956940690778 -34.6051512580003,-58.4955247904819 -34.6050527084161,-58.4947573727587 -34.6059260436955,-58.4939430274494 -34.6068528387446,-58.4940977396909 -34.6069430136499,-58.4947408718713 -34.6073161701717,-58.4948903031118 -34.6074016269666)))";;"689";11_8_8;COMUNA 11;"8";"8";"973";"455";"518";"87,84%";"407";"407";"100,00%";"0";"0,00%";"355";"0";"0";"355";"100,00%";"0";0.000
"MULTIPOLYGON (((-58.4955247904819 -34.6050527084161,-58.4953509118512 -34.6049514132446,-58.4947977571607 -34.6046285197299,-58.4940082721953 -34.6054925600406,-58.4931615480212 -34.6063965404937,-58.493346416461 -34.6065029770377,-58.4937882303147 -34.606762522813,-58.4939430274494 -34.6068528387446,-58.4947573727587 -34.6059260436955,-58.4955247904819 -34.6050527084161)))";;"690";11_8_9;COMUNA 11;"8";"9";"823";"349";"474";"73,63%";"456";"456";"100,00%";"0";"0,00%";"365";"0";"0";"365";"100,00%";"0";0.000
"MULTIPOLYGON (((-58.5028335782734 -34.6018040628582,-58.5024914397912 -34.6017828360737,-58.5008369597148 -34.6016713178865,-58.5005942786088 -34.6019762642255,-58.5006322656749 -34.6019787173046,-58.5020122366445 -34.6027904943653,-58.5032211995234 -34.6034070235633,-58.5024468084861 -34.6042809731271,-58.502293754433 -34.604462931127,-58.5024763311599 -34.604570622266,-58.5034249211716 -34.6051328656271,-58.5036072455107 -34.6052409776963,-58.5037340832419 -34.6050967043583,-58.5046198157128 -34.6041065774185,-58.505373842238 -34.6032636786808,-58.5059782101206 -34.6025880177706,-58.5061676914151 -34.6023785058724,-58.5058160796728 -34.6021612984489,-58.5055437883929 -34.6019930076964,-58.505398588254 -34.6020227780301,-58.5045038447095 -34.6019646349301,-58.5042836729394 -34.6019513997986,-58.5041699353311 -34.601880379473,-58.5028335782734 -34.6018040628582)))";;"691";11_9_1;COMUNA 11;"9";"1";"873";"401";"472";"84,96%";"364";"364";"100,00%";"0";"0,00%";"315";"2";"0.63";"313";"99,37%";"0.63";0.630
"MULTIPOLYGON (((-58.4919584781574 -34.6006376035792,-58.4917076866001 -34.6009715494404,-58.4926177409552 -34.6010292896582,-58.4935712347986 -34.6010920122958,-58.4937191859522 -34.6008949954322,-58.4938803642635 -34.6009972117733,-58.4940004659846 -34.6010319006578,-58.494195338021 -34.6010441045022,-58.4942789731086 -34.6010409137511,-58.4943681331558 -34.6010086358931,-58.4945164644225 -34.6009203545047,-58.4943773504826 -34.6008344719282,-58.4939540505661 -34.6005821770829,-58.4927167925713 -34.5998447834338,-58.4926042614903 -34.5997778366659,-58.4919584781574 -34.6006376035792)))";;"692";11_9_10;COMUNA 11;"9";"10";"671";"303";"368";"82,34%";"400";"400";"100,00%";"0";"0,00%";"352";"3";"0.85";"349";"99,15%";"0.85";0.850
"MULTIPOLYGON (((-58.4945132408539 -34.5998372857707,-58.4939540505661 -34.6005821770829,-58.4943773504826 -34.6008344719282,-58.4945164644225 -34.6009203545047,-58.4950096985954 -34.6011899534898,-58.4953821676158 -34.6012482368007,-58.4958457554545 -34.6006302008647,-58.4966251395895 -34.5995911440946,-58.4952935708917 -34.5987978849949,-58.4945132408539 -34.5998372857707)))";;"693";11_9_11;COMUNA 11;"9";"11";"586";"256";"330";"77,58%";"332";"332";"100,00%";"0";"0,00%";"258";"1";"0.39";"257";"99,61%";"0.39";0.390
"MULTIPOLYGON (((-58.4958457554545 -34.6006302008647,-58.4953821676158 -34.6012482368007,-58.4953411372776 -34.6013028977519,-58.4972049552179 -34.601427248841,-58.4978769076658 -34.6005320932825,-58.497978031126 -34.6003970589306,-58.4966251395895 -34.5995911440946,-58.4958457554545 -34.6006302008647)))";;"694";11_9_12;COMUNA 11;"9";"12";"658";"286";"372";"76,88%";"387";"387";"100,00%";"0";"0,00%";"297";"0";"0";"297";"100,00%";"0";0.000
"MULTIPOLYGON (((-58.5006322656749 -34.6019787173046,-58.5005942786088 -34.6019762642255,-58.5008369597148 -34.6016713178865,-58.5007084342523 -34.6016626252631,-58.5000246689463 -34.6016162148467,-58.499073717834 -34.6015499502027,-58.4972049552179 -34.601427248841,-58.4971427303413 -34.6015100864732,-58.4970064481065 -34.6016916106391,-58.4969455847765 -34.6017725463038,-58.497087056105 -34.6017818026446,-58.4978617838892 -34.6018306682255,-58.4981856831185 -34.6020242437827,-58.4989882814563 -34.602503673799,-58.4991174338994 -34.6025803283648,-58.4992641363694 -34.6026674004647,-58.4996225453752 -34.6028811738646,-58.499796340732 -34.6029847870397,-58.4999528421313 -34.6030781231682,-58.5010022706073 -34.6037031035271,-58.5011626075788 -34.6037967185886,-58.5013064170315 -34.6038806904179,-58.5021087074368 -34.6043536911566,-58.502293754433 -34.604462931127,-58.5024468084861 -34.6042809731271,-58.5032211995234 -34.6034070235633,-58.5020122366445 -34.6027904943653,-58.5006322656749 -34.6019787173046)))";;"695";11_9_2;COMUNA 11;"9";"2";"807";"378";"429";"88,11%";"355";"355";"100,00%";"0";"0,00%";"312";"0";"0";"312";"100,00%";"0";0.000
"MULTIPOLYGON (((-58.499073717834 -34.6015499502027,-58.5000246689463 -34.6016162148467,-58.5007084342523 -34.6016626252631,-58.5008369597148 -34.6016713178865,-58.5024914397912 -34.6017828360737,-58.5028335782734 -34.6018040628582,-58.5014157762393 -34.6009400514489,-58.5001109760998 -34.6001636682498,-58.4987543198154 -34.5993564400699,-58.4986609447963 -34.5994814019952,-58.4980736214694 -34.6002694911703,-58.497978031126 -34.6003970589306,-58.4978769076658 -34.6005320932825,-58.4972049552179 -34.601427248841,-58.499073717834 -34.6015499502027)))";;"696";11_9_3;COMUNA 11;"9";"3";"1008";"471";"537";"87,71%";"481";"481";"100,00%";"0";"0,00%";"379";"2";"0.53";"377";"99,47%";"0.53";0.530
"MULTIPOLYGON (((-58.5048623835146 -34.6015720318802,-58.5036481742013 -34.600821853447,-58.5035599974876 -34.6007673738854,-58.5034044319131 -34.6006712954522,-58.5030934720057 -34.600478785803,-58.5022145282803 -34.5999348978673,-58.5008809274643 -34.5991095865516,-58.5002172024273 -34.6000215879478,-58.5001109760998 -34.6001636682498,-58.5014157762393 -34.6009400514489,-58.5028335782734 -34.6018040628582,-58.5041699353311 -34.601880379473,-58.5042836729394 -34.6019513997986,-58.5045038447095 -34.6019646349301,-58.505398588254 -34.6020227780301,-58.5055437883929 -34.6019930076964,-58.5048623835146 -34.6015720318802)))";;"697";11_9_4;COMUNA 11;"9";"4";"659";"312";"347";"89,91%";"305";"305";"100,00%";"0";"0,00%";"255";"1";"0.39";"254";"99,61%";"0.39";0.390
"MULTIPOLYGON (((-58.5008809274643 -34.5991095865516,-58.5006429880444 -34.5989623311653,-58.4995434342457 -34.5982817264063,-58.4988561212527 -34.5992202075358,-58.4987543198154 -34.5993564400699,-58.5001109760998 -34.6001636682498,-58.5002172024273 -34.6000215879478,-58.5008809274643 -34.5991095865516)))";;"698";11_9_5;COMUNA 11;"9";"5";"737";"334";"403";"82,88%";"368";"368";"100,00%";"0";"0,00%";"308";"0";"0";"308";"100,00%";"0";0.000
"MULTIPOLYGON (((-58.4995434342457 -34.5982817264063,-58.498222579274 -34.5974641991505,-58.4974020343653 -34.5985518011823,-58.497306957101 -34.5986821148912,-58.4966251395895 -34.5995911440946,-58.497978031126 -34.6003970589306,-58.4980736214694 -34.6002694911703,-58.4986609447963 -34.5994814019952,-58.4987543198154 -34.5993564400699,-58.4988561212527 -34.5992202075358,-58.4995434342457 -34.5982817264063)))";;"699";11_9_6;COMUNA 11;"9";"6";"579";"264";"315";"83,81%";"337";"337";"100,00%";"0";"0,00%";"248";"1";"0.4";"247";"99,60%";"0.4";0.400
"MULTIPOLYGON (((-58.4967848860194 -34.5968111331741,-58.4947157690319 -34.5969476847742,-58.4960722641297 -34.5977604514123,-58.4952935708917 -34.5987978849949,-58.4966251395895 -34.5995911440946,-58.497306957101 -34.5986821148912,-58.4974020343653 -34.5985518011823,-58.498222579274 -34.5974641991505,-58.4980047535444 -34.5973293275663,-58.4971751147229 -34.5968173618249,-58.4971282620495 -34.5967885006927,-58.4967848860194 -34.5968111331741)))";;"700";11_9_7;COMUNA 11;"9";"7";"788";"318";"470";"67,66%";"384";"383";"99,74%";"1";"0,26%";"312";"3";"0.96";"309";"99,04%";"0.96";0.960
"MULTIPOLYGON (((-58.4960722641297 -34.5977604514123,-58.4947157690319 -34.5969476847742,-58.4939402201001 -34.5979916585853,-58.4931616699098 -34.5990328814587,-58.4945132408539 -34.5998372857707,-58.4952935708917 -34.5987978849949,-58.4960722641297 -34.5977604514123)))";;"701";11_9_8;COMUNA 11;"9";"8";"866";"370";"496";"74,60%";"356";"354";"99,44%";"2";"0,56%";"331";"1";"0.3";"330";"99,70%";"0.3";0.300
"MULTIPOLYGON (((-58.4931616699098 -34.5990328814587,-58.4926912616131 -34.5996620362263,-58.4926042614903 -34.5997778366659,-58.4927167925713 -34.5998447834338,-58.4939540505661 -34.6005821770829,-58.4945132408539 -34.5998372857707,-58.4931616699098 -34.5990328814587)))";;"702";11_9_9;COMUNA 11;"9";"9";"529";"228";"301";"75,75%";"300";"300";"100,00%";"0";"0,00%";"246";"1";"0.41";"245";"99,59%";"0.41";0.410
"MULTIPOLYGON (((-58.5096276931962 -34.5696,-58.509859361198 -34.5693403606771,-58.5066017368225 -34.5623940488487,-58.5060437693501 -34.56242653441,-58.5055924051666 -34.5624528115106,-58.5055893635824 -34.5624457167578,-58.5054323260007 -34.5624484612437,-58.5054371398931 -34.5625395903653,-58.5054218158706 -34.562704884754,-58.5053655765449 -34.562933787811,-58.5052580925414 -34.563171159787,-58.5050738112472 -34.5633916561831,-58.5049477915022 -34.5635086768655,-58.504726428258 -34.5636331953939,-58.5043800620964 -34.5638692400598,-58.5041732593676 -34.5640034713455,-58.5040227879297 -34.5640866950574,-58.5038718914011 -34.5641716793673,-58.5038233784541 -34.5641963446939,-58.5037699272472 -34.5642198144267,-58.5037146867906 -34.5642403268601,-58.5036613172384 -34.5642568243791,-58.5035225651267 -34.5642829283433,-58.5034448427513 -34.5642890813392,-58.5032733850379 -34.5642846312029,-58.5031277982175 -34.5642611573377,-58.5030226472083 -34.5642337965392,-58.5029128215406 -34.5647526584528,-58.5028012956075 -34.5652793380274,-58.5026995512986 -34.5652573281845,-58.5026141539212 -34.5652382003639,-58.5025111300685 -34.5652106271572,-58.5024180654764 -34.5651802335983,-58.5023181867943 -34.5651423770629,-58.5022681184539 -34.5651206317809,-58.5021941218344 -34.5650861471822,-58.5021119485578 -34.5650432141025,-58.5017933949716 -34.5654341787838,-58.5014379971279 -34.5658714943678,-58.5018773852926 -34.5660836169759,-58.501998473067 -34.5661424538752,-58.5025605713624 -34.5664158751629,-58.5027121452126 -34.5664895611977,-58.5033321543746 -34.5667934542109,-58.5039573625145 -34.5670998776234,-58.5041013624696 -34.5671748321445,-58.5042412751944 -34.5672477455431,-58.5046575170795 -34.5674521191493,-58.5050721430372 -34.5676557172078,-58.5052086490258 -34.5677227853488,-58.5062630652493 -34.5682410981576,-58.5073168984086 -34.5687590498947,-58.5086004983451 -34.5693894341977,-58.5088175185076 -34.5695091864123,-58.5090406309485 -34.5699973008757,-58.5091680942272 -34.5699437148338,-58.5092216351709 -34.5699158272084,-58.509365830973 -34.5698064468722,-58.5095221037353 -34.5696684799542,-58.5096276931962 -34.5696)))";;"703";12_1_1;COMUNA 12;"1";"1";"581";"263";"318";"82,70%";"216";"216";"100,00%";"0";"0,00%";"191";"1";"0.52";"190";"99,48%";"0.52";0.520
"MULTIPOLYGON (((-58.4974431219146 -34.5534131935851,-58.4980587391229 -34.5526645317376,-58.4970386949057 -34.5521257839454,-58.4961149536453 -34.5516378486833,-58.4960315844999 -34.5517568206287,-58.4955651379072 -34.5524215552045,-58.495013440136 -34.5532076541267,-58.4949482736294 -34.5533005629486,-58.4945535296505 -34.5538670305965,-58.4944649662545 -34.5539928340841,-58.4940340562309 -34.5546055086902,-58.493955019917 -34.5547178580285,-58.4944153662039 -34.5549578207108,-58.4945910092824 -34.5550513003574,-58.4948786969729 -34.555204400881,-58.4950458106928 -34.5552510489943,-58.4952752346804 -34.5552983845271,-58.4955390373606 -34.5553173288103,-58.4957685900103 -34.5552888608495,-58.4957684317968 -34.5552888148936,-58.4959256799535 -34.5552261849549,-58.4960669622443 -34.555097713369,-58.4962087914577 -34.5549141002661,-58.4968246009575 -34.5541653039141,-58.4974431219146 -34.5534131935851)))";;"704";12_1_10;COMUNA 12;"1";"10";"888";"425";"463";"91,79%";"439";"439";"100,00%";"0";"0,00%";"361";"4";"1.11";"357";"98,89%";"1.11";1.110
"MULTIPOLYGON (((-58.4940903796581 -34.5527196330282,-58.4931686921261 -34.5522323088245,-58.4922467599067 -34.5517447664032,-58.4914443666915 -34.5513205016858,-58.4913088333753 -34.5512491217609,-58.4911625734178 -34.5511720396959,-58.4910334256099 -34.551104038413,-58.4904873974628 -34.5518918763926,-58.4904080191428 -34.5520062659112,-58.4899844823314 -34.5526098676023,-58.4899041175272 -34.5527296138722,-58.4900286200182 -34.5527979785943,-58.49018035596 -34.5528759924775,-58.4911110586015 -34.5533724348873,-58.4918520014238 -34.5537653768689,-58.492028149463 -34.5538577332894,-58.4929572538221 -34.5543449232805,-58.493877769985 -34.5548276011047,-58.493955019917 -34.5547178580285,-58.4940340562309 -34.5546055086902,-58.4944649662545 -34.5539928340841,-58.4945535296505 -34.5538670305965,-58.4949482736294 -34.5533005629486,-58.495013440136 -34.5532076541267,-58.4940903796581 -34.5527196330282)))";;"705";12_1_11;COMUNA 12;"1";"11";"1038";"510";"528";"96,59%";"439";"439";"100,00%";"0";"0,00%";"374";"5";"1.34";"369";"98,66%";"1.34";1.340
"MULTIPOLYGON (((-58.5047237722262 -34.5617376896689,-58.5046734506573 -34.561717424387,-58.5045911160504 -34.561688226013,-58.5045018880123 -34.5616629737814,-58.5044150469842 -34.5616444111078,-58.5043238664441 -34.5616299345409,-58.5033593005607 -34.5615216632063,-58.5033023461323 -34.561515273425,-58.5029966312364 -34.5614809365613,-58.5030838822085 -34.5612918852178,-58.5031030086011 -34.5612348340912,-58.5031130253825 -34.5611760957607,-58.5031229526942 -34.5611084133972,-58.5031301619085 -34.5610531972776,-58.503132581903 -34.5609524877538,-58.5031266766584 -34.5608876276573,-58.5031154946262 -34.5608251637799,-58.503102701508 -34.560775799611,-58.5030726101261 -34.5606907353406,-58.5030304185838 -34.5605807443669,-58.5029848348015 -34.560497234554,-58.5029522064613 -34.5604467500991,-58.5029226473408 -34.5604057720917,-58.5028832093892 -34.5603564166719,-58.502819530047 -34.5602941199384,-58.5027375685738 -34.5602113126956,-58.5026313617805 -34.5601862462219,-58.5022234529606 -34.5606833367972,-58.501710435079 -34.5613366999866,-58.5011605696298 -34.5620368352112,-58.5007831540121 -34.5625175382717,-58.5003910148277 -34.5630167666236,-58.4998621428526 -34.5636902684358,-58.4994837763166 -34.5641720240282,-58.4992282679778 -34.5644973967912,-58.4990528228524 -34.5647207688644,-58.4991397611911 -34.5647626461994,-58.4997128251447 -34.5650410071884,-58.5002353111622 -34.5652908586545,-58.500862538263 -34.5655937056727,-58.5014379971279 -34.5658714943678,-58.5017933949716 -34.5654341787838,-58.5021119485578 -34.5650432141025,-58.5021941218344 -34.5650861471822,-58.5022681184539 -34.5651206317809,-58.5023181867943 -34.5651423770629,-58.5024180654764 -34.5651802335983,-58.5025111300685 -34.5652106271572,-58.5026141539212 -34.5652382003639,-58.5026995512986 -34.5652573281845,-58.5028012956075 -34.5652793380274,-58.5029128215406 -34.5647526584528,-58.5030226472083 -34.5642337965392,-58.5031277982175 -34.5642611573377,-58.5032733850379 -34.5642846312029,-58.5034448427513 -34.5642890813392,-58.5035225651267 -34.5642829283433,-58.5036613172384 -34.5642568243791,-58.5037146867906 -34.5642403268601,-58.5037699272472 -34.5642198144267,-58.5038233784541 -34.5641963446939,-58.5038718914011 -34.5641716793673,-58.5040227879297 -34.5640866950574,-58.5041732593676 -34.5640034713455,-58.5043800620964 -34.5638692400598,-58.504726428258 -34.5636331953939,-58.5049477915022 -34.5635086768655,-58.5050738112472 -34.5633916561831,-58.5052580925414 -34.563171159787,-58.5053655765449 -34.562933787811,-58.5054218158706 -34.562704884754,-58.5054371398931 -34.5625395903653,-58.5054323260007 -34.5624484612437,-58.5054063039465 -34.5623361414166,-58.5052935099202 -34.5621751173262,-58.5051294619209 -34.5620014343307,-58.5049552140787 -34.5618574038473,-58.5047237722262 -34.5617376896689)))";;"706";12_1_2;COMUNA 12;"1";"2";"582";"270";"312";"86,54%";"223";"223";"100,00%";"0";"0,00%";"196";"0";"0";"196";"100,00%";"0";0.000
"MULTIPOLYGON (((-58.493877769985 -34.5548276011047,-58.4937078704786 -34.5550689934252,-58.4936065440148 -34.5552160680832,-58.4934431958409 -34.555453232817,-58.4931712019466 -34.5558478260227,-58.4929266009849 -34.5562028325542,-58.4927832426146 -34.5564109760142,-58.4923871102418 -34.5569857469554,-58.492317684442 -34.5570865430346,-58.4918573920104 -34.5577492190426,-58.491327833945 -34.5585114914639,-58.4907784412988 -34.5593023588942,-58.4900228711831 -34.5603900439357,-58.4901865127269 -34.5604683205702,-58.4908456795344 -34.560783325337,-58.490984375957 -34.5608496342785,-58.4914544469152 -34.5610743232505,-58.4919301398132 -34.5613016148078,-58.4928837471642 -34.5617573890216,-58.4941295826919 -34.5623527349659,-58.4942888045009 -34.5624292465706,-58.4954173292095 -34.5629711565251,-58.4965931254869 -34.5635357199403,-58.4966764851088 -34.5635757689649,-58.4968228542084 -34.5636460129413,-58.4978605585719 -34.5641460222852,-58.4979910920621 -34.5642089451465,-58.4987870696294 -34.5645926730485,-58.4990528228524 -34.5647207688644,-58.4992282679778 -34.5644973967912,-58.4994837763166 -34.5641720240282,-58.4998621428526 -34.5636902684358,-58.5003910148277 -34.5630167666236,-58.5007831540121 -34.5625175382717,-58.5011605696298 -34.5620368352112,-58.501710435079 -34.5613366999866,-58.5022234529606 -34.5606833367972,-58.5026313617805 -34.5601862462219,-58.5027375685738 -34.5602113126956,-58.502819530047 -34.5602941199384,-58.5028832093892 -34.5603564166719,-58.5029226473408 -34.5604057720917,-58.5029522064613 -34.5604467500991,-58.5029848348015 -34.560497234554,-58.5030304185838 -34.5605807443669,-58.5030726101261 -34.5606907353406,-58.503102701508 -34.560775799611,-58.5031154946262 -34.5608251637799,-58.5031266766584 -34.5608876276573,-58.503132581903 -34.5609524877538,-58.5031301619085 -34.5610531972776,-58.5031229526942 -34.5611084133972,-58.5031130253825 -34.5611760957607,-58.5031030086011 -34.5612348340912,-58.5030838822085 -34.5612918852178,-58.5029966312364 -34.5614809365613,-58.5033023461323 -34.561515273425,-58.5033593005607 -34.5615216632063,-58.5043238664441 -34.5616299345409,-58.5044150469842 -34.5616444111078,-58.5045018880123 -34.5616629737814,-58.5045911160504 -34.561688226013,-58.5046734506573 -34.561717424387,-58.5047237722262 -34.5617376896689,-58.5049552140787 -34.5618574038473,-58.5051294619209 -34.5620014343307,-58.5052935099202 -34.5621751173262,-58.5054063039465 -34.5623361414166,-58.5054323260007 -34.5624484612437,-58.5055893635824 -34.5624457167578,-58.5055924051666 -34.5624528115106,-58.5060437693501 -34.56242653441,-58.5066017368225 -34.5623940488487,-58.5016040560929 -34.5517349394264,-58.5010852563003 -34.5519093166539,-58.5006552895502 -34.5520538333953,-58.5006505322853 -34.5520446406287,-58.5004376697599 -34.5519027282219,-58.5002246509351 -34.5517902534676,-58.4999398198941 -34.5517398453822,-58.4996953694891 -34.5517659772351,-58.4995179209809 -34.551822301076,-58.4993405809392 -34.5519324299265,-58.4990177962468 -34.5520997171771,-58.4986757912116 -34.551913260521,-58.4980587391229 -34.5526645317376,-58.4974431219146 -34.5534131935851,-58.4968246009575 -34.5541653039141,-58.4962087914577 -34.5549141002661,-58.4960669622443 -34.555097713369,-58.4959256799535 -34.5552261849549,-58.4957684317968 -34.5552888148936,-58.4957684608022 -34.5552888768734,-58.4955390373606 -34.5553173288103,-58.4952752346804 -34.5552983845271,-58.4950458106928 -34.5552510489943,-58.4948786969729 -34.555204400881,-58.4945910092824 -34.5550513003574,-58.4944153662039 -34.5549578207108,-58.493955019917 -34.5547178580285,-58.493877769985 -34.5548276011047)))";;"707";12_1_3;COMUNA 12;"1";"3";"687";"335";"352";"95,17%";"202";"200";"99,01%";"2";"1,00%";"187";"0";"0";"187";"100,00%";"0";0.000
"MULTIPOLYGON (((-58.4962937273417 -34.5495793238633,-58.495743672092 -34.5503646513077,-58.4966659497585 -34.5508517447832,-58.4975898558068 -34.5513397463201,-58.4986757912116 -34.551913260521,-58.4990177962468 -34.5520997171771,-58.4993405809392 -34.5519324299265,-58.4995179209809 -34.551822301076,-58.4996953694891 -34.5517659772351,-58.4999398198941 -34.5517398453822,-58.5002246509351 -34.5517902534676,-58.5004376697599 -34.5519027282219,-58.5006505322853 -34.5520446406287,-58.5006552895502 -34.5520538333953,-58.5010852563003 -34.5519093166539,-58.5016040560929 -34.5517349394264,-58.5006793893487 -34.5497624768993,-58.500551317578 -34.5494892713124,-58.4973354202964 -34.5480700984764,-58.4970610867236 -34.5484737937501,-58.4968387627536 -34.5488009510193,-58.4968482879283 -34.5488050494373,-58.4962937273417 -34.5495793238633)))";;"708";12_1_4;COMUNA 12;"1";"4";"885";"429";"456";"94,08%";"315";"315";"100,00%";"0";"0,00%";"313";"6";"1.92";"307";"98,08%";"1.92";1.920
"MULTIPOLYGON (((-58.4970610867236 -34.5484737937501,-58.4973354202964 -34.5480700984764,-58.4944362202648 -34.5467905696566,-58.4941629085121 -34.5471845952904,-58.4932487098963 -34.548502537343,-58.4932423206025 -34.5485052159533,-58.4929660065771 -34.5488974861737,-58.4938987233064 -34.549390161729,-58.4948211497652 -34.5498774100366,-58.495743672092 -34.5503646513077,-58.4962937273417 -34.5495793238633,-58.4968482879283 -34.5488050494373,-58.4968387627536 -34.5488009510193,-58.4970610867236 -34.5484737937501)))";;"709";12_1_5;COMUNA 12;"1";"5";"588";"284";"304";"93,42%";"249";"249";"100,00%";"0";"0,00%";"217";"5";"2.3";"212";"97,70%";"2.3";2.300
"MULTIPOLYGON (((-58.4927272493636 -34.5460362841314,-58.4924660049859 -34.54642516923,-58.49194010663 -34.5472094176719,-58.4919167811349 -34.5471975917138,-58.4918802008782 -34.5472518987851,-58.4918806418395 -34.5472959852565,-58.4913671515571 -34.5480574806121,-58.4914101411291 -34.5480759220798,-58.4908723939829 -34.5488679857682,-58.491512839432 -34.5492064436709,-58.4921381364426 -34.5495368733045,-58.4916665657618 -34.5502061017213,-58.4915835316927 -34.5503236620634,-58.4917086770612 -34.5503883537114,-58.4918602138693 -34.5504666311109,-58.4919481820751 -34.550342097247,-58.4924129453145 -34.5496824473252,-58.4933483918253 -34.5501765348713,-58.4942698021591 -34.5506632945542,-58.4951929259188 -34.5511508918955,-58.4961149536453 -34.5516378486833,-58.4970386949057 -34.5521257839454,-58.4980587391229 -34.5526645317376,-58.4986757912116 -34.551913260521,-58.4975898558068 -34.5513397463201,-58.4966659497585 -34.5508517447832,-58.495743672092 -34.5503646513077,-58.4948211497652 -34.5498774100366,-58.4938987233064 -34.549390161729,-58.4929660065771 -34.5488974861737,-58.4932423206025 -34.5485052159533,-58.4932487098963 -34.548502537343,-58.4941629085121 -34.5471845952904,-58.4944362202648 -34.5467905696566,-58.4927272493636 -34.5460362841314)))";;"710";12_1_6;COMUNA 12;"1";"6";"760";"346";"414";"83,57%";"330";"330";"100,00%";"0";"0,00%";"286";"5";"1.75";"281";"98,25%";"1.75";1.750
"MULTIPOLYGON (((-58.4923078387747 -34.5463545001283,-58.4925794694148 -34.5459710356134,-58.4917413121306 -34.5456010824922,-58.4914707905649 -34.5459807327093,-58.4909243200329 -34.5467476375517,-58.490925046025 -34.5467480151075,-58.4909169264742 -34.546900277665,-58.4908568085596 -34.5470718489009,-58.4907565145163 -34.5472379361247,-58.490500788115 -34.5476220971464,-58.4900502872977 -34.5473993715289,-58.4894602618386 -34.5481636930092,-58.4888726079426 -34.5489251235783,-58.4884921093544 -34.5493824089707,-58.4882487650765 -34.5496749385449,-58.4876613466247 -34.5504422083936,-58.487399398985 -34.5503057764495,-58.4869401086055 -34.550907516137,-58.4868354527852 -34.5510446559011,-58.4876552696453 -34.5514700037589,-58.4884622689195 -34.5517070302235,-58.4884623473544 -34.5517069371917,-58.4885603751713 -34.5515906660764,-58.4886155119221 -34.551525158399,-58.488914569725 -34.5510947929477,-58.4894603529135 -34.5503093564274,-58.4900091039476 -34.5495208883951,-58.4905611653779 -34.5487360791849,-58.4911052195406 -34.5479628190801,-58.4916688275641 -34.5471537754903,-58.4917651926092 -34.5471984730006,-58.4918048359564 -34.5471410664961,-58.491769676859 -34.5471213556353,-58.4923078387747 -34.5463545001283)))";;"711";12_1_7;COMUNA 12;"1";"7";"1089";"533";"556";"95,86%";"370";"370";"100,00%";"0";"0,00%";"360";"18";"5";"342";"95,00%";"5";5.000
"MULTIPOLYGON (((-58.4893002206918 -34.5523674444283,-58.4899041175272 -34.5527296138722,-58.4899844823314 -34.5526098676023,-58.4904080191428 -34.5520062659112,-58.4904873974628 -34.5518918763926,-58.4910334256099 -34.551104038413,-58.491090682295 -34.5510215565038,-58.4915835316927 -34.5503236620634,-58.4916665657618 -34.5502061017213,-58.4921381364426 -34.5495368733045,-58.491512839432 -34.5492064436709,-58.4908723939829 -34.5488679857682,-58.4914101411291 -34.5480759220798,-58.4913671515571 -34.5480574806121,-58.4918806418395 -34.5472959852565,-58.4918802008782 -34.5472518987851,-58.4919167811349 -34.5471975917138,-58.49194010663 -34.5472094176719,-58.4924660049859 -34.54642516923,-58.4927272493636 -34.5460362841314,-58.4925794694148 -34.5459710356134,-58.4923078387747 -34.5463545001283,-58.491769676859 -34.5471213556353,-58.4918048359564 -34.5471410664961,-58.4917651926092 -34.5471984730006,-58.4916688275641 -34.5471537754903,-58.4911052195406 -34.5479628190801,-58.4905611653779 -34.5487360791849,-58.4900091039476 -34.5495208883951,-58.4894603529135 -34.5503093564274,-58.488914569725 -34.5510947929477,-58.4886155119221 -34.551525158399,-58.4885603751713 -34.5515906660764,-58.4884623473544 -34.5517069371917,-58.4884622689195 -34.5517070302235,-58.4884619813619 -34.5517074268817,-58.488552654616 -34.5516973238699,-58.4886519637553 -34.5517225498623,-58.4887786953489 -34.5517832869699,-58.4888004521238 -34.5518046970517,-58.4888262002611 -34.5518300348744,-58.4888261061541 -34.5518300571955,-58.4888731916487 -34.5518766689838,-58.4888732808561 -34.5518771223935,-58.4889004732627 -34.5520153315097,-58.4891517437503 -34.5522784584942,-58.4893002206918 -34.5523674444283)))";;"712";12_1_8;COMUNA 12;"1";"8";"505";"241";"264";"91,29%";"214";"214";"100,00%";"0";"0,00%";"182";"5";"2.75";"177";"97,25%";"2.75";2.750
"MULTIPOLYGON (((-58.4922467599067 -34.5517447664032,-58.4931686921261 -34.5522323088245,-58.4940903796581 -34.5527196330282,-58.495013440136 -34.5532076541267,-58.4955651379072 -34.5524215552045,-58.4960315844999 -34.5517568206287,-58.4961149536453 -34.5516378486833,-58.4951929259188 -34.5511508918955,-58.4942698021591 -34.5506632945542,-58.4933483918253 -34.5501765348713,-58.4924129453145 -34.5496824473252,-58.4919481820751 -34.550342097247,-58.4918602138693 -34.5504666311109,-58.4917086770612 -34.5503883537114,-58.4915835316927 -34.5503236620634,-58.491090682295 -34.5510215565038,-58.4910334256099 -34.551104038413,-58.4911625734178 -34.5511720396959,-58.4913088333753 -34.5512491217609,-58.4914443666915 -34.5513205016858,-58.4922467599067 -34.5517447664032)))";;"713";12_1_9;COMUNA 12;"1";"9";"974";"468";"506";"92,49%";"423";"423";"100,00%";"0";"0,00%";"356";"4";"1.12";"352";"98,88%";"1.12";1.120
"MULTIPOLYGON (((-58.4864623383408 -34.5664681004285,-58.487274299803 -34.5668858452979,-58.4874055120195 -34.5669532865535,-58.4875120636622 -34.5668292454336,-58.4882569909942 -34.5659974355914,-58.4883682223864 -34.5658730405974,-58.4891641089264 -34.5649838174738,-58.4892900602173 -34.5648427275515,-58.4883101407555 -34.5644172844765,-58.4875298054098 -34.564078557473,-58.4873279304556 -34.5639841575701,-58.4863554291004 -34.5635291888943,-58.4854139840652 -34.5645407504357,-58.486376197302 -34.5650178421803,-58.4854983998504 -34.5659712906267,-58.4856493632387 -34.5660497869137,-58.4864623383408 -34.5664681004285)))";;"714";12_10_1;COMUNA 12;"10";"1";"994";"462";"532";"86,84%";"381";"381";"100,00%";"0";"0,00%";"366";"2";"0.55";"364";"99,45%";"0.55";0.550
"MULTIPOLYGON (((-58.4801434960315 -34.5688153255855,-58.4800308796585 -34.5689425934478,-58.4801175913306 -34.5689823718798,-58.4803799834782 -34.5691151637391,-58.4804729630711 -34.5691632509159,-58.4807680834677 -34.5693303979414,-58.4809063629238 -34.5694082680967,-58.4809822295516 -34.56945163892,-58.4810620989123 -34.5695005022895,-58.4813479447123 -34.569681100585,-58.4814606827631 -34.569753199109,-58.481795412479 -34.5699915378029,-58.4818664292362 -34.5700435711774,-58.4819371905874 -34.5700952524223,-58.4821022175127 -34.5702240346881,-58.4822218585059 -34.5703191605688,-58.4823473749796 -34.5704171728339,-58.4824426640576 -34.5704998370854,-58.4825868336739 -34.5706286220587,-58.4826793994414 -34.5707139627379,-58.4828623167849 -34.5708798553089,-58.4833235303252 -34.5712970497495,-58.4834053524093 -34.571372126969,-58.4834192442269 -34.5713847014579,-58.4834211185198 -34.571382716129,-58.4835784588744 -34.5712622520681,-58.4835786988792 -34.57126202307,-58.4834826247082 -34.5711748344089,-58.4829028722154 -34.5706496978344,-58.4828505003123 -34.5706006902917,-58.4828142227522 -34.570564779232,-58.4824647442586 -34.5702643303847,-58.4820661411181 -34.5699520568273,-58.4819894222112 -34.5699091797952,-58.4824528712456 -34.5693800686876,-58.4825779896336 -34.5692410986909,-58.482699192326 -34.5691063547399,-58.4834144808544 -34.568296341107,-58.4824982012973 -34.5677407647119,-58.4815872981361 -34.5671883497074,-58.4807493499184 -34.5681326021803,-58.4798375174973 -34.5675798925883,-58.4791256046975 -34.568384039583,-58.4792435304575 -34.5684464207397,-58.479262092402 -34.5684578975954,-58.4793318230933 -34.5684790862201,-58.4799825753832 -34.5687538669296,-58.4800534150627 -34.5687836469067,-58.4801434960315 -34.5688153255855)))";;"715";12_10_10;COMUNA 12;"10";"10";"815";"349";"466";"74,89%";"308";"307";"99,68%";"1";"0,33%";"299";"32";"10.7";"267";"89,30%";"10.7";10.700
"MULTIPOLYGON (((-58.4791256046975 -34.568384039583,-58.4798375174973 -34.5675798925883,-58.4807493499184 -34.5681326021803,-58.4815872981361 -34.5671883497074,-58.4806742784071 -34.5666347309298,-58.4797599084665 -34.5660802603526,-58.4788475940887 -34.5655269798382,-58.4780098870963 -34.5664719884164,-58.4771649261008 -34.5674252317586,-58.4770912134606 -34.5675083426915,-58.4770276325988 -34.5675963117571,-58.4768872677871 -34.5677328129801,-58.4769742810188 -34.5677613956332,-58.477858556725 -34.5680890497985,-58.4779523828065 -34.5681246734668,-58.4785475237408 -34.5683455931949,-58.4788682689706 -34.5685416160029,-58.4789100656197 -34.5685147078813,-58.4789612302057 -34.5685031512783,-58.4790100132208 -34.5685031447702,-58.479091323525 -34.5685300364579,-58.4791727209204 -34.5685665763865,-58.4794073767014 -34.5686683799097,-58.479941910926 -34.5689028228128,-58.4800308796585 -34.5689425934478,-58.4801434960315 -34.5688153255855,-58.4800534150627 -34.5687836469067,-58.4799825753832 -34.5687538669296,-58.4793318230933 -34.5684790862201,-58.479262092402 -34.5684578975954,-58.4792435304575 -34.5684464207397,-58.4791256046975 -34.568384039583)))";;"716";12_10_11;COMUNA 12;"10";"11";"883";"420";"463";"90,71%";"395";"395";"100,00%";"0";"0,00%";"345";"30";"8.7";"315";"91,30%";"8.7";8.700
"MULTIPOLYGON (((-58.4874055120195 -34.5669532865535,-58.487274299803 -34.5668858452979,-58.4864623383408 -34.5664681004285,-58.4856493632387 -34.5660497869137,-58.4854983998504 -34.5659712906267,-58.486376197302 -34.5650178421803,-58.4854139840652 -34.5645407504357,-58.484453484668 -34.5640644958699,-58.4835926072936 -34.5649804613083,-58.482765245098 -34.5658608500956,-58.4831054823618 -34.5660408016021,-58.4837245683764 -34.5663558512202,-58.483888302115 -34.5664391364224,-58.4845257875637 -34.566771433037,-58.4846896937775 -34.5668569707473,-58.4856553423585 -34.5673609699523,-58.4866132540693 -34.5678608078798,-58.4873110449958 -34.5670630991683,-58.4874055120195 -34.5669532865535)))";;"717";12_10_2;COMUNA 12;"10";"2";"994";"465";"529";"87,90%";"491";"490";"99,80%";"1";"0,20%";"390";"1";"0.26";"389";"99,74%";"0.26";0.260
"MULTIPOLYGON (((-58.484453484668 -34.5640644958699,-58.4854139840652 -34.5645407504357,-58.4863554291004 -34.5635291888943,-58.4853837046243 -34.5630746348449,-58.4846093466267 -34.5627123658113,-58.4836258918941 -34.5622524474592,-58.4829666859524 -34.5631155547742,-58.4828505197661 -34.5632696653465,-58.4821295138974 -34.5642261625944,-58.4830974991095 -34.5647251816662,-58.4823913779381 -34.5656651277231,-58.4825756290287 -34.5657605950187,-58.482765245098 -34.5658608500956,-58.4835926072936 -34.5649804613083,-58.484453484668 -34.5640644958699)))";;"718";12_10_3;COMUNA 12;"10";"3";"730";"337";"393";"85,75%";"338";"338";"100,00%";"0";"0,00%";"287";"5";"1.74";"282";"98,26%";"1.74";1.740
"MULTIPOLYGON (((-58.4812900878416 -34.5650946851577,-58.4812908185426 -34.5650950639237,-58.4814229597997 -34.5651634974483,-58.4818026968454 -34.565360207844,-58.4823913779381 -34.5656651277231,-58.4830974991095 -34.5647251816662,-58.4821295138974 -34.5642261625944,-58.4828505197661 -34.5632696653465,-58.4829666859524 -34.5631155547742,-58.4836258918941 -34.5622524474592,-58.4834738395833 -34.5622101475995,-58.4827814330858 -34.5620174379675,-58.4819988341844 -34.5616142311872,-58.4818433651027 -34.5615340086608,-58.4817832290687 -34.561620669106,-58.4815974353379 -34.5618797216431,-58.4814099673405 -34.5621443147554,-58.4812543005561 -34.5623618075377,-58.4811538707715 -34.5625058786701,-58.4809864635829 -34.5626388785438,-58.4806616908544 -34.5628910245884,-58.4803988575031 -34.5630932952929,-58.4801417182601 -34.5632925808212,-58.4802215607882 -34.5632319458513,-58.480372632959 -34.5633207727284,-58.4800681534128 -34.5635072160816,-58.4799101701994 -34.5636044962857,-58.4797216233053 -34.5636959352199,-58.479541500566 -34.5637703296916,-58.4790549215309 -34.5639320227197,-58.4793119601157 -34.5640657967501,-58.4799003678796 -34.5643720668334,-58.4808406713195 -34.5648613889488,-58.4810478222252 -34.5649691796453,-58.4812451821745 -34.5650714078506,-58.4812900878416 -34.5650946851577)))";;"719";12_10_4;COMUNA 12;"10";"4";"758";"381";"377";"101,06%";"307";"307";"100,00%";"0";"0,00%";"270";"5";"1.85";"265";"98,15%";"1.85";1.850
"MULTIPOLYGON (((-58.4793119601157 -34.5640657967501,-58.4791183195521 -34.5642382953601,-58.4781481470658 -34.5651028263241,-58.4771775288935 -34.5659677016394,-58.4763560244569 -34.5666996593847,-58.4761902069444 -34.5668491209846,-58.4751236336884 -34.5662186431718,-58.4746656876094 -34.566734627028,-58.4745962726232 -34.5668128520933,-58.4745238763979 -34.5668944365744,-58.4745969245891 -34.5669139373734,-58.4751674396471 -34.5671051564142,-58.4755939033842 -34.5672598371893,-58.4756850879596 -34.5672927162854,-58.4757751657861 -34.5673251728781,-58.4763990727033 -34.5675567342936,-58.4767930177072 -34.5677018366298,-58.4768872677871 -34.5677328129801,-58.4770276325988 -34.5675963117571,-58.4770912134606 -34.5675083426915,-58.4771649261008 -34.5674252317586,-58.4780098870963 -34.5664719884164,-58.4788475940887 -34.5655269798382,-58.4796850267776 -34.5645821766831,-58.4799003678796 -34.5643720668334,-58.4793119601157 -34.5640657967501)))";;"720";12_10_5;COMUNA 12;"10";"5";"738";"347";"391";"88,75%";"368";"368";"100,00%";"0";"0,00%";"298";"11";"3.69";"287";"96,31%";"3.69";3.690
"MULTIPOLYGON (((-58.4808406713195 -34.5648613889488,-58.4799003678796 -34.5643720668334,-58.4796850267776 -34.5645821766831,-58.4788475940887 -34.5655269798382,-58.4797599084665 -34.5660802603526,-58.4806742784071 -34.5666347309298,-58.4815872981361 -34.5671883497074,-58.4824249720611 -34.5662443026608,-58.4815109352989 -34.5656897746853,-58.4818026968454 -34.565360207844,-58.4814229597997 -34.5651634974483,-58.4812908185426 -34.5650950639237,-58.4812900878416 -34.5650946851577,-58.4812451821745 -34.5650714078506,-58.4810478222252 -34.5649691796453,-58.4808406713195 -34.5648613889488)))";;"721";12_10_6;COMUNA 12;"10";"6";"874";"404";"470";"85,96%";"423";"423";"100,00%";"0";"0,00%";"353";"5";"1.42";"348";"98,58%";"1.42";1.420
"MULTIPOLYGON (((-58.4833346784404 -34.5667961482985,-58.4834731278664 -34.5668800721533,-58.4842532519462 -34.5673521406507,-58.4851686871135 -34.5679060842729,-58.4860837086608 -34.5684597393543,-58.4867275348273 -34.5688492791489,-58.4874483935782 -34.56830143527,-58.4873531115773 -34.5682510298202,-58.4867803150405 -34.5679479619377,-58.4866132540693 -34.5678608078798,-58.4856553423585 -34.5673609699523,-58.4846896937775 -34.5668569707473,-58.4845257875637 -34.566771433037,-58.483888302115 -34.5664391364224,-58.4837245683764 -34.5663558512202,-58.4831054823618 -34.5660408016021,-58.482765245098 -34.5658608500956,-58.4825756290287 -34.5657605950187,-58.4823913779381 -34.5656651277231,-58.4818026968454 -34.565360207844,-58.4815109352989 -34.5656897746853,-58.4824249720611 -34.5662443026608,-58.4833346784404 -34.5667961482985)))";;"722";12_10_7;COMUNA 12;"10";"7";"768";"353";"415";"85,06%";"314";"313";"99,68%";"1";"0,32%";"295";"2";"0.68";"293";"99,32%";"0.68";0.680
"MULTIPOLYGON (((-58.4843298359691 -34.5688514177562,-58.4834923276717 -34.5697952661663,-58.4833771688096 -34.5699250800752,-58.4828142227522 -34.570564779232,-58.4828505003123 -34.5706006902917,-58.4829028722154 -34.5706496978344,-58.4834826247082 -34.5711748344089,-58.4835786988792 -34.57126202307,-58.4839195982597 -34.5710004559495,-58.4841438093562 -34.570828155824,-58.4849657385699 -34.5701965729676,-58.4856638068592 -34.5696602232682,-58.4857856125073 -34.5695666046914,-58.4859581487522 -34.5694339605615,-58.486611518997 -34.568937404346,-58.4867275348273 -34.5688492791489,-58.4860837086608 -34.5684597393543,-58.4851686871135 -34.5679060842729,-58.4843298359691 -34.5688514177562)))";;"723";12_10_8;COMUNA 12;"10";"8";"1166";"543";"623";"87,16%";"580";"579";"99,83%";"1";"0,17%";"477";"1";"0.21";"476";"99,79%";"0.21";0.210
"MULTIPOLYGON (((-58.4842532519462 -34.5673521406507,-58.4834731278664 -34.5668800721533,-58.4833346784404 -34.5667961482985,-58.4824249720611 -34.5662443026608,-58.4815872981361 -34.5671883497074,-58.4824982012973 -34.5677407647119,-58.4834144808544 -34.568296341107,-58.482699192326 -34.5691063547399,-58.4825779896336 -34.5692410986909,-58.4824528712456 -34.5693800686876,-58.4819894222112 -34.5699091797952,-58.4820661411181 -34.5699520568273,-58.4824647442586 -34.5702643303847,-58.4828142227522 -34.570564779232,-58.4833771688096 -34.5699250800752,-58.4834923276717 -34.5697952661663,-58.4843298359691 -34.5688514177562,-58.4851686871135 -34.5679060842729,-58.4842532519462 -34.5673521406507)))";;"724";12_10_9;COMUNA 12;"10";"9";"842";"415";"427";"97,19%";"386";"386";"100,00%";"0";"0,00%";"318";"18";"5.66";"300";"94,34%";"5.66";5.660
"MULTIPOLYGON (((-58.480820934987 -34.5696373048156,-58.4799092548914 -34.5690795252334,-58.4790550113112 -34.5700435576735,-58.4784088680144 -34.5707728993805,-58.4775797008954 -34.5717086069283,-58.4777537445667 -34.5718123224404,-58.4785072265311 -34.5722471050134,-58.4793203008859 -34.5713292815345,-58.4799746969863 -34.5705904968756,-58.4807109648748 -34.5697638758662,-58.480820934987 -34.5696373048156)))";;"725";12_11_1;COMUNA 12;"11";"1";"760";"343";"417";"82,25%";"388";"388";"100,00%";"0";"0,00%";"328";"3";"0.91";"325";"99,09%";"0.91";0.910
"MULTIPOLYGON (((-58.4690353099086 -34.572119155758,-58.4698374504375 -34.5725648348295,-58.469981259358 -34.572644688912,-58.4706983508521 -34.5730544503019,-58.4716494317697 -34.5735979990483,-58.4717998860694 -34.5736855268709,-58.4725685106795 -34.57413281016,-58.4733247976016 -34.5732393987068,-58.4741006473981 -34.5723228106054,-58.4731750214554 -34.5717768137678,-58.4722522173757 -34.5712323590029,-58.4721354841215 -34.5711635623017,-58.4713263602643 -34.5706871227467,-58.4706080077007 -34.5702641953842,-58.4704160110981 -34.5701502590833,-58.4695856575432 -34.571131337002,-58.4688405871916 -34.5720116963068,-58.4690353099086 -34.572119155758)))";;"726";12_11_10;COMUNA 12;"11";"10";"860";"411";"449";"91,54%";"346";"346";"100,00%";"0";"0,00%";"283";"2";"0.71";"281";"99,29%";"0.71";0.710
"MULTIPOLYGON (((-58.4708650271922 -34.5744961204651,-58.471805907701 -34.5750325555664,-58.4719584081166 -34.575119519616,-58.472742458324 -34.5755718007441,-58.4728867013296 -34.5756550317527,-58.4735471229532 -34.5760327373094,-58.4736847252384 -34.5761076577481,-58.4738290546519 -34.5761863803952,-58.4746189996106 -34.5766361135325,-58.4753789538374 -34.5757783246712,-58.4752341971374 -34.5756941811308,-58.4745931831002 -34.5753158489625,-58.4744533671604 -34.5752379014539,-58.4743115930471 -34.5751588975876,-58.4736266510036 -34.5747596480988,-58.473501311123 -34.5746817686212,-58.4733473613582 -34.5745860034285,-58.4725685106795 -34.57413281016,-58.4717998860694 -34.5736855268709,-58.4716494317697 -34.5735979990483,-58.4706983508521 -34.5730544503019,-58.469981259358 -34.572644688912,-58.4698374504375 -34.5725648348295,-58.4690353099086 -34.572119155758,-58.4688405871916 -34.5720116963068,-58.4680812837286 -34.5729088128466,-58.4682875873865 -34.573026484668,-58.4691338386307 -34.5735089988278,-58.4699256062461 -34.5739604526578,-58.4708650271922 -34.5744961204651)))";;"727";12_11_11;COMUNA 12;"11";"11";"774";"360";"414";"86,96%";"344";"343";"99,71%";"1";"0,29%";"278";"9";"3.24";"269";"96,76%";"3.24";3.240
"MULTIPOLYGON (((-58.4800308796585 -34.5689425934478,-58.479941910926 -34.5689028228128,-58.4794073767014 -34.5686683799097,-58.4791727209204 -34.5685665763865,-58.479091323525 -34.5685300364579,-58.4790100132208 -34.5685031447702,-58.4789612302057 -34.5685031512783,-58.4789100656197 -34.5685147078813,-58.4788682689706 -34.5685416160029,-58.4785475237408 -34.5683455931949,-58.4779523828065 -34.5681246734668,-58.4772150802557 -34.5689503626524,-58.4780110241734 -34.5694243704927,-58.4781378072035 -34.5694995690524,-58.4790550113112 -34.5700435576735,-58.4799092548914 -34.5690795252334,-58.480820934987 -34.5696373048156,-58.4809822295516 -34.56945163892,-58.4809063629238 -34.5694082680967,-58.4807680834677 -34.5693303979414,-58.4804729630711 -34.5691632509159,-58.4803799834782 -34.5691151637391,-58.4801175913306 -34.5689823718798,-58.4800308796585 -34.5689425934478)))";;"728";12_11_2;COMUNA 12;"11";"2";"645";"309";"336";"91,96%";"320";"320";"100,00%";"0";"0,00%";"267";"8";"3";"259";"97,00%";"3";3.000
"MULTIPOLYGON (((-58.4781378072035 -34.5694995690524,-58.4780110241734 -34.5694243704927,-58.4772150802557 -34.5689503626524,-58.4765316304242 -34.5696268093701,-58.475613820498 -34.5705351886303,-58.476365409196 -34.5709849149392,-58.4765535842806 -34.5710970112351,-58.4775797008954 -34.5717086069283,-58.4784088680144 -34.5707728993805,-58.4790550113112 -34.5700435576735,-58.4781378072035 -34.5694995690524)))";;"729";12_11_3;COMUNA 12;"11";"3";"568";"248";"320";"77,50%";"301";"301";"100,00%";"0";"0,00%";"254";"5";"1.97";"249";"98,03%";"1.97";1.970
"MULTIPOLYGON (((-58.4750424635723 -34.5728783766125,-58.4749482284987 -34.5729846582563,-58.4742679794927 -34.5737825051664,-58.4750864298151 -34.5742536421154,-58.4752418277842 -34.5743454611413,-58.4760242724306 -34.5748080035372,-58.4761644306179 -34.5748917241072,-58.4769508271011 -34.5740040618713,-58.4777323548163 -34.5731218178087,-58.4785072265311 -34.5722471050134,-58.4777537445667 -34.5718123224404,-58.4775797008954 -34.5717086069283,-58.4765535842806 -34.5710970112351,-58.475804416798 -34.5719834701066,-58.4751595973775 -34.5727464576587,-58.4750424635723 -34.5728783766125)))";;"730";12_11_4;COMUNA 12;"11";"4";"888";"405";"483";"83,85%";"422";"420";"99,53%";"2";"0,48%";"343";"2";"0.58";"341";"99,42%";"0.58";0.580
"MULTIPOLYGON (((-58.473501311123 -34.5746817686212,-58.4736266510036 -34.5747596480988,-58.4743115930471 -34.5751588975876,-58.4744533671604 -34.5752379014539,-58.4745931831002 -34.5753158489625,-58.4752341971374 -34.5756941811308,-58.4753789538374 -34.5757783246712,-58.4761644306179 -34.5748917241072,-58.4760242724306 -34.5748080035372,-58.4752418277842 -34.5743454611413,-58.4750864298151 -34.5742536421154,-58.4742679794927 -34.5737825051664,-58.4749482284987 -34.5729846582563,-58.4750424635723 -34.5728783766125,-58.4751595973775 -34.5727464576587,-58.475804416798 -34.5719834701066,-58.4765535842806 -34.5710970112351,-58.476365409196 -34.5709849149392,-58.475613820498 -34.5705351886303,-58.4748597957822 -34.5714260086855,-58.4741006473981 -34.5723228106054,-58.4733247976016 -34.5732393987068,-58.4725685106795 -34.57413281016,-58.4733473613582 -34.5745860034285,-58.473501311123 -34.5746817686212)))";;"731";12_11_5;COMUNA 12;"11";"5";"920";"450";"470";"95,74%";"346";"346";"100,00%";"0";"0,00%";"307";"48";"15.64";"259";"84,36%";"15.64";15.640
"MULTIPOLYGON (((-58.4746961218493 -34.569986174027,-58.4739361331197 -34.5708808624497,-58.4731750214554 -34.5717768137678,-58.4741006473981 -34.5723228106054,-58.4748597957822 -34.5714260086855,-58.475613820498 -34.5705351886303,-58.4765316304242 -34.5696268093701,-58.4772150802557 -34.5689503626524,-58.4779523828065 -34.5681246734668,-58.477858556725 -34.5680890497985,-58.4769742810188 -34.5677613956332,-58.4768872677871 -34.5677328129801,-58.4762904922297 -34.5683998113474,-58.4756179357925 -34.5690689979617,-58.4746961218493 -34.569986174027)))";;"732";12_11_6;COMUNA 12;"11";"6";"858";"403";"455";"88,57%";"373";"373";"100,00%";"0";"0,00%";"319";"15";"4.7";"304";"95,30%";"4.7";4.700
"MULTIPOLYGON (((-58.473014440827 -34.5703368358177,-58.4729229307867 -34.570445791884,-58.4722522173757 -34.5712323590029,-58.4731750214554 -34.5717768137678,-58.4739361331197 -34.5708808624497,-58.4746961218493 -34.569986174027,-58.4756179357925 -34.5690689979617,-58.4762904922297 -34.5683998113474,-58.4751911177445 -34.5677456749301,-58.4745983354612 -34.5684513986965,-58.4737769868681 -34.569429124087,-58.473014440827 -34.5703368358177)))";;"733";12_11_7;COMUNA 12;"11";"7";"778";"353";"425";"83,06%";"391";"391";"100,00%";"0";"0,00%";"330";"0";"0";"330";"100,00%";"0";0.000
"MULTIPOLYGON (((-58.4768872677871 -34.5677328129801,-58.4767930177072 -34.5677018366298,-58.4763990727033 -34.5675567342936,-58.4757751657861 -34.5673251728781,-58.4756850879596 -34.5672927162854,-58.4755939033842 -34.5672598371893,-58.4751674396471 -34.5671051564142,-58.4745969245891 -34.5669139373734,-58.4745238763979 -34.5668944365744,-58.4742687701486 -34.5671969390373,-58.4736901163623 -34.5679018824359,-58.4730272657181 -34.5687092994075,-58.4728782130374 -34.5688824180408,-58.4720938674061 -34.5697935063465,-58.471397782499 -34.5706019731589,-58.4713263602643 -34.5706871227467,-58.4721354841215 -34.5711635623017,-58.4722522173757 -34.5712323590029,-58.4729229307867 -34.570445791884,-58.473014440827 -34.5703368358177,-58.4737769868681 -34.569429124087,-58.4745983354612 -34.5684513986965,-58.4751911177445 -34.5677456749301,-58.4762904922297 -34.5683998113474,-58.4768872677871 -34.5677328129801)))";;"734";12_11_8;COMUNA 12;"11";"8";"922";"442";"480";"92,08%";"412";"411";"99,76%";"1";"0,24%";"344";"26";"7.56";"318";"92,44%";"7.56";7.560
"MULTIPOLYGON (((-58.4730021207034 -34.5664475273469,-58.473195906452 -34.5665619377729,-58.4733684861433 -34.5666615046409,-58.472783101195 -34.5673531339498,-58.4719614008617 -34.5683241568984,-58.471176371054 -34.5692517894585,-58.4704160110981 -34.5701502590833,-58.4706080077007 -34.5702641953842,-58.4713263602643 -34.5706871227467,-58.471397782499 -34.5706019731589,-58.4720938674061 -34.5697935063465,-58.4728782130374 -34.5688824180408,-58.4730272657181 -34.5687092994075,-58.4736901163623 -34.5679018824359,-58.4742687701486 -34.5671969390373,-58.4745238763979 -34.5668944365744,-58.4745962726232 -34.5668128520933,-58.4739916321887 -34.5666618076653,-58.4736315384319 -34.5665709241487,-58.4735404305326 -34.5665482031996,-58.4732627709235 -34.5664967880578,-58.4730021207034 -34.5664475273469)))";;"735";12_11_9;COMUNA 12;"11";"9";"869";"398";"471";"84,50%";"469";"468";"99,79%";"1";"0,21%";"373";"1";"0.27";"372";"99,73%";"0.27";0.270
"MULTIPOLYGON (((-58.484292157272 -34.5755802340758,-58.4840268122599 -34.5754303448001,-58.4830313494626 -34.5748609834788,-58.482891270117 -34.5747794539727,-58.48175756227 -34.575746367358,-58.4827374334635 -34.5766201205824,-58.484292157272 -34.5755802340758)))";;"736";12_12_1;COMUNA 12;"12";"1";"661";"285";"376";"75,80%";"352";"351";"99,72%";"1";"0,28%";"272";"4";"1.47";"268";"98,53%";"1.47";1.470
"MULTIPOLYGON (((-58.4817611943026 -34.5741265797403,-58.4807877303469 -34.5735636757067,-58.4806687731336 -34.5734948875231,-58.480471449189 -34.5736521062161,-58.4797369581321 -34.5741862477805,-58.4801689984107 -34.5743298547995,-58.48175756227 -34.575746367358,-58.482891270117 -34.5747794539727,-58.4817611943026 -34.5741265797403)))";;"737";12_12_2;COMUNA 12;"12";"2";"1098";"493";"605";"81,49%";"619";"619";"100,00%";"0";"0,00%";"501";"7";"1.4";"494";"98,60%";"1.4";1.400
"MULTIPOLYGON (((-58.4794415754661 -34.5727860880447,-58.4785072265311 -34.5722471050134,-58.4777323548163 -34.5731218178087,-58.4769508271011 -34.5740040618713,-58.4778499351696 -34.5745343986983,-58.4788531075367 -34.5737871960094,-58.4795189749965 -34.5740881752427,-58.4797369581321 -34.5741862477805,-58.480471449189 -34.5736521062161,-58.4806687731336 -34.5734948875231,-58.4800499773933 -34.5731370744367,-58.4798674137007 -34.573031743633,-58.4794415754661 -34.5727860880447)))";;"738";12_12_3;COMUNA 12;"12";"3";"1209";"571";"638";"89,50%";"628";"627";"99,84%";"1";"0,16%";"509";"1";"0.2";"508";"99,80%";"0.2";0.200
"MULTIPOLYGON (((-58.4778499351696 -34.5745343986983,-58.4769508271011 -34.5740040618713,-58.4761644306179 -34.5748917241072,-58.4753789538374 -34.5757783246712,-58.4746189996106 -34.5766361135325,-58.4748508671467 -34.5767681384914,-58.4750068651033 -34.5768569294217,-58.4755943296574 -34.5771902630956,-58.4765838519153 -34.5764793499527,-58.4774282910832 -34.5758726760607,-58.4780266862056 -34.575438358657,-58.4785526301357 -34.5750648249472,-58.4787110572663 -34.574941207475,-58.4788792738383 -34.5748099121153,-58.4797369581321 -34.5741862477805,-58.4795189749965 -34.5740881752427,-58.4788531075367 -34.5737871960094,-58.4778499351696 -34.5745343986983)))";;"739";12_12_4;COMUNA 12;"12";"4";"911";"417";"494";"84,41%";"437";"437";"100,00%";"0";"0,00%";"356";"0";"0";"356";"100,00%";"0";0.000
"MULTIPOLYGON (((-58.4801689984107 -34.5743298547995,-58.4797369581321 -34.5741862477805,-58.4788792738383 -34.5748099121153,-58.4787110572663 -34.574941207475,-58.4785526301357 -34.5750648249472,-58.4780266862056 -34.575438358657,-58.4787782115024 -34.5761465313769,-58.4783154828324 -34.5767552086827,-58.4786002576284 -34.5770249720157,-58.4790195884709 -34.5774222573296,-58.4791228035378 -34.577519008116,-58.4805787495054 -34.5765394665344,-58.48175756227 -34.575746367358,-58.4801689984107 -34.5743298547995)))";;"740";12_12_5;COMUNA 12;"12";"5";"803";"360";"443";"81,26%";"397";"396";"99,75%";"1";"0,25%";"328";"3";"0.91";"325";"99,09%";"0.91";0.910
"MULTIPOLYGON (((-58.48175756227 -34.575746367358,-58.4805787495054 -34.5765394665344,-58.4814016326277 -34.5775148772525,-58.4815538492124 -34.5774117509107,-58.4827374334635 -34.5766201205824,-58.48175756227 -34.575746367358)))";;"741";12_12_6;COMUNA 12;"12";"6";"553";"234";"319";"73,35%";"358";"358";"100,00%";"0";"0,00%";"260";"1";"0.38";"259";"99,62%";"0.38";0.380
"MULTIPOLYGON (((-58.4814016326277 -34.5775148772525,-58.4805787495054 -34.5765394665344,-58.4791228035378 -34.577519008116,-58.477773158275 -34.5784269668058,-58.4781986790841 -34.5786688250483,-58.478655284304 -34.578928354533,-58.478988076277 -34.5791249385084,-58.4801064142394 -34.5783919365999,-58.4814016326277 -34.5775148772525)))";;"742";12_12_7;COMUNA 12;"12";"7";"858";"400";"458";"87,34%";"521";"521";"100,00%";"0";"0,00%";"386";"7";"1.81";"379";"98,19%";"1.81";1.810
"MULTIPOLYGON (((-58.4786002576284 -34.5770249720157,-58.4783154828324 -34.5767552086827,-58.4787782115024 -34.5761465313769,-58.4780266862056 -34.575438358657,-58.4774282910832 -34.5758726760607,-58.4765838519153 -34.5764793499527,-58.4755943296574 -34.5771902630956,-58.4771503372173 -34.5780731540623,-58.4773332488211 -34.5781769394392,-58.477773158275 -34.5784269668058,-58.4791228035378 -34.577519008116,-58.4790195884709 -34.5774222573296,-58.4786002576284 -34.5770249720157)))";;"743";12_12_8;COMUNA 12;"12";"8";"716";"331";"385";"85,97%";"326";"325";"99,69%";"1";"0,31%";"267";"3";"1.12";"264";"98,88%";"1.12";1.120
"MULTIPOLYGON (((-58.4857788576857 -34.5734672666144,-58.4858894976891 -34.5733103375398,-58.4858207727587 -34.5732521790786,-58.4854561164526 -34.5729491360609,-58.4851852232173 -34.5727236132326,-58.4849959129604 -34.572562443874,-58.4848628177054 -34.5724833802178,-58.4847822546439 -34.5724061379877,-58.4848326409709 -34.5723433796945,-58.4843941679289 -34.5720090778721,-58.4843704048224 -34.5720302792522,-58.4842823457767 -34.5719388020821,-58.4838036858928 -34.5715075626901,-58.4836524128054 -34.5713731503791,-58.4836727238194 -34.571354474895,-58.4835784588744 -34.5712622520681,-58.4834211185198 -34.571382716129,-58.4834192442269 -34.5713847014579,-58.4834053524093 -34.571372126969,-58.4834190717743 -34.5713845832552,-58.4832330840812 -34.5715269340392,-58.4825075740144 -34.5720820073343,-58.484232256112 -34.5730926740696,-58.4843929413106 -34.5731868045717,-58.4854761079738 -34.5738250852143,-58.4857788576857 -34.5734672666144)))";;"744";12_13_1;COMUNA 12;"13";"1";"898";"403";"495";"81,41%";"536";"536";"100,00%";"0";"0,00%";"407";"3";"0.74";"404";"99,26%";"0.74";0.740
"MULTIPOLYGON (((-58.4818664292362 -34.5700435711774,-58.481795412479 -34.5699915378029,-58.4814606827631 -34.569753199109,-58.4813479447123 -34.569681100585,-58.4810620989123 -34.5695005022895,-58.4809822295516 -34.56945163892,-58.480820934987 -34.5696373048156,-58.4807109648748 -34.5697638758662,-58.4799746969863 -34.5705904968756,-58.4801486561319 -34.5706940681528,-58.4809031643422 -34.571138977151,-58.4818215104161 -34.5716792121082,-58.4825075740144 -34.5720820073343,-58.4832330840812 -34.5715269340392,-58.4834190717743 -34.5713845832552,-58.4834053524093 -34.571372126969,-58.4833235303252 -34.5712970497495,-58.4828623167849 -34.5708798553089,-58.4826793994414 -34.5707139627379,-58.4825868336739 -34.5706286220587,-58.4824426640576 -34.5704998370854,-58.4823473749796 -34.5704171728339,-58.4822218585059 -34.5703191605688,-58.4821022175127 -34.5702240346881,-58.4819371905874 -34.5700952524223,-58.4818664292362 -34.5700435711774)))";;"745";12_13_2;COMUNA 12;"13";"2";"872";"390";"482";"80,91%";"483";"483";"100,00%";"0";"0,00%";"389";"16";"4.11";"373";"95,89%";"4.11";4.110
"MULTIPOLYGON (((-58.4809031643422 -34.571138977151,-58.4801486561319 -34.5706940681528,-58.4799746969863 -34.5705904968756,-58.4793203008859 -34.5713292815345,-58.4785072265311 -34.5722471050134,-58.4794415754661 -34.5727860880447,-58.4798674137007 -34.573031743633,-58.4800499773933 -34.5731370744367,-58.4806687731336 -34.5734948875231,-58.4808597969827 -34.5733426696582,-58.4816380217987 -34.5727473146866,-58.4802372807566 -34.5718893885885,-58.4809031643422 -34.571138977151)))";;"746";12_13_3;COMUNA 12;"13";"3";"1564";"706";"858";"82,28%";"962";"962";"100,00%";"0";"0,00%";"721";"8";"1.11";"713";"98,89%";"1.11";1.110
"MULTIPOLYGON (((-58.4818215104161 -34.5716792121082,-58.4809031643422 -34.571138977151,-58.4802372807566 -34.5718893885885,-58.4816380217987 -34.5727473146866,-58.4824977191303 -34.5732495237018,-58.4835889624368 -34.5738952144575,-58.484111990942 -34.5732441101446,-58.484232256112 -34.5730926740696,-58.4825075740144 -34.5720820073343,-58.4818215104161 -34.5716792121082)))";;"747";12_13_4;COMUNA 12;"13";"4";"1257";"582";"675";"86,22%";"625";"623";"99,68%";"2";"0,32%";"526";"1";"0.19";"525";"99,81%";"0.19";0.190
"MULTIPOLYGON (((-58.4824977191303 -34.5732495237018,-58.4816380217987 -34.5727473146866,-58.4808597969827 -34.5733426696582,-58.4806687731336 -34.5734948875231,-58.4807877303469 -34.5735636757067,-58.4817611943026 -34.5741265797403,-58.482891270117 -34.5747794539727,-58.4835889624368 -34.5738952144575,-58.4824977191303 -34.5732495237018)))";;"748";12_13_5;COMUNA 12;"13";"5";"1077";"467";"610";"76,56%";"577";"576";"99,83%";"1";"0,17%";"475";"6";"1.26";"469";"98,74%";"1.26";1.260
"MULTIPOLYGON (((-58.4848324797866 -34.5746266461631,-58.4835889624368 -34.5738952144575,-58.482891270117 -34.5747794539727,-58.4830313494626 -34.5748609834788,-58.4840268122599 -34.5754303448001,-58.484292157272 -34.5755802340758,-58.4851745372473 -34.5750933640367,-58.4853969801097 -34.5749628948098,-58.4848324797866 -34.5746266461631)))";;"749";12_13_6;COMUNA 12;"13";"6";"911";"428";"483";"88,61%";"497";"497";"100,00%";"0";"0,00%";"395";"0";"0";"395";"100,00%";"0";0.000
"MULTIPOLYGON (((-58.4866187030798 -34.5741053715717,-58.4867986517764 -34.5739625836212,-58.4866797722071 -34.5738868995833,-58.4865351757208 -34.5737958676862,-58.4864368195639 -34.5737337011034,-58.4863379503529 -34.5736632243266,-58.4862610504159 -34.573602109827,-58.4861538326999 -34.5735139577002,-58.4858894976891 -34.5733103375398,-58.4857788576857 -34.5734672666144,-58.4854761079738 -34.5738250852143,-58.4843929413106 -34.5731868045717,-58.484232256112 -34.5730926740696,-58.484111990942 -34.5732441101446,-58.4835889624368 -34.5738952144575,-58.4848324797866 -34.5746266461631,-58.4853969801097 -34.5749628948098,-58.4864441463069 -34.5743487258626,-58.4863610367362 -34.574310360087,-58.4866187030798 -34.5741053715717)))";;"750";12_13_7;COMUNA 12;"13";"7";"493";"198";"295";"67,12%";"299";"299";"100,00%";"0";"0,00%";"249";"2";"0.8";"247";"99,20%";"0.8";0.800
"MULTIPOLYGON (((-58.4866220511161 -34.5756875507287,-58.4859199314923 -34.5765108196726,-58.4869271007211 -34.5770878313303,-58.4876192568936 -34.5762762493407,-58.4883359120267 -34.5754358541419,-58.487801970063 -34.5751232053853,-58.4875472632819 -34.5749740962449,-58.4873359024685 -34.574850331017,-58.4866220511161 -34.5756875507287)))";;"751";12_14_1;COMUNA 12;"14";"1";"1000";"393";"607";"64,74%";"490";"483";"98,57%";"7";"1,45%";"373";"30";"8.04";"343";"91,96%";"8.04";8.040
"MULTIPOLYGON (((-58.4819324444307 -34.5794316355659,-58.4812833695909 -34.5790624953546,-58.4801064142394 -34.5783919365999,-58.478988076277 -34.5791249385084,-58.4792326470187 -34.5792694187008,-58.4801834299697 -34.5798198021185,-58.4804836125763 -34.5799934983768,-58.4809937130046 -34.5802887873837,-58.4811292011629 -34.5803677139438,-58.4821455833616 -34.5809595526435,-58.4830135434292 -34.581464925162,-58.4831341320974 -34.5815350487786,-58.4839497906382 -34.5805787431199,-58.4829471143603 -34.5800086081795,-58.4819324444307 -34.5794316355659)))";;"752";12_14_10;COMUNA 12;"14";"10";"1023";"474";"549";"86,34%";"534";"534";"100,00%";"0";"0,00%";"441";"2";"0.45";"439";"99,55%";"0.45";0.450
"MULTIPOLYGON (((-58.4853969801097 -34.5749628948098,-58.4851745372473 -34.5750933640367,-58.484292157272 -34.5755802340758,-58.484538513433 -34.5757194214914,-58.484911413674 -34.5759330252115,-58.4859199314923 -34.5765108196726,-58.4866220511161 -34.5756875507287,-58.4873359024685 -34.574850331017,-58.4866104508596 -34.5744255980774,-58.4864441463069 -34.5743487258626,-58.4853969801097 -34.5749628948098)))";;"753";12_14_2;COMUNA 12;"14";"2";"914";"402";"512";"78,52%";"510";"510";"100,00%";"0";"0,00%";"400";"5";"1.25";"395";"98,75%";"1.25";1.250
"MULTIPOLYGON (((-58.4859199314923 -34.5765108196726,-58.484911413674 -34.5759330252115,-58.483811768625 -34.5772255283709,-58.484820974631 -34.5777995991181,-58.4859199314923 -34.5765108196726)))";;"754";12_14_3;COMUNA 12;"14";"3";"778";"360";"418";"86,12%";"403";"403";"100,00%";"0";"0,00%";"308";"1";"0.32";"307";"99,68%";"0.32";0.320
"MULTIPOLYGON (((-58.4869271007211 -34.5770878313303,-58.4859199314923 -34.5765108196726,-58.484820974631 -34.5777995991181,-58.4858303648228 -34.5783737318545,-58.4869271007211 -34.5770878313303)))";;"755";12_14_4;COMUNA 12;"14";"4";"866";"375";"491";"76,37%";"602";"602";"100,00%";"0";"0,00%";"407";"2";"0.49";"405";"99,51%";"0.49";0.490
"MULTIPOLYGON (((-58.4879327521625 -34.5776678632296,-58.4870958010154 -34.5771844919372,-58.4869271007211 -34.5770878313303,-58.4858303648228 -34.5783737318545,-58.4868359366761 -34.5789457441774,-58.4879327521625 -34.5776678632296)))";;"756";12_14_5;COMUNA 12;"14";"5";"986";"468";"518";"90,35%";"513";"513";"100,00%";"0";"0,00%";"421";"0";"0";"421";"100,00%";"0";0.000
"MULTIPOLYGON (((-58.4858303648228 -34.5783737318545,-58.484820974631 -34.5777995991181,-58.4846927849005 -34.5779499102777,-58.4838683943659 -34.5789217868526,-58.4848726829466 -34.5794967029668,-58.4858997100714 -34.5800363937084,-58.4868359366761 -34.5789457441774,-58.4858303648228 -34.5783737318545)))";;"757";12_14_6;COMUNA 12;"14";"6";"778";"371";"407";"91,15%";"393";"393";"100,00%";"0";"0,00%";"318";"0";"0";"318";"100,00%";"0";0.000
"MULTIPOLYGON (((-58.482859776545 -34.5783443278159,-58.4838683943659 -34.5789217868526,-58.4846927849005 -34.5779499102777,-58.484820974631 -34.5777995991181,-58.483811768625 -34.5772255283709,-58.484911413674 -34.5759330252115,-58.484538513433 -34.5757194214914,-58.484292157272 -34.5755802340758,-58.4827374334635 -34.5766201205824,-58.4815538492124 -34.5774117509107,-58.4814016326277 -34.5775148772525,-58.482859776545 -34.5783443278159)))";;"758";12_14_7;COMUNA 12;"14";"7";"1057";"480";"577";"83,19%";"569";"569";"100,00%";"0";"0,00%";"432";"9";"2.08";"423";"97,92%";"2.08";2.080
"MULTIPOLYGON (((-58.482859776545 -34.5783443278159,-58.4814016326277 -34.5775148772525,-58.4801064142394 -34.5783919365999,-58.4812833695909 -34.5790624953546,-58.4819324444307 -34.5794316355659,-58.4829471143603 -34.5800086081795,-58.4830324079091 -34.5799074630319,-58.4838683943659 -34.5789217868526,-58.482859776545 -34.5783443278159)))";;"759";12_14_8;COMUNA 12;"14";"8";"971";"448";"523";"85,66%";"633";"633";"100,00%";"0";"0,00%";"469";"4";"0.85";"465";"99,15%";"0.85";0.850
"MULTIPOLYGON (((-58.4839497906382 -34.5805787431199,-58.4831341320974 -34.5815350487786,-58.4841209058026 -34.5821085652494,-58.4849472857275 -34.5811459128428,-58.4858997100714 -34.5800363937084,-58.4848726829466 -34.5794967029668,-58.4838683943659 -34.5789217868526,-58.4830324079091 -34.5799074630319,-58.4829471143603 -34.5800086081795,-58.4839497906382 -34.5805787431199)))";;"760";12_14_9;COMUNA 12;"14";"9";"800";"375";"425";"88,24%";"420";"420";"100,00%";"0";"0,00%";"324";"2";"0.62";"322";"99,38%";"0.62";0.620
"MULTIPOLYGON (((-58.4933816859699 -34.5777981699728,-58.4933033134172 -34.5779252372284,-58.4930650919843 -34.57820446335,-58.4923355234719 -34.5790591854355,-58.4916636468161 -34.5798464217722,-58.4931388875372 -34.5807022250994,-58.4934534936557 -34.5808847594365,-58.4936189820164 -34.5807744313661,-58.4943290872187 -34.5802334523278,-58.4944605177934 -34.5801332731927,-58.4952858674597 -34.5795044379329,-58.4954165296894 -34.5794049622169,-58.4955459139018 -34.5793042190449,-58.4957285844779 -34.5791645864658,-58.4957742094948 -34.5791297839276,-58.4959081901081 -34.5790273489104,-58.4958041258065 -34.5789899812525,-58.4953907566052 -34.5788202968458,-58.4949895689523 -34.5786607490808,-58.4949351495743 -34.5786328749756,-58.4948967406961 -34.5786126025755,-58.4948527110605 -34.5785894441994,-58.494798294157 -34.5785677674744,-58.4946698663641 -34.5784972348498,-58.494368048393 -34.5783407576859,-58.494138446746 -34.5782144737244,-58.4934822604698 -34.5778456818546,-58.4933816859699 -34.5777981699728)))";;"761";12_15_1;COMUNA 12;"15";"1";"884";"394";"490";"80,41%";"508";"508";"100,00%";"0";"0,00%";"378";"24";"6.35";"354";"93,65%";"6.35";6.350
"MULTIPOLYGON (((-58.4898252223861 -34.5822049700272,-58.4893621102683 -34.5827989697684,-58.4889930458295 -34.5832724495682,-58.4888983108598 -34.5833945876284,-58.4882117508616 -34.5842803327273,-58.4881036496145 -34.5844186707893,-58.4887935939207 -34.5848181894367,-58.4895057000866 -34.5842049818993,-58.4898324226652 -34.5839237010124,-58.4902643604939 -34.583551828428,-58.4904375942155 -34.5834026281332,-58.4905196565423 -34.5833319023289,-58.4910425025679 -34.5828809888683,-58.4917515959997 -34.5822693885251,-58.4919396359691 -34.5821072242623,-58.492405518894 -34.5817049120658,-58.4925435063757 -34.5815929019471,-58.4910678724869 -34.5806107483746,-58.490665378209 -34.5811271302613,-58.4895933250399 -34.5805146697334,-58.4887437987984 -34.58160440613,-58.4893915609725 -34.5819641402057,-58.4898252223861 -34.5822049700272)))";;"762";12_15_10;COMUNA 12;"15";"10";"848";"426";"422";"100,95%";"368";"368";"100,00%";"0";"0,00%";"297";"1";"0.34";"296";"99,66%";"0.34";0.340
"MULTIPOLYGON (((-58.4867480571549 -34.5821698389992,-58.485959677628 -34.5831769346438,-58.4870331034763 -34.5837986522757,-58.4881036496145 -34.5844186707893,-58.4882117508616 -34.5842803327273,-58.4888983108598 -34.5833945876284,-58.4889930458295 -34.5832724495682,-58.4893621102683 -34.5827989697684,-58.4898252223861 -34.5822049700272,-58.4893915609725 -34.5819641402057,-58.4887437987984 -34.58160440613,-58.4876631572103 -34.5810041845555,-58.4868278984611 -34.5820678472044,-58.4867480571549 -34.5821698389992)))";;"763";12_15_11;COMUNA 12;"15";"11";"844";"377";"467";"80,73%";"323";"322";"99,69%";"1";"0,31%";"272";"2";"0.74";"270";"99,26%";"0.74";0.740
"MULTIPOLYGON (((-58.4867793415735 -34.5805174405188,-58.4860156133831 -34.5800972896492,-58.4858997100714 -34.5800363937084,-58.4849472857275 -34.5811459128428,-58.4841209058026 -34.5821085652494,-58.484746854546 -34.5824723420261,-58.4850954294486 -34.5826748925397,-58.4858243507844 -34.5830985064314,-58.485959677628 -34.5831769346438,-58.4867480571549 -34.5821698389992,-58.4868278984611 -34.5820678472044,-58.4876631572103 -34.5810041845555,-58.4875423109625 -34.5809370937552,-58.4867793415735 -34.5805174405188)))";;"764";12_15_12;COMUNA 12;"15";"12";"798";"377";"421";"89,55%";"312";"311";"99,68%";"1";"0,32%";"284";"5";"1.76";"279";"98,24%";"1.76";1.760
"MULTIPOLYGON (((-58.4885193295232 -34.5799032565166,-58.4876497377945 -34.5794086280307,-58.4868359366761 -34.5789457441774,-58.4858997100714 -34.5800363937084,-58.4860156133831 -34.5800972896492,-58.4867793415735 -34.5805174405188,-58.4875423109625 -34.5809370937552,-58.4876631572103 -34.5810041845555,-58.487761807085 -34.5808785957553,-58.4885193295232 -34.5799032565166)))";;"765";12_15_13;COMUNA 12;"15";"13";"690";"301";"389";"77,38%";"282";"281";"99,65%";"1";"0,36%";"262";"1";"0.38";"261";"99,62%";"0.38";0.380
"MULTIPOLYGON (((-58.4921111038331 -34.5774454397598,-58.4919973115916 -34.5775793459869,-58.4912722498719 -34.5784326522145,-58.4905967945885 -34.5792274895494,-58.4916636468161 -34.5798464217722,-58.4923355234719 -34.5790591854355,-58.4930650919843 -34.57820446335,-58.4933033134172 -34.5779252372284,-58.4931944929477 -34.5778769444189,-58.4930870528467 -34.5779932258003,-58.4921773991722 -34.5774668839658,-58.4921111038331 -34.5774454397598)))";;"766";12_15_2;COMUNA 12;"15";"2";"844";"366";"478";"76,57%";"547";"547";"100,00%";"0";"0,00%";"422";"5";"1.18";"417";"98,82%";"1.18";1.180
"MULTIPOLYGON (((-58.4902085660558 -34.5778047716706,-58.4895313178465 -34.5786002374257,-58.490408327833 -34.5791182321448,-58.4905967945885 -34.5792274895494,-58.4912722498719 -34.5784326522145,-58.4919973115916 -34.5775793459869,-58.4921112468423 -34.5774395459013,-58.489986004502 -34.5761885928294,-58.4898554117566 -34.5763254223166,-58.4894976007513 -34.5767458008049,-58.4891355305451 -34.5771713906254,-58.4902085660558 -34.5778047716706)))";;"767";12_15_3;COMUNA 12;"15";"3";"997";"438";"559";"78,35%";"569";"568";"99,82%";"1";"0,18%";"420";"1";"0.24";"419";"99,76%";"0.24";0.240
"MULTIPOLYGON (((-58.4867986517764 -34.5739625836212,-58.4866187030798 -34.5741053715717,-58.4863610367362 -34.574310360087,-58.4864441463069 -34.5743487258626,-58.4866104508596 -34.5744255980774,-58.4873359024685 -34.574850331017,-58.4875472632819 -34.5749740962449,-58.487801970063 -34.5751232053853,-58.4883359120267 -34.5754358541419,-58.4876192568936 -34.5762762493407,-58.4891355305451 -34.5771713906254,-58.4894976007513 -34.5767458008049,-58.4898554117566 -34.5763254223166,-58.4899777323239 -34.5761749176642,-58.4909535163516 -34.5767491302665,-58.4921195122673 -34.5774327054038,-58.4930870478696 -34.5779795487915,-58.4931964335374 -34.5778651206131,-58.4933033134172 -34.5779252372284,-58.4933816859699 -34.5777981699728,-58.4933984789324 -34.5777818644469,-58.4923256854001 -34.5771656945192,-58.491248799604 -34.5765470276276,-58.4901732250962 -34.5759288966216,-58.4890811246347 -34.5753015370121,-58.4894297351313 -34.574866863011,-58.4883220131782 -34.5742589761313,-58.4872055363787 -34.5736462919561,-58.4867986517764 -34.5739625836212)))";;"768";12_15_4;COMUNA 12;"15";"4";"974";"454";"520";"87,31%";"537";"536";"99,81%";"1";"0,19%";"418";"2";"0.48";"416";"99,52%";"0.48";0.480
"MULTIPOLYGON (((-58.4876192568936 -34.5762762493407,-58.4869271007211 -34.5770878313303,-58.4870958010154 -34.5771844919372,-58.4879327521625 -34.5776678632296,-58.4884559792839 -34.5779700201435,-58.4886785052832 -34.578098640349,-58.4888314550084 -34.5781869212586,-58.4895313178466 -34.5786002374258,-58.4902085660558 -34.5778047716706,-58.4891355305451 -34.5771713906254,-58.4876192568936 -34.5762762493407)))";;"769";12_15_5;COMUNA 12;"15";"5";"913";"397";"516";"76,94%";"497";"496";"99,80%";"1";"0,20%";"393";"3";"0.76";"390";"99,24%";"0.76";0.760
"MULTIPOLYGON (((-58.4884559792839 -34.5779700201435,-58.4879327521625 -34.5776678632296,-58.4868359366761 -34.5789457441774,-58.4876497377945 -34.5794086280307,-58.4886785052832 -34.578098640349,-58.4884559792839 -34.5779700201435)))";;"770";12_15_6;COMUNA 12;"15";"6";"829";"377";"452";"83,41%";"423";"423";"100,00%";"0";"0,00%";"343";"3";"0.87";"340";"99,13%";"0.87";0.870
"MULTIPOLYGON (((-58.4895313178466 -34.5786002374258,-58.4888314550084 -34.5781869212586,-58.4886785052832 -34.578098640349,-58.4876497377945 -34.5794086280307,-58.4885193295232 -34.5799032565166,-58.4895313178466 -34.5786002374258)))";;"771";12_15_7;COMUNA 12;"15";"7";"921";"397";"524";"75,76%";"483";"482";"99,79%";"1";"0,21%";"383";"0";"0";"383";"100,00%";"0";0.000
"MULTIPOLYGON (((-58.4905967945885 -34.5792274895494,-58.490408327833 -34.5791182321448,-58.4895313178466 -34.5786002374258,-58.4885193295232 -34.5799032565166,-58.487761807085 -34.5808785957553,-58.4876631572103 -34.5810041845555,-58.4887437987984 -34.58160440613,-58.4895933250399 -34.5805146697334,-58.4905967945885 -34.5792274895494)))";;"772";12_15_8;COMUNA 12;"15";"8";"938";"409";"529";"77,32%";"456";"456";"100,00%";"0";"0,00%";"364";"6";"1.65";"358";"98,35%";"1.65";1.650
"MULTIPOLYGON (((-58.4910678724869 -34.5806107483746,-58.4925435063757 -34.5815929019471,-58.4932455258986 -34.5810233385253,-58.4934534936557 -34.5808847594365,-58.4931388875372 -34.5807022250994,-58.4916636468161 -34.5798464217722,-58.4905967945885 -34.5792274895494,-58.4895933250399 -34.5805146697334,-58.490665378209 -34.5811271302613,-58.4910678724869 -34.5806107483746)))";;"773";12_15_9;COMUNA 12;"15";"9";"995";"455";"540";"84,26%";"553";"552";"99,82%";"1";"0,18%";"426";"1";"0.23";"425";"99,77%";"0.23";0.230
"MULTIPOLYGON (((-58.4917740689516 -34.5739357241961,-58.4928642686918 -34.5745333019798,-58.4939549949926 -34.5751311515308,-58.4945562432521 -34.5743804008658,-58.4951571403583 -34.5736302106476,-58.4952564520164 -34.5735062352548,-58.4958570813772 -34.5727566753884,-58.4947535237028 -34.572177931291,-58.4940982430376 -34.5718343544665,-58.4936503219792 -34.5715994587694,-58.4929796418937 -34.57243466279,-58.491870393443 -34.5718255405859,-58.4912673517239 -34.5725770534383,-58.4906652353058 -34.5733273657755,-58.4916149089126 -34.5738484343399,-58.4917740689516 -34.5739357241961)))";;"774";12_16_1;COMUNA 12;"16";"1";"1110";"537";"573";"93,72%";"447";"447";"100,00%";"0";"0,00%";"395";"9";"2.28";"386";"97,72%";"2.28";2.280
"MULTIPOLYGON (((-58.4906652353058 -34.5733273657755,-58.4895587170097 -34.5727202643679,-58.4888773910996 -34.5723464527087,-58.488062197114 -34.5729802434718,-58.4889552221218 -34.5734711319641,-58.4883220131783 -34.5742589761313,-58.4894297351313 -34.574866863011,-58.4900624272137 -34.5740785203145,-58.4906652353058 -34.5733273657755)))";;"775";12_16_10;COMUNA 12;"16";"10";"663";"306";"357";"85,71%";"459";"459";"100,00%";"0";"0,00%";"330";"1";"0.3";"329";"99,70%";"0.3";0.300
"MULTIPOLYGON (((-58.4900624272137 -34.5740785203145,-58.4911711811629 -34.5746864616001,-58.4922478488654 -34.5752768570779,-58.4922617271194 -34.5752844671627,-58.4933529699429 -34.5758827444461,-58.4939549949925 -34.5751311515308,-58.4928642686918 -34.5745333019798,-58.4917740689516 -34.5739357241961,-58.4916149089126 -34.5738484343399,-58.4906652353058 -34.5733273657755,-58.4900624272137 -34.5740785203145)))";;"776";12_16_11;COMUNA 12;"16";"11";"796";"374";"422";"88,63%";"384";"384";"100,00%";"0";"0,00%";"334";"2";"0.6";"332";"99,40%";"0.6";0.600
"MULTIPOLYGON (((-58.491633319726 -34.5760761271824,-58.4922478488654 -34.5752768570779,-58.4911711811629 -34.5746864616001,-58.4900624272137 -34.5740785203145,-58.4894297351313 -34.574866863011,-58.4905378989935 -34.5754749509492,-58.4916287063713 -34.5760735958586,-58.491633319726 -34.5760761271824)))";;"777";12_16_12;COMUNA 12;"16";"12";"714";"311";"403";"77,17%";"383";"383";"100,00%";"0";"0,00%";"316";"2";"0.63";"314";"99,37%";"0.63";0.630
"MULTIPOLYGON (((-58.4901732250962 -34.5759288966216,-58.491248799604 -34.5765470276276,-58.4923256854001 -34.5771656945192,-58.4927203809557 -34.5766725828711,-58.4933529699429 -34.5758827444461,-58.4922617271194 -34.5752844671627,-58.4922478488654 -34.5752768570779,-58.491633319726 -34.5760761271824,-58.4916287063713 -34.5760735958586,-58.4905378989935 -34.5754749509492,-58.4894297351313 -34.574866863011,-58.4890811246347 -34.5753015370121,-58.4901732250962 -34.5759288966216)))";;"778";12_16_13;COMUNA 12;"16";"13";"498";"230";"268";"85,82%";"252";"252";"100,00%";"0";"0,00%";"202";"1";"0.5";"201";"99,50%";"0.5";0.500
"MULTIPOLYGON (((-58.49119161091 -34.5706802290963,-58.4911136152805 -34.5706541193889,-58.4910288183803 -34.5706567448435,-58.4909437838965 -34.5707121190471,-58.4905814434479 -34.570992918666,-58.4904977783501 -34.571071743957,-58.4904117299077 -34.5711526824978,-58.4896949573448 -34.5717149095318,-58.4901612649293 -34.5719706615712,-58.4912673517239 -34.5725770534383,-58.491870393443 -34.5718255405859,-58.4929796418937 -34.57243466279,-58.4936503219792 -34.5715994587694,-58.4930937452406 -34.5713075438151,-58.4925252507596 -34.5710094317706,-58.4920950506175 -34.5707838221765,-58.491392190998 -34.5704151706844,-58.49119161091 -34.5706802290963)))";;"779";12_16_2;COMUNA 12;"16";"2";"873";"399";"474";"84,18%";"431";"431";"100,00%";"0";"0,00%";"363";"1";"0.28";"362";"99,72%";"0.28";0.280
"MULTIPOLYGON (((-58.4896351698493 -34.5705980436847,-58.4890316063421 -34.5713505317191,-58.4884298192471 -34.5721009035379,-58.4888773910996 -34.5723464527087,-58.4895587170097 -34.5727202643679,-58.4906652353058 -34.5733273657755,-58.4912673517239 -34.5725770534383,-58.4901612649293 -34.5719706615712,-58.4896949573448 -34.5717149095318,-58.4904117299077 -34.5711526824978,-58.4904977783501 -34.571071743957,-58.4905814434479 -34.570992918666,-58.4909437838965 -34.5707121190471,-58.4910288183803 -34.5706567448435,-58.4911136152805 -34.5706541193889,-58.49119161091 -34.5706802290963,-58.491392190998 -34.5704151706844,-58.4911707923696 -34.5702990907495,-58.4902662965097 -34.5698136435661,-58.4901635768333 -34.5699391651044,-58.4896351698493 -34.5705980436847)))";;"780";12_16_3;COMUNA 12;"16";"3";"908";"428";"480";"89,17%";"399";"399";"100,00%";"0";"0,00%";"359";"0";"0";"359";"100,00%";"0";0.000
"MULTIPOLYGON (((-58.4891669011331 -34.5692289319731,-58.4890145651083 -34.5691460035628,-58.4880668353274 -34.5686286465017,-58.4878889572552 -34.5685345243132,-58.4877840249511 -34.5686697630647,-58.4872758620681 -34.5693022882405,-58.4885472582019 -34.5700005770233,-58.4879434336395 -34.5707525668287,-58.4890316063421 -34.5713505317191,-58.4896351698493 -34.5705980436847,-58.4901635768333 -34.5699391651044,-58.4902662965097 -34.5698136435661,-58.4901190678429 -34.5697345887962,-58.489365389702 -34.5693369216284,-58.4891669011331 -34.5692289319731)))";;"781";12_16_4;COMUNA 12;"16";"4";"1143";"532";"611";"87,07%";"616";"616";"100,00%";"0";"0,00%";"521";"20";"3.84";"501";"96,16%";"3.84";3.840
"MULTIPOLYGON (((-58.4890316063421 -34.5713505317191,-58.4879434336395 -34.5707525668287,-58.4885472582019 -34.5700005770233,-58.4872758620681 -34.5693022882405,-58.4866720309378 -34.5700537084411,-58.4865728807492 -34.5701771134859,-58.4860692953912 -34.5708038576945,-58.4861971932402 -34.5708743291384,-58.4873410450539 -34.571502792628,-58.4882816510564 -34.5720195931623,-58.4884298192471 -34.5721009035379,-58.4890316063421 -34.5713505317191)))";;"782";12_16_5;COMUNA 12;"16";"5";"1339";"651";"688";"94,62%";"687";"687";"100,00%";"0";"0,00%";"618";"31";"5.02";"587";"94,98%";"5.02";5.020
"MULTIPOLYGON (((-58.4849657385699 -34.5701965729676,-58.4841438093562 -34.570828155824,-58.4854664639577 -34.571554285602,-58.4859607814297 -34.5709389546642,-58.4860692953912 -34.5708038576945,-58.4865728807492 -34.5701771134859,-58.4866720309378 -34.5700537084411,-58.4872758620681 -34.5693022882405,-58.4877840249511 -34.5686697630647,-58.4878889572552 -34.5685345243132,-58.4874483935782 -34.56830143527,-58.4867275348273 -34.5688492791489,-58.486611518997 -34.568937404346,-58.4859581487522 -34.5694339605615,-58.4857856125073 -34.5695666046914,-58.4856638068592 -34.5696602232682,-58.4849657385699 -34.5701965729676)))";;"783";12_16_6;COMUNA 12;"16";"6";"1406";"648";"758";"85,49%";"863";"863";"100,00%";"0";"0,00%";"647";"1";"0.15";"646";"99,85%";"0.15";0.150
"MULTIPOLYGON (((-58.4848326409709 -34.5723433796945,-58.4854664639577 -34.571554285602,-58.4841438093562 -34.570828155824,-58.4839195982597 -34.5710004559495,-58.4835786988792 -34.57126202307,-58.4835784588744 -34.5712622520681,-58.4836727238194 -34.571354474895,-58.4836524128054 -34.5713731503791,-58.4838036858928 -34.5715075626901,-58.4842823457767 -34.5719388020821,-58.4843704048224 -34.5720302792522,-58.4843941679289 -34.5720090778721,-58.4848326409709 -34.5723433796945)),((-58.4848326409709 -34.5723433796945,-58.4847822546439 -34.5724061379877,-58.4848628177054 -34.5724833802178,-58.4849959129604 -34.572562443874,-58.4851852232173 -34.5727236132326,-58.4854561164526 -34.5729491360609,-58.4858207727587 -34.5732521790786,-58.4858894976891 -34.5733103375398,-58.4861538326999 -34.5735139577002,-58.4862610504159 -34.573602109827,-58.4863379503529 -34.5736632243266,-58.4864368195639 -34.5737337011034,-58.4865351757208 -34.5737958676862,-58.4866797722071 -34.5738868995833,-58.4867986517764 -34.5739625836212,-58.4872055363787 -34.5736462919561,-58.488062197114 -34.5729802434718,-58.4869037582356 -34.5723433387248,-58.486738730728 -34.5722528040735,-58.4861049145077 -34.5730420455301,-58.4848326409709 -34.5723433796945)))";;"784";12_16_7;COMUNA 12;"16";"7";"754";"335";"419";"79,95%";"386";"386";"100,00%";"0";"0,00%";"338";"6";"1.78";"332";"98,22%";"1.78";1.780
"MULTIPOLYGON (((-58.4873410450539 -34.571502792628,-58.4861971932402 -34.5708743291384,-58.4860692953912 -34.5708038576945,-58.4859607814297 -34.5709389546642,-58.4854664639577 -34.571554285602,-58.4848326409709 -34.5723433796945,-58.4861049145077 -34.5730420455301,-58.486738730728 -34.5722528040735,-58.4873410450539 -34.571502792628)))";;"785";12_16_8;COMUNA 12;"16";"8";"1063";"488";"575";"84,87%";"690";"690";"100,00%";"0";"0,00%";"528";"2";"0.38";"526";"99,62%";"0.38";0.380
"MULTIPOLYGON (((-58.4884298192471 -34.5721009035379,-58.4882816510564 -34.5720195931623,-58.4873410450539 -34.571502792628,-58.486738730728 -34.5722528040735,-58.4869037582356 -34.5723433387248,-58.488062197114 -34.5729802434718,-58.4888773910996 -34.5723464527087,-58.4884298192471 -34.5721009035379)))";;"786";12_16_9;COMUNA 12;"16";"9";"838";"382";"456";"83,77%";"427";"427";"100,00%";"0";"0,00%";"362";"23";"6.35";"339";"93,65%";"6.35";6.350
"MULTIPOLYGON (((-58.4986794387065 -34.5663163016823,-58.4980654349429 -34.5670783454134,-58.4974870733217 -34.5677961485344,-58.4980287463664 -34.56809544263,-58.4985865178432 -34.5684036736254,-58.4987245562829 -34.5684799743127,-58.4991404615311 -34.5687101425581,-58.4992323592299 -34.5685968003119,-58.4997154130482 -34.5679995865848,-58.5003083080733 -34.5672664156771,-58.50040854107 -34.5671425765357,-58.5013381923607 -34.5659942778594,-58.5014379971279 -34.5658714943678,-58.500862538263 -34.5655937056727,-58.5002353111622 -34.5652908586545,-58.4997128251447 -34.5650410071884,-58.4986794387065 -34.5663163016823)))";;"787";12_17_1;COMUNA 12;"17";"1";"1010";"470";"540";"87,04%";"421";"421";"100,00%";"0";"0,00%";"355";"1";"0.28";"354";"99,72%";"0.28";0.280
"MULTIPOLYGON (((-58.4958372978254 -34.5668843846074,-58.4946449925405 -34.5662253777979,-58.4938208642367 -34.5672798621476,-58.4950118061626 -34.5679136648851,-58.4961291076557 -34.5685082490646,-58.4966779289997 -34.5688003637512,-58.4972219854467 -34.5690898715561,-58.4983473231384 -34.5696887289958,-58.4991404615311 -34.5687101425581,-58.4987245562829 -34.5684799743127,-58.4985865178432 -34.5684036736254,-58.4980287463664 -34.56809544263,-58.4974870733217 -34.5677961485344,-58.496943190096 -34.5674955145527,-58.4958372978254 -34.5668843846074)))";;"788";12_17_2;COMUNA 12;"17";"2";"1052";"491";"561";"87,52%";"426";"425";"99,77%";"1";"0,24%";"380";"10";"2.63";"370";"97,37%";"2.63";2.630
"MULTIPOLYGON (((-58.4938208642367 -34.5672798621476,-58.4936846279199 -34.5674542001851,-58.4934208333542 -34.5677918872117,-58.4930200317547 -34.5683050379244,-58.4937677591525 -34.5687046560247,-58.4941963358986 -34.5689313166052,-58.4943468025973 -34.5690114220118,-58.4947526473434 -34.5692287199149,-58.4948962177684 -34.5693055868736,-58.4953089624737 -34.5695254164168,-58.4957577300831 -34.5697644609895,-58.4958692837157 -34.5698238699188,-58.4964064461955 -34.5701092280727,-58.4975251490839 -34.5707035171591,-58.4982352560057 -34.5698268662333,-58.4983473231384 -34.5696887289958,-58.4972219854467 -34.5690898715561,-58.4966779289997 -34.5688003637512,-58.4961291076557 -34.5685082490646,-58.4950118061626 -34.5679136648851,-58.4938208642367 -34.5672798621476)))";;"789";12_17_3;COMUNA 12;"17";"3";"917";"444";"473";"93,87%";"389";"389";"100,00%";"0";"0,00%";"333";"2";"0.6";"331";"99,40%";"0.6";0.600
"MULTIPOLYGON (((-58.4926857991139 -34.5666757536186,-58.4916170610459 -34.5660471106606,-58.4903563267674 -34.5653056096347,-58.4892900602173 -34.5648427275515,-58.4891641089264 -34.5649838174738,-58.4883682223864 -34.5658730405974,-58.4895760726644 -34.5663294908318,-58.4908275362987 -34.5670724808634,-58.4918934735407 -34.5677052864064,-58.4930200317547 -34.5683050379244,-58.4934208333542 -34.5677918872117,-58.4936846279199 -34.5674542001851,-58.4938208642367 -34.5672798621476,-58.4926857991139 -34.5666757536186)))";;"790";12_17_4;COMUNA 12;"17";"4";"796";"356";"440";"80,91%";"368";"368";"100,00%";"0";"0,00%";"306";"6";"1.96";"300";"98,04%";"1.96";1.960
"MULTIPOLYGON (((-58.4918934735407 -34.5677052864064,-58.4908275362987 -34.5670724808634,-58.4895760726644 -34.5663294908318,-58.4883682223864 -34.5658730405974,-58.4882569909942 -34.5659974355914,-58.4875120636622 -34.5668292454336,-58.4874055120195 -34.5669532865535,-58.4880856732683 -34.5673030214536,-58.4886266217767 -34.5675810889205,-58.4887730778527 -34.5676564131275,-58.4899209800217 -34.5682497095401,-58.4910355191107 -34.5688256781498,-58.4911620542034 -34.5688910740881,-58.4921516964835 -34.5694167072053,-58.4930200317547 -34.5683050379244,-58.4918934735407 -34.5677052864064)))";;"791";12_17_5;COMUNA 12;"17";"5";"1133";"537";"596";"90,10%";"514";"512";"99,61%";"2";"0,39%";"437";"8";"1.83";"429";"98,17%";"1.83";1.830
"MULTIPOLYGON (((-58.4964064461955 -34.5701092280727,-58.4958692837157 -34.5698238699188,-58.4957577300831 -34.5697644609895,-58.4953089624737 -34.5695254164168,-58.4948962177684 -34.5693055868736,-58.4947526473434 -34.5692287199149,-58.4943468025973 -34.5690114220118,-58.4941963358986 -34.5689313166052,-58.4937677591525 -34.5687046560247,-58.4930200317547 -34.5683050379244,-58.4921516964835 -34.5694167072053,-58.4928826534799 -34.5698049257536,-58.4929959081554 -34.5698651115697,-58.4933131922868 -34.5700333495473,-58.4938735093407 -34.5703305445271,-58.4944316163299 -34.5706265402592,-58.4948771509997 -34.5708627718427,-58.4950396287232 -34.5709489298008,-58.4955324286516 -34.5712099362465,-58.4956240791072 -34.571097934913,-58.4963234806625 -34.5702180584683,-58.4964064461955 -34.5701092280727)))";;"792";12_17_6;COMUNA 12;"17";"6";"1006";"479";"527";"90,89%";"477";"477";"100,00%";"0";"0,00%";"414";"1";"0.24";"413";"99,76%";"0.24";0.240
"MULTIPOLYGON (((-58.4933131922868 -34.5700333495473,-58.4929959081554 -34.5698651115697,-58.4928826534799 -34.5698049257536,-58.4920950506175 -34.5707838221765,-58.4925252507596 -34.5710094317706,-58.4930937452406 -34.5713075438151,-58.4936503219792 -34.5715994587694,-58.4940982430376 -34.5718343544665,-58.4947535237028 -34.572177931291,-58.4958570813772 -34.5727566753884,-58.4959792010234 -34.5726137487207,-58.4966404094377 -34.57179670068,-58.4974078034517 -34.5708484159752,-58.4975251490839 -34.5707035171591,-58.4964064461955 -34.5701092280727,-58.4963234806625 -34.5702180584683,-58.4956240791072 -34.571097934913,-58.4955324286516 -34.5712099362465,-58.4950396287232 -34.5709489298008,-58.4948771509997 -34.5708627718427,-58.4944316163299 -34.5706265402592,-58.4938735093407 -34.5703305445271,-58.4933131922868 -34.5700333495473)))";;"793";12_17_7;COMUNA 12;"17";"7";"992";"469";"523";"89,67%";"431";"431";"100,00%";"0";"0,00%";"373";"4";"1.07";"369";"98,93%";"1.07";1.070
"MULTIPOLYGON (((-58.4928826534799 -34.5698049257536,-58.4921516964835 -34.5694167072053,-58.4911620542034 -34.5688910740881,-58.4910355191107 -34.5688256781498,-58.4899209800217 -34.5682497095401,-58.4887730778527 -34.5676564131275,-58.4886266217767 -34.5675810889205,-58.4880856732683 -34.5673030214536,-58.4874055120195 -34.5669532865535,-58.4873110449958 -34.5670630991683,-58.4866132540693 -34.5678608078798,-58.4867803150405 -34.5679479619377,-58.4873531115773 -34.5682510298202,-58.4874483935782 -34.56830143527,-58.4878889572552 -34.5685345243132,-58.4880668353274 -34.5686286465017,-58.4890145651083 -34.5691460035628,-58.4891669011331 -34.5692289319731,-58.489365389702 -34.5693369216284,-58.4901190678429 -34.5697345887962,-58.4902662965097 -34.5698136435661,-58.4911707923696 -34.5702990907495,-58.491392190998 -34.5704151706844,-58.4920950506175 -34.5707838221765,-58.4928826534799 -34.5698049257536)))";;"794";12_17_8;COMUNA 12;"17";"8";"1252";"590";"662";"89,12%";"701";"701";"100,00%";"0";"0,00%";"557";"5";"0.9";"552";"99,10%";"0.9";0.900
"MULTIPOLYGON (((-58.5062630652493 -34.5682410981576,-58.5052086490258 -34.5677227853488,-58.504212243454 -34.5689593791434,-58.5052742401521 -34.5694655846064,-58.5063383786712 -34.5699727659756,-58.5078802783672 -34.5707076592642,-58.5079804555396 -34.5706509999899,-58.5090406309485 -34.5699973008757,-58.5088175185076 -34.5695091864123,-58.5086004983451 -34.5693894341977,-58.5073168984086 -34.5687590498947,-58.5062630652493 -34.5682410981576)))";;"795";12_18_1;COMUNA 12;"18";"1";"631";"289";"342";"84,50%";"294";"294";"100,00%";"0";"0,00%";"231";"2";"0.87";"229";"99,13%";"0.87";0.870
"MULTIPOLYGON (((-58.5001508496756 -34.5757127423161,-58.5006924263684 -34.5752920642083,-58.4995826700499 -34.5747101968129,-58.4984935381717 -34.5741391587527,-58.4977274332092 -34.5737374624867,-58.4969616762359 -34.573335902137,-58.4963452224652 -34.5741008949197,-58.4962444648699 -34.5742262800939,-58.4956424661732 -34.574975912483,-58.4970451686783 -34.5757449950454,-58.4971550276487 -34.5758027130032,-58.497281748857 -34.5758692292742,-58.4988458692636 -34.5767286010984,-58.4996569319121 -34.5760967823099,-58.4998267351801 -34.5759645421021,-58.5001508496756 -34.5757127423161)))";;"796";12_18_10;COMUNA 12;"18";"10";"747";"361";"386";"93,52%";"360";"360";"100,00%";"0";"0,00%";"284";"3";"1.06";"281";"98,94%";"1.06";1.060
"MULTIPOLYGON (((-58.4969616762359 -34.573335902137,-58.4958570813772 -34.5727566753884,-58.4952564520164 -34.5735062352548,-58.4951571403583 -34.5736302106476,-58.4945562432521 -34.5743804008658,-58.4939549949926 -34.5751311515308,-58.4933529699429 -34.5758827444461,-58.4935083034271 -34.575967920206,-58.4944373299452 -34.5764763656171,-58.4950402864395 -34.5757256827132,-58.4956424661732 -34.574975912483,-58.4962444648699 -34.5742262800939,-58.4963452224652 -34.5741008949197,-58.4969616762359 -34.573335902137)))";;"797";12_18_11;COMUNA 12;"18";"11";"708";"316";"392";"80,61%";"285";"284";"99,65%";"1";"0,35%";"238";"10";"4.2";"228";"95,80%";"4.2";4.200
"MULTIPOLYGON (((-58.4980349645423 -34.5773602031139,-58.4988458692636 -34.5767286010984,-58.497281748857 -34.5758692292742,-58.4971550276487 -34.5758027130032,-58.4970451686783 -34.5757449950454,-58.4956424661732 -34.574975912483,-58.4950402864395 -34.5757256827132,-58.4944373299452 -34.5764763656171,-58.4943431196973 -34.5765937189648,-58.4938065356649 -34.5772686035929,-58.4953126492461 -34.5780949352906,-58.4963617940047 -34.5786705900443,-58.4970235942686 -34.5781502431327,-58.4972180899958 -34.5779982100882,-58.4978600485706 -34.5774964565265,-58.4980349645423 -34.5773602031139)))";;"798";12_18_12;COMUNA 12;"18";"12";"1163";"534";"629";"84,90%";"541";"540";"99,82%";"1";"0,19%";"436";"5";"1.15";"431";"98,85%";"1.15";1.150
"MULTIPOLYGON (((-58.4938065356649 -34.5772686035929,-58.4943431196973 -34.5765937189648,-58.4944373299452 -34.5764763656171,-58.4935083034271 -34.575967920206,-58.4933529699429 -34.5758827444461,-58.4927203809557 -34.5766725828711,-58.4923256854001 -34.5771656945192,-58.4933984789324 -34.5777818644469,-58.4933816859699 -34.5777981699728,-58.4934822604698 -34.5778456818546,-58.494138446746 -34.5782144737244,-58.494368048393 -34.5783407576859,-58.4946698663641 -34.5784972348498,-58.494798294157 -34.5785677674744,-58.4948527110605 -34.5785894441994,-58.4948967406961 -34.5786126025755,-58.4949351495743 -34.5786328749756,-58.4949895689523 -34.5786607490808,-58.4953907566052 -34.5788202968458,-58.4958041258065 -34.5789899812525,-58.4959081901081 -34.5790273489104,-58.4963617940047 -34.5786705900443,-58.4953126492461 -34.5780949352906,-58.4938065356649 -34.5772686035929)))";;"799";12_18_13;COMUNA 12;"18";"13";"756";"327";"429";"76,22%";"347";"347";"100,00%";"0";"0,00%";"306";"3";"0.98";"303";"99,02%";"0.98";0.980
"MULTIPOLYGON (((-58.501998473067 -34.5661424538752,-58.5018773852926 -34.5660836169759,-58.5014379971279 -34.5658714943678,-58.5013381923607 -34.5659942778594,-58.50040854107 -34.5671425765357,-58.5005499805234 -34.5672101413486,-58.5009994210615 -34.5674258556572,-58.5015185200731 -34.5676749279078,-58.5016724791798 -34.5677488257361,-58.5023177809487 -34.5680563778903,-58.5029444384094 -34.568355059139,-58.5030953341783 -34.5684269842569,-58.5036565120386 -34.5686944849438,-58.504212243454 -34.5689593791434,-58.5052086490258 -34.5677227853488,-58.5050721430372 -34.5676557172078,-58.5046575170795 -34.5674521191493,-58.5042412751944 -34.5672477455431,-58.5041013624696 -34.5671748321445,-58.5039573625145 -34.5670998776234,-58.5033321543746 -34.5667934542109,-58.5027121452126 -34.5664895611977,-58.5025605713624 -34.5664158751629,-58.501998473067 -34.5661424538752)))";;"800";12_18_2;COMUNA 12;"18";"2";"924";"440";"484";"90,91%";"355";"355";"100,00%";"0";"0,00%";"323";"5";"1.55";"318";"98,45%";"1.55";1.550
"MULTIPOLYGON (((-58.5078802783672 -34.5707076592642,-58.5063383786712 -34.5699727659756,-58.5052742401521 -34.5694655846064,-58.504212243454 -34.5689593791434,-58.5036565120386 -34.5686944849438,-58.5030953341783 -34.5684269842569,-58.5029444384094 -34.568355059139,-58.5023177809487 -34.5680563778903,-58.5016724791798 -34.5677488257361,-58.5015185200731 -34.5676749279078,-58.5007867764991 -34.5685961843775,-58.5008427244452 -34.5686256048066,-58.501575825086 -34.5689746844694,-58.5023579818811 -34.5693471954995,-58.5033312382116 -34.5698106983082,-58.5034728542019 -34.5698769919833,-58.5036031445638 -34.5699380777963,-58.5045349432013 -34.5703831333428,-58.5055980675969 -34.5708909552642,-58.506675086106 -34.5714054533027,-58.5067896493402 -34.5713410430166,-58.5068741649013 -34.5712890383982,-58.507121838248 -34.5711365476052,-58.507635920503 -34.5708460652723,-58.5078802783672 -34.5707076592642)))";;"801";12_18_3;COMUNA 12;"18";"3";"864";"379";"485";"78,14%";"363";"363";"100,00%";"0";"0,00%";"318";"7";"2.2";"311";"97,80%";"2.2";2.200
"MULTIPOLYGON (((-58.5045349432013 -34.5703831333428,-58.5036031445638 -34.5699380777963,-58.5034728542019 -34.5698769919833,-58.5033312382116 -34.5698106983082,-58.5023579818811 -34.5693471954995,-58.501575825086 -34.5689746844694,-58.5008427244452 -34.5686256048066,-58.5007867764991 -34.5685961843775,-58.5006811828615 -34.5687291103697,-58.5002209402224 -34.5693080101848,-58.5009711871273 -34.5697231473613,-58.5015612560288 -34.5700496651945,-58.5017213564481 -34.5701384911974,-58.5027842444038 -34.570727960962,-58.5038023520079 -34.5712925762727,-58.5048194514488 -34.5718566904035,-58.5053398866886 -34.5721453249071,-58.505546034876 -34.572027289924,-58.5064859626894 -34.5715116526042,-58.506675086106 -34.5714054533027,-58.5055980675969 -34.5708909552642,-58.5045349432013 -34.5703831333428)))";;"802";12_18_4;COMUNA 12;"18";"4";"817";"383";"434";"88,25%";"347";"347";"100,00%";"0";"0,00%";"308";"2";"0.65";"306";"99,35%";"0.65";0.650
"MULTIPOLYGON (((-58.5009711871273 -34.5697231473613,-58.5002209402224 -34.5693080101848,-58.5001228325898 -34.5694314259241,-58.4994415943266 -34.570271035342,-58.5002016321226 -34.5706754695471,-58.5009628695092 -34.5710805324448,-58.5020361424254 -34.5716515538782,-58.5030700852899 -34.5722017328668,-58.5032462852916 -34.5722954812992,-58.5041959348196 -34.5728051839707,-58.5051270989329 -34.5722671648276,-58.5053398866886 -34.5721453249071,-58.5048194514488 -34.5718566904035,-58.5038023520079 -34.5712925762727,-58.5027842444038 -34.570727960962,-58.5017213564481 -34.5701384911974,-58.5015612560288 -34.5700496651945,-58.5009711871273 -34.5697231473613)))";;"803";12_18_5;COMUNA 12;"18";"5";"913";"405";"508";"79,72%";"345";"342";"99,13%";"3";"0,88%";"301";"10";"3.32";"291";"96,68%";"3.32";3.320
"MULTIPOLYGON (((-58.4975251490839 -34.5707035171591,-58.4974078034517 -34.5708484159752,-58.4966404094377 -34.57179670068,-58.496789350641 -34.5718756062256,-58.4977360579615 -34.5723774723638,-58.4986217249347 -34.571281956692,-58.4987142216502 -34.5711674878972,-58.4994415943266 -34.570271035342,-58.5001228325898 -34.5694314259241,-58.5002209402224 -34.5693080101848,-58.5006811828615 -34.5687291103697,-58.5007867764991 -34.5685961843775,-58.5015185200731 -34.5676749279078,-58.5009994210615 -34.5674258556572,-58.5005499805234 -34.5672101413486,-58.50040854107 -34.5671425765357,-58.5003083080733 -34.5672664156771,-58.4997154130482 -34.5679995865848,-58.4992323592299 -34.5685968003119,-58.4991404615311 -34.5687101425581,-58.4983473231384 -34.5696887289958,-58.4982352560057 -34.5698268662333,-58.4975251490839 -34.5707035171591)))";;"804";12_18_6;COMUNA 12;"18";"6";"889";"420";"469";"89,55%";"358";"358";"100,00%";"0";"0,00%";"312";"11";"3.53";"301";"96,47%";"3.53";3.530
"MULTIPOLYGON (((-58.5020361424254 -34.5716515538782,-58.5009628695092 -34.5710805324448,-58.5002016321226 -34.5706754695471,-58.4994415943266 -34.570271035342,-58.4987142216502 -34.5711674878972,-58.4986217249347 -34.571281956692,-58.4992473853267 -34.5716117147228,-58.4993866199239 -34.5716841408556,-58.5001556081341 -34.5720844174513,-58.5003070221922 -34.5721632475155,-58.5012329724209 -34.5726494584231,-58.5022705808521 -34.5731942201675,-58.5029467709116 -34.5735492254996,-58.5029946052232 -34.5735179407808,-58.5039481614129 -34.5729483022261,-58.5041959348196 -34.5728051839707,-58.5032462852916 -34.5722954812992,-58.5030700852899 -34.5722017328668,-58.5020361424254 -34.5716515538782)))";;"805";12_18_7;COMUNA 12;"18";"7";"894";"429";"465";"92,26%";"373";"373";"100,00%";"0";"0,00%";"336";"3";"0.89";"333";"99,11%";"0.89";0.890
"MULTIPOLYGON (((-58.5012329724209 -34.5726494584231,-58.5003070221922 -34.5721632475155,-58.5001556081341 -34.5720844174513,-58.4993866199239 -34.5716841408556,-58.4992473853267 -34.5716117147228,-58.4986217249347 -34.571281956692,-58.4977360579615 -34.5723774723638,-58.4983652154528 -34.5727110368312,-58.4984992570357 -34.5727822682456,-58.4992697876284 -34.5731916347901,-58.4994314228458 -34.5732774349915,-58.5003457125921 -34.57375619094,-58.5017355620556 -34.5744838839288,-58.5022835074295 -34.5740610838795,-58.5029467709116 -34.5735492254996,-58.5022705808521 -34.5731942201675,-58.5012329724209 -34.5726494584231)))";;"806";12_18_8;COMUNA 12;"18";"8";"980";"444";"536";"82,84%";"382";"380";"99,48%";"2";"0,53%";"328";"9";"2.74";"319";"97,26%";"2.74";2.740
"MULTIPOLYGON (((-58.4977360579615 -34.5723774723638,-58.496789350641 -34.5718756062256,-58.4966404094377 -34.57179670068,-58.4959792010234 -34.5726137487207,-58.4958570813772 -34.5727566753884,-58.4969616762359 -34.573335902137,-58.4977274332092 -34.5737374624867,-58.4984935381717 -34.5741391587527,-58.4995826700499 -34.5747101968129,-58.5006924263684 -34.5752920642083,-58.5013287273402 -34.5747978294863,-58.501475715915 -34.5746844682162,-58.5017355620556 -34.5744838839288,-58.5003457125921 -34.57375619094,-58.4994314228458 -34.5732774349915,-58.4992697876284 -34.5731916347901,-58.4984992570357 -34.5727822682456,-58.4983652154528 -34.5727110368312,-58.4977360579615 -34.5723774723638)))";;"807";12_18_9;COMUNA 12;"18";"9";"794";"372";"422";"88,15%";"291";"291";"100,00%";"0";"0,00%";"290";"2";"0.69";"288";"99,31%";"0.69";0.690
"MULTIPOLYGON (((-58.509533830275 -34.5734300399428,-58.5095564185993 -34.5734762304243,-58.5095883825283 -34.5735403053856,-58.5096818897773 -34.5737309817714,-58.5097047328572 -34.5737756931889,-58.5097335435245 -34.5738339944298,-58.5097551938048 -34.5738771569351,-58.5098477632252 -34.5740642418426,-58.5099679505536 -34.5743069521465,-58.5099901228572 -34.574369410998,-58.509996456876 -34.5744285659831,-58.5100001539677 -34.5744920883716,-58.5100964436048 -34.5743310582758,-58.5102051381222 -34.5744246115422,-58.5108339206729 -34.573846805474,-58.5108419501645 -34.5738641092177,-58.5113973736907 -34.5734107441271,-58.5116657672645 -34.5731916648847,-58.509859361198 -34.5693403606771,-58.5096276931962 -34.5696,-58.5095221037353 -34.5696684799542,-58.509365830973 -34.5698064468722,-58.5092216351709 -34.5699158272084,-58.5091680942272 -34.5699437148338,-58.5090406309485 -34.5699973008757,-58.5079804555396 -34.5706509999899,-58.5078802783672 -34.5707076592642,-58.507635920503 -34.5708460652723,-58.507121838248 -34.5711365476052,-58.5068741649013 -34.5712890383982,-58.509203736821 -34.5726634433055,-58.5093608437078 -34.5730091727584,-58.5094892467297 -34.5733323768236,-58.5095111552557 -34.5733810324686,-58.509533830275 -34.5734300399428)))";;"808";12_19_1;COMUNA 12;"19";"1";"913";"403";"510";"79,02%";"404";"404";"100,00%";"0";"0,00%";"352";"2";"0.57";"350";"99,43%";"0.57";0.570
"MULTIPOLYGON (((-58.504555313655 -34.5797713407502,-58.5056912030389 -34.5804715384018,-58.5060751718152 -34.5800469483245,-58.5068833487992 -34.5791535227077,-58.5058671359348 -34.5785268883532,-58.5057493409171 -34.578453969162,-58.5063093659175 -34.5778359980377,-58.5064045036427 -34.5777306779091,-58.505403728396 -34.5771147386882,-58.5052655798778 -34.5770295016701,-58.5041367245808 -34.5763330298068,-58.5034846167504 -34.5770529980373,-58.5044874251202 -34.5776779667716,-58.5046119451833 -34.5777523638169,-58.503803672452 -34.5786461267629,-58.5031451616551 -34.5793743348504,-58.5041122195583 -34.5799716410553,-58.5042799272504 -34.580075250315,-58.504555313655 -34.5797713407502)))";;"809";12_19_10;COMUNA 12;"19";"10";"1080";"507";"573";"88,48%";"392";"391";"99,74%";"1";"0,26%";"360";"3";"0.83";"357";"99,17%";"0.83";0.830
"MULTIPOLYGON (((-58.5086635908269 -34.5791325827535,-58.5075356984476 -34.5784322688248,-58.5068833487992 -34.5791535227077,-58.5060751718152 -34.5800469483245,-58.5056912030389 -34.5804715384018,-58.5067415507745 -34.5805527870162,-58.5069092099796 -34.5805564589521,-58.5072074117483 -34.5807386116446,-58.5070674223806 -34.5808893730751,-58.5069657047869 -34.5810047150778,-58.5068985877175 -34.5810792309137,-58.5078714580699 -34.5811594414434,-58.5087660757998 -34.5812352369734,-58.509460839281 -34.581291946956,-58.5104652236385 -34.5813788855707,-58.510734645963 -34.5813963157695,-58.5124788259986 -34.581508931403,-58.5124949437517 -34.5811217257476,-58.5118203772216 -34.5810943923188,-58.5110282176786 -34.5810623128502,-58.5112947326257 -34.5807675469582,-58.5119542895264 -34.5800381678636,-58.5118104226407 -34.5799496306098,-58.5106051539346 -34.5792051490708,-58.509948229041 -34.5799303648559,-58.5098116892328 -34.5798454845309,-58.5086635908269 -34.5791325827535)))";;"810";12_19_11;COMUNA 12;"19";"11";"1082";"509";"573";"88,83%";"370";"370";"100,00%";"0";"0,00%";"372";"4";"1.08";"368";"98,92%";"1.08";1.080
"MULTIPOLYGON (((-58.5004631777442 -34.5803946220587,-58.5004629977761 -34.5803948266644,-58.5004632845336 -34.5803948935712,-58.5005641623436 -34.5804132017356,-58.5004084805508 -34.58058540215,-58.501162095793 -34.5806967913374,-58.5017190022065 -34.5809532449164,-58.5018258078827 -34.5808334874589,-58.502212495259 -34.5810705558032,-58.5024283187866 -34.5808304758102,-58.5035687999433 -34.5809369478812,-58.5036247783296 -34.5809169044334,-58.5036610956061 -34.5809181437938,-58.5037080064733 -34.580921882671,-58.5037866950436 -34.5809268623801,-58.5038275525267 -34.5809293517058,-58.5038547998981 -34.5809493672121,-58.5041846721879 -34.580983418959,-58.5043120673709 -34.5808375949112,-58.5051808747485 -34.5809063125531,-58.5051995980157 -34.5808877137163,-58.5053023766274 -34.5808956359606,-58.505259039565 -34.5809451655726,-58.5057388216413 -34.5809868997801,-58.5056363434874 -34.5809215763492,-58.505826658677 -34.580936298595,-58.5065220999186 -34.5809949969837,-58.5068304391121 -34.5810235490445,-58.5069657047869 -34.5810047150778,-58.5070674223806 -34.5808893730751,-58.5072074117483 -34.5807386116446,-58.5069092099796 -34.5805564589521,-58.5067415507745 -34.5805527870162,-58.5056912030389 -34.5804715384018,-58.504555313655 -34.5797713407502,-58.5042799272504 -34.580075250315,-58.5041122195583 -34.5799716410553,-58.5031451616551 -34.5793743348504,-58.5020145884787 -34.5786759427149,-58.5018853837505 -34.578596121773,-58.5008808816902 -34.5779728929188,-58.5002239680009 -34.5787000284518,-58.4995613407728 -34.5794334299589,-58.4990885756355 -34.5799567626027,-58.4990875056081 -34.5799565057384,-58.4989482253553 -34.5801219167697,-58.4989727639571 -34.5801282830734,-58.4990374835403 -34.5801446025293,-58.4996991357594 -34.5802622255444,-58.5003599373087 -34.5803775211922,-58.5004631777442 -34.5803946220587)))";;"811";12_19_12;COMUNA 12;"19";"12";"833";"388";"445";"87,19%";"392";"392";"100,00%";"0";"0,00%";"333";"35";"10.51";"298";"89,49%";"10.51";10.510
"MULTIPOLYGON (((-58.5002239680009 -34.5787000284518,-58.4990850823886 -34.5779977382457,-58.4980349645423 -34.5773602031139,-58.4978600485706 -34.5774964565265,-58.4972180899958 -34.5779982100882,-58.4970235942686 -34.5781502431327,-58.4963617940047 -34.5786705900443,-58.4959081901081 -34.5790273489104,-58.4957742094948 -34.5791297839276,-58.4958702720964 -34.579172083568,-58.4964738796717 -34.5793833353002,-58.4967879441246 -34.5794848015176,-58.4971946609553 -34.5796133545799,-58.4974337018266 -34.5796900505472,-58.4974093631542 -34.579722594036,-58.4975046526289 -34.5797449621988,-58.4975911720084 -34.5797674736454,-58.4982538650915 -34.5799417262789,-58.4985188745935 -34.5800105248972,-58.4989482253553 -34.5801219167697,-58.4990875056081 -34.5799565057384,-58.4990885756355 -34.5799567626027,-58.4995613407728 -34.5794334299589,-58.5002239680009 -34.5787000284518)))";;"812";12_19_13;COMUNA 12;"19";"13";"713";"306";"407";"75,18%";"322";"321";"99,69%";"1";"0,31%";"286";"3";"1.05";"283";"98,95%";"1.05";1.050
"MULTIPOLYGON (((-58.5080835422288 -34.5739122279873,-58.5074754796954 -34.5745832556822,-58.5073783903978 -34.5746918874118,-58.508534998002 -34.5753716282162,-58.5088939079008 -34.5755825581715,-58.5090273713565 -34.5756615250107,-58.5096699559706 -34.5749171634634,-58.5097501080265 -34.5748242413367,-58.5098268544435 -34.574731743024,-58.5098998567742 -34.5746434012153,-58.5099357607699 -34.5745972586106,-58.509968766181 -34.574544567544,-58.5100001539677 -34.5744920883716,-58.509996456876 -34.5744285659831,-58.5099901228572 -34.574369410998,-58.5099679505536 -34.5743069521465,-58.5098477632252 -34.5740642418426,-58.5097551938048 -34.5738771569351,-58.5097335435245 -34.5738339944298,-58.5097047328572 -34.5737756931889,-58.5096818897773 -34.5737309817714,-58.5095883825283 -34.5735403053856,-58.5095564185993 -34.5734762304243,-58.509533830275 -34.5734300399428,-58.5095111552557 -34.5733810324686,-58.5094892467297 -34.5733323768236,-58.5093608437078 -34.5730091727584,-58.509203736821 -34.5726634433055,-58.5080835422288 -34.5739122279873)))";;"813";12_19_2;COMUNA 12;"19";"2";"593";"267";"326";"81,90%";"233";"233";"100,00%";"0";"0,00%";"225";"0";"0";"225";"100,00%";"0";0.000
"MULTIPOLYGON (((-58.5108339206729 -34.573846805474,-58.5102051381222 -34.5744246115422,-58.5100964436048 -34.5743310582758,-58.5100001539677 -34.5744920883716,-58.509968766181 -34.574544567544,-58.5099357607699 -34.5745972586106,-58.5098998567742 -34.5746434012153,-58.5098268544435 -34.574731743024,-58.5097501080265 -34.5748242413367,-58.5096699559706 -34.5749171634634,-58.5090273713565 -34.5756615250107,-58.5090886096651 -34.5756978413152,-58.5096851532603 -34.5760509379083,-58.5102397968494 -34.5763792581136,-58.5107056940381 -34.5766550732949,-58.5108330291347 -34.5767316460877,-58.5120157661985 -34.5774429643948,-58.512135863927 -34.5775154540633,-58.5127156576612 -34.5778651620884,-58.5127832878199 -34.5779059811362,-58.5127846515303 -34.5779089168373,-58.5134156633843 -34.5777031787541,-58.5137334578144 -34.5775995619371,-58.5116657672645 -34.5731916648847,-58.5113973736907 -34.5734107441271,-58.5108419501645 -34.5738641092177,-58.5108339206729 -34.573846805474)))";;"814";12_19_3;COMUNA 12;"19";"3";"764";"349";"415";"84,10%";"278";"278";"100,00%";"0";"0,00%";"283";"0";"0";"283";"100,00%";"0";0.000
"MULTIPOLYGON (((-58.5124794909084 -34.5815092970441,-58.5124782490811 -34.5815072453907,-58.5124788259986 -34.581508931403,-58.5124794909084 -34.5815092970441)),((-58.5119542895264 -34.5800381678636,-58.5112947326257 -34.5807675469582,-58.5110282176786 -34.5810623128502,-58.5118203772216 -34.5810943923188,-58.5124949437517 -34.5811217257476,-58.5124788793931 -34.5815076486837,-58.5124794909084 -34.5815092970441,-58.5125614295895 -34.5816077672681,-58.5127389848112 -34.5816434811256,-58.5137105135037 -34.5816326292404,-58.5137517742771 -34.5815904512292,-58.5146967636712 -34.5815589789978,-58.5149696783243 -34.5813145043852,-58.5150289247326 -34.5813099491376,-58.5151041457097 -34.5813025380219,-58.5151051230341 -34.5813046446155,-58.5154566419065 -34.5812726695817,-58.5146210373965 -34.5794915469722,-58.5145978559622 -34.5794421340758,-58.5137334578144 -34.5775995619371,-58.5134156633843 -34.5777031787541,-58.5127846515303 -34.5779089168373,-58.5127832878199 -34.5779059811362,-58.5127156576612 -34.5778651620884,-58.512135863927 -34.5775154540633,-58.5113052940672 -34.5784323752711,-58.5106051539346 -34.5792051490708,-58.5118104226407 -34.5799496306098,-58.5119542895264 -34.5800381678636)))";;"815";12_19_4;COMUNA 12;"19";"4";"1082";"488";"594";"82,15%";"418";"417";"99,76%";"1";"0,24%";"367";"5";"1.36";"362";"98,64%";"1.36";1.360
"MULTIPOLYGON (((-58.5086635908269 -34.5791325827535,-58.5098116892328 -34.5798454845309,-58.509948229041 -34.5799303648559,-58.5106051539346 -34.5792051490708,-58.5113052940672 -34.5784323752711,-58.512135863927 -34.5775154540633,-58.5120157661985 -34.5774429643948,-58.5108330291347 -34.5767316460877,-58.5107056940381 -34.5766550732949,-58.5102397968494 -34.5763792581136,-58.5096851532603 -34.5760509379083,-58.5090886096651 -34.5756978413152,-58.5082784720231 -34.5766385382578,-58.5088507449529 -34.5769777036858,-58.508295086515 -34.5775949102361,-58.5081881225889 -34.5777121381545,-58.5080609058286 -34.5778516983839,-58.5075356984476 -34.5784322688248,-58.5086635908269 -34.5791325827535)))";;"816";12_19_5;COMUNA 12;"19";"5";"1089";"502";"587";"85,52%";"459";"459";"100,00%";"0";"0,00%";"406";"9";"2.22";"397";"97,78%";"2.22";2.220
"MULTIPOLYGON (((-58.5090273713565 -34.5756615250107,-58.5088939079008 -34.5755825581715,-58.508534998002 -34.5753716282162,-58.5073783903978 -34.5746918874118,-58.5072886187076 -34.5747922766036,-58.506545670388 -34.5756138480907,-58.5059169908249 -34.5763091720471,-58.5052655798778 -34.5770295016701,-58.505403728396 -34.5771147386882,-58.5064045036427 -34.5777306779091,-58.5063093659175 -34.5778359980377,-58.5057493409171 -34.578453969162,-58.5058671359348 -34.5785268883532,-58.5068833487992 -34.5791535227077,-58.5075356984476 -34.5784322688248,-58.5080609058286 -34.5778516983839,-58.5081881225889 -34.5777121381545,-58.508295086515 -34.5775949102361,-58.5088507449529 -34.5769777036858,-58.5082784720231 -34.5766385382578,-58.5090886096651 -34.5756978413152,-58.5090273713565 -34.5756615250107)))";;"817";12_19_6;COMUNA 12;"19";"6";"1078";"497";"581";"85,54%";"399";"398";"99,75%";"1";"0,25%";"356";"2";"0.56";"354";"99,44%";"0.56";0.560
"MULTIPOLYGON (((-58.5059169908249 -34.5763091720471,-58.506545670388 -34.5756138480907,-58.5072886187076 -34.5747922766036,-58.5073783903978 -34.5746918874118,-58.5074754796954 -34.5745832556822,-58.5080835422288 -34.5739122279873,-58.509203736821 -34.5726634433055,-58.5068741649013 -34.5712890383982,-58.5067896493402 -34.5713410430166,-58.506675086106 -34.5714054533027,-58.5064859626894 -34.5715116526042,-58.505546034876 -34.572027289924,-58.5053398866886 -34.5721453249071,-58.5051270989329 -34.5722671648276,-58.5041959348196 -34.5728051839707,-58.5039481614129 -34.5729483022261,-58.5029946052232 -34.5735179407808,-58.5029467709116 -34.5735492254996,-58.5022835074295 -34.5740610838795,-58.5017355620556 -34.5744838839288,-58.501475715915 -34.5746844682162,-58.5018696997769 -34.5749294232363,-58.5028688075989 -34.5755506741354,-58.503000393246 -34.5756319018017,-58.5041367245808 -34.5763330298068,-58.5052655798778 -34.5770295016701,-58.5059169908249 -34.5763091720471)))";;"818";12_19_7;COMUNA 12;"19";"7";"998";"465";"533";"87,24%";"386";"386";"100,00%";"0";"0,00%";"346";"2";"0.58";"344";"99,42%";"0.58";0.580
"MULTIPOLYGON (((-58.4988458692636 -34.5767286010984,-58.4980349645423 -34.5773602031139,-58.4990850823886 -34.5779977382457,-58.5002239680009 -34.5787000284518,-58.5008808816902 -34.5779728929188,-58.5015397412948 -34.5772436403834,-58.5022453091036 -34.5764626063413,-58.5023474288709 -34.5763502445373,-58.503000393246 -34.5756319018017,-58.5028688075989 -34.5755506741354,-58.5018696997769 -34.5749294232363,-58.501475715915 -34.5746844682162,-58.5013287273402 -34.5747978294863,-58.5006924263684 -34.5752920642083,-58.5001508496756 -34.5757127423161,-58.4998267351801 -34.5759645421021,-58.4996569319121 -34.5760967823099,-58.4988458692636 -34.5767286010984)))";;"819";12_19_8;COMUNA 12;"19";"8";"963";"476";"487";"97,74%";"360";"360";"100,00%";"0";"0,00%";"351";"42";"11.97";"309";"88,03%";"11.97";11.970
"MULTIPOLYGON (((-58.5020145884787 -34.5786759427149,-58.5031451616551 -34.5793743348504,-58.503803672452 -34.5786461267629,-58.5046119451833 -34.5777523638169,-58.5044874251202 -34.5776779667716,-58.5034846167504 -34.5770529980373,-58.5041367245808 -34.5763330298068,-58.503000393246 -34.5756319018017,-58.5023474288709 -34.5763502445373,-58.5022453091036 -34.5764626063413,-58.5015397412948 -34.5772436403834,-58.5008808816902 -34.5779728929188,-58.5018853837505 -34.578596121773,-58.5020145884787 -34.5786759427149)))";;"820";12_19_9;COMUNA 12;"19";"9";"789";"339";"450";"75,33%";"373";"372";"99,73%";"1";"0,27%";"316";"2";"0.63";"314";"99,37%";"0.63";0.630
"MULTIPOLYGON (((-58.4929572538221 -34.5543449232805,-58.492028149463 -34.5538577332894,-58.4918520014238 -34.5537653768689,-58.4911110586015 -34.5533724348873,-58.49018035596 -34.5528759924775,-58.4900286200182 -34.5527979785943,-58.4899041175272 -34.5527296138722,-58.4893002206918 -34.5523674444283,-58.4891517437503 -34.5522784584942,-58.4889004732627 -34.5520153315097,-58.4888732808561 -34.5518771223935,-58.4888731916487 -34.5518766689838,-58.4888261061541 -34.5518300571955,-58.4888262002611 -34.5518300348744,-58.4888004521238 -34.5518046970517,-58.4887786953489 -34.5517832869699,-58.4886519637553 -34.5517225498623,-58.488552654616 -34.5516973238699,-58.4884619813619 -34.5517074268817,-58.4878096763032 -34.5526072077169,-58.4872610587761 -34.5534101731573,-58.4867132807935 -34.5542091920214,-58.4862794412087 -34.5549017730603,-58.4864093380632 -34.554902593014,-58.4865597494328 -34.5549035496738,-58.4866638541976 -34.5549042335428,-58.4867694911451 -34.5549048465952,-58.4871931468607 -34.554911804917,-58.4875334675101 -34.5549174406578,-58.4878544653342 -34.5549227273037,-58.4883598442966 -34.5549480458345,-58.4885254949304 -34.5549563211474,-58.4887235777394 -34.5549662795451,-58.489966980342 -34.5550284758341,-58.4905237754005 -34.5550563796665,-58.4911787187201 -34.5550891879083,-58.4921352569393 -34.555137061835,-58.4923955666026 -34.5551510135248,-58.4929090357913 -34.5551786353055,-58.4929092433115 -34.555178646443,-58.4936065440148 -34.5552160680832,-58.4937078704786 -34.5550689934252,-58.493877769985 -34.5548276011047,-58.4929572538221 -34.5543449232805)))";;"821";12_2_1;COMUNA 12;"2";"1";"1066";"458";"608";"75,33%";"388";"386";"99,48%";"2";"0,52%";"371";"16";"4.31";"355";"95,69%";"4.31";4.310
"MULTIPOLYGON (((-58.4884622689195 -34.5517070302235,-58.4876552696453 -34.5514700037589,-58.4868354527852 -34.5510446559011,-58.4862445237971 -34.5518188211877,-58.4856654112407 -34.5525773467731,-58.4865089048814 -34.5530175576023,-58.4859328581869 -34.5538027046505,-58.4867132807935 -34.5542091920214,-58.4872610587761 -34.5534101731573,-58.4878096763032 -34.5526072077169,-58.4884619813619 -34.5517074268817,-58.4884622689195 -34.5517070302235)))";;"822";12_2_2;COMUNA 12;"2";"2";"738";"325";"413";"78,69%";"389";"389";"100,00%";"0";"0,00%";"316";"3";"0.95";"313";"99,05%";"0.95";0.950
"MULTIPOLYGON (((-58.4850722482185 -34.5533543940731,-58.4844860517462 -34.5541222818026,-58.4853599490966 -34.5545838340318,-58.485956741822 -34.5548990179247,-58.4862794412087 -34.5549017730603,-58.4867132807935 -34.5542091920214,-58.4859328581869 -34.5538027046505,-58.4865089048814 -34.5530175576023,-58.4856654112407 -34.5525773467731,-58.4850722482185 -34.5533543940731)))";;"823";12_2_3;COMUNA 12;"2";"3";"850";"393";"457";"86,00%";"480";"480";"100,00%";"0";"0,00%";"394";"4";"1.02";"390";"98,98%";"1.02";1.020
"MULTIPOLYGON (((-58.4904900664804 -34.5560790396018,-58.4914402859747 -34.5565332064776,-58.4923871102418 -34.5569857469554,-58.4927832426146 -34.5564109760142,-58.4929266009849 -34.5562028325542,-58.4931712019466 -34.5558478260227,-58.4934431958409 -34.555453232817,-58.4936065440148 -34.5552160680832,-58.4929092433115 -34.555178646443,-58.4929090357913 -34.5551786353055,-58.4923955666026 -34.5551510135248,-58.4921352569393 -34.555137061835,-58.4911787187201 -34.5550891879083,-58.4905237754005 -34.5550563796665,-58.489966980342 -34.5550284758341,-58.4887235777394 -34.5549662795451,-58.4885254949304 -34.5549563211474,-58.4883598442966 -34.5549480458345,-58.4878544653342 -34.5549227273037,-58.4875334675101 -34.5549174406578,-58.4871931468607 -34.554911804917,-58.4867694911451 -34.5549048465952,-58.4866638541976 -34.5549042335428,-58.4864749599013 -34.5551756208975,-58.4859438369939 -34.555938574858,-58.4866036336746 -34.5562557154261,-58.4871803426278 -34.5565328672815,-58.4873847540663 -34.556630436193,-58.4875197799483 -34.5566948483652,-58.4885014056379 -34.5571631168272,-58.4889420648068 -34.5565226417301,-58.4890285109025 -34.5563962089228,-58.4895520317812 -34.5556307079519,-58.4904900664804 -34.5560790396018)))";;"824";12_2_4;COMUNA 12;"2";"4";"1032";"491";"541";"90,76%";"457";"457";"100,00%";"0";"0,00%";"379";"0";"0";"379";"100,00%";"0";0.000
"MULTIPOLYGON (((-58.4914402859747 -34.5565332064776,-58.4904900664804 -34.5560790396018,-58.4895520317812 -34.5556307079519,-58.4890285109025 -34.5563962089228,-58.4889420648068 -34.5565226417301,-58.4885014056379 -34.5571631168272,-58.4894269363682 -34.5576046983021,-58.4903785293591 -34.5580585913214,-58.491327833945 -34.5585114914639,-58.4918573920104 -34.5577492190426,-58.492317684442 -34.5570865430346,-58.4923871102418 -34.5569857469554,-58.4914402859747 -34.5565332064776)))";;"825";12_2_5;COMUNA 12;"2";"5";"1020";"460";"560";"82,14%";"442";"442";"100,00%";"0";"0,00%";"401";"2";"0.5";"399";"99,50%";"0.5";0.500
"MULTIPOLYGON (((-58.4881199009946 -34.5594800620172,-58.4890720194652 -34.5599353734812,-58.4900228711831 -34.5603900439357,-58.4907784412988 -34.5593023588942,-58.491327833945 -34.5585114914639,-58.4903785293591 -34.5580585913214,-58.4894269363682 -34.5576046983021,-58.4885014056379 -34.5571631168272,-58.4880303633678 -34.5578476830767,-58.4879571026135 -34.5579539706653,-58.4875823721446 -34.5584973820103,-58.4875030688931 -34.5586124033349,-58.4872109580799 -34.5590453691631,-58.4881199009946 -34.5594800620172)))";;"826";12_2_6;COMUNA 12;"2";"6";"968";"433";"535";"80,93%";"399";"399";"100,00%";"0";"0,00%";"344";"1";"0.29";"343";"99,71%";"0.29";0.290
"MULTIPOLYGON (((-58.4872109580799 -34.5590453691631,-58.4862206331359 -34.5585717397956,-58.4859998198895 -34.5588902471984,-58.4853897992882 -34.5598118824214,-58.4853010459624 -34.5599392285447,-58.4862550269348 -34.5603938573439,-58.486388695783 -34.560457566731,-58.4871745350335 -34.5608270761598,-58.4873199543629 -34.5608954302615,-58.48813109178 -34.5612869012127,-58.4882921792931 -34.561364687927,-58.4890864644843 -34.5617379862058,-58.4892768419645 -34.5618274559426,-58.4900433819791 -34.5621956129281,-58.4904006431999 -34.5623672301681,-58.4905182263635 -34.5624236143911,-58.490991285271 -34.5626506284525,-58.4918340782095 -34.5614416440189,-58.4919301398132 -34.5613016148078,-58.4914544469152 -34.5610743232505,-58.490984375957 -34.5608496342785,-58.4908456795344 -34.560783325337,-58.4901865127269 -34.5604683205702,-58.4900228711831 -34.5603900439357,-58.4890720194652 -34.5599353734812,-58.4881199009946 -34.5594800620172,-58.4872109580799 -34.5590453691631)))";;"827";12_2_7;COMUNA 12;"2";"7";"850";"389";"461";"84,38%";"387";"387";"100,00%";"0";"0,00%";"319";"2";"0.63";"317";"99,37%";"0.63";0.630
"MULTIPOLYGON (((-58.4875823721446 -34.5584973820103,-58.4879571026135 -34.5579539706653,-58.4880303633678 -34.5578476830767,-58.4885014056379 -34.5571631168272,-58.4875197799483 -34.5566948483652,-58.4873847540663 -34.556630436193,-58.4871803426278 -34.5565328672815,-58.4866036336746 -34.5562557154261,-58.4859438369939 -34.555938574858,-58.4864749599013 -34.5551756208975,-58.4866638541976 -34.5549042335428,-58.4865597494328 -34.5549035496738,-58.4864093380632 -34.554902593014,-58.4862794412087 -34.5549017730603,-58.4856287547184 -34.5557900361172,-58.4850848591695 -34.5565812998103,-58.4843477993333 -34.5576788064331,-58.4834077572584 -34.5590313545014,-58.4835050684714 -34.5590780302011,-58.4835563138851 -34.5591026605753,-58.4836203436906 -34.5591334355336,-58.4837007129025 -34.5591720150223,-58.4843501397196 -34.5594837466014,-58.4850179612427 -34.5598043449858,-58.4851659314367 -34.5598748843957,-58.4853010459624 -34.5599392285447,-58.4853897992882 -34.5598118824214,-58.4859998198895 -34.5588902471984,-58.4862206331359 -34.5585717397956,-58.4872109580799 -34.5590453691631,-58.4875030688931 -34.5586124033349,-58.4875823721446 -34.5584973820103)))";;"828";12_2_8;COMUNA 12;"2";"8";"1003";"468";"535";"87,48%";"381";"380";"99,74%";"1";"0,26%";"345";"3";"0.87";"342";"99,13%";"0.87";0.870
"MULTIPOLYGON (((-58.5065039518727 -34.5837323696212,-58.5066224991784 -34.583601265315,-58.5071641703296 -34.5830034390542,-58.506030701264 -34.5822989586095,-58.5058799371181 -34.582205627916,-58.5053226043428 -34.582823313998,-58.5052199699481 -34.5829360304798,-58.5045128404248 -34.5837127150578,-58.5038546339411 -34.5844357147961,-58.5037441664013 -34.5845582922068,-58.5043972329403 -34.5849630873395,-58.5050341215359 -34.5853577433038,-58.5051583142231 -34.5854346751213,-58.5057137766367 -34.5857782269707,-58.5062280157454 -34.5860962969897,-58.506382875743 -34.5861915976356,-58.5071483024412 -34.5853464278335,-58.5070045168317 -34.585258237091,-58.5064786947831 -34.5849318642572,-58.5058001493476 -34.5845106801444,-58.5065039518727 -34.5837323696212)))";;"829";12_20_1;COMUNA 12;"20";"1";"851";"405";"446";"90,81%";"401";"401";"100,00%";"0";"0,00%";"317";"3";"0.95";"314";"99,05%";"0.95";0.950
"MULTIPOLYGON (((-58.5057137766367 -34.5857782269707,-58.5051583142231 -34.5854346751213,-58.5050341215359 -34.5853577433038,-58.5043972329403 -34.5849630873395,-58.5037441664013 -34.5845582922068,-58.5029790548484 -34.5854071732212,-58.5021880544098 -34.5862847208388,-58.5028468278188 -34.5866802261537,-58.5034892529115 -34.5870659442221,-58.5041769149937 -34.5874788277108,-58.5048481437735 -34.5878817829938,-58.5049779370953 -34.5877446903299,-58.5056089233681 -34.5870471180546,-58.5062828772876 -34.5863021308195,-58.506382875743 -34.5861915976356,-58.5062280157454 -34.5860962969897,-58.5057137766367 -34.5857782269707)))";;"830";12_20_2;COMUNA 12;"20";"2";"1286";"587";"699";"83,98%";"697";"696";"99,86%";"1";"0,14%";"559";"6";"1.07";"553";"98,93%";"1.07";1.070
"MULTIPOLYGON (((-58.501853510142 -34.5847080744,-58.5017354617911 -34.5848329764584,-58.5010545854918 -34.5855862511444,-58.5020157386037 -34.5861813215746,-58.5021880544098 -34.5862847208388,-58.5029790548484 -34.5854071732212,-58.5037441664013 -34.5845582922068,-58.5038546339411 -34.5844357147961,-58.5045128404248 -34.5837127150578,-58.5033865401108 -34.5830151093694,-58.5022546370653 -34.58231404417,-58.5015879121483 -34.5830482322561,-58.5014868895827 -34.5831593957236,-58.5013916540592 -34.5832641485575,-58.5007171687346 -34.5840062218844,-58.5017221651408 -34.5846233947011,-58.501853510142 -34.5847080744)))";;"831";12_20_3;COMUNA 12;"20";"3";"1026";"485";"541";"89,65%";"486";"484";"99,59%";"2";"0,41%";"411";"2";"0.49";"409";"99,51%";"0.49";0.490
"MULTIPOLYGON (((-58.5068985877175 -34.5810792309137,-58.5069657047869 -34.5810047150778,-58.5068304391121 -34.5810235490445,-58.5065220999186 -34.5809949969837,-58.505826658677 -34.580936298595,-58.5056363434874 -34.5809215763492,-58.5057388216413 -34.5809868997801,-58.505259039565 -34.5809451655726,-58.5053023766274 -34.5808956359606,-58.5051995980157 -34.5808877137163,-58.5051808747485 -34.5809063125531,-58.5043120673709 -34.5808375949112,-58.5041846721879 -34.580983418959,-58.5038547998981 -34.5809493672121,-58.5038275525267 -34.5809293517058,-58.5037866950436 -34.5809268623801,-58.5037080064733 -34.580921882671,-58.5036610956061 -34.5809181437938,-58.5036247783296 -34.5809169044334,-58.5035687999433 -34.5809369478812,-58.5024283187866 -34.5808304758102,-58.502212495259 -34.5810705558032,-58.5022396657444 -34.5810873786864,-58.5029618599416 -34.5815353301253,-58.5022546370653 -34.58231404417,-58.5033865401108 -34.5830151093694,-58.5045128404248 -34.5837127150578,-58.5052199699481 -34.5829360304798,-58.5053226043428 -34.582823313998,-58.5058799371181 -34.582205627916,-58.5062059589299 -34.5818443000761,-58.5064313046903 -34.581594631784,-58.5065352971559 -34.58147994186,-58.5068985877175 -34.5810792309137)))";;"832";12_20_4;COMUNA 12;"20";"4";"1034";"495";"539";"91,84%";"459";"459";"100,00%";"0";"0,00%";"391";"2";"0.51";"389";"99,49%";"0.51";0.510
"MULTIPOLYGON (((-58.5004632845336 -34.5803948935712,-58.5004634853441 -34.5803946730098,-58.5004631777442 -34.5803946220587,-58.5003599373087 -34.5803775211922,-58.4996991357594 -34.5802622255444,-58.4990374835403 -34.5801446025293,-58.4989727639571 -34.5801282830734,-58.4989482253553 -34.5801219167697,-58.4985188745935 -34.5800105248972,-58.4988476372062 -34.5802225494604,-58.4980908537389 -34.5810563269254,-58.4982199734436 -34.5811360110257,-58.4992211724719 -34.5817582764819,-58.5002214495147 -34.5823799705366,-58.5003512537714 -34.5824580323681,-58.5004882128845 -34.5825404582222,-58.5014868895827 -34.5831593957236,-58.5015879121483 -34.5830482322561,-58.5022546370653 -34.58231404417,-58.5029618599416 -34.5815353301253,-58.5022396657444 -34.5810873786864,-58.502212495259 -34.5810705558032,-58.5018258078827 -34.5808334874589,-58.5017190022065 -34.5809532449164,-58.501162095793 -34.5806967913374,-58.5004084805508 -34.58058540215,-58.5005641623436 -34.5804132017356,-58.5004632845336 -34.5803948935712)))";;"833";12_20_5;COMUNA 12;"20";"5";"993";"474";"519";"91,33%";"418";"417";"99,76%";"1";"0,24%";"382";"1";"0.26";"381";"99,74%";"0.26";0.260
"MULTIPOLYGON (((-58.5014868895827 -34.5831593957236,-58.5004882128845 -34.5825404582222,-58.5003512537714 -34.5824580323681,-58.5002214495147 -34.5823799705366,-58.4992211724719 -34.5817582764819,-58.4991287438909 -34.5818590124845,-58.4984548475841 -34.5826051579823,-58.4983450552851 -34.5827266739656,-58.4976570139988 -34.5834827490713,-58.4987851465106 -34.5841812521578,-58.4999185787852 -34.5848829122575,-58.5010545854918 -34.5855862511444,-58.5017354617911 -34.5848329764584,-58.501853510142 -34.5847080744,-58.5017221651408 -34.5846233947011,-58.5007171687346 -34.5840062218844,-58.5013916540592 -34.5832641485575,-58.5014868895827 -34.5831593957236)))";;"834";12_20_6;COMUNA 12;"20";"6";"1014";"447";"567";"78,84%";"524";"524";"100,00%";"0";"0,00%";"407";"1";"0.25";"406";"99,75%";"0.25";0.250
"MULTIPOLYGON (((-58.4980908537389 -34.5810563269254,-58.4988476372062 -34.5802225494604,-58.4985188745935 -34.5800105248972,-58.4982538650915 -34.5799417262789,-58.4975911720084 -34.5797674736454,-58.4975046526289 -34.5797449621988,-58.4969545937766 -34.5803547206091,-58.4968635264714 -34.5804556658142,-58.4961855335613 -34.5812005324453,-58.4973209474074 -34.5819029207422,-58.4965223421304 -34.5827802230338,-58.4976570139988 -34.5834827490713,-58.4983450552851 -34.5827266739656,-58.4984548475841 -34.5826051579823,-58.4991287438909 -34.5818590124845,-58.4992211724719 -34.5817582764819,-58.4982199734436 -34.5811360110257,-58.4980908537389 -34.5810563269254)))";;"835";12_20_7;COMUNA 12;"20";"7";"887";"393";"494";"79,55%";"417";"417";"100,00%";"0";"0,00%";"346";"7";"2.02";"339";"97,98%";"2.02";2.020
"MULTIPOLYGON (((-58.4944605177934 -34.5801332731927,-58.4943290872187 -34.5802334523278,-58.4936189820164 -34.5807744313661,-58.4934534936557 -34.5808847594365,-58.4942573992936 -34.5813778140814,-58.4953859859409 -34.5820766304302,-58.4965223421304 -34.5827802230338,-58.4973209474074 -34.5819029207422,-58.4961855335613 -34.5812005324453,-58.4968635264714 -34.5804556658142,-58.4969545937766 -34.5803547206091,-58.4975046526289 -34.5797449621988,-58.4974093631542 -34.579722594036,-58.4974337018266 -34.5796900505472,-58.4971946609553 -34.5796133545799,-58.4967879441246 -34.5794848015176,-58.4964738796717 -34.5793833353002,-58.4958702720964 -34.579172083568,-58.4957742094948 -34.5791297839276,-58.4957285844779 -34.5791645864658,-58.4955459139018 -34.5793042190449,-58.4954165296894 -34.5794049622169,-58.4952858674597 -34.5795044379329,-58.4944605177934 -34.5801332731927)))";;"836";12_20_8;COMUNA 12;"20";"8";"937";"451";"486";"92,80%";"436";"436";"100,00%";"0";"0,00%";"365";"35";"9.59";"330";"90,41%";"9.59";9.590
"MULTIPOLYGON (((-58.5010545854918 -34.5855862511444,-58.4999185787852 -34.5848829122575,-58.4997972944509 -34.5850145038389,-58.4991792124133 -34.5856985912048,-58.498528266228 -34.5864189540942,-58.4996665815238 -34.5871227275951,-58.5008006570282 -34.5878238859759,-58.5014504021686 -34.5871030889642,-58.5021880544098 -34.5862847208388,-58.5020157386037 -34.5861813215746,-58.5010545854918 -34.5855862511444)))";;"837";12_21_1;COMUNA 12;"21";"1";"1052";"479";"573";"83,60%";"588";"588";"100,00%";"0";"0,00%";"467";"2";"0.43";"465";"99,57%";"0.43";0.430
"MULTIPOLYGON (((-58.4901769210284 -34.5846204834184,-58.4895057000866 -34.5842049818993,-58.4887935939207 -34.5848181894367,-58.4889688735587 -34.5849300578091,-58.4895595287783 -34.5853025500667,-58.4902856969623 -34.5857604348949,-58.4908503012128 -34.5861164471956,-58.4914133771589 -34.5864714712664,-58.4919701550289 -34.5868224799812,-58.4925401396548 -34.5871819339516,-58.4926728442761 -34.5870361913185,-58.4931751398986 -34.586476537239,-58.4932924348812 -34.5863458687964,-58.4938262177205 -34.5857557098827,-58.4926935914568 -34.5850549086243,-58.4920425091876 -34.5857753778965,-58.4914746679135 -34.5854239495063,-58.4909075979157 -34.5850728704014,-58.4901769210284 -34.5846204834184)))";;"838";12_21_10;COMUNA 12;"21";"10";"664";"299";"365";"81,92%";"340";"340";"100,00%";"0";"0,00%";"258";"4";"1.55";"254";"98,45%";"1.55";1.550
"MULTIPOLYGON (((-58.4999185787852 -34.5848829122575,-58.4987851465106 -34.5841812521578,-58.4976570139988 -34.5834827490713,-58.4969154236589 -34.5842977108777,-58.4968212875612 -34.5844011921625,-58.4962636175663 -34.5850186959263,-58.497393803004 -34.5857174928318,-58.498528266228 -34.5864189540942,-58.4991792124133 -34.5856985912048,-58.4997972944509 -34.5850145038389,-58.4999185787852 -34.5848829122575)))";;"839";12_21_2;COMUNA 12;"21";"2";"1074";"482";"592";"81,42%";"530";"529";"99,81%";"1";"0,19%";"476";"44";"9.24";"432";"90,76%";"9.24";9.240
"MULTIPOLYGON (((-58.4946460044115 -34.5828932684176,-58.4941104586693 -34.5834866007847,-58.4939941901138 -34.5836154387491,-58.4951280851672 -34.5843165798955,-58.4962636175663 -34.5850186959263,-58.4968212875612 -34.5844011921625,-58.4969154236589 -34.5842977108777,-58.4976570139988 -34.5834827490713,-58.4965223421304 -34.5827802230338,-58.4953859859409 -34.5820766304302,-58.4952543996788 -34.5822192771108,-58.4946460044115 -34.5828932684176)))";;"840";12_21_3;COMUNA 12;"21";"3";"920";"441";"479";"92,07%";"437";"437";"100,00%";"0";"0,00%";"360";"16";"4.44";"344";"95,56%";"4.44";4.440
"MULTIPOLYGON (((-58.4953859859409 -34.5820766304302,-58.4942573992936 -34.5813778140814,-58.4934534936557 -34.5808847594365,-58.4932455258986 -34.5810233385253,-58.4925435063757 -34.5815929019471,-58.492405518894 -34.5817049120658,-58.4919396359691 -34.5821072242623,-58.4917515959997 -34.5822693885251,-58.4910425025679 -34.5828809888683,-58.4922111222428 -34.5836317990624,-58.4927419162981 -34.5830449553488,-58.4928597178942 -34.5829138645723,-58.4939941901138 -34.5836154387491,-58.4941104586693 -34.5834866007847,-58.4946460044115 -34.5828932684176,-58.4952543996788 -34.5822192771108,-58.4953859859409 -34.5820766304302)))";;"841";12_21_4;COMUNA 12;"21";"4";"1015";"471";"544";"86,58%";"529";"529";"100,00%";"0";"0,00%";"421";"2";"0.48";"419";"99,52%";"0.48";0.480
"MULTIPOLYGON (((-58.4922111222428 -34.5836317990624,-58.4910425025679 -34.5828809888683,-58.4905196565423 -34.5833319023289,-58.4904375942155 -34.5834026281332,-58.4902643604939 -34.583551828428,-58.4898324226652 -34.5839237010124,-58.4895057000866 -34.5842049818993,-58.4901769210284 -34.5846204834184,-58.4909075979157 -34.5850728704014,-58.4914746679135 -34.5854239495063,-58.4920425091876 -34.5857753778965,-58.4926935914568 -34.5850549086243,-58.4933450029698 -34.584334083587,-58.4938990301053 -34.5837209603921,-58.4939941901138 -34.5836154387491,-58.4928597178942 -34.5829138645723,-58.4927419162981 -34.5830449553488,-58.4922111222428 -34.5836317990624)))";;"842";12_21_5;COMUNA 12;"21";"5";"813";"383";"430";"89,07%";"220";"220";"100,00%";"0";"0,00%";"297";"2";"0.67";"295";"99,33%";"0.67";0.670
"MULTIPOLYGON (((-58.4956120550119 -34.5857379871369,-58.4961710973612 -34.5851211902978,-58.4962636175663 -34.5850186959263,-58.4951280851672 -34.5843165798955,-58.4939941901138 -34.5836154387491,-58.4938990301053 -34.5837209603921,-58.4933450029698 -34.584334083587,-58.4926935914568 -34.5850549086243,-58.4938262177205 -34.5857557098827,-58.4949580112352 -34.5864559373609,-58.4960923790369 -34.5871577733366,-58.4967426710618 -34.5864381279546,-58.4956120550119 -34.5857379871369)))";;"843";12_21_6;COMUNA 12;"21";"6";"869";"420";"449";"93,54%";"377";"377";"100,00%";"0";"0,00%";"326";"1";"0.31";"325";"99,69%";"0.31";0.310
"MULTIPOLYGON (((-58.4996665815238 -34.5871227275951,-58.498528266228 -34.5864189540942,-58.497393803004 -34.5857174928318,-58.4962636175663 -34.5850186959263,-58.4961710973612 -34.5851211902978,-58.4956120550119 -34.5857379871369,-58.4967426710618 -34.5864381279546,-58.4960923790369 -34.5871577733366,-58.49722659554 -34.587859457874,-58.4982243743096 -34.5884767315641,-58.4983646641478 -34.5885634546949,-58.4993553895929 -34.5891759321982,-58.4994996851679 -34.5892649064216,-58.5001487723551 -34.5885460181856,-58.5006915423446 -34.5879449812035,-58.5008006570282 -34.5878238859759,-58.4996665815238 -34.5871227275951)))";;"844";12_21_7;COMUNA 12;"21";"7";"957";"459";"498";"92,17%";"437";"437";"100,00%";"0";"0,00%";"340";"3";"0.88";"337";"99,12%";"0.88";0.880
"MULTIPOLYGON (((-58.49722659554 -34.587859457874,-58.4960923790369 -34.5871577733366,-58.4954407138873 -34.5878788944732,-58.4960070553743 -34.5882293891389,-58.4954727624604 -34.5888227266299,-58.4953611699577 -34.5889457896502,-58.4955923425811 -34.5890892544438,-58.4959279442245 -34.5892964957797,-58.4970663616913 -34.589999448064,-58.4982024984139 -34.590700911373,-58.4983331555568 -34.5905566421981,-58.4985388861328 -34.5903287559752,-58.4988480332199 -34.5899864680473,-58.4994996851679 -34.5892649064216,-58.4993553895929 -34.5891759321982,-58.4983646641478 -34.5885634546949,-58.4982243743096 -34.5884767315641,-58.49722659554 -34.587859457874)))";;"845";12_21_8;COMUNA 12;"21";"8";"803";"367";"436";"84,17%";"398";"397";"99,75%";"1";"0,25%";"319";"2";"0.63";"317";"99,37%";"0.63";0.630
"MULTIPOLYGON (((-58.4931751398986 -34.586476537239,-58.4926728442761 -34.5870361913185,-58.4925401396548 -34.5871819339516,-58.4936635142814 -34.587890203819,-58.4938905082861 -34.5880333207961,-58.49422533524 -34.588241060028,-58.4947944001007 -34.5885941653359,-58.4953611699577 -34.5889457896502,-58.4954727624604 -34.5888227266299,-58.4960070553743 -34.5882293891389,-58.4954407138873 -34.5878788944732,-58.4960923790369 -34.5871577733366,-58.4949580112352 -34.5864559373609,-58.4938262177205 -34.5857557098827,-58.4932924348812 -34.5863458687964,-58.4931751398986 -34.586476537239)))";;"846";12_21_9;COMUNA 12;"21";"9";"801";"372";"429";"86,71%";"322";"322";"100,00%";"0";"0,00%";"286";"0";"0";"286";"100,00%";"0";0.000
"MULTIPOLYGON (((-58.5124781845423 -34.5815088899911,-58.5124788259986 -34.581508931403,-58.5124782490811 -34.5815072453907,-58.5124781845423 -34.5815088899911)),((-58.5139210361742 -34.5823983008886,-58.5145715665768 -34.5816841235324,-58.5146967636712 -34.5815589789978,-58.5137517742771 -34.5815904512292,-58.5137105135037 -34.5816326292404,-58.5127389848112 -34.5816434811256,-58.5125614295895 -34.5816077672681,-58.5124794909084 -34.5815092970441,-58.5124788793931 -34.5815076486837,-58.5124782490811 -34.5815072453907,-58.5124793950708 -34.5815102964871,-58.5124781845423 -34.5815088899911,-58.510734645963 -34.5813963157695,-58.5104652236385 -34.5813788855707,-58.5106461451578 -34.5814911432117,-58.509834832963 -34.5823804395045,-58.510969187803 -34.5830867857332,-58.5111558211571 -34.5832030545753,-58.5118721168539 -34.5836441946103,-58.5124680561184 -34.5840112215865,-58.513272541256 -34.5831174036351,-58.5138138189016 -34.5825160971538,-58.5139210361742 -34.5823983008886)))";;"847";12_22_1;COMUNA 12;"22";"1";"788";"364";"424";"85,85%";"330";"330";"100,00%";"0";"0,00%";"294";"2";"0.68";"292";"99,32%";"0.68";0.680
"MULTIPOLYGON (((-58.4994996851679 -34.5892649064216,-58.4988480332199 -34.5899864680473,-58.4985388861328 -34.5903287559752,-58.4983331555568 -34.5905566421981,-58.4982024984139 -34.590700911373,-58.4994872980186 -34.5914941539241,-58.5008170994647 -34.5923152572159,-58.5009302207879 -34.5921910619917,-58.5011551861597 -34.5919451365104,-58.501466798875 -34.5916044610464,-58.5015817910571 -34.5914787152529,-58.5021190383649 -34.590885984157,-58.5027738195151 -34.5901636294726,-58.5022365693419 -34.5898318196299,-58.5021044522575 -34.589753056396,-58.5019762537381 -34.589676545368,-58.5014381578051 -34.5893436758736,-58.5001487723551 -34.5885460181856,-58.4994996851679 -34.5892649064216)))";;"848";12_22_10;COMUNA 12;"22";"10";"964";"457";"507";"90,14%";"404";"404";"100,00%";"0";"0,00%";"370";"7";"1.89";"363";"98,11%";"1.89";1.890
"MULTIPOLYGON (((-58.502781941557 -34.5912942351614,-58.5022377835182 -34.5909567936301,-58.5021190383649 -34.590885984157,-58.5015817910571 -34.5914787152529,-58.501466798875 -34.5916044610464,-58.5011551861597 -34.5919451365104,-58.5009302207879 -34.5921910619917,-58.5008170994647 -34.5923152572159,-58.5019281694047 -34.5930011998104,-58.5021419863206 -34.5931333896228,-58.5033113467367 -34.5938561331024,-58.5034718395455 -34.593953548201,-58.5041168446016 -34.5932415424554,-58.5047686476714 -34.5925219249444,-58.503439911621 -34.5917017799288,-58.5032996113054 -34.5916152035348,-58.502781941557 -34.5912942351614)))";;"849";12_22_11;COMUNA 12;"22";"11";"955";"422";"533";"79,17%";"464";"464";"100,00%";"0";"0,00%";"371";"5";"1.35";"366";"98,65%";"1.35";1.350
"MULTIPOLYGON (((-58.5087660757998 -34.5812352369734,-58.5078714580699 -34.5811594414434,-58.5068985877175 -34.5810792309137,-58.5065352971559 -34.58147994186,-58.5064313046903 -34.581594631784,-58.5062059589299 -34.5818443000761,-58.5058799371181 -34.582205627916,-58.506030701264 -34.5822989586095,-58.5071641703296 -34.5830034390542,-58.5078411773882 -34.5834241232807,-58.5083581367061 -34.5837454230128,-58.5085127387334 -34.583839664709,-58.5091731105919 -34.5831103711097,-58.5097265886546 -34.5824991481094,-58.509834832963 -34.5823804395045,-58.5106461451578 -34.5814911432117,-58.5104652236385 -34.5813788855707,-58.509460839281 -34.581291946956,-58.5087660757998 -34.5812352369734)))";;"850";12_22_2;COMUNA 12;"22";"2";"954";"444";"510";"87,06%";"416";"416";"100,00%";"0";"0,00%";"362";"3";"0.83";"359";"99,17%";"0.83";0.830
"MULTIPOLYGON (((-58.5111558211571 -34.5832030545753,-58.510969187803 -34.5830867857332,-58.509834832963 -34.5823804395045,-58.5097265886546 -34.5824991481094,-58.5091731105919 -34.5831103711097,-58.5085127387334 -34.583839664709,-58.5091726334244 -34.5842417556008,-58.5096873846808 -34.5845554445521,-58.5098411385796 -34.5846503891324,-58.5105680031855 -34.5850992794252,-58.5098936591632 -34.5858225291558,-58.5104927579023 -34.5861928744144,-58.5110406295898 -34.5855868594337,-58.5111544070748 -34.5854613866881,-58.511810258914 -34.5847377852701,-58.5123572615229 -34.5841343703327,-58.5124680561184 -34.5840112215865,-58.5118721168539 -34.5836441946103,-58.5111558211571 -34.5832030545753)))";;"851";12_22_3;COMUNA 12;"22";"3";"786";"347";"439";"79,04%";"343";"343";"100,00%";"0";"0,00%";"299";"0";"0";"299";"100,00%";"0";0.000
"MULTIPOLYGON (((-58.5085127387334 -34.583839664709,-58.5083581367061 -34.5837454230128,-58.5078411773882 -34.5834241232807,-58.5071641703296 -34.5830034390542,-58.5066224991784 -34.583601265315,-58.5065039518727 -34.5837323696212,-58.5058001493476 -34.5845106801444,-58.5064786947831 -34.5849318642572,-58.5070045168317 -34.585258237091,-58.5071483024412 -34.5853464278335,-58.5078069262476 -34.5857504983818,-58.5083084795811 -34.5860582822141,-58.5084710937247 -34.5861587183653,-58.5091782061085 -34.5853802505432,-58.5098411385796 -34.5846503891324,-58.5096873846808 -34.5845554445521,-58.5091726334244 -34.5842417556008,-58.5085127387334 -34.583839664709)))";;"852";12_22_4;COMUNA 12;"22";"4";"885";"419";"466";"89,91%";"338";"338";"100,00%";"0";"0,00%";"299";"0";"0";"299";"100,00%";"0";0.000
"MULTIPOLYGON (((-58.5097882910732 -34.5869719825545,-58.5104927579023 -34.5861928744144,-58.5098936591632 -34.5858225291558,-58.5105680031855 -34.5850992794252,-58.5098411385796 -34.5846503891324,-58.5091782061085 -34.5853802505432,-58.5084710937247 -34.5861587183653,-58.5078286474446 -34.5868660284686,-58.507702777796 -34.5870040382646,-58.5075965670144 -34.5871205609576,-58.506921595014 -34.5878630204007,-58.5076368016883 -34.5883048191715,-58.5068935642157 -34.5891223064388,-58.5075041724639 -34.5894979438963,-58.5082440006785 -34.5886798204058,-58.5090218557351 -34.5878196339544,-58.5097882910732 -34.5869719825545)))";;"853";12_22_5;COMUNA 12;"22";"5";"1207";"575";"632";"90,98%";"422";"422";"100,00%";"0";"0,00%";"435";"1";"0.23";"434";"99,77%";"0.23";0.230
"MULTIPOLYGON (((-58.5084710937247 -34.5861587183653,-58.5083084795811 -34.5860582822141,-58.5078069262476 -34.5857504983818,-58.5071483024412 -34.5853464278335,-58.506382875743 -34.5861915976356,-58.5062828772876 -34.5863021308195,-58.5056089233681 -34.5870471180546,-58.5049779370953 -34.5877446903299,-58.5048481437735 -34.5878817829938,-58.505015015006 -34.5879820109737,-58.5055152050005 -34.5882820598541,-58.506018039249 -34.5885836550877,-58.5061776739044 -34.5886818416983,-58.5068935642157 -34.5891223064388,-58.5076368016883 -34.5883048191715,-58.506921595014 -34.5878630204007,-58.5075965670144 -34.5871205609576,-58.507702777796 -34.5870040382646,-58.5078286474446 -34.5868660284686,-58.5084710937247 -34.5861587183653)))";;"854";12_22_6;COMUNA 12;"22";"6";"1119";"517";"602";"85,88%";"555";"555";"100,00%";"0";"0,00%";"448";"0";"0";"448";"100,00%";"0";0.000
"MULTIPOLYGON (((-58.5040766240706 -34.5887262358488,-58.5034239081809 -34.5894464138102,-58.5046098386582 -34.5901787176156,-58.5047445161884 -34.5902627591491,-58.504896060624 -34.5903572176524,-58.5053351053615 -34.5906277096337,-58.5060719641456 -34.59108176381,-58.5067238179889 -34.5903608679403,-58.5075041724639 -34.5894979438963,-58.5068935642157 -34.5891223064388,-58.5061776739044 -34.5886818416983,-58.506018039249 -34.5885836550877,-58.5055152050005 -34.5882820598541,-58.505015015006 -34.5879820109737,-58.5048481437735 -34.5878817829938,-58.5047019236996 -34.5880363466622,-58.5040766240706 -34.5887262358488)))";;"855";12_22_7;COMUNA 12;"22";"7";"1121";"503";"618";"81,39%";"549";"549";"100,00%";"0";"0,00%";"459";"3";"0.65";"456";"99,35%";"0.65";0.650
"MULTIPOLYGON (((-58.503439911621 -34.5917017799288,-58.5047686476714 -34.5925219249444,-58.5052848561924 -34.5919520754992,-58.5054223118677 -34.5918000496095,-58.5060719641456 -34.59108176381,-58.5053351053615 -34.5906277096337,-58.504896060624 -34.5903572176524,-58.5047445161884 -34.5902627591491,-58.5046098386582 -34.5901787176156,-58.5034239081809 -34.5894464138102,-58.5027738195151 -34.5901636294726,-58.5021190383649 -34.590885984157,-58.5022377835182 -34.5909567936301,-58.502781941557 -34.5912942351614,-58.5032996113054 -34.5916152035348,-58.503439911621 -34.5917017799288)))";;"856";12_22_8;COMUNA 12;"22";"8";"982";"465";"517";"89,94%";"386";"386";"100,00%";"0";"0,00%";"365";"5";"1.37";"360";"98,63%";"1.37";1.370
"MULTIPOLYGON (((-58.5028468278188 -34.5866802261537,-58.5021880544098 -34.5862847208388,-58.5014504021686 -34.5871030889642,-58.5008006570282 -34.5878238859759,-58.5006915423446 -34.5879449812035,-58.5001487723551 -34.5885460181856,-58.5014381578051 -34.5893436758736,-58.5019762537381 -34.589676545368,-58.5021044522575 -34.589753056396,-58.5022365693419 -34.5898318196299,-58.5027738195151 -34.5901636294726,-58.5034239081809 -34.5894464138102,-58.5040766240706 -34.5887262358488,-58.5047019236996 -34.5880363466622,-58.5048481437735 -34.5878817829938,-58.5041769149937 -34.5874788277108,-58.5034892529115 -34.5870659442221,-58.5028468278188 -34.5866802261537)))";;"857";12_22_9;COMUNA 12;"22";"9";"920";"420";"500";"84,00%";"448";"447";"99,78%";"1";"0,22%";"365";"5";"1.37";"360";"98,63%";"1.37";1.370
"MULTIPOLYGON (((-58.4875166412796 -34.5449771929105,-58.48693435654 -34.5457467828567,-58.4863475517471 -34.5465223570044,-58.4857639692173 -34.547293561225,-58.4860280335584 -34.5474333767837,-58.4876109886469 -34.5482637368381,-58.4888726079426 -34.5489251235783,-58.4894602618386 -34.5481636930092,-58.4900502872977 -34.5473993715289,-58.490500788115 -34.5476220971464,-58.4907565145163 -34.5472379361247,-58.4908568085596 -34.5470718489009,-58.4909169264742 -34.546900277665,-58.490925046025 -34.5467480151075,-58.4909243200329 -34.5467476375517,-58.4914707905649 -34.5459807327093,-58.4917413121306 -34.5456010824922,-58.4901656102559 -34.5449055610469,-58.4882041315847 -34.5440397113978,-58.4879284240267 -34.5444025131022,-58.4874987399463 -34.5449679239097,-58.4875166412796 -34.5449771929105)))";;"858";12_3_1;COMUNA 12;"3";"1";"232";"111";"121";"91,74%";"126";"126";"100,00%";"0";"0,00%";"104";"1";"0.96";"103";"99,04%";"0.96";0.960
"MULTIPOLYGON (((-58.4838041035814 -34.5516048208504,-58.4843759925903 -34.5508514463362,-58.4849636124779 -34.550077290571,-58.4847345321337 -34.5499654959375,-58.4841990773232 -34.5497042411975,-58.484014433449 -34.5496058182786,-58.4830932636329 -34.5491146850901,-58.4826401314038 -34.5488731289294,-58.4821757652134 -34.5486260796548,-58.4815980865642 -34.5493923329606,-58.4814924031519 -34.5495324966497,-58.4816009387759 -34.5495841020211,-58.4817755373249 -34.5496885163546,-58.4820076882811 -34.549848416891,-58.482226562253 -34.5500101501767,-58.4823409863789 -34.5501227426963,-58.4824347224622 -34.550215055819,-58.4825815122189 -34.5504132806558,-58.4827040450919 -34.5506158052602,-58.4827761352078 -34.5508558947847,-58.482797776013 -34.5509381805512,-58.4827981037103 -34.5509835533549,-58.4827978236139 -34.5511361519622,-58.4827214542277 -34.5512411132101,-58.4825819132407 -34.5514350759283,-58.4823740301848 -34.5516272167632,-58.4822689227324 -34.5516788445322,-58.4822157916002 -34.551705614232,-58.4820598022479 -34.5517820898969,-58.482280457969 -34.5518972008785,-58.4832129734178 -34.5523834786855,-58.4838041035814 -34.5516048208504)))";;"859";12_3_10;COMUNA 12;"3";"10";"878";"433";"445";"97,30%";"363";"363";"100,00%";"0";"0,00%";"305";"5";"1.64";"300";"98,36%";"1.64";1.640
"MULTIPOLYGON (((-58.4838041035814 -34.5516048208504,-58.4832129734178 -34.5523834786855,-58.4841416687992 -34.5528677780789,-58.4850722482185 -34.5533543940731,-58.4856654112407 -34.5525773467731,-58.4862445237971 -34.5518188211877,-58.4868354527852 -34.5510446559011,-58.4859028464133 -34.5505595324847,-58.4851382962306 -34.5501625442509,-58.4849636124779 -34.550077290571,-58.4843759925903 -34.5508514463362,-58.4838041035814 -34.5516048208504)))";;"860";12_3_11;COMUNA 12;"3";"11";"785";"363";"422";"86,02%";"346";"345";"99,71%";"1";"0,29%";"290";"6";"2.07";"284";"97,93%";"2.07";2.070
"MULTIPOLYGON (((-58.4879284240267 -34.5444025131022,-58.4882041315847 -34.5440397113978,-58.4862462932345 -34.5431754192464,-58.4859857199263 -34.5435391274638,-58.4856534657711 -34.5440028823806,-58.485669696794 -34.5440114521478,-58.48508280657 -34.5447842034194,-58.4844991386465 -34.545552584796,-58.4839172468091 -34.5463187093521,-58.4844492789666 -34.5465971499947,-58.484837112013 -34.5468025829288,-58.4857639692173 -34.547293561225,-58.4863475517471 -34.5465223570044,-58.48693435654 -34.5457467828567,-58.4875166412796 -34.5449771929105,-58.4874987399463 -34.5449679239097,-58.4879284240267 -34.5444025131022)))";;"861";12_3_2;COMUNA 12;"3";"2";"698";"329";"369";"89,16%";"268";"268";"100,00%";"0";"0,00%";"249";"0";"0";"249";"100,00%";"0";0.000
"MULTIPOLYGON (((-58.4835775027289 -34.5450724414448,-58.4829950944892 -34.5458360264252,-58.4839172468091 -34.5463187093521,-58.4844991386465 -34.545552584796,-58.48508280657 -34.5447842034194,-58.485669696794 -34.5440114521478,-58.4856534657711 -34.5440028823806,-58.4859857199263 -34.5435391274638,-58.4862462932345 -34.5431754192464,-58.4833503619818 -34.5418969133078,-58.4830891993334 -34.5422655842787,-58.4828429410009 -34.5426132120224,-58.482844774493 -34.5426139969535,-58.48229666644 -34.5433358106934,-58.4817117067873 -34.5441061510639,-58.4826533243941 -34.5445937704566,-58.4835775027289 -34.5450724414448)))";;"862";12_3_3;COMUNA 12;"3";"3";"824";"371";"453";"81,90%";"313";"312";"99,68%";"1";"0,32%";"270";"2";"0.74";"268";"99,26%";"0.74";0.740
"MULTIPOLYGON (((-58.4805515403626 -34.5456338633281,-58.4799622940241 -34.5464097593025,-58.4809028214997 -34.546900138769,-58.4811860283244 -34.5470451030412,-58.4818291428321 -34.5473772731179,-58.4824128464881 -34.5466023551165,-58.4825906782493 -34.5463662588211,-58.4829950944892 -34.5458360264252,-58.4835775027289 -34.5450724414448,-58.4826533243941 -34.5445937704566,-58.4817117067873 -34.5441061510639,-58.4811292038782 -34.5448731781502,-58.4805515403626 -34.5456338633281)))";;"863";12_3_4;COMUNA 12;"3";"4";"805";"373";"432";"86,34%";"304";"303";"99,67%";"1";"0,33%";"268";"10";"3.73";"258";"96,27%";"3.73";3.730
"MULTIPOLYGON (((-58.4851838644577 -34.5480603250935,-58.4857639692173 -34.547293561225,-58.484837112013 -34.5468025829288,-58.4844492789666 -34.5465971499947,-58.4839172468091 -34.5463187093521,-58.4829950944892 -34.5458360264252,-58.4825906782493 -34.5463662588211,-58.4824128464881 -34.5466023551165,-58.4818291428321 -34.5473772731179,-58.4822793685917 -34.547609818308,-58.4827557306223 -34.5478566539834,-58.4836773067394 -34.5483341271417,-58.4844639661732 -34.5487416845823,-58.4846081735274 -34.5488210991248,-58.4848539878572 -34.5484962508594,-58.4851838644577 -34.5480603250935)))";;"864";12_3_5;COMUNA 12;"3";"5";"819";"368";"451";"81,60%";"341";"341";"100,00%";"0";"0,00%";"292";"8";"2.74";"284";"97,26%";"2.74";2.740
"MULTIPOLYGON (((-58.4848539878572 -34.5484962508594,-58.4846081735274 -34.5488210991248,-58.4854096615946 -34.549262663448,-58.4855322473132 -34.5493281365993,-58.4864645009085 -34.5498258692368,-58.4872513568126 -34.5502286900468,-58.487399398985 -34.5503057764495,-58.4876613466247 -34.5504422083936,-58.4882487650765 -34.5496749385449,-58.4884921093544 -34.5493824089707,-58.4888726079426 -34.5489251235783,-58.4876109886469 -34.5482637368381,-58.4860280335584 -34.5474333767837,-58.4857639692173 -34.547293561225,-58.4851838644577 -34.5480603250935,-58.4848539878572 -34.5484962508594)))";;"865";12_3_6;COMUNA 12;"3";"6";"1820";"890";"930";"95,70%";"347";"346";"99,71%";"1";"0,29%";"451";"30";"6.65";"421";"93,35%";"6.65";6.650
"MULTIPOLYGON (((-58.4855322473132 -34.5493281365993,-58.4854096615946 -34.549262663448,-58.4846081735274 -34.5488210991248,-58.484014433449 -34.5496058182786,-58.4841990773232 -34.5497042411975,-58.4847345321337 -34.5499654959375,-58.4849636124779 -34.550077290571,-58.4851382962306 -34.5501625442509,-58.4859028464133 -34.5505595324847,-58.4868354527852 -34.5510446559011,-58.4869401086055 -34.550907516137,-58.487399398985 -34.5503057764495,-58.4872513568126 -34.5502286900468,-58.4864645009085 -34.5498258692368,-58.4855322473132 -34.5493281365993)))";;"866";12_3_7;COMUNA 12;"3";"7";"1009";"448";"561";"79,86%";"422";"422";"100,00%";"0";"0,00%";"378";"4";"1.06";"374";"98,94%";"1.06";1.060
"MULTIPOLYGON (((-58.4827557306223 -34.5478566539834,-58.4822793685917 -34.547609818308,-58.4818291428321 -34.5473772731179,-58.4811860283244 -34.5470451030412,-58.4809028214997 -34.546900138769,-58.4799622940241 -34.5464097593025,-58.4793940544886 -34.5471579721093,-58.4803339067722 -34.5476513843003,-58.4810824937338 -34.5480443909202,-58.4812567453463 -34.5481370449606,-58.4821757652134 -34.5486260796548,-58.4826401314038 -34.5488731289294,-58.4830932636329 -34.5491146850901,-58.484014433449 -34.5496058182786,-58.4846081735274 -34.5488210991248,-58.4844639661732 -34.5487416845823,-58.4836773067394 -34.5483341271417,-58.4827557306223 -34.5478566539834)))";;"867";12_3_8;COMUNA 12;"3";"8";"724";"330";"394";"83,76%";"303";"302";"99,67%";"1";"0,33%";"253";"3";"1.19";"250";"98,81%";"1.19";1.190
"MULTIPOLYGON (((-58.4782037647391 -34.5487250334682,-58.4776297071242 -34.5494807036603,-58.4772534914759 -34.5499724621258,-58.4770414267735 -34.5502496127849,-58.4770999961818 -34.5502991152356,-58.4771431630992 -34.5503702402039,-58.4772068575242 -34.5505223523968,-58.4773062238672 -34.5507159410896,-58.4774483242091 -34.5509332580362,-58.4775803667791 -34.551068952534,-58.4776645623463 -34.5511442274239,-58.4777422028853 -34.5512136577213,-58.478018024094 -34.5514163088743,-58.4782204607266 -34.5515469231601,-58.4784520908925 -34.5516620396702,-58.4785429211361 -34.55170569191,-58.4786857640431 -34.5517744792911,-58.4789362879949 -34.5518692393495,-58.4792176247136 -34.5519589944969,-58.4793749318057 -34.5519922140876,-58.4795897810223 -34.5520319047019,-58.4796849480568 -34.5520494979477,-58.4801061296889 -34.5521017649923,-58.4804712104334 -34.5521179807585,-58.4805856484997 -34.552126156475,-58.480786760373 -34.5521713828635,-58.4809367020093 -34.5521089693261,-58.4812631397248 -34.5520255779188,-58.4816679450529 -34.5519196929689,-58.4820598022479 -34.5517820898969,-58.4822157916002 -34.551705614232,-58.4822689227324 -34.5516788445322,-58.4823740301848 -34.5516272167632,-58.4825819132407 -34.5514350759283,-58.4827214542277 -34.5512411132101,-58.4827978236139 -34.5511361519622,-58.4827981037103 -34.5509835533549,-58.482797776013 -34.5509381805512,-58.4827761352078 -34.5508558947847,-58.4827040450919 -34.5506158052602,-58.4825815122189 -34.5504132806558,-58.4824347224622 -34.550215055819,-58.4823409863789 -34.5501227426963,-58.482226562253 -34.5500101501767,-58.4820076882811 -34.549848416891,-58.4817755373249 -34.5496885163546,-58.4816009387759 -34.5495841020211,-58.4814924031519 -34.5495324966497,-58.4815980865642 -34.5493923329606,-58.4821757652134 -34.5486260796548,-58.4812567453463 -34.5481370449606,-58.4810824937338 -34.5480443909202,-58.4803339067722 -34.5476513843003,-58.4793940544886 -34.5471579721093,-58.4789719100794 -34.5477137594119,-58.4787969580499 -34.5479441455148,-58.4782037647391 -34.5487250334682)))";;"868";12_3_9;COMUNA 12;"3";"9";"669";"325";"344";"94,48%";"235";"234";"99,57%";"1";"0,43%";"223";"2";"0.9";"221";"99,10%";"0.9";0.900
"MULTIPOLYGON (((-58.480510362375 -34.5437142713053,-58.4803118841792 -34.5441203757299,-58.4801052363356 -34.5445409182744,-58.4797009526404 -34.5453637606746,-58.4792967460755 -34.5461864607643,-58.4799622940241 -34.5464097593025,-58.4805515403626 -34.5456338633281,-58.4811292038782 -34.5448731781502,-58.4817117067873 -34.5441061510639,-58.48229666644 -34.5433358106934,-58.482844774493 -34.5426139969535,-58.4828429410009 -34.5426132120224,-58.4830891993334 -34.5422655842787,-58.4833503619818 -34.5418969133078,-58.4817448523079 -34.5411880606736,-58.4815375961395 -34.5415966110013,-58.4813085750205 -34.54204806005,-58.4813221205773 -34.5420528033684,-58.4809152246314 -34.5428855805699,-58.480510362375 -34.5437142713053)))";;"869";12_4_1;COMUNA 12;"4";"1";"769";"377";"392";"96,17%";"284";"284";"100,00%";"0";"0,00%";"277";"0";"0";"277";"100,00%";"0";0.000
"MULTIPOLYGON (((-58.4793940544886 -34.5471579721093,-58.4779002952606 -34.5466825814426,-58.4773531514127 -34.5465027102752,-58.4768893404195 -34.5463483211549,-58.4758888627781 -34.5460152485864,-58.4754841060691 -34.5468458237277,-58.4750847019331 -34.5476654104415,-58.4760783876237 -34.5480029975045,-58.4770974472702 -34.5483491654236,-58.4782037647391 -34.5487250334682,-58.4787969580499 -34.5479441455148,-58.4789719100794 -34.5477137594119,-58.4793940544886 -34.5471579721093)))";;"870";12_4_10;COMUNA 12;"4";"10";"630";"312";"318";"98,11%";"293";"292";"99,66%";"1";"0,34%";"243";"0";"0";"243";"100,00%";"0";0.000
"MULTIPOLYGON (((-58.478703793795 -34.545024583603,-58.4783638148039 -34.5457158575602,-58.4782979630232 -34.5458532668445,-58.4779002952606 -34.5466825814426,-58.4793940544886 -34.5471579721093,-58.4799622940241 -34.5464097593025,-58.4792967460755 -34.5461864607643,-58.4797009526404 -34.5453637606746,-58.4801052363356 -34.5445409182744,-58.4803118841792 -34.5441203757299,-58.480510362375 -34.5437142713053,-58.4809152246314 -34.5428855805699,-58.4813221205773 -34.5420528033684,-58.4813085750205 -34.54204806005,-58.4815375961395 -34.5415966110013,-58.4817448523079 -34.5411880606736,-58.4807407846545 -34.5407447353444,-58.4805589150493 -34.5411746372415,-58.4803189606537 -34.5417418322746,-58.480306361136 -34.5417389249298,-58.4799111128775 -34.5425534568423,-58.4795074344452 -34.5433852428712,-58.4793142274571 -34.5437833868463,-58.4791041722558 -34.5442104777908,-58.478703793795 -34.545024583603)))";;"871";12_4_2;COMUNA 12;"4";"2";"788";"386";"402";"96,02%";"327";"327";"100,00%";"0";"0,00%";"287";"12";"4.18";"275";"95,82%";"4.18";4.180
"MULTIPOLYGON (((-58.4768893404195 -34.5463483211549,-58.4773531514127 -34.5465027102752,-58.4779002952606 -34.5466825814426,-58.4782979630232 -34.5458532668445,-58.4783638148039 -34.5457158575602,-58.478703793795 -34.545024583603,-58.4791041722558 -34.5442104777908,-58.4793142274571 -34.5437833868463,-58.4795074344452 -34.5433852428712,-58.4785029823154 -34.5430556429711,-58.4777663096881 -34.5428139639892,-58.4775070495158 -34.5427284282377,-58.4774172063242 -34.5429151381472,-58.4771026636507 -34.5435498537772,-58.4767047351955 -34.54435261427,-58.4763666984662 -34.5450345863072,-58.4762942921059 -34.5451831929732,-58.4760904298109 -34.5456016155674,-58.4758888627781 -34.5460152485864,-58.4768893404195 -34.5463483211549)))";;"872";12_4_3;COMUNA 12;"4";"3";"1088";"512";"576";"88,89%";"471";"469";"99,58%";"2";"0,43%";"418";"0";"0";"418";"100,00%";"0";0.000
"MULTIPOLYGON (((-58.4794542959375 -34.5411142261216,-58.4793103511348 -34.5414080626954,-58.4783038800449 -34.5410736723595,-58.4773029493339 -34.5407411041204,-58.4769020605965 -34.5415629513994,-58.4766986355092 -34.5419801779644,-58.47649631441 -34.5423949391311,-58.4775070495158 -34.5427284282377,-58.4777663096881 -34.5428139639892,-58.4785029823154 -34.5430556429711,-58.4795074344452 -34.5433852428712,-58.4799111128775 -34.5425534568423,-58.480306361136 -34.5417389249298,-58.4803189606537 -34.5417418322746,-58.4805589150493 -34.5411746372415,-58.4807407846545 -34.5407447353444,-58.4797303239552 -34.5402985741827,-58.4795973855621 -34.540734320608,-58.4795108184607 -34.5410180683444,-58.4795024463648 -34.5410104821325,-58.4794542959375 -34.5411142261216)))";;"873";12_4_4;COMUNA 12;"4";"4";"952";"467";"485";"96,29%";"331";"329";"99,40%";"2";"0,61%";"295";"2";"0.68";"293";"99,32%";"0.68";0.680
"MULTIPOLYGON (((-58.4773029493339 -34.5407411041204,-58.4783038800449 -34.5410736723595,-58.4793103511348 -34.5414080626954,-58.4794542959375 -34.5411142261216,-58.4795024463648 -34.5410104821325,-58.4795108184607 -34.5410180683444,-58.4795973855621 -34.540734320608,-58.4797349910384 -34.5402992203503,-58.4778771135634 -34.5394802691737,-58.4759124478323 -34.5386126859104,-58.4757611500952 -34.5388303281328,-58.4754113100596 -34.539333568928,-58.4754114680994 -34.5393336422144,-58.4754080163553 -34.5393383068493,-58.4749273931792 -34.5399878076996,-58.475414906155 -34.5401211289392,-58.4753831720193 -34.5401830488408,-58.4753469053104 -34.540259979288,-58.4750127264388 -34.5409456621013,-58.474818230042 -34.5413644340466,-58.474718683866 -34.5415786090805,-58.4746233048374 -34.5417739799016,-58.4756224498819 -34.5421060068297,-58.4758948989364 -34.5421965454063,-58.47649631441 -34.5423949391311,-58.4766986355092 -34.5419801779644,-58.4769020605965 -34.5415629513994,-58.4773029493339 -34.5407411041204)))";;"874";12_4_5;COMUNA 12;"4";"5";"606";"283";"323";"87,62%";"298";"298";"100,00%";"0";"0,00%";"249";"2";"0.8";"247";"99,20%";"0.8";0.800
"MULTIPOLYGON (((-58.4775070495158 -34.5427284282377,-58.47649631441 -34.5423949391311,-58.4758948989364 -34.5421965454063,-58.4756224498819 -34.5421060068297,-58.4746233048374 -34.5417739799016,-58.4742211085521 -34.5425986354076,-58.473834390208 -34.5433913147144,-58.4748064852318 -34.5437168010851,-58.4757097292475 -34.5440192577906,-58.4765545049366 -34.5443021360526,-58.4767047351955 -34.54435261427,-58.4771026636507 -34.5435498537772,-58.4774172063242 -34.5429151381472,-58.4775070495158 -34.5427284282377)))";;"875";12_4_6;COMUNA 12;"4";"6";"760";"344";"416";"82,69%";"368";"367";"99,73%";"1";"0,27%";"297";"2";"0.67";"295";"99,33%";"0.67";0.670
"MULTIPOLYGON (((-58.4743560065406 -34.540759872552,-58.473786311236 -34.5415297512776,-58.4732360070986 -34.5422734271423,-58.4726919052075 -34.5430086488228,-58.4720939267085 -34.5438166925126,-58.4715370398085 -34.5445693050373,-58.4727249335674 -34.5449655827108,-58.4727249923627 -34.5449654292516,-58.4728713912469 -34.5450142222733,-58.4729654441153 -34.5450456243409,-58.4734046876309 -34.5442179417441,-58.4737324553008 -34.54360020715,-58.473834390208 -34.5433913147144,-58.4742211085521 -34.5425986354076,-58.4746233048374 -34.5417739799016,-58.474718683866 -34.5415786090805,-58.474818230042 -34.5413644340466,-58.4750127264388 -34.5409456621013,-58.4753469053104 -34.540259979288,-58.4753831720193 -34.5401830488408,-58.475414906155 -34.5401211289392,-58.4749273931792 -34.5399878076996,-58.4746773117793 -34.5403257360783,-58.4743560065406 -34.540759872552)))";;"876";12_4_7;COMUNA 12;"4";"7";"1071";"476";"595";"80,00%";"653";"653";"100,00%";"0";"0,00%";"499";"3";"0.6";"496";"99,40%";"0.6";0.600
"MULTIPOLYGON (((-58.4734046876309 -34.5442179417441,-58.4729654441153 -34.5450456243409,-58.4736359877457 -34.5452691682627,-58.4739054658301 -34.5453583029789,-58.4749010757312 -34.5456876597514,-58.4754951088319 -34.5458841575302,-58.4758888627781 -34.5460152485864,-58.4760904298109 -34.5456016155674,-58.4762942921059 -34.5451831929732,-58.4763666984662 -34.5450345863072,-58.4767047351955 -34.54435261427,-58.4765545049366 -34.5443021360526,-58.4757097292475 -34.5440192577906,-58.4748064852318 -34.5437168010851,-58.473834390208 -34.5433913147144,-58.4737324553008 -34.54360020715,-58.4734046876309 -34.5442179417441)))";;"877";12_4_8;COMUNA 12;"4";"8";"786";"376";"410";"91,71%";"355";"355";"100,00%";"0";"0,00%";"289";"11";"3.81";"278";"96,19%";"3.81";3.810
"MULTIPOLYGON (((-58.47350920012 -34.5461593624516,-58.4731009287634 -34.5469849297522,-58.4741005572625 -34.5473290116213,-58.4745762859346 -34.5474927063621,-58.4750847019331 -34.5476654104415,-58.4754841060691 -34.5468458237277,-58.4758888627781 -34.5460152485864,-58.4754951088319 -34.5458841575302,-58.4749010757312 -34.5456876597514,-58.4739054658301 -34.5453583029789,-58.47350920012 -34.5461593624516)))";;"878";12_4_9;COMUNA 12;"4";"9";"594";"264";"330";"80,00%";"279";"279";"100,00%";"0";"0,00%";"224";"1";"0.45";"223";"99,55%";"0.45";0.450
"MULTIPOLYGON (((-58.4770974472702 -34.5483491654236,-58.4760783876237 -34.5480029975045,-58.4750847019331 -34.5476654104415,-58.4746812907077 -34.548493235955,-58.4742958259708 -34.5492840847652,-58.4742475774328 -34.549375009072,-58.4741024057004 -34.5496484861678,-58.4751683567461 -34.5498598002712,-58.4762231624374 -34.5500688526698,-58.4768893987949 -34.5502023748282,-58.4770414267735 -34.5502496127849,-58.4772534914759 -34.5499724621258,-58.4776297071242 -34.5494807036603,-58.4782037647391 -34.5487250334682,-58.4770974472702 -34.5483491654236)))";;"879";12_5_1;COMUNA 12;"5";"1";"622";"298";"324";"91,98%";"256";"256";"100,00%";"0";"0,00%";"212";"0";"0";"212";"100,00%";"0";0.000
"MULTIPOLYGON (((-58.4752021256222 -34.5514157141355,-58.4745095576634 -34.5523244870683,-58.4744359426856 -34.5524209070665,-58.4751018041803 -34.5527892385182,-58.4751738868055 -34.5526945084998,-58.4758785346552 -34.5517675606967,-58.4762694883066 -34.5512531278664,-58.4764607088382 -34.5510045738191,-58.4770414267735 -34.5502496127849,-58.4768893987949 -34.5502023748282,-58.4762231624374 -34.5500688526698,-58.4751683567461 -34.5498598002712,-58.4741024057004 -34.5496484861678,-58.4740153395589 -34.5497112436698,-58.4749095628719 -34.550184418993,-58.4743219341371 -34.5509579629679,-58.4752021256222 -34.5514157141355)))";;"880";12_5_10;COMUNA 12;"5";"10";"695";"327";"368";"88,86%";"326";"326";"100,00%";"0";"0,00%";"284";"26";"9.15";"258";"90,85%";"9.15";9.150
"MULTIPOLYGON (((-58.472585329041 -34.5500527217375,-58.4717129121386 -34.5495974159312,-58.4710691726744 -34.5504436983176,-58.4710076405789 -34.5505246217725,-58.4718635523529 -34.550998033219,-58.4727035555603 -34.5514627071339,-58.4735728512412 -34.5519435705605,-58.4744359426856 -34.5524209070665,-58.4745095576634 -34.5523244870683,-58.4752021256222 -34.5514157141355,-58.4743219341371 -34.5509579629679,-58.4737006132736 -34.5506347660875,-58.4734293241867 -34.5504931639311,-58.472585329041 -34.5500527217375)))";;"881";12_5_11;COMUNA 12;"5";"11";"793";"365";"428";"85,28%";"377";"377";"100,00%";"0";"0,00%";"332";"31";"9.34";"301";"90,66%";"9.34";9.340
"MULTIPOLYGON (((-58.4726868635642 -34.5478276095295,-58.4721291462847 -34.5489539037685,-58.4719923100839 -34.549230194764,-58.4730526326218 -34.5494404009681,-58.4741024057004 -34.5496484861678,-58.4742475774328 -34.549375009072,-58.4742958259708 -34.5492840847652,-58.4746812907077 -34.548493235955,-58.4750847019331 -34.5476654104415,-58.4745762859346 -34.5474927063621,-58.4741005572625 -34.5473290116213,-58.4731009287634 -34.5469849297522,-58.47289593913 -34.5473994735664,-58.4726868635642 -34.5478276095295)))";;"882";12_5_2;COMUNA 12;"5";"2";"658";"302";"356";"84,83%";"356";"356";"100,00%";"0";"0,00%";"283";"9";"3.18";"274";"96,82%";"3.18";3.180
"MULTIPOLYGON (((-58.4716885128965 -34.547495206711,-58.4706793602929 -34.5471592046995,-58.4700493741778 -34.5484773342314,-58.4700229082432 -34.5485351554282,-58.4698949181001 -34.5488144718724,-58.4704187321566 -34.5489183179771,-58.4709523360772 -34.5490240626689,-58.4719923100839 -34.549230194764,-58.4721291462847 -34.5489539037685,-58.4726868635642 -34.5478276095295,-58.47289593913 -34.5473994735664,-58.4731009287634 -34.5469849297522,-58.4720979889309 -34.5466397835467,-58.4718946137436 -34.5470670726577,-58.4716885128965 -34.547495206711)))";;"883";12_5_3;COMUNA 12;"5";"3";"1358";"656";"702";"93,45%";"665";"665";"100,00%";"0";"0,00%";"543";"2";"0.37";"541";"99,63%";"0.37";0.370
"MULTIPOLYGON (((-58.472496479105 -34.5458022479407,-58.4720979889309 -34.5466397835467,-58.4731009287634 -34.5469849297522,-58.47350920012 -34.5461593624516,-58.4739054658301 -34.5453583029789,-58.4736359877457 -34.5452691682627,-58.4729654441153 -34.5450456243409,-58.4728713912469 -34.5450142222733,-58.472496479105 -34.5458022479407)))";;"884";12_5_4;COMUNA 12;"5";"4";"657";"298";"359";"83,01%";"313";"313";"100,00%";"0";"0,00%";"277";"2";"0.72";"275";"99,28%";"0.72";0.720
"MULTIPOLYGON (((-58.4710533503051 -34.5462801946425,-58.4720979889309 -34.5466397835467,-58.472496479105 -34.5458022479407,-58.4728713912469 -34.5450142222733,-58.4727249923627 -34.5449654292516,-58.4727249335674 -34.5449655827108,-58.4715370398085 -34.5445693050373,-58.4710125664904 -34.545278952949,-58.4704308953425 -34.5460660001798,-58.4708207502332 -34.5462004186251,-58.4710533503051 -34.5462801946425)))";;"885";12_5_5;COMUNA 12;"5";"5";"694";"300";"394";"76,14%";"436";"436";"100,00%";"0";"0,00%";"348";"2";"0.57";"346";"99,43%";"0.57";0.570
"MULTIPOLYGON (((-58.4710533503051 -34.5462801946425,-58.4708207502332 -34.5462004186251,-58.4704308953425 -34.5460660001798,-58.4699395073873 -34.5467154271084,-58.4694007066118 -34.5474104905484,-58.4691289624369 -34.5477610849947,-58.4688478534461 -34.5481137920632,-58.4687186599648 -34.5482759187695,-58.4686633220202 -34.5483453617472,-58.4685537415563 -34.548482872649,-58.4685530396568 -34.5484837534505,-58.4685085279942 -34.5485396032595,-58.4698949181001 -34.5488144718724,-58.4700229082432 -34.5485351554282,-58.4700493741778 -34.5484773342314,-58.4706793602929 -34.5471592046995,-58.4716885128965 -34.547495206711,-58.4718946137436 -34.5470670726577,-58.4720979889309 -34.5466397835467,-58.4710533503051 -34.5462801946425)))";;"886";12_5_6;COMUNA 12;"5";"6";"635";"279";"356";"78,37%";"424";"424";"100,00%";"0";"0,00%";"301";"2";"0.66";"299";"99,34%";"0.66";0.660
"MULTIPOLYGON (((-58.4704187321566 -34.5489183179771,-58.4698949181001 -34.5488144718724,-58.4685085279942 -34.5485396032595,-58.4682258818072 -34.5488942808477,-58.4681892848515 -34.5489399888592,-58.4683729748813 -34.5490757614531,-58.4693026557534 -34.5495814425405,-58.4701573565151 -34.550054232255,-58.4702393999759 -34.5499469687033,-58.4708479102463 -34.5491459767824,-58.4717129121386 -34.5495974159312,-58.4719923100839 -34.549230194764,-58.4709523360772 -34.5490240626689,-58.4704187321566 -34.5489183179771)))";;"887";12_5_7;COMUNA 12;"5";"7";"759";"348";"411";"84,67%";"401";"400";"99,75%";"1";"0,25%";"327";"10";"3.06";"317";"96,94%";"3.06";3.060
"MULTIPOLYGON (((-58.4717129121386 -34.5495974159312,-58.4708479102463 -34.5491459767824,-58.4702393999759 -34.5499469687033,-58.4701573565151 -34.550054232255,-58.4710076405789 -34.5505246217725,-58.4710691726744 -34.5504436983176,-58.4717129121386 -34.5495974159312)))";;"888";12_5_8;COMUNA 12;"5";"8";"997";"433";"564";"76,77%";"499";"498";"99,80%";"1";"0,20%";"421";"1";"0.24";"420";"99,76%";"0.24";0.240
"MULTIPOLYGON (((-58.4749095628719 -34.550184418993,-58.4740153395589 -34.5497112436698,-58.4741024057004 -34.5496484861678,-58.4730526326218 -34.5494404009681,-58.4719923100839 -34.549230194764,-58.4717129121386 -34.5495974159312,-58.472585329041 -34.5500527217375,-58.4734293241867 -34.5504931639311,-58.4737006132736 -34.5506347660875,-58.4743219341371 -34.5509579629679,-58.4749095628719 -34.550184418993)))";;"889";12_5_9;COMUNA 12;"5";"9";"769";"363";"406";"89,41%";"352";"352";"100,00%";"0";"0,00%";"311";"9";"2.89";"302";"97,11%";"2.89";2.890
"MULTIPOLYGON (((-58.4838498720587 -34.5548677799016,-58.4833069853483 -34.5556517817699,-58.484214349434 -34.5561277032791,-58.4850848591695 -34.5565812998103,-58.4856287547184 -34.5557900361172,-58.4862794412087 -34.5549017730603,-58.485956741822 -34.5548990179247,-58.4853599490966 -34.5545838340318,-58.4844860517462 -34.5541222818026,-58.4841399788915 -34.5545756032631,-58.4839520055864 -34.5548159288106,-58.4838498720587 -34.5548677799016)))";;"890";12_6_1;COMUNA 12;"6";"1";"789";"337";"452";"74,56%";"386";"386";"100,00%";"0";"0,00%";"320";"0";"0";"320";"100,00%";"0";0.000
"MULTIPOLYGON (((-58.4824464670309 -34.5584943768697,-58.4834077572584 -34.5590313545014,-58.4843477993333 -34.5576788064331,-58.4850848591695 -34.5565812998103,-58.484214349434 -34.5561277032791,-58.4833069853483 -34.5556517817699,-58.4828327449429 -34.5562761146762,-58.4824582320785 -34.5567689447362,-58.4823463283994 -34.5569162934274,-58.481536355938 -34.5579858357251,-58.4824464670309 -34.5584943768697)))";;"891";12_6_10;COMUNA 12;"6";"10";"774";"361";"413";"87,41%";"353";"353";"100,00%";"0";"0,00%";"316";"2";"0.63";"314";"99,37%";"0.63";0.630
"MULTIPOLYGON (((-58.4827166689047 -34.5553463730807,-58.4829982898054 -34.5554898542624,-58.4833069853483 -34.5556517817699,-58.4838498720587 -34.5548677799016,-58.4839520055864 -34.5548159288106,-58.4841399788915 -34.5545756032631,-58.4844860517462 -34.5541222818026,-58.4850722482185 -34.5533543940731,-58.4841416687992 -34.5528677780789,-58.4832129734178 -34.5523834786855,-58.483077251064 -34.5525623829011,-58.482634255572 -34.5531442433887,-58.4820396993124 -34.5539252199607,-58.4814565349533 -34.5546912615292,-58.4823859258822 -34.5551717005679,-58.4827166689047 -34.5553463730807)))";;"892";12_6_2;COMUNA 12;"6";"2";"870";"401";"469";"85,50%";"478";"478";"100,00%";"0";"0,00%";"353";"2";"0.57";"351";"99,43%";"0.57";0.570
"MULTIPOLYGON (((-58.4801868323507 -34.5529605254575,-58.4796044238219 -34.5537265581945,-58.4805298785233 -34.5542104628483,-58.4808271568242 -34.5543658487321,-58.4814565349533 -34.5546912615292,-58.4820396993124 -34.5539252199607,-58.482634255572 -34.5531442433887,-58.483077251064 -34.5525623829011,-58.4832129734178 -34.5523834786855,-58.482280457969 -34.5518972008785,-58.4820598022479 -34.5517820898969,-58.4816679450529 -34.5519196929689,-58.4812631397248 -34.5520255779188,-58.4809367020093 -34.5521089693261,-58.480786760373 -34.5521713828635,-58.4807867598315 -34.5521713875959,-58.4801868323507 -34.5529605254575)))";;"893";12_6_3;COMUNA 12;"6";"3";"686";"319";"367";"86,92%";"305";"305";"100,00%";"0";"0,00%";"257";"1";"0.39";"256";"99,61%";"0.39";0.390
"MULTIPOLYGON (((-58.4777481821702 -34.5527485870678,-58.4786742119911 -34.5532369426207,-58.4794012185275 -34.5536203136728,-58.4796044238219 -34.5537265581945,-58.4801868323507 -34.5529605254575,-58.4807867598315 -34.5521713875959,-58.480786760373 -34.5521713828635,-58.4805856484997 -34.552126156475,-58.4804712104334 -34.5521179807585,-58.4801061296889 -34.5521017649923,-58.4796849480568 -34.5520494979477,-58.4795897810223 -34.5520319047019,-58.4793749318057 -34.5519922140876,-58.4792176247136 -34.5519589944969,-58.4789362879949 -34.5518692393495,-58.4786857640431 -34.5517744792911,-58.4785429211361 -34.55170569191,-58.4784520908925 -34.5516620396702,-58.4782204607266 -34.5515469231601,-58.478018024094 -34.5514163088743,-58.4777422028853 -34.5512136577213,-58.4776645623463 -34.5511442274239,-58.4775803667791 -34.551068952534,-58.4774483242091 -34.5509332580362,-58.4773062238672 -34.5507159410896,-58.4772068575242 -34.5505223523968,-58.4771431630992 -34.5503702402039,-58.4770999961818 -34.5502991152356,-58.4770414267735 -34.5502496127849,-58.4764607088382 -34.5510045738191,-58.4762694883066 -34.5512531278664,-58.4758785346552 -34.5517675606967,-58.4765567370426 -34.5521203188216,-58.4768180770712 -34.5522581121487,-58.4777481821702 -34.5527485870678)))";;"894";12_6_4;COMUNA 12;"6";"4";"950";"436";"514";"84,82%";"354";"354";"100,00%";"0";"0,00%";"349";"2";"0.57";"347";"99,43%";"0.57";0.570
"MULTIPOLYGON (((-58.4777481821702 -34.5527485870678,-58.4768180770712 -34.5522581121487,-58.4761180311144 -34.553179430731,-58.476026035168 -34.5533008548428,-58.4769411686746 -34.5538076058104,-58.4778552065801 -34.5543137161795,-58.4787720648853 -34.5548213686578,-58.4796844223219 -34.5553265499321,-58.4805907463131 -34.5558283447936,-58.4806751647369 -34.5557175526968,-58.4814565349533 -34.5546912615292,-58.4808271568242 -34.5543658487321,-58.4805298785233 -34.5542104628483,-58.4796044238219 -34.5537265581945,-58.4794012185275 -34.5536203136728,-58.4786742119911 -34.5532369426207,-58.4777481821702 -34.5527485870678)))";;"895";12_6_5;COMUNA 12;"6";"5";"1001";"481";"520";"92,50%";"475";"475";"100,00%";"0";"0,00%";"387";"3";"0.78";"384";"99,22%";"0.78";0.780
"MULTIPOLYGON (((-58.4742520338441 -34.5539057112459,-58.4751761026515 -34.5544234609663,-58.4760803476213 -34.5549300785525,-58.4762952367638 -34.5546551126574,-58.4769411686746 -34.5538076058104,-58.476026035168 -34.5533008548428,-58.4761180311144 -34.553179430731,-58.4768180770712 -34.5522581121487,-58.4765567370426 -34.5521203188216,-58.4758785346552 -34.5517675606967,-58.4751738868055 -34.5526945084998,-58.4751018041803 -34.5527892385182,-58.4744359426856 -34.5524209070665,-58.473586166729 -34.5535337835141,-58.4739290593854 -34.553724747151,-58.4742520338441 -34.5539057112459)))";;"896";12_6_6;COMUNA 12;"6";"6";"983";"442";"541";"81,70%";"425";"425";"100,00%";"0";"0,00%";"380";"2";"0.53";"378";"99,47%";"0.53";0.530
"MULTIPOLYGON (((-58.4778552065801 -34.5543137161795,-58.4769411686746 -34.5538076058104,-58.4762952367638 -34.5546551126574,-58.4760803476213 -34.5549300785525,-58.4769905627295 -34.5554400691356,-58.4779100683275 -34.5559551928113,-58.4787720648853 -34.5548213686578,-58.4778552065801 -34.5543137161795)))";;"897";12_6_7;COMUNA 12;"6";"7";"736";"335";"401";"83,54%";"401";"401";"100,00%";"0";"0,00%";"332";"2";"0.6";"330";"99,40%";"0.6";0.600
"MULTIPOLYGON (((-58.4793543475234 -34.5567642665083,-58.4797212746715 -34.556969859045,-58.4801377593908 -34.5564230148657,-58.4805907463131 -34.5558283447936,-58.4796844223219 -34.5553265499321,-58.4787720648853 -34.5548213686578,-58.4779100683275 -34.5559551928113,-58.4788169004279 -34.5564631981909,-58.4793543475234 -34.5567642665083)))";;"898";12_6_8;COMUNA 12;"6";"8";"733";"343";"390";"87,95%";"314";"314";"100,00%";"0";"0,00%";"288";"1";"0.35";"287";"99,65%";"0.35";0.350
"MULTIPOLYGON (((-58.4827166689047 -34.5553463730807,-58.4823859258822 -34.5551717005679,-58.4814565349533 -34.5546912615292,-58.4806751647369 -34.5557175526968,-58.4805907463131 -34.5558283447936,-58.4801377593908 -34.5564230148657,-58.4797212746715 -34.556969859045,-58.4805257964103 -34.5574205393238,-58.4806283842095 -34.5574780621206,-58.4808055506924 -34.5575774066742,-58.481536355938 -34.5579858357251,-58.4823463283994 -34.5569162934274,-58.4824582320785 -34.5567689447362,-58.4828327449429 -34.5562761146762,-58.4833069853483 -34.5556517817699,-58.4829982898054 -34.5554898542624,-58.4827166689047 -34.5553463730807)))";;"899";12_6_9;COMUNA 12;"6";"9";"725";"319";"406";"78,57%";"369";"369";"100,00%";"0";"0,00%";"302";"2";"0.66";"300";"99,34%";"0.66";0.660
"MULTIPOLYGON (((-58.4788169004279 -34.5564631981909,-58.4779100683275 -34.5559551928113,-58.4769905627295 -34.5554400691356,-58.4760803476213 -34.5549300785525,-58.4756128631001 -34.5555281843775,-58.4754915874647 -34.5556885565716,-58.4749803523904 -34.5563648370483,-58.4759029166053 -34.5568568758142,-58.4768431992357 -34.5573583425641,-58.4770393447136 -34.5574629018892,-58.4773578255744 -34.557625899623,-58.4776146713759 -34.5577573533426,-58.4777666346309 -34.5578392397991,-58.4781144543536 -34.5573657946599,-58.4782370075304 -34.5572230261746,-58.4793543475234 -34.5567642665083,-58.4788169004279 -34.5564631981909)))";;"900";12_7_1;COMUNA 12;"7";"1";"836";"377";"459";"82,14%";"385";"385";"100,00%";"0";"0,00%";"318";"4";"1.26";"314";"98,74%";"1.26";1.260
"MULTIPOLYGON (((-58.469451734192 -34.5627050601683,-58.468763598802 -34.5634976666849,-58.4686103754498 -34.5636750060017,-58.4696108916924 -34.5643274471237,-58.4704391899785 -34.5648675621174,-58.471422873252 -34.5638397038974,-58.4721950936296 -34.5630327795169,-58.4712162911321 -34.5624812779071,-58.470978424583 -34.5623472742192,-58.4701602003873 -34.5618892079571,-58.469451734192 -34.5627050601683)))";;"901";12_7_10;COMUNA 12;"7";"10";"1092";"498";"594";"83,84%";"616";"616";"100,00%";"0";"0,00%";"476";"11";"2.31";"465";"97,69%";"2.31";2.310
"MULTIPOLYGON (((-58.4751761026515 -34.5544234609663,-58.4742520338441 -34.5539057112459,-58.4739290593854 -34.553724747151,-58.473586166729 -34.5535337835141,-58.4729836929285 -34.5543227451922,-58.4727430066224 -34.5546379909341,-58.4724494649163 -34.5550166235974,-58.4729169875926 -34.555265117854,-58.4731344904778 -34.5553810202462,-58.4740725264683 -34.5558808888591,-58.4745294176534 -34.5561243776674,-58.4749803523904 -34.5563648370483,-58.4754915874647 -34.5556885565716,-58.4756128631001 -34.5555281843775,-58.4760803476213 -34.5549300785525,-58.4751761026515 -34.5544234609663)))";;"902";12_7_2;COMUNA 12;"7";"2";"836";"402";"434";"92,63%";"338";"338";"100,00%";"0";"0,00%";"310";"1";"0.32";"309";"99,68%";"0.32";0.320
"MULTIPOLYGON (((-58.4740725264683 -34.5558808888591,-58.4731344904778 -34.5553810202462,-58.4729169875926 -34.555265117854,-58.4724494649163 -34.5550166235974,-58.4718499473139 -34.555790085591,-58.4715559712858 -34.556162941157,-58.4708720881087 -34.5570301409452,-58.4700684235224 -34.5579443884503,-58.4696496461906 -34.5584207725671,-58.4691842172671 -34.5589284971383,-58.4701008153588 -34.5594044523715,-58.4702240672211 -34.5592726783434,-58.4708518893295 -34.558526477637,-58.4709545403358 -34.5584157615155,-58.4710617022353 -34.5583000447709,-58.4719108384326 -34.5575890360061,-58.4717896132913 -34.5575238308694,-58.4727817436774 -34.556809002239,-58.4740725264683 -34.5558808888591)))";;"903";12_7_3;COMUNA 12;"7";"3";"879";"400";"479";"83,51%";"379";"378";"99,74%";"1";"0,26%";"325";"2";"0.62";"323";"99,38%";"0.62";0.620
"MULTIPOLYGON (((-58.4709545403358 -34.5584157615155,-58.4708518893295 -34.558526477637,-58.4702240672211 -34.5592726783434,-58.4701008153588 -34.5594044523715,-58.4714284411145 -34.5600937618553,-58.4722703152629 -34.5597648107526,-58.4726340098228 -34.5593090569783,-58.4733661533527 -34.5583917707542,-58.4734525421721 -34.5582835892758,-58.4740444992735 -34.5576027302606,-58.4741214384167 -34.5575010283395,-58.4749803523904 -34.5563648370483,-58.4745294176534 -34.5561243776674,-58.4740725264683 -34.5558808888591,-58.4727817436774 -34.556809002239,-58.4717896132913 -34.5575238308694,-58.4719108384326 -34.5575890360061,-58.4710617022353 -34.5583000447709,-58.4709545403358 -34.5584157615155)))";;"904";12_7_4;COMUNA 12;"7";"4";"944";"444";"500";"88,80%";"404";"404";"100,00%";"0";"0,00%";"359";"8";"2.23";"351";"97,77%";"2.23";2.230
"MULTIPOLYGON (((-58.4759029166053 -34.5568568758142,-58.4749803523904 -34.5563648370483,-58.4741214384167 -34.5575010283395,-58.4740444992735 -34.5576027302606,-58.4734525421721 -34.5582835892758,-58.4733661533527 -34.5583917707542,-58.4726340098228 -34.5593090569783,-58.4722703152629 -34.5597648107526,-58.4729534263745 -34.559478967795,-58.4743243173484 -34.5589131856895,-58.4756590945129 -34.5583351379041,-58.4763104321231 -34.5580590686422,-58.4766635077356 -34.5579093741153,-58.4773578255744 -34.557625899623,-58.4770393447136 -34.5574629018892,-58.4768431992357 -34.5573583425641,-58.4759029166053 -34.5568568758142)))";;"905";12_7_5;COMUNA 12;"7";"5";"745";"350";"395";"88,61%";"353";"353";"100,00%";"0";"0,00%";"290";"0";"0";"290";"100,00%";"0";0.000
"MULTIPOLYGON (((-58.4745747919178 -34.5603416765153,-58.4754916935977 -34.5608306903091,-58.4761841506766 -34.5599193777527,-58.4768962524668 -34.558982142191,-58.4773130207703 -34.5584335471481,-58.4777666346309 -34.5578392397991,-58.4776146713759 -34.5577573533426,-58.4773578255744 -34.557625899623,-58.4766635077356 -34.5579093741153,-58.4763104321231 -34.5580590686422,-58.4756590945129 -34.5583351379041,-58.4743243173484 -34.5589131856895,-58.4729534263745 -34.559478967795,-58.4722703152629 -34.5597648107526,-58.4714284411145 -34.5600937618553,-58.4716022859597 -34.56022812153,-58.4726993074718 -34.5607769344492,-58.4735530169705 -34.5597978739687,-58.4743377784027 -34.560215214792,-58.4745747919178 -34.5603416765153)))";;"906";12_7_6;COMUNA 12;"7";"6";"908";"414";"494";"83,81%";"440";"440";"100,00%";"0";"0,00%";"347";"10";"2.88";"337";"97,12%";"2.88";2.880
"MULTIPOLYGON (((-58.4745747919178 -34.5603416765153,-58.4743377784027 -34.560215214792,-58.4735530169705 -34.5597978739687,-58.4726993074718 -34.5607769344492,-58.4716022859597 -34.56022812153,-58.4709276401431 -34.5610051755025,-58.4701602003873 -34.5618892079571,-58.470978424583 -34.5623472742192,-58.4712162911321 -34.5624812779071,-58.4721950936296 -34.5630327795169,-58.4731211936385 -34.5620650552973,-58.4738181378382 -34.5613367218825,-58.4745747919178 -34.5603416765153)))";;"907";12_7_7;COMUNA 12;"7";"7";"822";"379";"443";"85,55%";"386";"386";"100,00%";"0";"0,00%";"301";"10";"3.32";"291";"96,68%";"3.32";3.320
"MULTIPOLYGON (((-58.4684648689601 -34.5597241324192,-58.467738612413 -34.5605334966537,-58.468688764529 -34.5610654493932,-58.468892060002 -34.561179247158,-58.4690274200563 -34.5612510039892,-58.4701602003873 -34.5618892079571,-58.4709276401431 -34.5610051755025,-58.4716022859597 -34.56022812153,-58.4714284411145 -34.5600937618553,-58.4701008153588 -34.5594044523715,-58.4691842172671 -34.5589284971383,-58.4689299653913 -34.559205846817,-58.4684648689601 -34.5597241324192)))";;"908";12_7_8;COMUNA 12;"7";"8";"874";"392";"482";"81,33%";"445";"445";"100,00%";"0";"0,00%";"365";"8";"2.19";"357";"97,81%";"2.19";2.190
"MULTIPOLYGON (((-58.468892060002 -34.561179247158,-58.468688764529 -34.5610654493932,-58.467738612413 -34.5605334966537,-58.4670371979829 -34.5613151078622,-58.4676839439126 -34.5616873533193,-58.4669137962877 -34.5620112700164,-58.466490199816 -34.5621902355387,-58.4665758432566 -34.5622536159547,-58.4675404902445 -34.5629677682134,-58.4676489512794 -34.5630481195463,-58.4686103754498 -34.5636750060017,-58.468763598802 -34.5634976666849,-58.469451734192 -34.5627050601683,-58.4701602003873 -34.5618892079571,-58.4690274200563 -34.5612510039892,-58.468892060002 -34.561179247158)))";;"909";12_7_9;COMUNA 12;"7";"9";"1237";"558";"679";"82,18%";"750";"749";"99,87%";"1";"0,13%";"557";"7";"1.26";"550";"98,74%";"1.26";1.260
"MULTIPOLYGON (((-58.4797212746715 -34.556969859045,-58.4793543475234 -34.5567642665083,-58.4782370075304 -34.5572230261746,-58.4781144543536 -34.5573657946599,-58.4777666346309 -34.5578392397991,-58.4786854014834 -34.5583344974678,-58.4796044346322 -34.5588298889951,-58.4797132379813 -34.558888538498,-58.480521095366 -34.55932640072,-58.4800655462246 -34.5599742419616,-58.4797347513053 -34.5604428307099,-58.4806755198009 -34.5609297598816,-58.4817310575209 -34.5614742716362,-58.4818433651027 -34.5615340086608,-58.481925501238 -34.5614156441123,-58.4821163133527 -34.5611455090323,-58.482282017396 -34.5609100065055,-58.4824309828037 -34.5606980540587,-58.4825632098293 -34.5605096517554,-58.4826028554164 -34.5604533222148,-58.4826636351165 -34.5603669645715,-58.4828343576847 -34.5601259198308,-58.4829983849878 -34.5598970653066,-58.4832230661708 -34.5595783316061,-58.4833156159532 -34.5594464050618,-58.4834090221573 -34.5593123507032,-58.4835563138851 -34.5591026605753,-58.4835050684714 -34.5590780302011,-58.4834077572584 -34.5590313545014,-58.4824464670309 -34.5584943768697,-58.481536355938 -34.5579858357251,-58.4808055506924 -34.5575774066742,-58.4806283842095 -34.5574780621206,-58.4805257964103 -34.5574205393238,-58.4797212746715 -34.556969859045)))";;"910";12_8_1;COMUNA 12;"8";"1";"1465";"737";"728";"101,24%";"586";"586";"100,00%";"0";"0,00%";"548";"7";"1.28";"541";"98,72%";"1.28";1.280
"MULTIPOLYGON (((-58.4790549215309 -34.5639320227197,-58.4790050305586 -34.5639119580826,-58.4788425252037 -34.5639669821124,-58.4787779149945 -34.5639910057856,-58.4780217461242 -34.5642894965063,-58.477397775432 -34.5645500776883,-58.4773033668756 -34.5645908547697,-58.4768786789426 -34.5647811351912,-58.4769771249274 -34.5649740899732,-58.4766624946673 -34.5650918076066,-58.4765542982767 -34.565135483829,-58.4762547364682 -34.5652602412612,-58.4761076362426 -34.565318429081,-58.4771775288935 -34.5659677016394,-58.4781481470658 -34.5651028263241,-58.4791183195521 -34.5642382953601,-58.4793119601157 -34.5640657967501,-58.4790549215309 -34.5639320227197)))";;"911";12_8_10;COMUNA 12;"8";"10";"731";"328";"403";"81,39%";"324";"323";"99,69%";"1";"0,31%";"290";"0";"0";"290";"100,00%";"0";0.000
"MULTIPOLYGON (((-58.4761076362426 -34.565318429081,-58.4758087531584 -34.5654367061822,-58.4751236336884 -34.5662186431718,-58.4761902069444 -34.5668491209846,-58.4763560244569 -34.5666996593847,-58.4771775288935 -34.5659677016394,-58.4761076362426 -34.565318429081)))";;"912";12_8_11;COMUNA 12;"8";"11";"642";"286";"356";"80,34%";"300";"300";"100,00%";"0";"0,00%";"262";"1";"0.38";"261";"99,62%";"0.38";0.380
"MULTIPOLYGON (((-58.4787906734768 -34.5599542044677,-58.4787088876621 -34.5600672484627,-58.478077743006 -34.5609437773173,-58.478587629754 -34.5612196398589,-58.479019448711 -34.5614552976554,-58.4797347513053 -34.5604428307099,-58.4800655462246 -34.5599742419616,-58.480521095366 -34.55932640072,-58.4797132379813 -34.558888538498,-58.4796044346322 -34.5588298889951,-58.4786854014834 -34.5583344974678,-58.4777666346309 -34.5578392397991,-58.4773130207703 -34.5584335471481,-58.4768962524668 -34.558982142191,-58.4778510344637 -34.5594720494982,-58.4787906734768 -34.5599542044677)))";;"913";12_8_2;COMUNA 12;"8";"2";"745";"337";"408";"82,60%";"325";"324";"99,69%";"1";"0,31%";"273";"1";"0.37";"272";"99,63%";"0.37";0.370
"MULTIPOLYGON (((-58.4764719475251 -34.5613540577786,-58.4757802556091 -34.562314810493,-58.476737706019 -34.5627917676271,-58.4769124082806 -34.5628788639605,-58.4777239451593 -34.5632886441356,-58.4783731508658 -34.5623699301507,-58.479019448711 -34.5614552976554,-58.478587629754 -34.5612196398589,-58.478077743006 -34.5609437773173,-58.4787088876621 -34.5600672484627,-58.4787906734768 -34.5599542044677,-58.4778510344637 -34.5594720494982,-58.4768962524668 -34.558982142191,-58.4761841506766 -34.5599193777527,-58.4754916935977 -34.5608306903091,-58.4761199093986 -34.5611657082825,-58.4764719475251 -34.5613540577786)))";;"914";12_8_3;COMUNA 12;"8";"3";"868";"387";"481";"80,46%";"384";"384";"100,00%";"0";"0,00%";"325";"3";"0.92";"322";"99,08%";"0.92";0.920
"MULTIPOLYGON (((-58.4817310575209 -34.5614742716362,-58.4806755198009 -34.5609297598816,-58.4797347513053 -34.5604428307099,-58.479019448711 -34.5614552976554,-58.4783731508658 -34.5623699301507,-58.4777239451593 -34.5632886441356,-58.4768257305489 -34.5643009088586,-58.477106914725 -34.5644701227505,-58.4773033668756 -34.5645908547697,-58.477397775432 -34.5645500776883,-58.4780217461242 -34.5642894965063,-58.4787779149945 -34.5639910057856,-58.4788425252037 -34.5639669821124,-58.4790050305586 -34.5639119580826,-58.4790549215309 -34.5639320227197,-58.479541500566 -34.5637703296916,-58.4797216233053 -34.5636959352199,-58.4799101701994 -34.5636044962857,-58.4800681534128 -34.5635072160816,-58.480372632959 -34.5633207727284,-58.4802215607882 -34.5632319458513,-58.4801417182601 -34.5632925808212,-58.4803988575031 -34.5630932952929,-58.4806616908544 -34.5628910245884,-58.4809864635829 -34.5626388785438,-58.4811538707715 -34.5625058786701,-58.4812543005561 -34.5623618075377,-58.4814099673405 -34.5621443147554,-58.4815974353379 -34.5618797216431,-58.4817832290687 -34.561620669106,-58.4818433651027 -34.5615340086608,-58.4817310575209 -34.5614742716362)))";;"915";12_8_4;COMUNA 12;"8";"4";"769";"376";"393";"95,67%";"316";"316";"100,00%";"0";"0,00%";"262";"1";"0.38";"261";"99,62%";"0.38";0.380
"MULTIPOLYGON (((-58.4777239451593 -34.5632886441356,-58.4769124082806 -34.5628788639605,-58.476737706019 -34.5627917676271,-58.4766397434136 -34.5629260805935,-58.4759135402062 -34.563747887939,-58.4768257305489 -34.5643009088586,-58.4777239451593 -34.5632886441356)))";;"916";12_8_5;COMUNA 12;"8";"5";"602";"280";"322";"86,96%";"441";"441";"100,00%";"0";"0,00%";"344";"1";"0.29";"343";"99,71%";"0.29";0.290
"MULTIPOLYGON (((-58.4754916935977 -34.5608306903091,-58.4745747919178 -34.5603416765153,-58.4738181378382 -34.5613367218825,-58.4731211936385 -34.5620650552973,-58.4740164038421 -34.5626004923964,-58.4744183370271 -34.5628414511063,-58.4749995740478 -34.5631938743715,-58.4757802556091 -34.562314810493,-58.4764719475251 -34.5613540577786,-58.4761199093986 -34.5611657082825,-58.4754916935977 -34.5608306903091)))";;"917";12_8_6;COMUNA 12;"8";"6";"836";"376";"460";"81,74%";"416";"416";"100,00%";"0";"0,00%";"352";"2";"0.57";"350";"99,43%";"0.57";0.570
"MULTIPOLYGON (((-58.4749995740478 -34.5631938743715,-58.4744183370271 -34.5628414511063,-58.4740164038421 -34.5626004923964,-58.4731211936385 -34.5620650552973,-58.4721950936296 -34.5630327795169,-58.4731304891063 -34.5635597688161,-58.4741596335774 -34.5641395613747,-58.4750756480446 -34.5646959754082,-58.4759135402062 -34.563747887939,-58.4766397434136 -34.5629260805935,-58.476737706019 -34.5627917676271,-58.4757802556091 -34.562314810493,-58.4749995740478 -34.5631938743715)))";;"918";12_8_7;COMUNA 12;"8";"7";"871";"384";"487";"78,85%";"440";"439";"99,77%";"1";"0,23%";"364";"19";"5.22";"345";"94,78%";"5.22";5.220
"MULTIPOLYGON (((-58.4731304891063 -34.5635597688161,-58.4721950936296 -34.5630327795169,-58.471422873252 -34.5638397038974,-58.4704391899785 -34.5648675621174,-58.4706498207268 -34.5650048785819,-58.471371280699 -34.5654519618385,-58.4724205354858 -34.5660976858342,-58.4733218872469 -34.5650829182172,-58.4741596335774 -34.5641395613747,-58.4731304891063 -34.5635597688161)))";;"919";12_8_8;COMUNA 12;"8";"8";"927";"440";"487";"90,35%";"504";"503";"99,80%";"1";"0,20%";"415";"3";"0.72";"412";"99,28%";"0.72";0.720
"MULTIPOLYGON (((-58.4727418536645 -34.5662938656197,-58.4730021207034 -34.5664475273469,-58.4732627709235 -34.5664967880578,-58.4735404305326 -34.5665482031996,-58.4736315384319 -34.5665709241487,-58.4739916321887 -34.5666618076653,-58.4745962726232 -34.5668128520933,-58.4746656876094 -34.566734627028,-58.4751236336884 -34.5662186431718,-58.4758087531584 -34.5654367061822,-58.4761076362426 -34.565318429081,-58.4762547364682 -34.5652602412612,-58.4765542982767 -34.565135483829,-58.4766624946673 -34.5650918076066,-58.4769771249274 -34.5649740899732,-58.4768786789426 -34.5647811351912,-58.4773033668756 -34.5645908547697,-58.477106914725 -34.5644701227505,-58.4768257305489 -34.5643009088586,-58.4759135402062 -34.563747887939,-58.4750756480446 -34.5646959754082,-58.4741596335774 -34.5641395613747,-58.4733218872469 -34.5650829182172,-58.4724205354858 -34.5660976858342,-58.472460466747 -34.5661281065189,-58.4727418536645 -34.5662938656197)))";;"920";12_8_9;COMUNA 12;"8";"9";"975";"462";"513";"90,06%";"473";"473";"100,00%";"0";"0,00%";"396";"2";"0.51";"394";"99,49%";"0.51";0.510
"MULTIPOLYGON (((-58.4965931254869 -34.5635357199403,-58.4954173292095 -34.5629711565251,-58.4944558586885 -34.5642978775637,-58.4956334542429 -34.5648606889863,-58.496957352831 -34.565493380676,-58.4981097773819 -34.5660440619446,-58.4986794387065 -34.5663163016823,-58.4997128251447 -34.5650410071884,-58.4991397611911 -34.5647626461994,-58.4990528228524 -34.5647207688644,-58.4987870696294 -34.5645926730485,-58.4979910920621 -34.5642089451465,-58.4978605585719 -34.5641460222852,-58.4968228542084 -34.5636460129413,-58.4966764851088 -34.5635757689649,-58.4965931254869 -34.5635357199403)))";;"921";12_9_1;COMUNA 12;"9";"1";"937";"414";"523";"79,16%";"403";"402";"99,75%";"1";"0,25%";"331";"8";"2.42";"323";"97,58%";"2.42";2.420
"MULTIPOLYGON (((-58.4956334542429 -34.5648606889863,-58.4944558586885 -34.5642978775637,-58.4935787667034 -34.5655080150188,-58.4934769125459 -34.5656441734821,-58.4946449925405 -34.5662253777979,-58.4958372978254 -34.5668843846074,-58.496943190096 -34.5674955145527,-58.4974870733217 -34.5677961485344,-58.4980654349429 -34.5670783454134,-58.4986794387065 -34.5663163016823,-58.4981097773819 -34.5660440619446,-58.496957352831 -34.565493380676,-58.4956334542429 -34.5648606889863)))";;"922";12_9_2;COMUNA 12;"9";"2";"1127";"541";"586";"92,32%";"466";"465";"99,79%";"1";"0,22%";"420";"8";"1.9";"412";"98,10%";"1.9";1.900
"MULTIPOLYGON (((-58.4928837471642 -34.5617573890216,-58.4919301398132 -34.5613016148078,-58.4918340782095 -34.5614416440189,-58.490991285271 -34.5626506284525,-58.4919363890799 -34.5631042287377,-58.4920948439654 -34.5631802503985,-58.493323576788 -34.5637567344673,-58.4923561911703 -34.5650872432786,-58.4934769125459 -34.5656441734821,-58.4935787667034 -34.5655080150188,-58.4944558586885 -34.5642978775637,-58.4954173292095 -34.5629711565251,-58.4942888045009 -34.5624292465706,-58.4941295826919 -34.5623527349659,-58.4928837471642 -34.5617573890216)))";;"923";12_9_3;COMUNA 12;"9";"3";"1005";"483";"522";"92,53%";"455";"455";"100,00%";"0";"0,00%";"385";"18";"4.68";"367";"95,32%";"4.68";4.680
"MULTIPOLYGON (((-58.4909878972276 -34.5644613432196,-58.4909073182636 -34.5645829869492,-58.4903563267674 -34.5653056096347,-58.4916170610459 -34.5660471106606,-58.4926857991139 -34.5666757536186,-58.4938208642367 -34.5672798621476,-58.4946449925405 -34.5662253777979,-58.4934769125459 -34.5656441734821,-58.4923561911703 -34.5650872432786,-58.493323576788 -34.5637567344673,-58.4920948439654 -34.5631802503985,-58.4919363890799 -34.5631042287377,-58.4910874506797 -34.5643111726375,-58.4909878972276 -34.5644613432196)))";;"924";12_9_4;COMUNA 12;"9";"4";"1061";"498";"563";"88,45%";"468";"468";"100,00%";"0";"0,00%";"392";"8";"2.04";"384";"97,96%";"2.04";2.040
"MULTIPOLYGON (((-58.4858012326153 -34.5626303818954,-58.4853837046243 -34.5630746348449,-58.4863554291004 -34.5635291888943,-58.4873279304556 -34.5639841575701,-58.4875298054098 -34.564078557473,-58.4883101407555 -34.5644172844765,-58.4892900602173 -34.5648427275515,-58.4903563267674 -34.5653056096347,-58.4909073182636 -34.5645829869492,-58.4909878972276 -34.5644613432196,-58.4910874506797 -34.5643111726375,-58.4919363890799 -34.5631042287377,-58.490991285271 -34.5626506284525,-58.4904650910028 -34.5634053602044,-58.4900432948942 -34.5640104821831,-58.4890918912183 -34.5635563052666,-58.488139220752 -34.563101557758,-58.487184942932 -34.5626459579932,-58.4863769481845 -34.5622602551404,-58.4862211390651 -34.5621835212785,-58.4858012326153 -34.5626303818954)))";;"925";12_9_5;COMUNA 12;"9";"5";"965";"469";"496";"94,56%";"456";"456";"100,00%";"0";"0,00%";"358";"4";"1.12";"354";"98,88%";"1.12";1.120
"MULTIPOLYGON (((-58.4900433819791 -34.5621956129281,-58.4892768419645 -34.5618274559426,-58.4890864644843 -34.5617379862058,-58.4882921792931 -34.561364687927,-58.48813109178 -34.5612869012127,-58.4873199543629 -34.5608954302615,-58.4871745350335 -34.5608270761598,-58.4862211390651 -34.5621835212785,-58.4863769481845 -34.5622602551404,-58.487184942932 -34.5626459579932,-58.488139220752 -34.563101557758,-58.4890918912183 -34.5635563052666,-58.4900432948942 -34.5640104821831,-58.4904650910028 -34.5634053602044,-58.490991285271 -34.5626506284525,-58.4905182263635 -34.5624236143911,-58.4904006431999 -34.5623672301681,-58.4900433819791 -34.5621956129281)))";;"926";12_9_6;COMUNA 12;"9";"6";"960";"452";"508";"88,98%";"452";"452";"100,00%";"0";"0,00%";"377";"3";"0.8";"374";"99,20%";"0.8";0.800
"MULTIPOLYGON (((-58.4858012326153 -34.5626303818954,-58.4862211390651 -34.5621835212785,-58.4871745350335 -34.5608270761598,-58.486388695783 -34.560457566731,-58.4862550269348 -34.5603938573439,-58.4853010459624 -34.5599392285447,-58.4851659314367 -34.5598748843957,-58.4850179612427 -34.5598043449858,-58.4843501397196 -34.5594837466014,-58.4837007129025 -34.5591720150223,-58.4836203436906 -34.5591334355336,-58.4835563138851 -34.5591026605753,-58.4834090221573 -34.5593123507032,-58.4833156159532 -34.5594464050618,-58.4832230661708 -34.5595783316061,-58.4829983849878 -34.5598970653066,-58.4828343576847 -34.5601259198308,-58.4826636351165 -34.5603669645715,-58.4826028554164 -34.5604533222148,-58.4825632098293 -34.5605096517554,-58.4824309828037 -34.5606980540587,-58.482282017396 -34.5609100065055,-58.4821163133527 -34.5611455090323,-58.481925501238 -34.5614156441123,-58.4818433651027 -34.5615340086608,-58.4819988341844 -34.5616142311872,-58.4827814330858 -34.5620174379675,-58.4834738395833 -34.5622101475995,-58.4836258918941 -34.5622524474592,-58.4846093466267 -34.5627123658113,-58.4853837046243 -34.5630746348449,-58.4858012326153 -34.5626303818954)))";;"927";12_9_7;COMUNA 12;"9";"7";"879";"437";"442";"98,87%";"369";"369";"100,00%";"0";"0,00%";"307";"2";"0.65";"305";"99,35%";"0.65";0.650
"MULTIPOLYGON (((-58.472193546158 -34.5396675424214,-58.4731342057568 -34.5401435449546,-58.4732630664014 -34.5402087482841,-58.4743560065406 -34.540759872552,-58.4746773117793 -34.5403257360783,-58.4749273931792 -34.5399878076996,-58.4754080163553 -34.5393383068493,-58.4754114680994 -34.5393336422144,-58.4754113100596 -34.539333568928,-58.4757611500952 -34.5388303281328,-58.4759124478323 -34.5386126859104,-58.4727082675926 -34.5371976346099,-58.4726836657611 -34.5371867692743,-58.472463335343 -34.5374997246616,-58.4721677131993 -34.5379196194249,-58.4721993415636 -34.5379336503576,-58.4721999875433 -34.5379339369261,-58.4718493226989 -34.538417930826,-58.4712699194007 -34.5392000529487,-58.472193546158 -34.5396675424214)))";;"928";13_1_1;COMUNA 13;"1";"1";"733";"316";"417";"75,78%";"393";"392";"99,75%";"1";"0,26%";"296";"1";"0.34";"295";"99,66%";"0.34";0.340
"MULTIPOLYGON (((-58.4703407708457 -34.5387298806135,-58.4694003983629 -34.5382538564346,-58.4688345891569 -34.5390206838498,-58.4697723286374 -34.5394955152372,-58.470440276631 -34.5398337304808,-58.4707022485431 -34.5399664664726,-58.4716265615748 -34.5404350869442,-58.4721185783436 -34.5397675530493,-58.472193546158 -34.5396675424214,-58.4712699194007 -34.5392000529487,-58.4703407708457 -34.5387298806135)))";;"929";13_1_10;COMUNA 13;"1";"10";"709";"341";"368";"92,66%";"368";"368";"100,00%";"0";"0,00%";"314";"0";"0";"314";"100,00%";"0";0.000
"MULTIPOLYGON (((-58.4710560777679 -34.5412088968847,-58.4719930034228 -34.5416846970651,-58.4725657797539 -34.5409111643269,-58.473786311236 -34.5415297512776,-58.4743560065406 -34.540759872552,-58.4732630664014 -34.5402087482841,-58.4731342057568 -34.5401435449546,-58.472193546158 -34.5396675424214,-58.4721185783436 -34.5397675530493,-58.4716265615748 -34.5404350869442,-58.4711533432963 -34.5410771233029,-58.4710560777679 -34.5412088968847)))";;"930";13_1_11;COMUNA 13;"1";"11";"660";"285";"375";"76,00%";"346";"346";"100,00%";"0";"0,00%";"300";"3";"1";"297";"99,00%";"1";1.000
"MULTIPOLYGON (((-58.4725657797539 -34.5409111643269,-58.4719930034228 -34.5416846970651,-58.4710560777679 -34.5412088968847,-58.4705140912868 -34.5419433341613,-58.4714513623062 -34.5424170256405,-58.4726919052075 -34.5430086488228,-58.4732360070986 -34.5422734271423,-58.473786311236 -34.5415297512776,-58.4725657797539 -34.5409111643269)))";;"931";13_1_12;COMUNA 13;"1";"12";"544";"255";"289";"88,24%";"310";"309";"99,68%";"1";"0,32%";"246";"1";"0.41";"245";"99,59%";"0.41";0.410
"MULTIPOLYGON (((-58.4684375038346 -34.5430313886861,-58.4693652426119 -34.5435015752456,-58.4699377149538 -34.5427245337835,-58.4708751617976 -34.5431993564281,-58.4720939267085 -34.5438166925126,-58.4726919052075 -34.5430086488228,-58.4714513623062 -34.5424170256405,-58.4705140912868 -34.5419433341613,-58.469587555019 -34.5414750576409,-58.4690110880667 -34.5422551965664,-58.4684375038346 -34.5430313886861)))";;"932";13_1_13;COMUNA 13;"1";"13";"622";"283";"339";"83,48%";"306";"306";"100,00%";"0";"0,00%";"245";"1";"0.41";"244";"99,59%";"0.41";0.410
"MULTIPOLYGON (((-58.4708751617976 -34.5431993564281,-58.4699377149538 -34.5427245337835,-58.4693652426119 -34.5435015752456,-58.4703026098266 -34.5439766135067,-58.4715370398085 -34.5445693050373,-58.4720939267085 -34.5438166925126,-58.4708751617976 -34.5431993564281)))";;"933";13_1_14;COMUNA 13;"1";"14";"647";"262";"385";"68,05%";"355";"353";"99,44%";"2";"0,57%";"283";"28";"9.89";"255";"90,11%";"9.89";9.890
"MULTIPOLYGON (((-58.472463335343 -34.5374997246616,-58.4726836657611 -34.5371867692743,-58.4705288418942 -34.5362350665992,-58.4704492415316 -34.5361999090401,-58.4702401521792 -34.5365711832078,-58.4700236517263 -34.536955613187,-58.470024872847 -34.5369561519064,-58.4700334776109 -34.5370617199086,-58.4700492340678 -34.5372004581059,-58.4700125697973 -34.5373796943746,-58.4699719826197 -34.5374676588201,-58.4699531780451 -34.5375083661418,-58.469935818732 -34.5375317485894,-58.4694003983629 -34.5382538564346,-58.4703407708457 -34.5387298806135,-58.4712699194007 -34.5392000529487,-58.4718493226989 -34.538417930826,-58.4721999875433 -34.5379339369261,-58.4721993415636 -34.5379336503576,-58.4721677131993 -34.5379196194249,-58.472463335343 -34.5374997246616)))";;"934";13_1_2;COMUNA 13;"1";"2";"770";"373";"397";"93,95%";"408";"408";"100,00%";"0";"0,00%";"343";"5";"1.46";"338";"98,54%";"1.46";1.460
"MULTIPOLYGON (((-58.467899158252 -34.5385470423671,-58.4688345891569 -34.5390206838498,-58.4694003983629 -34.5382538564346,-58.469935818732 -34.5375317485894,-58.4699531780451 -34.5375083661418,-58.4699719826197 -34.5374676588201,-58.4700125697973 -34.5373796943746,-58.4700492340678 -34.5372004581059,-58.4700334776109 -34.5370617199086,-58.470024872847 -34.5369561519064,-58.4700236517263 -34.536955613187,-58.4702401521792 -34.5365711832078,-58.4704492415316 -34.5361999090401,-58.4685467595887 -34.5353596043839,-58.4684579950823 -34.5353203813291,-58.4683859255902 -34.5354999709588,-58.4683584365485 -34.5354863800213,-58.4682714763285 -34.5357050566857,-58.4681092968574 -34.536112900803,-58.468066411093 -34.536097097702,-58.4679307932827 -34.5364301970529,-58.4675662174329 -34.5373256405167,-58.4676168776237 -34.5373512918139,-58.4675990083298 -34.5373962947198,-58.4672790419997 -34.5381407013931,-58.4672499813926 -34.5382182481855,-58.4674727489585 -34.5383316785836,-58.4674729368557 -34.5383312042425,-58.467899158252 -34.5385470423671)))";;"935";13_1_3;COMUNA 13;"1";"3";"612";"286";"326";"87,73%";"314";"314";"100,00%";"0";"0,00%";"258";"4";"1.55";"254";"98,45%";"1.55";1.550
"MULTIPOLYGON (((-58.4653088749573 -34.5382957749695,-58.4663904183142 -34.5388407734655,-58.4665416550828 -34.5389170400963,-58.4668991098281 -34.5391052064404,-58.4670323685845 -34.5387659600279,-58.4672173635058 -34.5382987476017,-58.4672499544957 -34.5382183199583,-58.4672499813926 -34.5382182481855,-58.4672790419997 -34.5381407013931,-58.4675990083298 -34.5373962947198,-58.4676168776237 -34.5373512918139,-58.4675662174329 -34.5373256405167,-58.4679307932827 -34.5364301970529,-58.468066411093 -34.536097097702,-58.4681092968574 -34.536112900803,-58.4682714763285 -34.5357050566857,-58.4683584365485 -34.5354863800213,-58.4683859255902 -34.5354999709588,-58.4684579950823 -34.5353203813291,-58.467387044116 -34.5348473411111,-58.4671522871315 -34.535256831378,-58.4668071241279 -34.5358414998678,-58.466806949734 -34.5358416002617,-58.4667598918545 -34.5359244227831,-58.4665979541656 -34.5362093011244,-58.4663030068027 -34.536686586979,-58.4675655581409 -34.5373253066903,-58.466959567682 -34.5380712810483,-58.4658079029507 -34.5374880480337,-58.4653088749573 -34.5382957749695)))";;"936";13_1_4;COMUNA 13;"1";"4";"763";"379";"384";"98,70%";"524";"524";"100,00%";"0";"0,00%";"367";"3";"0.82";"364";"99,18%";"0.82";0.820
"MULTIPOLYGON (((-58.4675655581409 -34.5373253066903,-58.4663030068027 -34.536686586979,-58.4658079029507 -34.5374880480337,-58.466959567682 -34.5380712810483,-58.4675655581409 -34.5373253066903)))";;"937";13_1_5;COMUNA 13;"1";"5";"835";"402";"433";"92,84%";"674";"674";"100,00%";"0";"0,00%";"421";"7";"1.66";"414";"98,34%";"1.66";1.660
"MULTIPOLYGON (((-58.4648352830245 -34.539062088865,-58.4643295129948 -34.5398802347462,-58.463824073494 -34.5406979558645,-58.4646924391868 -34.5411363461244,-58.4656334981256 -34.5416114203524,-58.4658496785013 -34.5417205751276,-58.4659938391859 -34.5413714700842,-58.4661701661427 -34.5409401768951,-58.4662113541218 -34.5408370017472,-58.4663483630189 -34.540494446051,-58.4665034966389 -34.5401078029883,-58.4665694471397 -34.5399434267996,-58.4666816900421 -34.5396636913937,-58.4668560515298 -34.5392147906735,-58.4668991098281 -34.5391052064404,-58.4665416550828 -34.5389170400963,-58.4663904183142 -34.5388407734655,-58.4653088749573 -34.5382957749695,-58.465133055498 -34.5385802994239,-58.4648352830245 -34.539062088865)))";;"938";13_1_6;COMUNA 13;"1";"6";"882";"430";"452";"95,13%";"519";"519";"100,00%";"0";"0,00%";"386";"1";"0.26";"385";"99,74%";"0.26";0.260
"MULTIPOLYGON (((-58.4674997322474 -34.5425560543455,-58.4684375038346 -34.5430313886861,-58.4690110880667 -34.5422551965664,-58.469587555019 -34.5414750576409,-58.4688524444813 -34.5411036001948,-58.4686533690839 -34.5410024080203,-58.467721661789 -34.5405290468549,-58.468260174559 -34.5397992700703,-58.4688345891569 -34.5390206838498,-58.467899158252 -34.5385470423671,-58.4674729368557 -34.5383312042425,-58.4674727489585 -34.5383316785836,-58.4672499813926 -34.5382182481855,-58.4672499544957 -34.5382183199583,-58.4672173635058 -34.5382987476017,-58.4670323685845 -34.5387659600279,-58.4668991098281 -34.5391052064404,-58.4668560515298 -34.5392147906735,-58.4666816900421 -34.5396636913937,-58.4665694471397 -34.5399434267996,-58.4665034966389 -34.5401078029883,-58.4663483630189 -34.540494446051,-58.4662113541218 -34.5408370017472,-58.4661701661427 -34.5409401768951,-58.4659938391859 -34.5413714700842,-58.4658496785013 -34.5417205751276,-58.4658444815017 -34.5417331498139,-58.4660737927187 -34.5418421471854,-58.4660766685017 -34.5418351520147,-58.4661193940975 -34.5418567011534,-58.4662447623605 -34.5419200104689,-58.466572695341 -34.5420862056465,-58.4674997322474 -34.5425560543455)))";;"939";13_1_7;COMUNA 13;"1";"7";"509";"240";"269";"89,22%";"254";"254";"100,00%";"0";"0,00%";"185";"0";"0";"185";"100,00%";"0";0.000
"MULTIPOLYGON (((-58.4701293764888 -34.5407417512446,-58.4693932488937 -34.5403726915524,-58.4691953661623 -34.5402724861469,-58.468260174559 -34.5397992700703,-58.467721661789 -34.5405290468549,-58.4686533690839 -34.5410024080203,-58.4688524444813 -34.5411036001948,-58.469587555019 -34.5414750576409,-58.4705140912868 -34.5419433341613,-58.4710560777679 -34.5412088968847,-58.4707700144974 -34.5410629232015,-58.4701293764888 -34.5407417512446)))";;"940";13_1_8;COMUNA 13;"1";"8";"538";"260";"278";"93,53%";"302";"302";"100,00%";"0";"0,00%";"241";"7";"2.9";"234";"97,10%";"2.9";2.900
"MULTIPOLYGON (((-58.4697723286374 -34.5394955152372,-58.4688345891569 -34.5390206838498,-58.468260174559 -34.5397992700703,-58.4691953661623 -34.5402724861469,-58.4693932488937 -34.5403726915524,-58.4701293764888 -34.5407417512446,-58.4707700144974 -34.5410629232015,-58.4710560777679 -34.5412088968847,-58.4711533432964 -34.5410771233029,-58.4716265615748 -34.5404350869442,-58.4707022485431 -34.5399664664726,-58.470440276631 -34.5398337304808,-58.4697723286374 -34.5394955152372)))";;"941";13_1_9;COMUNA 13;"1";"9";"457";"220";"237";"92,83%";"223";"223";"100,00%";"0";"0,00%";"217";"2";"0.92";"215";"99,08%";"0.92";0.920
"MULTIPOLYGON (((-58.4568216713241 -34.5537964633099,-58.4557787288597 -34.5532258894594,-58.4550407395152 -34.5540873638499,-58.4555304193078 -34.5543672655736,-58.4558637405136 -34.5545577159509,-58.455983619364 -34.5546246480845,-58.4562031066752 -34.5547511940419,-58.4563895333265 -34.5546299306627,-58.4566394635687 -34.5544645836385,-58.4568963731032 -34.5542948700328,-58.4571938863344 -34.5540981142255,-58.4572697332416 -34.5540416361579,-58.4573661803915 -34.5539698765528,-58.4575816325638 -34.5538059345862,-58.4577681414203 -34.5536644568903,-58.4578195567597 -34.5536262177626,-58.4582284946504 -34.5533156557642,-58.4582619624561 -34.5532445821822,-58.4581171648307 -34.5531691660226,-58.4575927538283 -34.5528975129867,-58.4568216713241 -34.5537964633099)))";;"942";13_10_1;COMUNA 13;"10";"1";"798";"376";"422";"89,10%";"569";"569";"100,00%";"0";"0,00%";"415";"1";"0.24";"414";"99,76%";"0.24";0.240
"MULTIPOLYGON (((-58.4516643703916 -34.5562190337658,-58.4505124918311 -34.5555357944915,-58.4499011993814 -34.5562522434671,-58.449728026931 -34.5564513187558,-58.4489005509064 -34.557402609256,-58.4500360473089 -34.5580826232354,-58.4500465397374 -34.558088959198,-58.4502880920226 -34.5579342611404,-58.4508175303299 -34.5576281027731,-58.4512638760716 -34.5573725000119,-58.4513413456816 -34.5573281390352,-58.4518191873311 -34.5570491558143,-58.4523823260811 -34.5567228518543,-58.4524489830168 -34.5566843345918,-58.4516643703916 -34.5562190337658)))";;"943";13_10_10;COMUNA 13;"10";"10";"893";"389";"504";"77,18%";"549";"549";"100,00%";"0";"0,00%";"424";"7";"1.65";"417";"98,35%";"1.65";1.650
"MULTIPOLYGON (((-58.4485159864503 -34.5557236860462,-58.4476935253014 -34.5566797580109,-58.4489005509064 -34.557402609256,-58.449728026931 -34.5564513187558,-58.4499011993814 -34.5562522434671,-58.4505124918311 -34.5555357944915,-58.4492975625198 -34.5548151412938,-58.4485159864503 -34.5557236860462)))";;"944";13_10_11;COMUNA 13;"10";"11";"616";"267";"349";"76,50%";"489";"489";"100,00%";"0";"0,00%";"314";"7";"2.23";"307";"97,77%";"2.23";2.230
"MULTIPOLYGON (((-58.4539996807857 -34.5534923372057,-58.4533609355427 -34.5542388735896,-58.4532735040565 -34.5543415476337,-58.4543010323464 -34.5549504533312,-58.4547853513247 -34.55523740021,-58.4548737037233 -34.5552897322394,-58.4550232561483 -34.5553784077553,-58.4550955214942 -34.5554212311341,-58.4551808188109 -34.555374051164,-58.45578061148 -34.5550160347645,-58.4562031066752 -34.5547511940419,-58.455983619364 -34.5546246480845,-58.4558637405136 -34.5545577159509,-58.4555304193078 -34.5543672655736,-58.4550407395152 -34.5540873638499,-58.4557787288597 -34.5532258894594,-58.4568216713241 -34.5537964633099,-58.4575927538283 -34.5528975129867,-58.4574054954085 -34.5528005287107,-58.4572777343475 -34.5527343228694,-58.4564898931534 -34.5523257453677,-58.4557418086375 -34.5519377997843,-58.4554579488299 -34.5517879171932,-58.4547236293417 -34.5526462209282,-58.4539996807857 -34.5534923372057)))";;"945";13_10_2;COMUNA 13;"10";"2";"900";"436";"464";"93,97%";"528";"527";"99,81%";"1";"0,19%";"404";"6";"1.49";"398";"98,51%";"1.49";1.490
"MULTIPOLYGON (((-58.454277920049 -34.5511648549091,-58.4530063264263 -34.550504025691,-58.4523085996374 -34.5513176680254,-58.4515756143367 -34.5521723612899,-58.4528381147185 -34.5528284859672,-58.4535516826261 -34.5520015315228,-58.4547236293417 -34.5526462209282,-58.4554579488299 -34.5517879171932,-58.454277920049 -34.5511648549091)))";;"946";13_10_3;COMUNA 13;"10";"3";"964";"448";"516";"86,82%";"526";"526";"100,00%";"0";"0,00%";"427";"5";"1.17";"422";"98,83%";"1.17";1.170
"MULTIPOLYGON (((-58.4515756143367 -34.5521723612899,-58.4511496076273 -34.5526691052197,-58.4509133266613 -34.5529417293908,-58.4509126800505 -34.552942475456,-58.4503350401891 -34.5536090687094,-58.4501028745934 -34.5538789869511,-58.4492975625198 -34.5548151412938,-58.4505124918311 -34.5555357944915,-58.4513147334001 -34.5545956176907,-58.451396208055 -34.55450012793,-58.452121638129 -34.5536589571645,-58.4522478909359 -34.553512482433,-58.4528381147185 -34.5528284859672,-58.4515756143367 -34.5521723612899)))";;"947";13_10_4;COMUNA 13;"10";"4";"1110";"533";"577";"92,37%";"555";"552";"99,46%";"3";"0,54%";"417";"1";"0.24";"416";"99,76%";"0.24";0.240
"MULTIPOLYGON (((-58.452121638129 -34.5536589571645,-58.451396208055 -34.55450012793,-58.4513147334001 -34.5545956176907,-58.4505124918311 -34.5555357944915,-58.4516643703916 -34.5562190337658,-58.4523566097258 -34.5554189170505,-58.4524739258399 -34.5552811037379,-58.4528904885761 -34.5547916789211,-58.4532735040565 -34.5543415476337,-58.4533609355427 -34.5542388735896,-58.4539996807857 -34.5534923372057,-58.4547236293417 -34.5526462209282,-58.4535516826261 -34.5520015315228,-58.4528381147185 -34.5528284859672,-58.4522478909359 -34.553512482433,-58.452121638129 -34.5536589571645)))";;"948";13_10_5;COMUNA 13;"10";"5";"568";"270";"298";"90,60%";"351";"351";"100,00%";"0";"0,00%";"252";"6";"2.38";"246";"97,62%";"2.38";2.380
"MULTIPOLYGON (((-58.4524489830168 -34.5566843345918,-58.4526392218749 -34.5567967498895,-58.4526723382665 -34.5567711880723,-58.4526904722518 -34.5567500618398,-58.4533558425374 -34.55639502801,-58.4538896939535 -34.5561265319879,-58.4539395686452 -34.5560889305935,-58.4539077380037 -34.5560361794239,-58.4545477316128 -34.5556723340077,-58.4545750517331 -34.5557174787328,-58.4550955214942 -34.5554212311341,-58.4550232561483 -34.5553784077553,-58.4548737037233 -34.5552897322394,-58.4547853513247 -34.55523740021,-58.4543010323464 -34.5549504533312,-58.4532735040565 -34.5543415476337,-58.4528904885761 -34.5547916789211,-58.4524739258399 -34.5552811037379,-58.4523566097258 -34.5554189170505,-58.4516643703916 -34.5562190337658,-58.4524489830168 -34.5566843345918)))";;"949";13_10_6;COMUNA 13;"10";"6";"900";"440";"460";"95,65%";"464";"464";"100,00%";"0";"0,00%";"388";"35";"9.02";"353";"90,98%";"9.02";9.020
"MULTIPOLYGON (((-58.4528007763025 -34.5568926125191,-58.452000574977 -34.5578126571519,-58.4529024990943 -34.5583513487648,-58.4536977589774 -34.5574260160076,-58.454011311802 -34.5570611630207,-58.4545021102123 -34.5564934951141,-58.4553160631871 -34.5555519548627,-58.45578061148 -34.5550160347645,-58.4551808188109 -34.555374051164,-58.4550955214942 -34.5554212311341,-58.4545750517331 -34.5557174787328,-58.4545477316128 -34.5556723340077,-58.4539077380037 -34.5560361794239,-58.4539395686452 -34.5560889305935,-58.4538896939535 -34.5561265319879,-58.4533558425374 -34.55639502801,-58.4526904722518 -34.5567500618398,-58.4526723382665 -34.5567711880723,-58.4526392218749 -34.5567967498895,-58.4528007763025 -34.5568926125191)))";;"950";13_10_7;COMUNA 13;"10";"7";"661";"292";"369";"79,13%";"416";"416";"100,00%";"0";"0,00%";"321";"2";"0.62";"319";"99,38%";"0.62";0.620
"MULTIPOLYGON (((-58.4529024990943 -34.5583513487648,-58.452000574977 -34.5578126571519,-58.451152592632 -34.5587876943705,-58.4519642094043 -34.5592708183727,-58.4520620977391 -34.5593291394254,-58.4521504723359 -34.5592263959891,-58.4529024990943 -34.5583513487648)))";;"951";13_10_8;COMUNA 13;"10";"8";"910";"346";"564";"61,35%";"608";"607";"99,84%";"1";"0,16%";"432";"2";"0.46";"430";"99,54%";"0.46";0.460
"MULTIPOLYGON (((-58.4528007763025 -34.5568926125191,-58.4526392218749 -34.5567967498895,-58.4524489830168 -34.5566843345918,-58.4523823260811 -34.5567228518543,-58.4518191873311 -34.5570491558143,-58.4513413456816 -34.5573281390352,-58.4512638760716 -34.5573725000119,-58.4508175303299 -34.5576281027731,-58.4502880920226 -34.5579342611404,-58.4500465397374 -34.558088959198,-58.4501501218665 -34.5581565527147,-58.450150070384 -34.5581565810282,-58.4505040740245 -34.5583880358108,-58.4505851061525 -34.5584410040166,-58.4507383184485 -34.5585410940644,-58.451152592632 -34.5587876943705,-58.452000574977 -34.5578126571519,-58.4528007763025 -34.5568926125191)))";;"952";13_10_9;COMUNA 13;"10";"9";"701";"297";"404";"73,51%";"389";"389";"100,00%";"0";"0,00%";"325";"1";"0.31";"324";"99,69%";"0.31";0.310
;"58.439715203923946 -34.540197886688411,-58.439493640234204 -34.54030355409688,-58.43935738520927 -34.540296485535706,-58.439237997283151 -34.540233079325404,-58.439093251581625 -34.540155442061689,-58.438939906279828 -34.540092028989534,-58.438769525693381 -34.540077840109404,-58.438505365200598 -34.540035462077107,-58.438309469095195 -34.539964926755871,-58.438070943026261 -34.539866141732389,-58.437960135820461 -34.539859076741621,-58.43781536676223 -34.539866089920075,-58.437679014821484 -34.539901345448747,-58.4375086263097 -34.539915466030294,-58.437346665494623 -34.539922475105392,-58.437227417662619 -34.539964705846032,-58.437125108160267 -34.539999967851699,-58.43700585359241 -34.540063396577587,-58.436852462130574 -34.540154988335495,-58.436733132984259 -34.540183133389696,-58.436613882230048 -34.540232546972831,-58.436426370816207 -34.540295890104616,-58.43623902485394 -34.540373388593906,-58.436111090327593 -34.540429842394545,-58.436025870708001 -34.540514334914484,-58.435949161621124 -34.540599040516106,-58.435838404797259 -34.540697612489573,-58.435736151623836 -34.540817525291622,-58.435667860875959 -34.540923219493479,-58.435599731018932 -34.541057154482452,-58.435505893647715 -34.541205168890741,-58.435429250133602 -34.541346214899008,-58.435326880499716 -34.541557681000185,-58.43525871948637 -34.541783310307039,-58.435224429259478 -34.54201591935729,-58.435122233127764 -34.542213370548268,-58.435034334128439 -34.542413219367639,-58.435011308693745 -34.542551671462697,-58.434892662288235 -34.5425620675354,-58.434759200240691 -34.542591968076927,-58.434603522148763 -34.54262869467474,-58.434458909743974 -34.542660845950309,-58.434289355326143 -34.542706865155253,-58.434094690164194 -34.542762033610963,-58.43390283257451 -34.542819526472364,-58.433768854643269 -34.542862313746724,-58.433746041936651 -34.542871604557625,-58.433712334675072 -34.542882230870518,-58.433681435792472 -34.542893562100403,-58.433651898589225 -34.542905104924053,-58.43362227629224 -34.542916577294385,-58.43359256895058 -34.542927838359546,-58.433562776490831 -34.542939099397152,-58.433533154218729 -34.542950430894003,-58.433503531864808 -34.542961973661299,-58.433474164783917 -34.542973657334272,-58.433444712535376 -34.542985481831529,-58.433415260303178 -34.542997235895768,-58.43338563786704 -34.543008919486148,-58.433356270703769 -34.543020743982424,-58.433326988568176 -34.543032779769739,-58.433297791460056 -34.543045026848141,-58.433269019696198 -34.543057837429195,-58.433240588215618 -34.543071070640835,-58.433212582028929 -34.543085008207449,-58.433185341551855 -34.54309972063745,-58.433158696538598 -34.543115278316066,-58.433132306671993 -34.543131329031844,-58.433106172051417 -34.543147591081393,-58.433080037395747 -34.543163923551184,-58.433053732584071 -34.543180044696363,-58.43302700238538 -34.543195672751224,-58.43299976176457 -34.543210596417175,-58.432972095782368 -34.543224956566355,-58.432943919328707 -34.543238753177747,-58.432915657830591 -34.543252338484194,-58.432887226152651 -34.543265782890735,-58.432858879550864 -34.543279297737314,-58.432830788145544 -34.543293164769125,-58.432803037046902 -34.5433073840072,-58.432775796349745 -34.543322307622873,-58.43274898106926 -34.54333758346624,-58.432722335848553 -34.5433532819007,-58.432695945848366 -34.543369262095588,-58.432669726008626 -34.543385383178332,-58.43264359116808 -34.543401785979867,-58.432617711623728 -34.543418259264541,-58.4325919171037 -34.543434943842307,-58.432566292769252 -34.543451698882464,-58.432540753458987 -34.54346866521584,-58.432515384385084 -34.543485561160018,-58.432490015250039 -34.543502597950642,-58.432464816249656 -34.543519846055723,-58.432439702298616 -34.543537235028388,-58.432414843592788 -34.543554835336785,-58.432390155123514 -34.543572365256452,-58.432365381430927 -34.543590176853428,-58.432340777949371 -34.543607988487651,-58.43231625954251 -34.543625870563915,-58.432291656039979 -34.543643682188119,-58.432267222697376 -34.543661634701479,-58.432242789344286 -34.543679587209901,-58.432218611236308 -34.543697751054744,-58.43219460328821 -34.543716055789012,-58.432170680363392 -34.543734571817396,-58.432146842538884 -34.543753087862335,-58.43212300470384 -34.543771603902556,-58.432099166909779 -34.543789979086313,-58.432057023789682 -34.543825956143444,-58.432034206936322 -34.543845317532877,-58.432011304987185 -34.543864608470706,-58.431988403027489 -34.543883899404165,-58.431965415920232 -34.543903260737714,-58.431942599050466 -34.543922551683899,-58.431919867203511 -34.543942053924802,-58.431897305542286 -34.543961626630228,-58.431874914040904 -34.543981340226111,-58.431852777810548 -34.544001194734086,-58.431830981936514 -34.54402126060166,-58.431809356196396 -34.54404153778593,-58.431788241009116 -34.544062096799067,-58.431767466126246 -34.544083008024074,-58.431746946540784 -34.544103989736065,-58.431726682200697 -34.544125182786907,-58.431706587994661 -34.544146587155119,-58.43168666400107 -34.544167991563171,-58.431666825082488 -34.544189466415403,-58.431646815904777 -34.544211011646908,-58.431626891880519 -34.544232416044977,-58.431606797649344 -34.54425374997048,-58.431586533237414 -34.544274942997511,-58.431565843336465 -34.544295924634987,-58.431545068339844 -34.544316835821292,-58.431524293280333 -34.544337887855718,-58.431503688459728 -34.544358869504158,-58.431483594193026 -34.544380132983058,-58.431464010454079 -34.544401748718549,-58.431445362722194 -34.544423928097366,-58.431427395768118 -34.544446389351108,-58.431409854230914 -34.544469202840503,-58.431392738137077 -34.544492298139843,-58.431375962427815 -34.544515534375769,-58.431359441991667 -34.544538911526558,-58.43134309171694 -34.544562429570476,-58.431326911656569 -34.544585947655833,-58.431310816698904 -34.544609465760814,-58.431294636646804 -34.544632913415839,-58.431278626756395 -34.544656501964141,-58.431262872139612 -34.544680231427726,-58.431247372823094 -34.54470403138081,-58.43123204369509 -34.544727901801551,-58.431216884729174 -34.544751913115881,-58.431201896005049 -34.544775854046307,-58.431186992331227 -34.544799935848459,-58.431172088648836 -34.544824017648693,-58.431157099845777 -34.544848099425025,-58.431142196146169 -34.544872181221429,-58.431127292437964 -34.544896263015893,-58.431112473833295 -34.544920344830452,-58.431097655193476 -34.544944497068983,-58.431083006769406 -34.544968649349691,-58.43106844342244 -34.544992872076449,-58.431054135377025 -34.545017165293395,-58.431039997494445 -34.545041599404442,-58.431025944742537 -34.545065963109941,-58.431012147239237 -34.545090538157574,-58.430998605091489 -34.54511504284396,-58.430985062909073 -34.545139617954618,-58.430971690889976 -34.545164333959598,-58.430958403975353 -34.545189049985147,-58.43094520213856 -34.54521383645713,-58.430932170518808 -34.545238622971866,-58.430919309062745 -34.545263550381144,-58.430906617823979 -34.54528847783326,-58.430894011663376 -34.54531347573198,-58.430881660806051 -34.545338544121691,-58.430869565279046 -34.545363612576594,-58.430857639943142 -34.545388751500433,-58.430845969911118 -34.545413960915475,-58.430834470043635 -34.545439311225422,-58.430823055281856 -34.545464661556395,-58.430811810711688 -34.545490082356501,-58.430800736333268 -34.545515573625771,-58.43078991725946 -34.545541135386529,-58.430779268404585 -34.545566697190708,-58.430768959940629 -34.545592399934584,-58.43075890678189 -34.545618173170126,-58.430749279127411 -34.545644087367769,-58.430739906832535 -34.545669931205524,-58.430730874929644 -34.545695915983302,-58.43072226855886 -34.54572197129756,-58.430714172833547 -34.545748097170758,-58.430706247275246 -34.545774363939572,-58.430698577024046 -34.545800701200555,-58.430691247247175 -34.545826968124302,-58.430684087610871 -34.545853446369705,-58.430677268449408 -34.545879854277985,-58.430670619482918 -34.545906332656273,-58.430664225797685 -34.545932951952771,-58.43065800236171 -34.545959500867646,-58.430651949121184 -34.545986120252607,-58.430646151189514 -34.546012810130009,-58.430640523507634 -34.54603942962585,-58.430635066021743 -34.546066119591906,-58.430629863872312 -34.546092809624625,-58.430624661719534 -34.546119499657024,-58.430619800016899 -34.546146189778511,-58.430615193624327 -34.546172950392652,-58.430611012768871 -34.546199781544146,-58.430606916997142 -34.546226683143622,-58.430603161703708 -34.54625351440648,-58.430599576607854 -34.54628041613968,-58.430596246823214 -34.546307388365648,-58.430593087317646 -34.546334219784477,-58.430590097983099 -34.546361192099553,-58.430587278873858 -34.546388164459188,-58.430584715103713 -34.546415136885813,-58.430582151331912 -34.54644210931226,-58.430579842926583 -34.546469011379848,-58.430577619579388 -34.546496054321352,-58.430575651599057 -34.546523026904048,-58.430573768731215 -34.546549999508962,-58.430572141176519 -34.546577042606749,-58.430570513620758 -34.546604085704416,-58.430569141405527 -34.546631128869123,-58.430567854330377 -34.546658101630243,-58.430566652341206 -34.546685144839465,-58.430565705693091 -34.546712188115769,-58.430564844158326 -34.546739231414328,-58.430564152851005 -34.546766274757573,-58.430563461516172 -34.546793388526524,-58.4305630255501 -34.546820431936716,-58.430562759811892 -34.546847475391601,-58.430563855601477 -34.546875293888966,-58.430566823523876 -34.54690409884072,-58.430570812628865 -34.546933397041897,-58.430575227280578 -34.546962765780592,-58.430579131412365 -34.546991711829612,-58.430582184701898 -34.547019882970318,-58.430583451134574 -34.54704664512397,-58.430582249929415 -34.547071645982392,-58.430577985473377 -34.547094392407928,-58.43056793445686 -34.547113968147734,-58.430467662172703 -34.547133590530329,-58.429996165424775 -34.546821619522603,-58.430052274206822 -34.546773956239356,-58.429954919230568 -34.54673449169681,-58.429932608329814 -34.546762656050426,-58.429910470901518 -34.546782510196579,-58.429889014153872 -34.546802927928304,-58.429867812654926 -34.546823557002377,-58.42984814283917 -34.546845102020768,-58.429830259938633 -34.546867844756306,-58.429813653546347 -34.54689108081385,-58.429797472604676 -34.546914598687074,-58.429781717141587 -34.546938327950315,-58.429767493503185 -34.546962621031284,-58.429755397406801 -34.546987689368834,-58.429744662909037 -34.547013321479305,-58.429734353948305 -34.547039024129468,-58.429723619437489 -34.547064656237879,-58.429712459431833 -34.547090076952756,-58.429702746224407 -34.5471158501867,-58.429695501077795 -34.547142257919447,-58.429690724077595 -34.547169088873936,-58.429688755822937 -34.547195991013353,-58.429690532547738 -34.547223035016735,-58.429693841362358 -34.547250009008273,-58.429697660921825 -34.54727684228596,-58.429701906056458 -34.547303675678414,-58.429705470277227 -34.547330508886624,-58.429707672555502 -34.547357623429995,-58.429712173096902 -34.547384316039086,-58.429721355252816 -34.547410235228156,-58.429732495218701 -34.547435732389999,-58.429742358304196 -34.547461651761125,-58.429752732167479 -34.547487359991642,-58.429766681439638 -34.547511590242969,-58.429784546637649 -34.547534201753983,-58.429802837447042 -34.54755674295113,-58.429817723091517 -34.547580762171116,-58.429829714313428 -34.547606118700948,-58.429843663600018 -34.547630419368843,-58.429862550444355 -34.547652467736228,-58.429884076497139 -34.547672897015708,-58.429906368788316 -34.547692833516273,-58.429929427428462 -34.547711995534186,-58.429953592960153 -34.547730171882826,-58.429978184049801 -34.54774841876651,-58.430003711828533 -34.547765609508495,-58.430030942991827 -34.547780054093288,-58.430060984830803 -34.547789710466546,-58.430093155926492 -34.547795846109267,-58.4301253270269 -34.547801981743518,-58.430149269338692 -34.547737830192702,-58.430069193288283 -34.547693863098587,-58.430479160937672 -34.547332828269944,-58.430607082252017 -34.547348214791199,-58.430614648017304 -34.547372795397536,-58.430618297135133 -34.547400966692159,-58.430619647510589 -34.547430827602739,-58.430620487225774 -34.547460617953163,-58.430622434189793 -34.547488436670861,-58.430624807053185 -34.547515410390204,-58.430626754344139 -34.547542383997602,-58.430628361177064 -34.547569357515442,-58.43062971263948 -34.547596401391907,-58.430630808758139 -34.547623445201161,-58.430631649532806 -34.547650488943241,-58.430632490308007 -34.547677532685178,-58.430633075738896 -34.547704576359948,-58.430639173656935 -34.547783736600159,-58.430516507517851 -34.547823635778933,-58.430390164680666 -34.547906564045725,-58.430304678056544 -34.54798654514186,-58.430215435494183 -34.548094061677951,-58.430103975122996 -34.548207840116689,-58.430033373560711 -34.548312333179837,-58.429940361117502 -34.548481330247334,-58.429825154785128 -34.548595036993191,-58.429732247303086 -34.548711848387022,-58.429628190550503 -34.548825628378225,-58.429531543543078 -34.548927015346983,-58.429353156444819 -34.549099087464576,-58.42927508631346 -34.549145124604223,-58.429167307934691 -34.549197421436389,-58.429067032058128 -34.549218944157346,-58.428996382896564 -34.549225051723063,-58.428918345978055 -34.54918812702936,-58.428814348618523 -34.549151195083937,-58.428736388209963 -34.549135820595389,-58.428636033465231 -34.549141919686384,-58.428572867049709 -34.549166480658855,-58.428524594683076 -34.549194214929926,-58.428468815709422 -34.549261808090307,-58.428439089889935 -34.549310956973471,-58.428294207542606 -34.549344720627069,-58.428190153059347 -34.549240179350477,-58.428130774787093 -34.549160229250795,-58.427970950378239 -34.549101800894086,-58.42784838535254 -34.54909563892614,-58.427748100307667 -34.549138570010484,-58.427655216364734 -34.549190869770314,-58.427521347336757 -34.549347528718172,-58.427443251281588 -34.549452088529236,-58.427413500891923 -34.54975948860929,-58.427309388434551 -34.549793262866764,-58.427238827690907 -34.549790143659187,-58.427134764835358 -34.549707081361312,-58.426978748009731 -34.549700908772607,-58.426937899721153 -34.54968251567869,-58.426900808509849 -34.549636305476753,-58.426848734081929 -34.549596358762187,-58.426778178757644 -34.549581055624294,-58.426689056124005 -34.549593283464041,-58.426618406473501 -34.549599389653181,-58.426566404047449 -34.549590148493856,-58.426514406968053 -34.549568582796645,-58.426455004690474 -34.549547155730934,-58.426336107205692 -34.549522471344879,-58.426202989600966 -34.549510811368961,-58.426059896176234 -34.549538375433045,-58.425940616265677 -34.549609399227215,-58.425826182631241 -34.549692185478122,-58.42583090218416 -34.549798741155321,-58.425806952952357 -34.549869723137917,-58.425756283811474 -34.549924992078076,-58.425756256638721 -34.549986473800722,-58.425744661011812 -34.550030979402365,-58.425729585652633 -34.550052665987479,-58.425603977791283 -34.549803743082698,-58.425624068860053 -34.549796002345779,-58.425580441639163 -34.549710773859701,-58.425560606282048 -34.5497177399834,-58.425371641196833 -34.549348439821522,-58.425399989620665 -34.549338166315579,-58.425344117448411 -34.549227510277809,-58.425315769401699 -34.549237009087101,-58.425183103993362 -34.548977730960452,-58.425194434344263 -34.548955691159627,-58.425185676759952 -34.54893477200077,-58.425164147009362 -34.548924412788672,-58.425142441874151 -34.548925532927527,-58.425121241166941 -34.548940597530169,-58.425117655742561 -34.548964048224711,-58.425244877982848 -34.549213253861588,-58.425317588392808 -34.54935680395706,-58.425510549746853 -34.549735119923078,-58.425490714315451 -34.549742226887005,-58.425534000992769 -34.549827455301028,-58.425553751323633 -34.549820348304273,-58.42567102270678 -34.550057648473953,-58.42657488590639 -34.551825606750043,-58.426698554231969 -34.552046005560896,-58.426901681539753 -34.551970216714203,-58.428134865433414 -34.551412236387598,-58.428462621519522 -34.551292745734806,-58.428699473134884 -34.551165834211332,-58.429168861736734 -34.550874354398694,-58.429571949965592 -34.550916308800588,-58.4297876247388 -34.550938520028993,-58.430040485013848 -34.55096443297888,-58.430560901136637 -34.551017810356427,-58.430879990554921 -34.55106831880034,-58.431089087102933 -34.551140701458131,-58.431353807133007 -34.551276148549675,-58.431627038931616 -34.551449208554644,-58.431629223409878 -34.551450541180415,-58.431827477777823 -34.551577764839628,-58.431940847155211 -34.551640282926265,-58.432035584136329 -34.551692587017214,-58.432332249079224 -34.551857668786127,-58.436036216667851 -34.549828667697454,-58.436430374685813 -34.549610235625835,-58.43734554941021 -34.549121151570546,-58.437774889849337 -34.548887777209693,-58.440180535963464 -34.547595015029465,-58.440598851966215 -34.547361981928667,-58.44102814698013 -34.547122822286028,-58.442823188938299 -34.546133785329424,-58.443093458735071 -34.54598516003994,-58.44545076651761 -34.544688693893107,-58.445790712593222 -34.54450820008725,-58.445855298270494 -34.54471396282927,-58.445855333418642 -34.544736959057488,-58.445852093594453 -34.544769063878476,-58.445845622028841 -34.544793141936253,-58.445840765519797 -34.544825246533463,-58.445839141826582 -34.544860027015716,-58.445840746097538 -34.544921562332725,-58.445843971098384 -34.544963032081078,-58.445850427580062 -34.545013866311109,-58.445858502100528 -34.5450580121664,-58.445879507412599 -34.545115536996896,-58.445894047893177 -34.545163696897824,-58.445924756865253 -34.545203832702533,-58.447289776557689 -34.5470121481004,-58.448044164174526 -34.546898573657451,-58.448773866052903 -34.546788724308634,-58.449486627943962 -34.5466814040957,-58.449630863018896 -34.54665953363255,-58.449852989303587 -34.547705640308514,-58.450106981868174 -34.548849164087265,-58.450810111510428 -34.548743749560757)))""";"953";13_11_1;"13";"11";"1";"568";"296";"272";"123,64%";"220";"217";"98,64%";"3";"1,38%";"172";"7";"4.07";"165";"95,93%";"4.07";4.070
"MULTIPOLYGON (((-58.4472897765577 -34.5470121481004,-58.4459247568653 -34.5452038327025,-58.4458940478932 -34.5451636968978,-58.4458795074126 -34.5451155369969,-58.4458585021005 -34.5450580121664,-58.4458504275801 -34.5450138663111,-58.4458439710984 -34.5449630320811,-58.4458407460975 -34.5449215623327,-58.4458391418266 -34.5448600270157,-58.4458407655198 -34.5448252465335,-58.4458456220288 -34.5447931419363,-58.4458520935945 -34.5447690638785,-58.4458553334186 -34.5447369590575,-58.4458552982705 -34.5447139628293,-58.4457907125932 -34.5445082000873,-58.4454507665176 -34.5446886938931,-58.4430934587351 -34.5459851600399,-58.4428231889383 -34.5461337853294,-58.4410281469801 -34.547122822286,-58.4405988519662 -34.5473619819287,-58.4406669232391 -34.5474394626561,-58.4410612197052 -34.5479225135657,-58.4411319244218 -34.5480233054447,-58.4411612065482 -34.5480137327,-58.4413668601543 -34.5479546111018,-58.4417666710536 -34.5478559432765,-58.4421920114545 -34.5477738285026,-58.4431384445156 -34.5483347847087,-58.4433388642649 -34.548453554602,-58.444277312812 -34.5490098525503,-58.4453736462406 -34.5496596912277,-58.4464774862202 -34.5503138873926,-58.447632834522 -34.5509987151012,-58.4480260254694 -34.5503462679071,-58.4487814636592 -34.5502322665463,-58.4495089806193 -34.550122412619,-58.450015244577 -34.5500491539677,-58.4500784008354 -34.5499665405847,-58.4501932738374 -34.5498938120139,-58.4503133675385 -34.5498766547242,-58.4501069818682 -34.5488491640873,-58.4498529893036 -34.5477056403085,-58.4496308630189 -34.5466595336325,-58.449486627944 -34.5466814040957,-58.4487738660529 -34.5467887243086,-58.4480441641745 -34.5468985736575,-58.4472897765577 -34.5470121481004)))";;"954";13_11_2;COMUNA 13;"11";"2";"746";"344";"402";"85,57%";"330";"329";"99,70%";"1";"0,30%";"241";"0";"0";"241";"100,00%";"0";0.000
"MULTIPOLYGON (((-58.4503133675385 -34.5498766547242,-58.4505453703249 -34.5499690179598,-58.4510616402015 -34.5498886159351,-58.4517924708359 -34.5497780444529,-58.4530063264263 -34.550504025691,-58.4533932371538 -34.550052767206,-58.4540229057031 -34.5495186337659,-58.4541574870459 -34.5494045534285,-58.4541610831408 -34.5491970792111,-58.4541211852995 -34.5489847425565,-58.4539581260556 -34.5487597204772,-58.4538186413127 -34.5485672366223,-58.4536634174402 -34.5483134809643,-58.4532550258909 -34.5483750726607,-58.4527546220044 -34.5484505294196,-58.4521597368797 -34.5485402020252,-58.4515415282411 -34.5486334613192,-58.4508101115104 -34.5487437495608,-58.4501069818682 -34.5488491640873,-58.4503133675385 -34.5498766547242)))";;"955";13_11_3;COMUNA 13;"11";"3";"579";"264";"315";"83,81%";"259";"259";"100,00%";"0";"0,00%";"207";"1";"0.48";"206";"99,52%";"0.48";0.480
"MULTIPOLYGON (((-58.4530063264263 -34.550504025691,-58.4517924708359 -34.5497780444529,-58.4510616402015 -34.5498886159351,-58.4505453703249 -34.5499690179598,-58.4506349391137 -34.5500188417996,-58.4506863250697 -34.5500893168041,-58.4506819074592 -34.5501743662934,-58.4506407814006 -34.5502375421813,-58.4506158111997 -34.5502812796726,-58.450554127584 -34.5503371635007,-58.4504645442746 -34.5503845395126,-58.4506680349972 -34.5512332177027,-58.45092390144 -34.5525207472365,-58.4510265654864 -34.552617163842,-58.4510234423698 -34.5527038201744,-58.4509133266613 -34.5529417293908,-58.4511496076273 -34.5526691052197,-58.4515756143367 -34.5521723612899,-58.4523085996374 -34.5513176680254,-58.4530063264263 -34.550504025691)))";;"956";13_11_4;COMUNA 13;"11";"4";"557";"245";"312";"78,53%";"308";"308";"100,00%";"0";"0,00%";"229";"1";"0.44";"228";"99,56%";"0.44";0.440
"MULTIPOLYGON (((-58.4510265654864 -34.552617163842,-58.45092390144 -34.5525207472365,-58.4506680349972 -34.5512332177027,-58.4504645442746 -34.5503845395126,-58.450554127584 -34.5503371635007,-58.4506158111997 -34.5502812796726,-58.4506407814006 -34.5502375421813,-58.4506819074592 -34.5501743662934,-58.4506863250697 -34.5500893168041,-58.4506349391137 -34.5500188417996,-58.4505453703249 -34.5499690179598,-58.4503133675385 -34.5498766547242,-58.4501932738374 -34.5498938120139,-58.4500784008354 -34.5499665405847,-58.450015244577 -34.5500491539677,-58.4495089806193 -34.550122412619,-58.4487814636592 -34.5502322665463,-58.4480260254694 -34.5503462679071,-58.447632834522 -34.5509987151012,-58.4487392631806 -34.5516544403672,-58.4498546459422 -34.5523155088409,-58.4499107347235 -34.5523486852739,-58.4508558244604 -34.5529088064316,-58.4509126800505 -34.552942475456,-58.4509133266613 -34.5529417293908,-58.4510234423698 -34.5527038201744,-58.4510265654864 -34.552617163842)))";;"957";13_11_5;COMUNA 13;"11";"5";"591";"278";"313";"88,82%";"262";"262";"100,00%";"0";"0,00%";"222";"0";"0";"222";"100,00%";"0";0.000
"MULTIPOLYGON (((-58.4464774862202 -34.5503138873926,-58.4453736462406 -34.5496596912277,-58.444277312812 -34.5490098525503,-58.443459722464 -34.5499594186109,-58.4439046557337 -34.5502252749207,-58.4445636369288 -34.5506118009844,-58.4456692717885 -34.5512603001317,-58.4461479231366 -34.5515410127537,-58.4468157759052 -34.551935838028,-58.4479272324183 -34.5525927684447,-58.4490528350466 -34.5532581413505,-58.4494129465603 -34.5534710077585,-58.4501028745934 -34.5538789869511,-58.4503350401891 -34.5536090687094,-58.4509126800505 -34.552942475456,-58.4508558244604 -34.5529088064316,-58.4499107347235 -34.5523486852739,-58.4498546459422 -34.5523155088409,-58.4487392631806 -34.5516544403672,-58.447632834522 -34.5509987151012,-58.4464774862202 -34.5503138873926)))";;"958";13_11_6;COMUNA 13;"11";"6";"1081";"521";"560";"93,04%";"482";"482";"100,00%";"0";"0,00%";"408";"1";"0.25";"407";"99,75%";"0.25";0.250
"MULTIPOLYGON (((-58.4445636369288 -34.5506118009844,-58.4439046557337 -34.5502252749207,-58.443459722464 -34.5499594186109,-58.4426659533254 -34.5508810943394,-58.44378314996 -34.5515438384421,-58.4448768742766 -34.5521926949496,-58.4460170005868 -34.5528690844223,-58.4471378250427 -34.5535339813172,-58.4482545819117 -34.554196472896,-58.4492975625198 -34.5548151412938,-58.4501028745934 -34.5538789869511,-58.4494129465603 -34.5534710077585,-58.4490528350466 -34.5532581413505,-58.4479272324183 -34.5525927684447,-58.4468157759052 -34.551935838028,-58.4461479231366 -34.5515410127537,-58.4456692717885 -34.5512603001317,-58.4445636369288 -34.5506118009844)))";;"959";13_11_7;COMUNA 13;"11";"7";"726";"343";"383";"89,56%";"355";"355";"100,00%";"0";"0,00%";"284";"22";"7.75";"262";"92,25%";"7.75";7.750
"MULTIPOLYGON (((-58.4466486608212 -34.556059878613,-58.447347704111 -34.5564725929248,-58.4476935253014 -34.5566797580109,-58.4485159864503 -34.5557236860462,-58.4492975625198 -34.5548151412938,-58.4482545819117 -34.554196472896,-58.4471378250427 -34.5535339813172,-58.4470420424569 -34.5536491152068,-58.4463579402811 -34.5544406815901,-58.445529508009 -34.5553990624271,-58.4466486608212 -34.556059878613)))";;"960";13_12_1;COMUNA 13;"12";"1";"703";"329";"374";"87,97%";"420";"418";"99,52%";"2";"0,48%";"277";"0";"0";"277";"100,00%";"0";0.000
"MULTIPOLYGON (((-58.4425813381601 -34.5608136456888,-58.443382526971 -34.5598773246576,-58.4441974918885 -34.5589248023973,-58.4439893003011 -34.5588016665278,-58.4430644476981 -34.5582508626333,-58.4419634219069 -34.5576046654607,-58.4408384168023 -34.5569250722056,-58.4404871641985 -34.5567158443793,-58.4402689407645 -34.5565859394271,-58.440042717816 -34.556450680242,-58.4397064487145 -34.5562496223196,-58.4385824143483 -34.5555776847225,-58.4374622278827 -34.5549079911267,-58.4363452933721 -34.5542402598074,-58.435615601991 -34.5538039533643,-58.4355118238907 -34.553749628964,-58.4353534657727 -34.5536908615774,-58.4351651014873 -34.5536646912834,-58.4346535479346 -34.5535935856731,-58.4341098539966 -34.5539569768724,-58.4351816952111 -34.5544550833682,-58.4353354017439 -34.5545268817624,-58.4354559148488 -34.5545867706071,-58.4357171123288 -34.5547164120033,-58.4359822219644 -34.5548594345877,-58.4362434084503 -34.5550290766778,-58.436536667459 -34.555261826554,-58.4366872125878 -34.5553802444057,-58.436869918012 -34.5555523332969,-58.4370990949652 -34.5557454889607,-58.4373309168468 -34.5559220242629,-58.4375009593015 -34.5560346702379,-58.4376988376391 -34.5561472512516,-58.4379863517375 -34.5562598501194,-58.4383431594061 -34.5563654900036,-58.4384907513316 -34.5564093945926,-58.4388117259801 -34.5565049551144,-58.4391487783709 -34.5566410831167,-58.4395391990932 -34.5567975733581,-58.4398351387841 -34.5569336916536,-58.4401589910618 -34.5571039708642,-58.4404428283754 -34.5573030460455,-58.440692955451 -34.5575101430217,-58.4409142253276 -34.5577211077476,-58.4410585522447 -34.5578962821849,-58.4411644030319 -34.5580714496659,-58.4412509174426 -34.558298376556,-58.4413375052422 -34.5585730520225,-58.4413759385191 -34.5587442636461,-58.4413855395112 -34.5588158882699,-58.4413328954728 -34.55895666006,-58.4412994207866 -34.5590347563067,-58.4412598027211 -34.5591682060694,-58.4412080055495 -34.5593244011753,-58.4411287804148 -34.5595460168889,-58.4410313389433 -34.5597625586609,-58.4409582604447 -34.5599136792163,-58.4408455135692 -34.5600597219795,-58.440653664053 -34.5602763169209,-58.4404892441666 -34.560419885105,-58.4403278903618 -34.5605558476516,-58.4401664529359 -34.5606842744177,-58.4398923689572 -34.5608907116353,-58.4396944938113 -34.5610242016066,-58.4394691186946 -34.5611676864713,-58.4392407703542 -34.5612860283771,-58.4389241340859 -34.5614345653076,-58.4386865960944 -34.5615327626375,-58.4384734954494 -34.5616108226117,-58.4382481372851 -34.5616838091098,-58.4379802140909 -34.5617567865797,-58.4376574678896 -34.561827216903,-58.4372770104937 -34.5618743234699,-58.4372033712701 -34.56188184366,-58.4371050439012 -34.561891330551,-58.4370250200059 -34.5618986380177,-58.4368913632978 -34.5619100187946,-58.4367791601991 -34.5619180939755,-58.4366789610542 -34.5619238475652,-58.4366178373014 -34.5619264402718,-58.4365501587317 -34.5619285385642,-58.4364446829711 -34.5619297131625,-58.4363627034904 -34.5619291320991,-58.4363003039839 -34.5619279213851,-58.4362173886179 -34.5619256498055,-58.4361159154417 -34.5619221064679,-58.4360252539823 -34.5619177203006,-58.4359356151008 -34.561910165135,-58.4358188209476 -34.5618995051976,-58.4357436540812 -34.5618920235023,-58.4356686576921 -34.5618839079675,-58.4355701666116 -34.5618726884381,-58.435496277168 -34.5618638687865,-58.4353857836992 -34.5618501815347,-58.4352752904284 -34.5618360012032,-58.4351244478651 -34.5618158254822,-58.435027575165 -34.5618022818333,-58.4349578575982 -34.5617921951392,-58.4348584978648 -34.562089157581,-58.4349447107172 -34.5621597437334,-58.4353191802043 -34.5624683631464,-58.4353191559495 -34.5624683711467,-58.4354104876816 -34.5625437512917,-58.4359489125221 -34.5625421768371,-58.4368207113021 -34.5625318065763,-58.4369789687604 -34.5625293223055,-58.4371250526191 -34.56252683528,-58.4372790488432 -34.5625258603571,-58.4374251325348 -34.5625238765156,-58.4375706079945 -34.5625203817446,-58.4376953880396 -34.5625178896495,-58.4378347763838 -34.5625154004032,-58.4379595577556 -34.5625083761497,-58.4380910345793 -34.5625013531185,-58.4382219041769 -34.5624892943919,-58.4383612956851 -34.5624757265947,-58.4385250346016 -34.5624611563757,-58.4386589474687 -34.5624490977831,-58.4387861646855 -34.5624375412755,-58.4389328605912 -34.5624224636265,-58.4390880782297 -34.5624063803632,-58.4392469478799 -34.5623902976043,-58.4394021655389 -34.5623737103984,-58.4395506872566 -34.5623586323552,-58.4396663402985 -34.5623435479344,-58.4398197328566 -34.5623229315074,-58.4399475600449 -34.5623053313849,-58.4400906050779 -34.5622842091453,-58.4402287804825 -34.562263589385,-58.4403766949273 -34.562241964163,-58.4405100005056 -34.5622223502801,-58.440657916399 -34.5621946821988,-58.4408161802295 -34.5621650016206,-58.4409659222122 -34.5621363264067,-58.441164038223 -34.5620987315347,-58.4411009935163 -34.5620053692427,-58.4411957431578 -34.561986630892,-58.4413250620164 -34.5619587650356,-58.441420669149 -34.56193237211,-58.4418779280356 -34.5618177275309,-58.4425441919205 -34.5616450147386,-58.4432141987445 -34.5614722284767,-58.4434090754481 -34.5614009886374,-58.4434790798872 -34.561376311659,-58.4434957437069 -34.5613704375561,-58.4425813381601 -34.5608136456888)))";;"961";13_12_10;COMUNA 13;"12";"10";"564";"281";"283";"99,29%";"302";"301";"99,67%";"1";"0,33%";"249";"2";"0.8";"247";"99,20%";"0.8";0.800
"MULTIPOLYGON (((-58.4460170005868 -34.5528690844223,-58.4448768742766 -34.5521926949496,-58.44378314996 -34.5515438384421,-58.4430035037842 -34.5524461512203,-58.4441048933423 -34.553101072401,-58.4452373655193 -34.5537744395801,-58.4463579402811 -34.5544406815901,-58.4470420424569 -34.5536491152068,-58.4471378250427 -34.5535339813172,-58.4460170005868 -34.5528690844223)))";;"962";13_12_2;COMUNA 13;"12";"2";"897";"439";"458";"95,85%";"392";"392";"100,00%";"0";"0,00%";"320";"2";"0.63";"318";"99,38%";"0.63";0.630
"MULTIPOLYGON (((-58.4452373655193 -34.5537744395801,-58.4441048933423 -34.553101072401,-58.4434226379133 -34.5539038908094,-58.4432856405622 -34.5540640877197,-58.4424776946291 -34.5550087181374,-58.4435981778834 -34.5556789995929,-58.4447117849828 -34.5563451145634,-58.445529508009 -34.5553990624271,-58.4463579402811 -34.5544406815901,-58.4452373655193 -34.5537744395801)))";;"963";13_12_3;COMUNA 13;"12";"3";"624";"309";"315";"98,10%";"298";"297";"99,66%";"1";"0,34%";"237";"1";"0.42";"236";"99,58%";"0.42";0.420
"MULTIPOLYGON (((-58.44378314996 -34.5515438384421,-58.4426659533254 -34.5508810943394,-58.4418889399533 -34.5517834709555,-58.441076148655 -34.5527273169437,-58.4409520912105 -34.552871386054,-58.4402431625858 -34.5536812949695,-58.4413636971626 -34.5543440615232,-58.4416209817663 -34.5544962258557,-58.4424776946291 -34.5550087181374,-58.4432856405622 -34.5540640877197,-58.4434226379133 -34.5539038908094,-58.4441048933423 -34.553101072401,-58.4430035037842 -34.5524461512203,-58.44378314996 -34.5515438384421)))";;"964";13_12_4;COMUNA 13;"12";"4";"860";"404";"456";"88,60%";"454";"454";"100,00%";"0";"0,00%";"352";"0";"0";"352";"100,00%";"0";0.000
"MULTIPOLYGON (((-58.434634961229 -34.5533236475443,-58.4346535479346 -34.5535935856731,-58.4351651014873 -34.5536646912834,-58.4353534657727 -34.5536908615774,-58.4355118238907 -34.553749628964,-58.435615601991 -34.5538039533643,-58.4363452933721 -34.5542402598074,-58.4374622278827 -34.5549079911267,-58.4382910010281 -34.5539568484631,-58.4383861132865 -34.5538477779291,-58.4391082628458 -34.5530099937701,-58.4402431625858 -34.5536812949695,-58.4409520912105 -34.552871386054,-58.441076148655 -34.5527273169437,-58.4418889399533 -34.5517834709555,-58.4426659533254 -34.5508810943394,-58.443459722464 -34.5499594186109,-58.444277312812 -34.5490098525503,-58.4433388642649 -34.548453554602,-58.4431384445156 -34.5483347847087,-58.4421920114545 -34.5477738285026,-58.4417666710536 -34.5478559432765,-58.4413668601543 -34.5479546111018,-58.4411612065482 -34.5480137327,-58.4411319244218 -34.5480233054447,-58.4410612197052 -34.5479225135657,-58.4406669232391 -34.5474394626561,-58.4405988519662 -34.5473619819287,-58.4401805359635 -34.5475950150295,-58.4377748898493 -34.5488877772097,-58.4373455494102 -34.5491211515705,-58.4364303746858 -34.5496102356258,-58.4360362166679 -34.5498286676975,-58.4323322490792 -34.5518576687861,-58.4326409998377 -34.5520291615526,-58.4342123810177 -34.5529382496255,-58.434634961229 -34.5533236475443)))";;"965";13_12_5;COMUNA 13;"12";"5";"707";"334";"373";"89,54%";"271";"270";"99,63%";"1";"0,37%";"218";"3";"1.38";"215";"98,62%";"1.38";1.380
"MULTIPOLYGON (((-58.4402431625858 -34.5536812949695,-58.4391082628458 -34.5530099937701,-58.4383861132865 -34.5538477779291,-58.4382910010281 -34.5539568484631,-58.4374622278827 -34.5549079911267,-58.4385824143483 -34.5555776847225,-58.4393067858554 -34.5547549711805,-58.4394112645354 -34.5546336475744,-58.4396230128005 -34.554761580955,-58.4405264396306 -34.5553074071045,-58.441221331289 -34.554508832841,-58.4413636971626 -34.5543440615232,-58.4402431625858 -34.5536812949695)))";;"966";13_12_6;COMUNA 13;"12";"6";"570";"267";"303";"88,12%";"329";"329";"100,00%";"0";"0,00%";"240";"7";"2.92";"233";"97,08%";"2.92";2.920
"MULTIPOLYGON (((-58.4397064487145 -34.5562496223196,-58.440042717816 -34.556450680242,-58.4402689407645 -34.5565859394271,-58.4404871641985 -34.5567158443793,-58.4408384168023 -34.5569250722056,-58.4416444413732 -34.5559827766576,-58.4424776946291 -34.5550087181374,-58.4416209817663 -34.5544962258557,-58.4413636971626 -34.5543440615232,-58.441221331289 -34.554508832841,-58.4405264396306 -34.5553074071045,-58.4396230128005 -34.554761580955,-58.4394112645354 -34.5546336475744,-58.4393067858554 -34.5547549711805,-58.4385824143483 -34.5555776847225,-58.4397064487145 -34.5562496223196)))";;"967";13_12_7;COMUNA 13;"12";"7";"896";"417";"479";"87,06%";"419";"418";"99,76%";"1";"0,24%";"341";"2";"0.59";"339";"99,41%";"0.59";0.590
"MULTIPOLYGON (((-58.445831623182 -34.5570148823059,-58.4466486608212 -34.556059878613,-58.445529508009 -34.5553990624271,-58.4447117849828 -34.5563451145634,-58.4435981778834 -34.5556789995929,-58.4424776946291 -34.5550087181374,-58.4416444413732 -34.5559827766576,-58.4418039385395 -34.5560790760489,-58.4425282358064 -34.5565085835944,-58.442768251356 -34.5566508829996,-58.443878716992 -34.557308905992,-58.4450076700075 -34.557977907909,-58.445831623182 -34.5570148823059)))";;"968";13_12_8;COMUNA 13;"12";"8";"629";"282";"347";"81,27%";"373";"373";"100,00%";"0";"0,00%";"282";"0";"0";"282";"100,00%";"0";0.000
"MULTIPOLYGON (((-58.443878716992 -34.557308905992,-58.442768251356 -34.5566508829996,-58.4425282358064 -34.5565085835944,-58.4418039385395 -34.5560790760489,-58.4416444413732 -34.5559827766576,-58.4408384168023 -34.5569250722056,-58.4419634219069 -34.5576046654607,-58.4430644476981 -34.5582508626333,-58.4439893003011 -34.5588016665278,-58.4441974918885 -34.5589248023973,-58.4450076700075 -34.557977907909,-58.443878716992 -34.557308905992)))";;"969";13_12_9;COMUNA 13;"12";"9";"945";"473";"472";"100,21%";"514";"513";"99,81%";"1";"0,19%";"384";"4";"1.04";"380";"98,96%";"1.04";1.040
"MULTIPOLYGON (((-58.4493980833918 -34.5591465460828,-58.4490472255051 -34.5589381881065,-58.4489515528329 -34.5588809916939,-58.4490294510343 -34.5588345898982,-58.4488810055447 -34.5587452029588,-58.4488031072506 -34.5587921680662,-58.4486855364907 -34.5588601154376,-58.4477869405455 -34.559350664884,-58.4475455822492 -34.5594815565465,-58.4477199037915 -34.5595846108627,-58.4481916295617 -34.559863553605,-58.4493434640276 -34.5605444902433,-58.4493271937397 -34.5606121675507,-58.4493500858655 -34.5606580876059,-58.4493827704204 -34.5606873178366,-58.4494730001019 -34.5607264843287,-58.4494860271154 -34.5607113442163,-58.4495331116403 -34.5606566285429,-58.450442201524 -34.5611941416177,-58.4512610132016 -34.5602525591967,-58.451898459402 -34.5595195561611,-58.4520620977391 -34.5593291394254,-58.4519642094043 -34.5592708183727,-58.451152592632 -34.5587876943705,-58.4507383184485 -34.5585410940644,-58.4502598965167 -34.5586337264925,-58.4493980833918 -34.5591465460828)))";;"970";13_13_1;COMUNA 13;"13";"1";"1028";"461";"567";"81,31%";"466";"466";"100,00%";"0";"0,00%";"376";"2";"0.53";"374";"99,47%";"0.53";0.530
"MULTIPOLYGON (((-58.4496239672207 -34.562136211441,-58.4487200648776 -34.5616008057203,-58.4485902174963 -34.5617516425839,-58.4479110007391 -34.562545611648,-58.4488139722398 -34.5630776427391,-58.4488936699238 -34.562984337776,-58.4496239672207 -34.562136211441)))";;"971";13_13_10;COMUNA 13;"13";"10";"919";"388";"531";"73,07%";"456";"456";"100,00%";"0";"0,00%";"358";"0";"0";"358";"100,00%";"0";0.000
"MULTIPOLYGON (((-58.4479110007391 -34.562545611648,-58.447002507928 -34.5620103335424,-58.4462053412044 -34.5629423121583,-58.4471140945227 -34.5634771031687,-58.4480183479853 -34.5640091402277,-58.4488139722398 -34.5630776427391,-58.4479110007391 -34.562545611648)))";;"972";13_13_11;COMUNA 13;"13";"11";"603";"278";"325";"85,54%";"278";"278";"100,00%";"0";"0,00%";"215";"0";"0";"215";"100,00%";"0";0.000
"MULTIPOLYGON (((-58.4441867347741 -34.5617550685002,-58.4444774988063 -34.5619273734485,-58.4446199023632 -34.5620106377674,-58.4449287990542 -34.5621911841215,-58.4462053412044 -34.5629423121583,-58.447002507928 -34.5620103335424,-58.4455276470391 -34.5611412933999,-58.4455279413492 -34.5611411060775,-58.4451735839933 -34.5610765752564,-58.4443230318851 -34.5614392873691,-58.4441662435628 -34.5614875039616,-58.4441605209602 -34.5614892638097,-58.4441867347741 -34.5617550685002)))";;"973";13_13_12;COMUNA 13;"13";"12";"997";"435";"562";"77,40%";"397";"396";"99,75%";"1";"0,25%";"327";"1";"0.31";"326";"99,69%";"0.31";0.310
"MULTIPOLYGON (((-58.4452345436877 -34.5595380813508,-58.4441974918885 -34.5589248023973,-58.443382526971 -34.5598773246576,-58.4444177976406 -34.5604873001648,-58.4439126879196 -34.5610677424222,-58.4437768401645 -34.5609906757424,-58.4435374774525 -34.5612806513704,-58.4434957437069 -34.5613704375561,-58.4434790798872 -34.561376311659,-58.4441662435628 -34.5614875039616,-58.4443230318851 -34.5614392873691,-58.4451735839933 -34.5610765752564,-58.4455279413492 -34.5611411060775,-58.4466921787482 -34.5604000804313,-58.4466916733225 -34.5603997825265,-58.4465357442163 -34.5603078755984,-58.4462911026733 -34.5601629038734,-58.4462477777453 -34.5601372630897,-58.4462463938195 -34.5601364447089,-58.4452345436877 -34.5595380813508)))";;"974";13_13_13;COMUNA 13;"13";"13";"1219";"588";"631";"93,19%";"685";"685";"100,00%";"0";"0,00%";"556";"2";"0.36";"554";"99,64%";"0.36";0.360
"MULTIPOLYGON (((-58.4444177976406 -34.5604873001648,-58.443382526971 -34.5598773246576,-58.4425813381601 -34.5608136456888,-58.4434957437069 -34.5613704375561,-58.4435374774525 -34.5612806513704,-58.4437768401645 -34.5609906757424,-58.4439126879196 -34.5610677424222,-58.4444177976406 -34.5604873001648)))";;"975";13_13_14;COMUNA 13;"13";"14";"677";"330";"347";"95,10%";"530";"530";"100,00%";"0";"0,00%";"348";"2";"0.57";"346";"99,43%";"0.57";0.570
"MULTIPOLYGON (((-58.4500360473089 -34.5580826232354,-58.4489005509064 -34.557402609256,-58.4484886363885 -34.5578761045742,-58.4480714385267 -34.5583545980583,-58.4488031072506 -34.5587921680662,-58.4488810055447 -34.5587452029588,-58.4490294510343 -34.5588345898982,-58.4489515528329 -34.5588809916939,-58.4490472255051 -34.5589381881065,-58.4493980833918 -34.5591465460828,-58.4502598965167 -34.5586337264925,-58.4507383184485 -34.5585410940644,-58.4505851061525 -34.5584410040166,-58.4505040740245 -34.5583880358108,-58.450150070384 -34.5581565810282,-58.4501501218665 -34.5581565527147,-58.4500465397374 -34.558088959198,-58.4500360473089 -34.5580826232354)))";;"976";13_13_2;COMUNA 13;"13";"2";"314";"140";"174";"80,46%";"200";"200";"100,00%";"0";"0,00%";"155";"4";"2.58";"151";"97,42%";"2.58";2.580
"MULTIPOLYGON (((-58.4489005509064 -34.557402609256,-58.4476935253014 -34.5566797580109,-58.447347704111 -34.5564725929248,-58.4466486608212 -34.556059878613,-58.445831623182 -34.5570148823059,-58.4468706195994 -34.5576363876309,-58.4480714385267 -34.5583545980583,-58.4484886363885 -34.5578761045742,-58.4489005509064 -34.557402609256)))";;"977";13_13_3;COMUNA 13;"13";"3";"737";"330";"407";"81,08%";"434";"434";"100,00%";"0";"0,00%";"322";"3";"0.93";"319";"99,07%";"0.93";0.930
"MULTIPOLYGON (((-58.4488031072506 -34.5587921680662,-58.4480714385267 -34.5583545980583,-58.4468706195994 -34.5576363876309,-58.4460469287796 -34.5585937157016,-58.4472441806813 -34.5593031304541,-58.4473929661369 -34.5593913221811,-58.4475455822492 -34.5594815565465,-58.4477869405455 -34.559350664884,-58.4486855364907 -34.5588601154376,-58.4488031072506 -34.5587921680662)))";;"978";13_13_4;COMUNA 13;"13";"4";"842";"370";"472";"78,39%";"513";"513";"100,00%";"0";"0,00%";"394";"4";"1.02";"390";"98,98%";"1.02";1.020
"MULTIPOLYGON (((-58.4468706195994 -34.5576363876309,-58.445831623182 -34.5570148823059,-58.4450076700075 -34.557977907909,-58.4460469287796 -34.5585937157016,-58.4468706195994 -34.5576363876309)))";;"979";13_13_5;COMUNA 13;"13";"5";"827";"376";"451";"83,37%";"512";"512";"100,00%";"0";"0,00%";"411";"0";"0";"411";"100,00%";"0";0.000
"MULTIPOLYGON (((-58.4460469287796 -34.5585937157016,-58.4450076700075 -34.557977907909,-58.4441974918885 -34.5589248023973,-58.4452345436877 -34.5595380813508,-58.4460469287796 -34.5585937157016)))";;"980";13_13_6;COMUNA 13;"13";"6";"261";"118";"143";"82,52%";"188";"188";"100,00%";"0";"0,00%";"132";"3";"2.27";"129";"97,73%";"2.27";2.270
"MULTIPOLYGON (((-58.4475455822492 -34.5594815565465,-58.4473929661369 -34.5593913221811,-58.4472441806813 -34.5593031304541,-58.4460469287796 -34.5585937157016,-58.4452345436877 -34.5595380813508,-58.4462463938195 -34.5601364447089,-58.4462477777453 -34.5601372630897,-58.4462911026733 -34.5601629038734,-58.4466886892182 -34.559952102129,-58.4469061263811 -34.5598374069895,-58.447422391332 -34.5595483047589,-58.4475455822492 -34.5594815565465)))";;"981";13_13_7;COMUNA 13;"13";"7";"629";"295";"334";"88,32%";"408";"408";"100,00%";"0";"0,00%";"305";"1";"0.33";"304";"99,67%";"0.33";0.330
"MULTIPOLYGON (((-58.4481916295617 -34.559863553605,-58.4477199037915 -34.5595846108627,-58.4475455822492 -34.5594815565465,-58.447422391332 -34.5595483047589,-58.4469061263811 -34.5598374069895,-58.4466886892182 -34.559952102129,-58.4462911026733 -34.5601629038734,-58.4465357442163 -34.5603078755984,-58.4466916733225 -34.5603997825265,-58.4466921787482 -34.5604000804313,-58.4455279413492 -34.5611411060775,-58.4455276470391 -34.5611412933999,-58.447002507928 -34.5620103335424,-58.4477084649937 -34.5611851037469,-58.4478137065456 -34.5610589137991,-58.4487200648776 -34.5616008057203,-58.4496239672207 -34.562136211441,-58.4497202662455 -34.5620243857484,-58.450442201524 -34.5611941416177,-58.4495331116403 -34.5606566285429,-58.4494860271154 -34.5607113442163,-58.4494730001019 -34.5607264843287,-58.4493827704204 -34.5606873178366,-58.4493500858655 -34.5606580876059,-58.4493271937397 -34.5606121675507,-58.4493434640276 -34.5605444902433,-58.4481916295617 -34.559863553605)))";;"982";13_13_8;COMUNA 13;"13";"8";"649";"277";"372";"74,46%";"360";"360";"100,00%";"0";"0,00%";"249";"0";"0";"249";"100,00%";"0";0.000
"MULTIPOLYGON (((-58.4487200648776 -34.5616008057203,-58.4478137065456 -34.5610589137991,-58.4477084649937 -34.5611851037469,-58.447002507928 -34.5620103335424,-58.4479110007391 -34.562545611648,-58.4485902174963 -34.5617516425839,-58.4487200648776 -34.5616008057203)))";;"983";13_13_9;COMUNA 13;"13";"9";"780";"338";"442";"76,47%";"342";"342";"100,00%";"0";"0,00%";"287";"1";"0.35";"286";"99,65%";"0.35";0.350
"MULTIPOLYGON (((-58.4555817828539 -34.559950972617,-58.4546768448704 -34.5594111035008,-58.4538364540023 -34.560385244071,-58.4547416525962 -34.5609239925366,-58.4554007836877 -34.5601596332699,-58.4555817828539 -34.559950972617)))";;"984";13_14_1;COMUNA 13;"14";"1";"776";"367";"409";"89,73%";"441";"441";"100,00%";"0";"0,00%";"341";"18";"5.28";"323";"94,72%";"5.28";5.280
"MULTIPOLYGON (((-58.4530401461407 -34.5613088165553,-58.452149850511 -34.5607802685221,-58.4513361513242 -34.5617226319819,-58.4522288355756 -34.5622504113903,-58.4530401461407 -34.5613088165553)))";;"985";13_14_10;COMUNA 13;"14";"10";"727";"317";"410";"77,32%";"369";"369";"100,00%";"0";"0,00%";"298";"1";"0.34";"297";"99,66%";"0.34";0.340
"MULTIPOLYGON (((-58.452149850511 -34.5607802685221,-58.4512610132016 -34.5602525591967,-58.450442201524 -34.5611941416177,-58.4513361513242 -34.5617226319819,-58.452149850511 -34.5607802685221)))";;"986";13_14_11;COMUNA 13;"14";"11";"806";"357";"449";"79,51%";"347";"347";"100,00%";"0";"0,00%";"284";"4";"1.41";"280";"98,59%";"1.41";1.410
"MULTIPOLYGON (((-58.4546768448704 -34.5594111035008,-58.4545254129656 -34.5593208077016,-58.4537895386668 -34.558881229369,-58.452947695523 -34.559856208908,-58.4538364540023 -34.560385244071,-58.4546768448704 -34.5594111035008)))";;"987";13_14_2;COMUNA 13;"14";"2";"381";"165";"216";"76,39%";"212";"212";"100,00%";"0";"0,00%";"162";"0";"0";"162";"100,00%";"0";0.000
"MULTIPOLYGON (((-58.4537346356846 -34.5588484773942,-58.4529024990943 -34.5583513487648,-58.4521504723359 -34.5592263959891,-58.4520620977391 -34.5593291394254,-58.452947695523 -34.559856208908,-58.4537895386668 -34.558881229369,-58.4537346356846 -34.5588484773942)))";;"988";13_14_3;COMUNA 13;"14";"3";"660";"289";"371";"77,90%";"534";"534";"100,00%";"0";"0,00%";"367";"2";"0.54";"365";"99,46%";"0.54";0.540
"MULTIPOLYGON (((-58.452947695523 -34.559856208908,-58.4520620977391 -34.5593291394254,-58.451898459402 -34.5595195561611,-58.4512610132016 -34.5602525591967,-58.452149850511 -34.5607802685221,-58.452947695523 -34.559856208908)))";;"989";13_14_4;COMUNA 13;"14";"4";"734";"327";"407";"80,34%";"360";"360";"100,00%";"0";"0,00%";"291";"1";"0.34";"290";"99,66%";"0.34";0.340
"MULTIPOLYGON (((-58.4538364540023 -34.560385244071,-58.452947695523 -34.559856208908,-58.452149850511 -34.5607802685221,-58.4530401461407 -34.5613088165553,-58.4534185925512 -34.5608696009163,-58.4538364540023 -34.560385244071)))";;"990";13_14_5;COMUNA 13;"14";"5";"531";"246";"285";"86,32%";"291";"291";"100,00%";"0";"0,00%";"228";"3";"1.32";"225";"98,68%";"1.32";1.320
"MULTIPOLYGON (((-58.4552713399748 -34.5626333979504,-58.4556763691265 -34.5628738551476,-58.4558723299451 -34.562988941799,-58.4566933122391 -34.5620356326768,-58.4571215471486 -34.5615383772897,-58.4575068694265 -34.5610852754467,-58.4565053751907 -34.5604958361507,-58.4557374732076 -34.5600438026648,-58.4555817828539 -34.559950972617,-58.4554007836877 -34.5601596332699,-58.4547416525962 -34.5609239925366,-58.4538364540023 -34.560385244071,-58.4534185925512 -34.5608696009163,-58.4530401461407 -34.5613088165553,-58.453946030734 -34.5618466553594,-58.4548679305308 -34.5623939254633,-58.4552713399748 -34.5626333979504)))";;"991";13_14_6;COMUNA 13;"14";"6";"846";"373";"473";"78,86%";"439";"439";"100,00%";"0";"0,00%";"359";"2";"0.56";"357";"99,44%";"0.56";0.560
"MULTIPOLYGON (((-58.4552713399748 -34.5626333979504,-58.4548679305308 -34.5623939254633,-58.4540585032658 -34.5633320111287,-58.4548521344401 -34.5638011700236,-58.4550644405702 -34.5639268932775,-58.4558723299451 -34.562988941799,-58.4556763691265 -34.5628738551476,-58.4552713399748 -34.5626333979504)))";;"992";13_14_7;COMUNA 13;"14";"7";"384";"172";"212";"81,13%";"224";"224";"100,00%";"0";"0,00%";"165";"1";"0.61";"164";"99,39%";"0.61";0.610
"MULTIPOLYGON (((-58.4548679305308 -34.5623939254633,-58.453946030734 -34.5618466553594,-58.4531355766653 -34.5627864251317,-58.4540585032658 -34.5633320111287,-58.4548679305308 -34.5623939254633)))";;"993";13_14_8;COMUNA 13;"14";"8";"604";"282";"322";"87,58%";"409";"408";"99,76%";"1";"0,25%";"254";"1";"0.39";"253";"99,61%";"0.39";0.390
"MULTIPOLYGON (((-58.453946030734 -34.5618466553594,-58.4530401461407 -34.5613088165553,-58.4522288355756 -34.5622504113903,-58.4531355766653 -34.5627864251317,-58.453946030734 -34.5618466553594)))";;"994";13_14_9;COMUNA 13;"14";"9";"534";"225";"309";"72,82%";"328";"328";"100,00%";"0";"0,00%";"238";"2";"0.84";"236";"99,16%";"0.84";0.840
"MULTIPOLYGON (((-58.4601725806671 -34.561271283542,-58.4592810485549 -34.5607418719471,-58.4584897350134 -34.5616644941065,-58.4593807611965 -34.5621934184067,-58.4594902429149 -34.5620660917171,-58.4601725806671 -34.561271283542)))";;"995";13_15_1;COMUNA 13;"15";"1";"745";"332";"413";"80,39%";"470";"470";"100,00%";"0";"0,00%";"350";"3";"0.86";"347";"99,14%";"0.86";0.860
"MULTIPOLYGON (((-58.4577490523964 -34.5640916164174,-58.4568544405637 -34.5635659902065,-58.4567534667102 -34.5636831736211,-58.4560422147505 -34.5645057789262,-58.4569373420389 -34.5650356365712,-58.4577490523964 -34.5640916164174)))";;"996";13_15_10;COMUNA 13;"15";"10";"632";"244";"388";"62,89%";"451";"451";"100,00%";"0";"0,00%";"331";"3";"0.91";"328";"99,09%";"0.91";0.910
"MULTIPOLYGON (((-58.4586400149081 -34.5646150527114,-58.4577490523964 -34.5640916164174,-58.4569373420389 -34.5650356365712,-58.4578252446102 -34.565561261781,-58.4586400149081 -34.5646150527114)))";;"997";13_15_11;COMUNA 13;"15";"11";"735";"305";"430";"70,93%";"522";"522";"100,00%";"0";"0,00%";"369";"19";"5.15";"350";"94,85%";"5.15";5.150
"MULTIPOLYGON (((-58.4595338830333 -34.5651401727492,-58.4586400149081 -34.5646150527114,-58.4578252446102 -34.565561261781,-58.4587163082109 -34.5660887820832,-58.4595338830333 -34.5651401727492)))";;"998";13_15_12;COMUNA 13;"15";"12";"654";"272";"382";"71,20%";"410";"410";"100,00%";"0";"0,00%";"328";"14";"4.27";"314";"95,73%";"4.27";4.270
"MULTIPOLYGON (((-58.4575068694265 -34.5610852754467,-58.4571215471486 -34.5615383772897,-58.4566933122391 -34.5620356326768,-58.4576742253831 -34.562614646439,-58.4577957143853 -34.5624737296175,-58.4584897350134 -34.5616644941065,-58.4592810485549 -34.5607418719471,-58.4582963158187 -34.5601570958732,-58.4575068694265 -34.5610852754467)))";;"999";13_15_2;COMUNA 13;"15";"2";"712";"294";"418";"70,33%";"498";"498";"100,00%";"0";"0,00%";"360";"0";"0";"360";"100,00%";"0";0.000
"MULTIPOLYGON (((-58.4602732459964 -34.5627181810728,-58.459547271211 -34.5622922300379,-58.4593807611965 -34.5621934184067,-58.4584897350134 -34.5616644941065,-58.4577957143853 -34.5624737296175,-58.4576742253831 -34.562614646439,-58.4585661930913 -34.5631411821684,-58.4588266858784 -34.5632949299281,-58.459455447835 -34.5636679225406,-58.4602732459964 -34.5627181810728)))";;"1000";13_15_3;COMUNA 13;"15";"3";"746";"293";"453";"64,68%";"425";"425";"100,00%";"0";"0,00%";"349";"2";"0.57";"347";"99,43%";"0.57";0.570
"MULTIPOLYGON (((-58.4611685513135 -34.5632435006102,-58.4602732459964 -34.5627181810728,-58.459455447835 -34.5636679225406,-58.4602041637166 -34.5641120443105,-58.4603470122902 -34.5641967692042,-58.4611685513135 -34.5632435006102)))";;"1001";13_15_4;COMUNA 13;"15";"4";"492";"197";"295";"66,78%";"287";"286";"99,65%";"1";"0,35%";"199";"1";"0.5";"198";"99,50%";"0.5";0.500
"MULTIPOLYGON (((-58.4621297592658 -34.5638088860594,-58.4618816878894 -34.5636618358816,-58.4611685513135 -34.5632435006102,-58.4603470122902 -34.5641967692042,-58.4613020109724 -34.5647631469216,-58.4621297592658 -34.5638088860594)))";;"1002";13_15_5;COMUNA 13;"15";"5";"802";"361";"441";"81,86%";"530";"530";"100,00%";"0";"0,00%";"391";"2";"0.51";"389";"99,49%";"0.51";0.510
"MULTIPOLYGON (((-58.4613020109724 -34.5647631469216,-58.4603470122902 -34.5641967692042,-58.4595338830333 -34.5651401727492,-58.4604884614672 -34.5657009931076,-58.4613020109724 -34.5647631469216)))";;"1003";13_15_6;COMUNA 13;"15";"6";"659";"294";"365";"80,55%";"358";"358";"100,00%";"0";"0,00%";"281";"1";"0.36";"280";"99,64%";"0.36";0.360
"MULTIPOLYGON (((-58.4603470122902 -34.5641967692042,-58.4602041637166 -34.5641120443105,-58.459455447835 -34.5636679225406,-58.4586400149081 -34.5646150527114,-58.4595338830333 -34.5651401727492,-58.4603470122902 -34.5641967692042)))";;"1004";13_15_7;COMUNA 13;"15";"7";"803";"346";"457";"75,71%";"475";"475";"100,00%";"0";"0,00%";"383";"3";"0.78";"380";"99,22%";"0.78";0.780
"MULTIPOLYGON (((-58.459455447835 -34.5636679225406,-58.4588266858784 -34.5632949299281,-58.4585661930913 -34.5631411821684,-58.4578550484595 -34.5639683757804,-58.4577490523964 -34.5640916164174,-58.4586400149081 -34.5646150527114,-58.459455447835 -34.5636679225406)))";;"1005";13_15_8;COMUNA 13;"15";"8";"713";"324";"389";"83,29%";"457";"457";"100,00%";"0";"0,00%";"372";"2";"0.54";"370";"99,46%";"0.54";0.540
"MULTIPOLYGON (((-58.4576742253831 -34.562614646439,-58.4566933122391 -34.5620356326768,-58.4558723299451 -34.562988941799,-58.4550644405702 -34.5639268932775,-58.4560422147505 -34.5645057789262,-58.4567534667102 -34.5636831736211,-58.4568544405637 -34.5635659902065,-58.4577490523964 -34.5640916164174,-58.4578550484595 -34.5639683757804,-58.4585661930913 -34.5631411821684,-58.4576742253831 -34.562614646439)))";;"1006";13_15_9;COMUNA 13;"15";"9";"867";"357";"510";"70,00%";"614";"614";"100,00%";"0";"0,00%";"416";"2";"0.48";"414";"99,52%";"0.48";0.480
"MULTIPOLYGON (((-58.4642255334125 -34.559696370417,-58.4640145863468 -34.5595749589603,-58.4633202870949 -34.559175016883,-58.4627985465746 -34.5597850458656,-58.4626766442819 -34.5599266719848,-58.4635698917787 -34.5604569039503,-58.4645226562007 -34.5610224117289,-58.4646702640739 -34.560810287266,-58.4651628847134 -34.5602360272314,-58.4642255334125 -34.559696370417)))";;"1007";13_16_1;COMUNA 13;"16";"1";"854";"365";"489";"74,64%";"521";"520";"99,81%";"1";"0,19%";"392";"3";"0.77";"389";"99,23%";"0.77";0.770
"MULTIPOLYGON (((-58.4618681798639 -34.5608656549215,-58.4609743428623 -34.5603373120263,-58.4600809427944 -34.5598091738278,-58.4592810485549 -34.5607418719471,-58.4601725806671 -34.561271283542,-58.4610635281789 -34.5618003364445,-58.4618681798639 -34.5608656549215)))";;"1008";13_16_10;COMUNA 13;"16";"10";"839";"358";"481";"74,43%";"581";"581";"100,00%";"0";"0,00%";"391";"3";"0.77";"388";"99,23%";"0.77";0.770
"MULTIPOLYGON (((-58.4610635281789 -34.5618003364445,-58.4601725806671 -34.561271283542,-58.4594902429149 -34.5620660917171,-58.4593807611965 -34.5621934184067,-58.459547271211 -34.5622922300379,-58.4602732459964 -34.5627181810728,-58.4610635281789 -34.5618003364445)))";;"1009";13_16_11;COMUNA 13;"16";"11";"724";"299";"425";"70,35%";"499";"499";"100,00%";"0";"0,00%";"381";"3";"0.79";"378";"99,21%";"0.79";0.790
"MULTIPOLYGON (((-58.4619556787855 -34.5623300870633,-58.4610635281789 -34.5618003364445,-58.4602732459964 -34.5627181810728,-58.4611685513135 -34.5632435006102,-58.4619556787855 -34.5623300870633)))";;"1010";13_16_12;COMUNA 13;"16";"12";"730";"315";"415";"75,90%";"425";"425";"100,00%";"0";"0,00%";"347";"21";"6.05";"326";"93,95%";"6.05";6.050
"MULTIPOLYGON (((-58.4629173072228 -34.5629011004521,-58.4619556787855 -34.5623300870633,-58.4611685513135 -34.5632435006102,-58.4618816878894 -34.5636618358816,-58.4621297592658 -34.5638088860594,-58.4629173072228 -34.5629011004521)))";;"1011";13_16_13;COMUNA 13;"16";"13";"552";"259";"293";"88,40%";"257";"257";"100,00%";"0";"0,00%";"223";"0";"0";"223";"100,00%";"0";0.000
"MULTIPOLYGON (((-58.4633202870949 -34.559175016883,-58.4624125834213 -34.5586521072209,-58.4615114457238 -34.5581329938182,-58.4609849313518 -34.558747170225,-58.4608858419093 -34.5588636529198,-58.4617779600372 -34.5593931938144,-58.4626766442819 -34.5599266719848,-58.4627985465746 -34.5597850458656,-58.4633202870949 -34.559175016883)))";;"1012";13_16_2;COMUNA 13;"16";"2";"876";"376";"500";"75,20%";"550";"549";"99,82%";"1";"0,18%";"430";"0";"0";"430";"100,00%";"0";0.000
"MULTIPOLYGON (((-58.4599146547921 -34.5582871297288,-58.4592432362196 -34.5590562317779,-58.4590958748377 -34.5592268690063,-58.4585324737748 -34.5598793452119,-58.4582963158187 -34.5601570958732,-58.4592810485549 -34.5607418719471,-58.4600809427944 -34.5598091738278,-58.4601821627042 -34.5596912129086,-58.4608858419093 -34.5588636529198,-58.4609849313518 -34.558747170225,-58.4615114457238 -34.5581329938182,-58.4605646928635 -34.5575875337096,-58.4599589218408 -34.5582364946395,-58.4599146547921 -34.5582871297288)))";;"1013";13_16_3;COMUNA 13;"16";"3";"509";"210";"299";"70,23%";"405";"405";"100,00%";"0";"0,00%";"252";"3";"1.19";"249";"98,81%";"1.19";1.190
"MULTIPOLYGON (((-58.4617779600372 -34.5593931938144,-58.4608858419093 -34.5588636529198,-58.4601821627042 -34.5596912129086,-58.4600809427944 -34.5598091738278,-58.4609743428623 -34.5603373120263,-58.461059983421 -34.5602375904233,-58.4617779600372 -34.5593931938144)))";;"1014";13_16_4;COMUNA 13;"16";"4";"696";"308";"388";"79,38%";"492";"492";"100,00%";"0";"0,00%";"368";"0";"0";"368";"100,00%";"0";0.000
"MULTIPOLYGON (((-58.4626766442819 -34.5599266719848,-58.4617779600372 -34.5593931938144,-58.461059983421 -34.5602375904233,-58.4609743428623 -34.5603373120263,-58.4618681798639 -34.5608656549215,-58.4626766442819 -34.5599266719848)))";;"1015";13_16_5;COMUNA 13;"16";"5";"526";"229";"297";"77,10%";"359";"359";"100,00%";"0";"0,00%";"252";"3";"1.19";"249";"98,81%";"1.19";1.190
"MULTIPOLYGON (((-58.4635698917787 -34.5604569039503,-58.4626766442819 -34.5599266719848,-58.4618681798639 -34.5608656549215,-58.4627622835563 -34.5613941320781,-58.4635698917787 -34.5604569039503)))";;"1016";13_16_6;COMUNA 13;"16";"6";"412";"189";"223";"84,75%";"249";"249";"100,00%";"0";"0,00%";"183";"4";"2.19";"179";"97,81%";"2.19";2.190
"MULTIPOLYGON (((-58.4645226562007 -34.5610224117289,-58.4635698917787 -34.5604569039503,-58.4627622835563 -34.5613941320781,-58.4637288442487 -34.5619654912879,-58.4644238249023 -34.5611643209201,-58.4645226562007 -34.5610224117289)))";;"1017";13_16_7;COMUNA 13;"16";"7";"765";"323";"442";"73,08%";"467";"467";"100,00%";"0";"0,00%";"369";"0";"0";"369";"100,00%";"0";0.000
"MULTIPOLYGON (((-58.4637288442487 -34.5619654912879,-58.4627622835563 -34.5613941320781,-58.4619556787855 -34.5623300870633,-58.4629173072228 -34.5629011004521,-58.4637288442487 -34.5619654912879)))";;"1018";13_16_8;COMUNA 13;"16";"8";"671";"281";"390";"72,05%";"411";"411";"100,00%";"0";"0,00%";"352";"1";"0.28";"351";"99,72%";"0.28";0.280
"MULTIPOLYGON (((-58.4627622835563 -34.5613941320781,-58.4618681798639 -34.5608656549215,-58.4610635281789 -34.5618003364445,-58.4619556787855 -34.5623300870633,-58.4627622835563 -34.5613941320781)))";;"1019";13_16_9;COMUNA 13;"16";"9";"827";"361";"466";"77,47%";"461";"461";"100,00%";"0";"0,00%";"380";"2";"0.53";"378";"99,47%";"0.53";0.530
"MULTIPOLYGON (((-58.4661710765455 -34.560816451281,-58.4651628847134 -34.5602360272314,-58.4646702640739 -34.560810287266,-58.4645226562007 -34.5610224117289,-58.4654979931812 -34.5616012923832,-58.466490199816 -34.5621902355387,-58.4669137962877 -34.5620112700164,-58.4676839439126 -34.5616873533193,-58.4670371979829 -34.5613151078622,-58.4661710765455 -34.560816451281)))";;"1020";13_17_1;COMUNA 13;"17";"1";"1065";"487";"578";"84,26%";"613";"613";"100,00%";"0";"0,00%";"476";"3";"0.63";"473";"99,37%";"0.63";0.630
"MULTIPOLYGON (((-58.4631510835992 -34.5644143358739,-58.4621297592658 -34.5638088860594,-58.4613020109724 -34.5647631469216,-58.4623242774315 -34.565369448677,-58.4633585626197 -34.5659828547361,-58.4640888244829 -34.5651380227116,-58.464185022479 -34.5650263969412,-58.4632826130646 -34.564492226082,-58.4631510835992 -34.5644143358739)))";;"1021";13_17_10;COMUNA 13;"17";"10";"944";"431";"513";"84,02%";"498";"498";"100,00%";"0";"0,00%";"398";"0";"0";"398";"100,00%";"0";0.000
"MULTIPOLYGON (((-58.4652244251399 -34.5656418999331,-58.4651080460083 -34.5655727443126,-58.464185022479 -34.5650263969412,-58.4640888244829 -34.5651380227116,-58.4633585626197 -34.5659828547361,-58.4643960981353 -34.5665981534172,-58.4652244251399 -34.5656418999331)))";;"1022";13_17_11;COMUNA 13;"17";"11";"570";"239";"331";"72,21%";"314";"314";"100,00%";"0";"0,00%";"247";"0";"0";"247";"100,00%";"0";0.000
"MULTIPOLYGON (((-58.4654979931812 -34.5616012923832,-58.4645226562007 -34.5610224117289,-58.4644238249023 -34.5611643209201,-58.4637288442487 -34.5619654912879,-58.4629173072228 -34.5629011004521,-58.4634196645576 -34.5631994216312,-58.4637062166935 -34.5633679482099,-58.4650984308593 -34.5627779730233,-58.466490199816 -34.5621902355387,-58.4654979931812 -34.5616012923832)))";;"1023";13_17_2;COMUNA 13;"17";"2";"1083";"484";"599";"80,80%";"662";"660";"99,70%";"2";"0,30%";"472";"4";"0.85";"468";"99,15%";"0.85";0.850
"MULTIPOLYGON (((-58.4665758432566 -34.5622536159547,-58.466490199816 -34.5621902355387,-58.4650984308593 -34.5627779730233,-58.4637062166935 -34.5633679482099,-58.4639433933945 -34.5634990786002,-58.4649726445586 -34.5641129642032,-58.4657752317878 -34.563182130733,-58.4665758432566 -34.5622536159547)))";;"1024";13_17_3;COMUNA 13;"17";"3";"817";"389";"428";"90,89%";"555";"555";"100,00%";"0";"0,00%";"389";"3";"0.77";"386";"99,23%";"0.77";0.770
"MULTIPOLYGON (((-58.4668163261533 -34.5638038881982,-58.4657752317878 -34.563182130733,-58.4649726445586 -34.5641129642032,-58.4660167238836 -34.5647271927929,-58.4668163261533 -34.5638038881982)))";;"1025";13_17_4;COMUNA 13;"17";"4";"552";"243";"309";"78,64%";"303";"303";"100,00%";"0";"0,00%";"247";"2";"0.81";"245";"99,19%";"0.81";0.810
"MULTIPOLYGON (((-58.4675404902445 -34.5629677682134,-58.4665758432566 -34.5622536159547,-58.4657752317878 -34.563182130733,-58.4668163261533 -34.5638038881982,-58.4677158564205 -34.5643410614172,-58.4679265655505 -34.5644632410754,-58.4681570858955 -34.5641996982148,-58.4686103754498 -34.5636750060017,-58.4676489512794 -34.5630481195463,-58.4675404902445 -34.5629677682134)))";;"1026";13_17_5;COMUNA 13;"17";"5";"707";"296";"411";"72,02%";"367";"367";"100,00%";"0";"0,00%";"345";"3";"0.87";"342";"99,13%";"0.87";0.870
"MULTIPOLYGON (((-58.4679265655505 -34.5644632410754,-58.4677158564205 -34.5643410614172,-58.4668163261533 -34.5638038881982,-58.4660167238836 -34.5647271927929,-58.4671290972975 -34.5653814821189,-58.4675457100608 -34.5648985576905,-58.4679265655505 -34.5644632410754)))";;"1027";13_17_6;COMUNA 13;"17";"6";"768";"338";"430";"78,60%";"414";"414";"100,00%";"0";"0,00%";"360";"0";"0";"360";"100,00%";"0";0.000
"MULTIPOLYGON (((-58.4652244251399 -34.5656418999331,-58.4643960981353 -34.5665981534172,-58.4648689408384 -34.5668785103251,-58.4649725486355 -34.5668458309533,-58.4657553513849 -34.5666088316592,-58.4663746094638 -34.5664207781774,-58.4662423930584 -34.566344088581,-58.4663009648368 -34.5663352132386,-58.4663350169779 -34.5663021826114,-58.4671290972975 -34.5653814821189,-58.4660167238836 -34.5647271927929,-58.4652244251399 -34.5656418999331)))";;"1028";13_17_7;COMUNA 13;"17";"7";"840";"373";"467";"79,87%";"484";"484";"100,00%";"0";"0,00%";"386";"0";"0";"386";"100,00%";"0";0.000
"MULTIPOLYGON (((-58.4660167238836 -34.5647271927929,-58.4649726445586 -34.5641129642032,-58.464185022479 -34.5650263969412,-58.4651080460083 -34.5655727443126,-58.4652244251399 -34.5656418999331,-58.4660167238836 -34.5647271927929)))";;"1029";13_17_8;COMUNA 13;"17";"8";"739";"353";"386";"91,45%";"389";"389";"100,00%";"0";"0,00%";"316";"2";"0.63";"314";"99,37%";"0.63";0.630
"MULTIPOLYGON (((-58.4637062166935 -34.5633679482099,-58.4634196645576 -34.5631994216312,-58.4629173072228 -34.5629011004521,-58.4621297592658 -34.5638088860594,-58.4631510835992 -34.5644143358739,-58.4632826130646 -34.564492226082,-58.464185022479 -34.5650263969412,-58.4649726445586 -34.5641129642032,-58.4639433933945 -34.5634990786002,-58.4637062166935 -34.5633679482099)))";;"1030";13_17_9;COMUNA 13;"17";"9";"1006";"434";"572";"75,87%";"532";"531";"99,81%";"1";"0,19%";"403";"4";"0.99";"399";"99,01%";"0.99";0.990
"MULTIPOLYGON (((-58.4721852585086 -34.5663846183397,-58.4720557679825 -34.5663692755464,-58.4716230272251 -34.5663249398008,-58.4711668737652 -34.5662673641295,-58.4708977640077 -34.566251325455,-58.4708026688444 -34.5662447117951,-58.4706318042588 -34.5662347930032,-58.4705319417594 -34.5662294471033,-58.4704364214504 -34.5662279038303,-58.4696516304716 -34.5669231927803,-58.4701254297401 -34.5672103605423,-58.4710453673624 -34.5677679311077,-58.4717672779647 -34.5682055043322,-58.4719614008617 -34.5683241568984,-58.472783101195 -34.5673531339498,-58.4733684861433 -34.5666615046409,-58.473195906452 -34.5665619377729,-58.4729027822946 -34.5665030868034,-58.4722943169843 -34.5664005260082,-58.4721852585086 -34.5663846183397)))";;"1031";13_18_1;COMUNA 13;"18";"1";"888";"403";"485";"83,09%";"433";"431";"99,54%";"2";"0,46%";"334";"1";"0.3";"333";"99,70%";"0.3";0.300
"MULTIPOLYGON (((-58.4649366503774 -34.5710892553726,-58.4641540466973 -34.5706348814104,-58.4631558060917 -34.5717879670502,-58.4617302962928 -34.5734321894167,-58.4625225333342 -34.5742021555494,-58.4629031188665 -34.574592805933,-58.4633555686456 -34.5750083853759,-58.4649915594845 -34.5739950126698,-58.4660374144441 -34.5733358759265,-58.4673642913018 -34.5724961486204,-58.4671176325632 -34.5723542503044,-58.4659998027398 -34.5717036943279,-58.4649366503774 -34.5710892553726)))";;"1032";13_18_10;COMUNA 13;"18";"10";"812";"368";"444";"82,88%";"364";"363";"99,73%";"1";"0,28%";"274";"5";"1.82";"269";"98,18%";"1.82";1.820
"MULTIPOLYGON (((-58.4708464015959 -34.5659775844813,-58.4707297806126 -34.5661026681229,-58.4704364214504 -34.5662279038303,-58.4705319417594 -34.5662294471033,-58.4706318042588 -34.5662347930032,-58.4708026688444 -34.5662447117951,-58.4708977640077 -34.566251325455,-58.4711668737652 -34.5662673641295,-58.4716230272251 -34.5663249398008,-58.4720557679825 -34.5663692755464,-58.4721852585086 -34.5663846183397,-58.4722943169843 -34.5664005260082,-58.4729027822946 -34.5665030868034,-58.473195906452 -34.5665619377729,-58.4730021207034 -34.5664475273469,-58.4727418536645 -34.5662938656197,-58.472460466747 -34.5661281065189,-58.4724205354858 -34.5660976858342,-58.471371280699 -34.5654519618385,-58.4706498207268 -34.5650048785819,-58.4704391899785 -34.5648675621174,-58.4696108916924 -34.5643274471237,-58.4689619020237 -34.5650737122553,-58.4691240020164 -34.5651700461064,-58.4704702800018 -34.5659621857884,-58.4708464015959 -34.5659775844813)))";;"1033";13_18_2;COMUNA 13;"18";"2";"867";"391";"476";"82,14%";"521";"521";"100,00%";"0";"0,00%";"407";"6";"1.47";"401";"98,53%";"1.47";1.470
"MULTIPOLYGON (((-58.4681192472638 -34.5660458751706,-58.4678848556928 -34.5663118912172,-58.4680154784307 -34.5663518414977,-58.4684256514003 -34.5663159058803,-58.4684732432846 -34.566345130273,-58.4684912055777 -34.5663311147229,-58.4686339812204 -34.5664159003177,-58.4687094048775 -34.566345118876,-58.4687483082653 -34.5663060307331,-58.4686728766501 -34.5662645537538,-58.4692452297775 -34.5662402275676,-58.4697063988192 -34.5662280887629,-58.4700871173343 -34.5662280663185,-58.4704364214504 -34.5662279038303,-58.4707297806126 -34.5661026681229,-58.4708464015959 -34.5659775844813,-58.4704702800018 -34.5659621857884,-58.4691240020164 -34.5651700461064,-58.4689619020237 -34.5650737122553,-58.4696108916924 -34.5643274471237,-58.4686103754498 -34.5636750060017,-58.4681570858955 -34.5641996982148,-58.4679265655505 -34.5644632410754,-58.4675457100608 -34.5648985576905,-58.4671290972975 -34.5653814821189,-58.4663350169779 -34.5663021826114,-58.4663009648368 -34.5663352132386,-58.4664523319675 -34.5663123907774,-58.4674241256004 -34.5661338985028,-58.4681192472638 -34.5660458751706)))";;"1034";13_18_3;COMUNA 13;"18";"3";"940";"423";"517";"81,82%";"500";"500";"100,00%";"0";"0,00%";"397";"8";"2.02";"389";"97,98%";"2.02";2.020
"MULTIPOLYGON (((-58.4678848556928 -34.5663118912172,-58.4678608158351 -34.5663454537229,-58.4673736850271 -34.566915624853,-58.4687443244992 -34.5677248958296,-58.4696516304716 -34.5669231927803,-58.4704364214504 -34.5662279038303,-58.4700871173343 -34.5662280663185,-58.4697063988192 -34.5662280887629,-58.4692452297775 -34.5662402275676,-58.4686728766501 -34.5662645537538,-58.4687483082653 -34.5663060307331,-58.4687094048775 -34.566345118876,-58.4686339812204 -34.5664159003177,-58.4684912055777 -34.5663311147229,-58.4684732432846 -34.566345130273,-58.4684256514003 -34.5663159058803,-58.4680154784307 -34.5663518414977,-58.4678848556928 -34.5663118912172)))";;"1035";13_18_4;COMUNA 13;"18";"4";"719";"324";"395";"82,03%";"367";"367";"100,00%";"0";"0,00%";"294";"0";"0";"294";"100,00%";"0";0.000
"MULTIPOLYGON (((-58.4701254297401 -34.5672103605423,-58.4696516304716 -34.5669231927803,-58.4687443244992 -34.5677248958296,-58.4686801365001 -34.5677816620311,-58.4677623406818 -34.5685925839368,-58.4679997094592 -34.568733213781,-58.4685094417955 -34.5690318655359,-58.4687302105823 -34.5691612266435,-58.4694741715183 -34.5695971220237,-58.4696932081688 -34.5693397745724,-58.4702427099419 -34.5687017564049,-58.4709328314265 -34.5679005501673,-58.4710453673624 -34.5677679311077,-58.4701254297401 -34.5672103605423)))";;"1036";13_18_5;COMUNA 13;"18";"5";"702";"315";"387";"81,40%";"356";"356";"100,00%";"0";"0,00%";"282";"1";"0.35";"281";"99,65%";"0.35";0.350
"MULTIPOLYGON (((-58.4702427099419 -34.5687017564049,-58.4696932081688 -34.5693397745724,-58.4694741715183 -34.5695971220237,-58.4687302105823 -34.5691612266435,-58.4685094417955 -34.5690318655359,-58.4679997094592 -34.568733213781,-58.4677623406818 -34.5685925839368,-58.4668149857665 -34.5694296277287,-58.4677745186391 -34.5700511678274,-58.4685381535352 -34.570545732534,-58.4686252534088 -34.5705944628356,-58.4695856575432 -34.571131337002,-58.4704160110981 -34.5701502590833,-58.471176371054 -34.5692517894585,-58.4719614008617 -34.5683241568984,-58.4717672779647 -34.5682055043322,-58.4710453673624 -34.5677679311077,-58.4709328314265 -34.5679005501673,-58.4702427099419 -34.5687017564049)))";;"1037";13_18_6;COMUNA 13;"18";"6";"739";"346";"393";"88,04%";"409";"409";"100,00%";"0";"0,00%";"302";"1";"0.33";"301";"99,67%";"0.33";0.330
"MULTIPOLYGON (((-58.463879284198 -34.5691393971052,-58.464918565425 -34.5697516627096,-58.4657382341419 -34.56880484342,-58.4668149857665 -34.5694296277287,-58.4677623406818 -34.5685925839368,-58.4686801365001 -34.5677816620311,-58.4687443244992 -34.5677248958296,-58.4673736850271 -34.566915624853,-58.4678608158351 -34.5663454537229,-58.4678848556928 -34.5663118912172,-58.4681192472638 -34.5660458751706,-58.4674241256004 -34.5661338985028,-58.4664523319675 -34.5663123907774,-58.4663009648368 -34.5663352132386,-58.4662423930584 -34.566344088581,-58.4663746094638 -34.5664207781774,-58.4657553513849 -34.5666088316592,-58.4649725486355 -34.5668458309533,-58.4648689408384 -34.5668785103251,-58.4649967298057 -34.5669542859527,-58.4655078028464 -34.5672570349896,-58.4647002356765 -34.5681905423353,-58.463879284198 -34.5691393971052)))";;"1038";13_18_7;COMUNA 13;"18";"7";"971";"464";"507";"91,52%";"480";"480";"100,00%";"0";"0,00%";"383";"2";"0.52";"381";"99,48%";"0.52";0.520
"MULTIPOLYGON (((-58.463114504675 -34.5700233136425,-58.462287897985 -34.5709787070223,-58.4620832228463 -34.5712163924574,-58.4614069522394 -34.5720017026285,-58.4608827337304 -34.5726103840278,-58.4617302962928 -34.5734321894167,-58.4631558060917 -34.5717879670502,-58.4641540466973 -34.5706348814104,-58.4649366503774 -34.5710892553726,-58.4658377294377 -34.5702931448443,-58.4668149857665 -34.5694296277287,-58.4657382341419 -34.56880484342,-58.464918565425 -34.5697516627096,-58.463879284198 -34.5691393971052,-58.463114504675 -34.5700233136425)))";;"1039";13_18_8;COMUNA 13;"18";"8";"801";"339";"462";"73,38%";"361";"359";"99,45%";"2";"0,56%";"280";"1";"0.36";"279";"99,64%";"0.36";0.360
"MULTIPOLYGON (((-58.4677745186391 -34.5700511678274,-58.4668149857665 -34.5694296277287,-58.4658377294377 -34.5702931448443,-58.4649366503774 -34.5710892553726,-58.4659998027398 -34.5717036943279,-58.4671176325632 -34.5723542503044,-58.4673642913018 -34.5724961486204,-58.4680812837286 -34.5729088128466,-58.4688405871916 -34.5720116963068,-58.4695856575432 -34.571131337002,-58.4686252534088 -34.5705944628356,-58.4685381535352 -34.570545732534,-58.4677745186391 -34.5700511678274)))";;"1040";13_18_9;COMUNA 13;"18";"9";"525";"228";"297";"76,77%";"210";"208";"99,05%";"2";"0,96%";"170";"0";"0";"170";"100,00%";"0";0.000
"MULTIPOLYGON (((-58.4648689408384 -34.5668785103251,-58.4643960981353 -34.5665981534172,-58.4633585626197 -34.5659828547361,-58.4625506432093 -34.5669174748685,-58.463175107163 -34.5672880536258,-58.4633160060651 -34.5673713664965,-58.4633159087852 -34.5673713479441,-58.4635004963916 -34.5674804961534,-58.4635004095252 -34.5674805251254,-58.4635872478866 -34.5675319352213,-58.4647002356765 -34.5681905423353,-58.4655078028464 -34.5672570349896,-58.4649967298057 -34.5669542859527,-58.4648689408384 -34.5668785103251)))";;"1041";13_19_1;COMUNA 13;"19";"1";"805";"351";"454";"77,31%";"417";"416";"99,76%";"1";"0,24%";"340";"16";"4.71";"324";"95,29%";"4.71";4.710
"MULTIPOLYGON (((-58.4596500698064 -34.5680033997915,-58.4588884672214 -34.5675452598075,-58.4576280378218 -34.568998023694,-58.4577133976695 -34.569537768938,-58.4578059438547 -34.5695029824431,-58.4577938595177 -34.5694154429515,-58.4587870844023 -34.5690813798258,-58.4588832934095 -34.5689832095945,-58.4596500698064 -34.5680033997915)))";;"1042";13_19_10;COMUNA 13;"19";"10";"693";"315";"378";"83,33%";"418";"418";"100,00%";"0";"0,00%";"312";"2";"0.64";"310";"99,36%";"0.64";0.640
"MULTIPOLYGON (((-58.4599118567135 -34.5681593283397,-58.4596500698064 -34.5680033997915,-58.4588832934095 -34.5689832095945,-58.4596610260736 -34.56872441737,-58.4603985701277 -34.5684490694123,-58.4599118567135 -34.5681593283397)))";;"1043";13_19_11;COMUNA 13;"19";"11";"405";"199";"206";"96,60%";"224";"224";"100,00%";"0";"0,00%";"193";"0";"0";"193";"100,00%";"0";0.000
"MULTIPOLYGON (((-58.4609487129912 -34.568764655651,-58.4606296262186 -34.5685816145279,-58.460424280829 -34.5684637888447,-58.4603985701277 -34.5684490694123,-58.4596610260736 -34.56872441737,-58.4588832934095 -34.5689832095945,-58.4587870844023 -34.5690813798258,-58.4577938595177 -34.5694154429515,-58.4578059438547 -34.5695029824431,-58.4577133976695 -34.569537768938,-58.4577856754562 -34.5696007323441,-58.4579845452342 -34.5697937062932,-58.4587940806495 -34.5705805294617,-58.4596794024341 -34.5714408733504,-58.4602616525136 -34.572008305126,-58.4608827337304 -34.5726103840278,-58.4614069522394 -34.5720017026285,-58.46006057823 -34.5711933363191,-58.4609506324236 -34.5706127639046,-58.4599592141915 -34.5700844129822,-58.4608510591443 -34.5688717715425,-58.4609487129912 -34.568764655651)))";;"1044";13_19_12;COMUNA 13;"19";"12";"753";"323";"430";"75,12%";"356";"354";"99,44%";"2";"0,56%";"268";"3";"1.12";"265";"98,88%";"1.12";1.120
"MULTIPOLYGON (((-58.4633585626197 -34.5659828547361,-58.4623242774315 -34.565369448677,-58.4615151605064 -34.5663041324724,-58.4616968349982 -34.5664108289215,-58.4625506432093 -34.5669174748685,-58.4633585626197 -34.5659828547361)))";;"1045";13_19_2;COMUNA 13;"19";"2";"933";"427";"506";"84,39%";"498";"498";"100,00%";"0";"0,00%";"397";"2";"0.5";"395";"99,50%";"0.5";0.500
"MULTIPOLYGON (((-58.4623242774315 -34.565369448677,-58.4613020109724 -34.5647631469216,-58.4604884614672 -34.5657009931076,-58.4615151605064 -34.5663041324724,-58.4623242774315 -34.565369448677)))";;"1046";13_19_3;COMUNA 13;"19";"3";"699";"314";"385";"81,56%";"371";"371";"100,00%";"0";"0,00%";"295";"3";"1.02";"292";"98,98%";"1.02";1.020
"MULTIPOLYGON (((-58.4615151605064 -34.5663041324724,-58.4604884614672 -34.5657009931076,-58.4596649325731 -34.5666502424302,-58.4606901048145 -34.5672571211598,-58.4615151605064 -34.5663041324724)))";;"1047";13_19_4;COMUNA 13;"19";"4";"500";"230";"270";"85,19%";"314";"314";"100,00%";"0";"0,00%";"227";"0";"0";"227";"100,00%";"0";0.000
"MULTIPOLYGON (((-58.4635004461865 -34.5674805468297,-58.4635005293255 -34.5674805194725,-58.4635004095252 -34.5674805251254,-58.4635004461865 -34.5674805468297)),((-58.4635004963916 -34.5674804961534,-58.4633159087852 -34.5673713479441,-58.4633160060651 -34.5673713664965,-58.463175107163 -34.5672880536258,-58.4625506432093 -34.5669174748685,-58.4616968349982 -34.5664108289215,-58.4615151605064 -34.5663041324724,-58.4606901048145 -34.5672571211598,-58.4617267000314 -34.5678706817442,-58.461812430952 -34.5679213888344,-58.4620339526422 -34.5680522410193,-58.4627639915637 -34.5684824023988,-58.463879284198 -34.5691393971052,-58.4647002356765 -34.5681905423353,-58.4635872478866 -34.5675319352213,-58.4635004461865 -34.5674805468297,-58.4633979922659 -34.5675142596218,-58.4635004963916 -34.5674804961534)))";;"1048";13_19_5;COMUNA 13;"19";"5";"929";"406";"523";"77,63%";"483";"480";"99,38%";"3";"0,63%";"366";"10";"2.73";"356";"97,27%";"2.73";2.730
"MULTIPOLYGON (((-58.463879284198 -34.5691393971052,-58.4627639915637 -34.5684824023988,-58.4621041810903 -34.5692440537766,-58.4619981845798 -34.5693698333176,-58.4622696857903 -34.5695263202348,-58.463114504675 -34.5700233136425,-58.463879284198 -34.5691393971052)))";;"1049";13_19_6;COMUNA 13;"19";"6";"497";"222";"275";"80,73%";"252";"252";"100,00%";"0";"0,00%";"215";"0";"0";"215";"100,00%";"0";0.000
"MULTIPOLYGON (((-58.4609506324236 -34.5706127639046,-58.46006057823 -34.5711933363191,-58.4614069522394 -34.5720017026285,-58.4620832228463 -34.5712163924574,-58.462287897985 -34.5709787070223,-58.463114504675 -34.5700233136425,-58.4622696857903 -34.5695263202348,-58.4619981845798 -34.5693698333176,-58.4611194947867 -34.5688633242417,-58.4609487129912 -34.568764655651,-58.4608510591443 -34.5688717715425,-58.4599592141915 -34.5700844129822,-58.4609506324236 -34.5706127639046)))";;"1050";13_19_7;COMUNA 13;"19";"7";"733";"319";"414";"77,05%";"278";"277";"99,64%";"1";"0,36%";"257";"38";"14.79";"219";"85,21%";"14.79";14.790
"MULTIPOLYGON (((-58.4617267000314 -34.5678706817442,-58.4606901048145 -34.5672571211598,-58.4599118567135 -34.5681593283397,-58.4603985701277 -34.5684490694123,-58.460424280829 -34.5684637888447,-58.4606296262186 -34.5685816145279,-58.4609487129912 -34.568764655651,-58.4611194947867 -34.5688633242417,-58.4619981845798 -34.5693698333176,-58.4621041810903 -34.5692440537766,-58.4627639915637 -34.5684824023988,-58.4620339526422 -34.5680522410193,-58.461812430952 -34.5679213888344,-58.4617267000314 -34.5678706817442)))";;"1051";13_19_8;COMUNA 13;"19";"8";"744";"317";"427";"74,24%";"405";"404";"99,75%";"1";"0,25%";"329";"0";"0";"329";"100,00%";"0";0.000
"MULTIPOLYGON (((-58.4606901048145 -34.5672571211598,-58.4596649325731 -34.5666502424302,-58.4588884672214 -34.5675452598075,-58.4596500698064 -34.5680033997915,-58.4599118567135 -34.5681593283397,-58.4606901048145 -34.5672571211598)))";;"1052";13_19_9;COMUNA 13;"19";"9";"661";"277";"384";"72,14%";"422";"421";"99,76%";"1";"0,24%";"332";"3";"0.9";"329";"99,10%";"0.9";0.900
"MULTIPOLYGON (((-58.4697821297552 -34.5446832980676,-58.4692073447625 -34.5454635078389,-58.4687337390643 -34.5461064498519,-58.4682108494937 -34.5468163671785,-58.4694007066118 -34.5474104905484,-58.4699395073873 -34.5467154271084,-58.4704308953425 -34.5460660001798,-58.4710125664904 -34.545278952949,-58.4715370398085 -34.5445693050373,-58.4703026098266 -34.5439766135067,-58.4697821297552 -34.5446832980676)))";;"1053";13_2_1;COMUNA 13;"2";"1";"1073";"497";"576";"86,28%";"708";"707";"99,86%";"1";"0,14%";"545";"38";"6.97";"507";"93,03%";"6.97";6.970
"MULTIPOLYGON (((-58.4642060437765 -34.5457736865951,-58.4639757262866 -34.5456619233744,-58.4638535033244 -34.5456000202559,-58.463008416498 -34.5451714134906,-58.4620652046321 -34.5446930797087,-58.4618811085021 -34.5445996939025,-58.4611273656431 -34.544211287805,-58.4606222358845 -34.5439509157705,-58.45979543953 -34.5447187522585,-58.4604773463396 -34.5450934322141,-58.4614272776284 -34.54556649636,-58.4623721128808 -34.5460370881608,-58.4632541446137 -34.5464761221332,-58.4637242305246 -34.5467086652605,-58.4637642331821 -34.5466378869374,-58.4640244183885 -34.5461372269894,-58.4641718296824 -34.5458493948136,-58.4642060437765 -34.5457736865951)))";;"1054";13_2_10;COMUNA 13;"2";"10";"1102";"494";"608";"81,25%";"562";"562";"100,00%";"0";"0,00%";"468";"12";"2.56";"456";"97,44%";"2.56";2.560
"MULTIPOLYGON (((-58.466974811593 -34.5432629385584,-58.4668551543134 -34.5434240771251,-58.4667242626317 -34.5435993715444,-58.4663942225284 -34.5440415156784,-58.4665390852103 -34.5441145428493,-58.4673383879784 -34.5445187596485,-58.4682697969624 -34.5449897993864,-58.4684196847426 -34.5450656411203,-58.4692073447625 -34.5454635078389,-58.4697821297552 -34.5446832980676,-58.4703026098266 -34.5439766135067,-58.4693652426119 -34.5435015752456,-58.4684375038346 -34.5430313886861,-58.4674997322474 -34.5425560543455,-58.466974811593 -34.5432629385584)))";;"1055";13_2_2;COMUNA 13;"2";"2";"860";"408";"452";"90,27%";"402";"402";"100,00%";"0";"0,00%";"359";"1";"0.28";"358";"99,72%";"0.28";0.280
"MULTIPOLYGON (((-58.4692073447625 -34.5454635078389,-58.4684196847426 -34.5450656411203,-58.4682697969624 -34.5449897993864,-58.4673383879784 -34.5445187596485,-58.4668632412381 -34.5451617649912,-58.4663380436736 -34.5458725195975,-58.4672732071182 -34.5463438484236,-58.4682108494937 -34.5468163671785,-58.4687337390643 -34.5461064498519,-58.4692073447625 -34.5454635078389)))";;"1056";13_2_3;COMUNA 13;"2";"3";"591";"272";"319";"85,27%";"344";"344";"100,00%";"0";"0,00%";"259";"2";"0.77";"257";"99,23%";"0.77";0.770
"MULTIPOLYGON (((-58.4663942225284 -34.5440415156784,-58.4667242626317 -34.5435993715444,-58.4668551543134 -34.5434240771251,-58.466974811593 -34.5432629385584,-58.4674997322474 -34.5425560543455,-58.466572695341 -34.5420862056465,-58.4662447623605 -34.5419200104689,-58.4661193940975 -34.5418567011534,-58.4660766685017 -34.5418351520147,-58.4660737927187 -34.5418421471854,-58.4658444815017 -34.5417331498139,-58.46581172336 -34.5418124114851,-58.4656585406131 -34.5421910953869,-58.4655241644232 -34.5425310443949,-58.4654879958482 -34.5426224580429,-58.465319406709 -34.5430490314276,-58.4651709855158 -34.5434227847266,-58.4651411989946 -34.5434978593231,-58.4650342226312 -34.5437761140934,-58.4648879269844 -34.54416240277,-58.4648631612672 -34.5442276880022,-58.4646703953123 -34.5447127142806,-58.4646560761197 -34.5447531611592,-58.4645909050091 -34.5448998370826,-58.4645584789786 -34.5449756158184,-58.4645540635044 -34.5449859278304,-58.4647491351122 -34.5450754191909,-58.4647504944539 -34.5450724483173,-58.4649050113012 -34.5447349452211,-58.465010261921 -34.5452033361298,-58.4653843359204 -34.5453918173416,-58.4663380436736 -34.5458725195975,-58.4668632412381 -34.5451617649912,-58.4673383879784 -34.5445187596485,-58.4665390852103 -34.5441145428493,-58.4663942225284 -34.5440415156784)))";;"1057";13_2_4;COMUNA 13;"2";"4";"666";"322";"344";"93,60%";"302";"302";"100,00%";"0";"0,00%";"239";"3";"1.26";"236";"98,74%";"1.26";1.260
"MULTIPOLYGON (((-58.4612942839936 -34.5433267407221,-58.4606222358845 -34.5439509157705,-58.4611273656431 -34.544211287805,-58.4618811085021 -34.5445996939025,-58.4620652046321 -34.5446930797087,-58.463008416498 -34.5451714134906,-58.4635324463795 -34.5444584195028,-58.4625873671106 -34.5439820616357,-58.4631176061724 -34.5432652662966,-58.4619831739576 -34.5426869978878,-58.4612942839936 -34.5433267407221)))";;"1058";13_2_6;COMUNA 13;"2";"6";"949";"465";"484";"96,07%";"687";"687";"100,00%";"0";"0,00%";"470";"7";"1.49";"463";"98,51%";"1.49";1.490
"MULTIPOLYGON (((-58.4635324463795 -34.5444584195028,-58.463008416498 -34.5451714134906,-58.4638535033244 -34.5456000202559,-58.4639757262866 -34.5456619233744,-58.4642060437765 -34.5457736865951,-58.4643731983092 -34.5454037373544,-58.4645263933199 -34.5450505494291,-58.4645540635044 -34.5449859278304,-58.4645584789786 -34.5449756158184,-58.4645909050091 -34.5448998370826,-58.4646560761197 -34.5447531611592,-58.4643881480057 -34.5439117649874,-58.4640579141898 -34.5437442259268,-58.4639280339338 -34.5436783790987,-58.4631176061724 -34.5432652662966,-58.4625873671106 -34.5439820616357,-58.4635324463795 -34.5444584195028)))";;"1059";13_2_7;COMUNA 13;"2";"7";"667";"322";"345";"93,33%";"372";"372";"100,00%";"0";"0,00%";"300";"1";"0.33";"299";"99,67%";"0.33";0.330
"MULTIPOLYGON (((-58.4651587111656 -34.5456904981855,-58.465249872262 -34.5458597296624,-58.4654467527775 -34.5462839707648,-58.4655627692964 -34.5464822168819,-58.4657501113803 -34.5466679957458,-58.4658141989272 -34.546581299904,-58.4667502185658 -34.5470541820272,-58.4676870148474 -34.5475274090358,-58.4688478534461 -34.5481137920632,-58.4691289624369 -34.5477610849947,-58.4694007066118 -34.5474104905484,-58.4682108494937 -34.5468163671785,-58.4672732071182 -34.5463438484236,-58.4663380436736 -34.5458725195975,-58.4653843359204 -34.5453918173416,-58.465010261921 -34.5452033361298,-58.4649050113012 -34.5447349452211,-58.4647504944539 -34.5450724483173,-58.4647519472319 -34.5450767092797,-58.4650226206132 -34.545870579779,-58.4651587111656 -34.5456904981855)))";;"1060";13_2_8;COMUNA 13;"2";"8";"618";"263";"355";"74,08%";"325";"324";"99,69%";"1";"0,31%";"253";"1";"0.4";"252";"99,60%";"0.4";0.400
"MULTIPOLYGON (((-58.4642060437765 -34.5457736865951,-58.4641718296824 -34.5458493948136,-58.4640244183885 -34.5461372269894,-58.4637642331821 -34.5466378869374,-58.4637242305246 -34.5467086652605,-58.4639394001786 -34.5468150767265,-58.4644570692908 -34.5470712091861,-58.4651867651464 -34.5474329740717,-58.4661221099378 -34.5479079737323,-58.4670619761867 -34.5483771911112,-58.4681892848515 -34.5489399888592,-58.4682258818072 -34.5488942808477,-58.4685085279942 -34.5485396032595,-58.4685530396568 -34.5484837534505,-58.4685537415563 -34.548482872649,-58.4686633220202 -34.5483453617472,-58.4687186599648 -34.5482759187695,-58.4688478534461 -34.5481137920632,-58.4676870148474 -34.5475274090358,-58.4667502185658 -34.5470541820272,-58.4658141989272 -34.546581299904,-58.4657501113803 -34.5466679957458,-58.4655627692964 -34.5464822168819,-58.4654467527775 -34.5462839707648,-58.465249872262 -34.5458597296624,-58.4651587111656 -34.5456904981855,-58.4650226206132 -34.545870579779,-58.4647519472319 -34.5450767092797,-58.4647504944539 -34.5450724483173,-58.4647491351122 -34.5450754191909,-58.4645540635044 -34.5449859278304,-58.4645263933199 -34.5450505494291,-58.4643731983092 -34.5454037373544,-58.4642060437765 -34.5457736865951)))";;"1061";13_2_9;COMUNA 13;"2";"9";"1055";"496";"559";"88,73%";"498";"497";"99,80%";"1";"0,20%";"396";"1";"0.25";"395";"99,75%";"0.25";0.250
"MULTIPOLYGON (((-58.4604884614672 -34.5657009931076,-58.4595338830333 -34.5651401727492,-58.4587163082109 -34.5660887820832,-58.4596649325731 -34.5666502424302,-58.4604884614672 -34.5657009931076)))";;"1062";13_20_1;COMUNA 13;"20";"1";"646";"282";"364";"77,47%";"414";"414";"100,00%";"0";"0,00%";"301";"0";"0";"301";"100,00%";"0";0.000
"MULTIPOLYGON (((-58.4563230220185 -34.5673057760944,-58.4554332370059 -34.5667847176615,-58.4547869956979 -34.5675361892189,-58.4556764441867 -34.568056688874,-58.4563230220185 -34.5673057760944)))";;"1063";13_20_10;COMUNA 13;"20";"10";"564";"237";"327";"72,48%";"369";"369";"100,00%";"0";"0,00%";"272";"2";"0.74";"270";"99,26%";"0.74";0.740
"MULTIPOLYGON (((-58.4554332370059 -34.5667847176615,-58.454526607545 -34.5662538624108,-58.4538757651729 -34.5670029344303,-58.4547869956979 -34.5675361892189,-58.4554332370059 -34.5667847176615)))";;"1064";13_20_11;COMUNA 13;"20";"11";"598";"271";"327";"82,87%";"341";"341";"100,00%";"0";"0,00%";"261";"4";"1.53";"257";"98,47%";"1.53";1.530
"MULTIPOLYGON (((-58.4533128488043 -34.5655430396601,-58.4531544055501 -34.5656347919735,-58.4528654436575 -34.5658021707626,-58.4522875199713 -34.5661082630446,-58.4538757651729 -34.5670029344303,-58.454526607545 -34.5662538624108,-58.4533128488043 -34.5655430396601)))";;"1065";13_20_12;COMUNA 13;"20";"12";"564";"232";"332";"69,88%";"440";"440";"100,00%";"0";"0,00%";"277";"2";"0.72";"275";"99,28%";"0.72";0.720
"MULTIPOLYGON (((-58.4596649325731 -34.5666502424302,-58.4587163082109 -34.5660887820832,-58.4579461379566 -34.566982385242,-58.4581778670246 -34.5671177520807,-58.4588884672214 -34.5675452598075,-58.4596649325731 -34.5666502424302)))";;"1066";13_20_2;COMUNA 13;"20";"2";"943";"406";"537";"75,61%";"471";"471";"100,00%";"0";"0,00%";"394";"0";"0";"394";"100,00%";"0";0.000
"MULTIPOLYGON (((-58.4587163082109 -34.5660887820832,-58.4578252446102 -34.565561261781,-58.4570203321934 -34.5664959863476,-58.4579142955002 -34.5670192870211,-58.4579461379566 -34.566982385242,-58.4587163082109 -34.5660887820832)))";;"1067";13_20_3;COMUNA 13;"20";"3";"412";"190";"222";"85,59%";"232";"232";"100,00%";"0";"0,00%";"175";"0";"0";"175";"100,00%";"0";0.000
"MULTIPOLYGON (((-58.4578252446102 -34.565561261781,-58.4569373420389 -34.5650356365712,-58.4561297852694 -34.5659747216104,-58.4570203321934 -34.5664959863476,-58.4578252446102 -34.565561261781)))";;"1068";13_20_4;COMUNA 13;"20";"4";"685";"267";"418";"63,88%";"412";"412";"100,00%";"0";"0,00%";"316";"1";"0.32";"315";"99,68%";"0.32";0.320
"MULTIPOLYGON (((-58.4569373420389 -34.5650356365712,-58.4560422147505 -34.5645057789262,-58.4550644405702 -34.5639268932775,-58.4542490405012 -34.5648737123753,-58.4552280124958 -34.565446759211,-58.4561297852694 -34.5659747216104,-58.4569373420389 -34.5650356365712)))";;"1069";13_20_5;COMUNA 13;"20";"5";"602";"250";"352";"71,02%";"421";"421";"100,00%";"0";"0,00%";"312";"1";"0.32";"311";"99,68%";"0.32";0.320
"MULTIPOLYGON (((-58.4561297852694 -34.5659747216104,-58.4552280124958 -34.565446759211,-58.4542490405012 -34.5648737123753,-58.4535359118007 -34.5654138255699,-58.4533128488043 -34.5655430396601,-58.454526607545 -34.5662538624108,-58.4554332370059 -34.5667847176615,-58.4561297852694 -34.5659747216104)))";;"1070";13_20_6;COMUNA 13;"20";"6";"815";"327";"488";"67,01%";"609";"609";"100,00%";"0";"0,00%";"428";"2";"0.47";"426";"99,53%";"0.47";0.470
"MULTIPOLYGON (((-58.4579142955002 -34.5670192870211,-58.4570203321934 -34.5664959863476,-58.4561297852694 -34.5659747216104,-58.4554332370059 -34.5667847176615,-58.4563230220185 -34.5673057760944,-58.4572193733132 -34.5678306312756,-58.4574710521752 -34.5675364745468,-58.4578325607197 -34.5671140766688,-58.4579142955002 -34.5670192870211)))";;"1071";13_20_7;COMUNA 13;"20";"7";"835";"370";"465";"79,57%";"503";"503";"100,00%";"0";"0,00%";"372";"1";"0.27";"371";"99,73%";"0.27";0.270
"MULTIPOLYGON (((-58.4579461379566 -34.566982385242,-58.4579142955002 -34.5670192870211,-58.4578325607197 -34.5671140766688,-58.4574710521752 -34.5675364745468,-58.4572193733132 -34.5678306312756,-58.4565755237364 -34.5685828869618,-58.4574750402889 -34.5691092192529,-58.4576280378218 -34.568998023694,-58.4588884672214 -34.5675452598075,-58.4581778670246 -34.5671177520807,-58.4579461379566 -34.566982385242)))";;"1072";13_20_8;COMUNA 13;"20";"8";"783";"341";"442";"77,15%";"584";"584";"100,00%";"0";"0,00%";"386";"1";"0.26";"385";"99,74%";"0.26";0.260
"MULTIPOLYGON (((-58.4572193733132 -34.5678306312756,-58.4563230220185 -34.5673057760944,-58.4556764441867 -34.568056688874,-58.4565755237364 -34.5685828869618,-58.4572193733132 -34.5678306312756)))";;"1073";13_20_9;COMUNA 13;"20";"9";"551";"234";"317";"73,82%";"389";"389";"100,00%";"0";"0,00%";"258";"2";"0.78";"256";"99,22%";"0.78";0.780
"MULTIPOLYGON (((-58.4532414801004 -34.5642788234737,-58.4523193146308 -34.5637326680438,-58.4515118894346 -34.5646671450773,-58.4523691938289 -34.5651721724793,-58.4531544055501 -34.5656347919735,-58.4533128488043 -34.5655430396601,-58.4535359118007 -34.5654138255699,-58.4542490405012 -34.5648737123753,-58.4550644405702 -34.5639268932775,-58.4548521344401 -34.5638011700236,-58.4540585032658 -34.5633320111287,-58.4532414801004 -34.5642788234737)))";;"1074";13_21_1;COMUNA 13;"21";"1";"601";"257";"344";"74,71%";"367";"366";"99,73%";"1";"0,27%";"244";"2";"0.82";"242";"99,18%";"0.82";0.820
"MULTIPOLYGON (((-58.4506093091887 -34.5641354158172,-58.449714146176 -34.5636079765932,-58.4488139722398 -34.5630776427391,-58.4480183479853 -34.5640091402277,-58.4489165691669 -34.5645376485809,-58.4498153975884 -34.5650665024731,-58.4506093091887 -34.5641354158172)))";;"1075";13_21_10;COMUNA 13;"21";"10";"916";"382";"534";"71,54%";"430";"430";"100,00%";"0";"0,00%";"342";"1";"0.29";"341";"99,71%";"0.29";0.290
"MULTIPOLYGON (((-58.4540585032658 -34.5633320111287,-58.4531355766653 -34.5627864251317,-58.4524352799431 -34.5635984465508,-58.4523193146308 -34.5637326680438,-58.4532414801004 -34.5642788234737,-58.4540585032658 -34.5633320111287)))";;"1076";13_21_2;COMUNA 13;"21";"2";"309";"132";"177";"74,58%";"206";"206";"100,00%";"0";"0,00%";"149";"1";"0.67";"148";"99,33%";"0.67";0.670
"MULTIPOLYGON (((-58.4531355766653 -34.5627864251317,-58.4522288355756 -34.5622504113903,-58.451413675259 -34.563196296296,-58.4523193146308 -34.5637326680438,-58.4524352799431 -34.5635984465508,-58.4531355766653 -34.5627864251317)))";;"1077";13_21_3;COMUNA 13;"21";"3";"537";"234";"303";"77,23%";"312";"312";"100,00%";"0";"0,00%";"233";"0";"0";"233";"100,00%";"0";0.000
"MULTIPOLYGON (((-58.4522288355756 -34.5622504113903,-58.4513361513242 -34.5617226319819,-58.4506260545712 -34.5625450652498,-58.4505209861978 -34.5626675250485,-58.451413675259 -34.563196296296,-58.4522288355756 -34.5622504113903)))";;"1078";13_21_4;COMUNA 13;"21";"4";"861";"388";"473";"82,03%";"403";"403";"100,00%";"0";"0,00%";"319";"0";"0";"319";"100,00%";"0";0.000
"MULTIPOLYGON (((-58.4513361513242 -34.5617226319819,-58.450442201524 -34.5611941416177,-58.4497202662455 -34.5620243857484,-58.4496239672207 -34.562136211441,-58.4505209861978 -34.5626675250485,-58.4506260545712 -34.5625450652498,-58.4513361513242 -34.5617226319819)))";;"1079";13_21_5;COMUNA 13;"21";"5";"850";"396";"454";"87,22%";"378";"378";"100,00%";"0";"0,00%";"291";"2";"0.69";"289";"99,31%";"0.69";0.690
"MULTIPOLYGON (((-58.4505209861978 -34.5626675250485,-58.4496239672207 -34.562136211441,-58.4488936699238 -34.562984337776,-58.4488139722398 -34.5630776427391,-58.449714146176 -34.5636079765932,-58.4505209861978 -34.5626675250485)))";;"1080";13_21_6;COMUNA 13;"21";"6";"759";"333";"426";"78,17%";"387";"387";"100,00%";"0";"0,00%";"312";"2";"0.64";"310";"99,36%";"0.64";0.640
"MULTIPOLYGON (((-58.451413675259 -34.563196296296,-58.4505209861978 -34.5626675250485,-58.449714146176 -34.5636079765932,-58.4506093091887 -34.5641354158172,-58.4510684143066 -34.5635969154575,-58.451413675259 -34.563196296296)))";;"1081";13_21_7;COMUNA 13;"21";"7";"1125";"497";"628";"79,14%";"550";"550";"100,00%";"0";"0,00%";"450";"2";"0.44";"448";"99,56%";"0.44";0.440
"MULTIPOLYGON (((-58.4523193146308 -34.5637326680438,-58.451413675259 -34.563196296296,-58.4510684143066 -34.5635969154575,-58.4506093091887 -34.5641354158172,-58.4515118894346 -34.5646671450773,-58.4523193146308 -34.5637326680438)))";;"1082";13_21_8;COMUNA 13;"21";"8";"735";"329";"406";"81,03%";"431";"431";"100,00%";"0";"0,00%";"345";"1";"0.29";"344";"99,71%";"0.29";0.290
"MULTIPOLYGON (((-58.4515118894346 -34.5646671450773,-58.4506093091887 -34.5641354158172,-58.4498153975884 -34.5650665024731,-58.4498821355681 -34.5651057365793,-58.4512732095876 -34.5656855481144,-58.4522875199713 -34.5661082630446,-58.4528654436575 -34.5658021707626,-58.4531544055501 -34.5656347919735,-58.4523691938289 -34.5651721724793,-58.4515118894346 -34.5646671450773)))";;"1083";13_21_9;COMUNA 13;"21";"9";"842";"404";"438";"92,24%";"542";"541";"99,82%";"1";"0,18%";"360";"1";"0.28";"359";"99,72%";"0.28";0.280
"MULTIPOLYGON (((-58.4489527715247 -34.5659608139251,-58.4481177822965 -34.5654687235819,-58.4473197439936 -34.566398877773,-58.4477957635211 -34.5666783152585,-58.4478545000505 -34.5667128309692,-58.4483860765979 -34.5672225646436,-58.449044406335 -34.5678537943786,-58.4499299728319 -34.5673812639655,-58.450162920885 -34.5672569164795,-58.450780452318 -34.5669197100658,-58.4515840956606 -34.5664807525741,-58.451718276332 -34.566409705265,-58.4522875199713 -34.5661082630446,-58.4512732095876 -34.5656855481144,-58.4502098066168 -34.5662758924117,-58.4494569865715 -34.5666937187085,-58.4489527715247 -34.5659608139251)))";;"1084";13_22_1;COMUNA 13;"22";"1";"589";"231";"358";"64,53%";"342";"341";"99,71%";"1";"0,29%";"251";"3";"1.2";"248";"98,80%";"1.2";1.200
"MULTIPOLYGON (((-58.4498153975884 -34.5650665024731,-58.4494703760161 -34.5654710608513,-58.4502098066168 -34.5662758924117,-58.4512732095876 -34.5656855481144,-58.4498821355681 -34.5651057365793,-58.4498153975884 -34.5650665024731)))";;"1085";13_22_2;COMUNA 13;"22";"2";"520";"228";"292";"78,08%";"287";"287";"100,00%";"0";"0,00%";"221";"1";"0.45";"220";"99,55%";"0.45";0.450
"MULTIPOLYGON (((-58.4494703760161 -34.5654710608513,-58.4491650308205 -34.5658292121427,-58.4489527715247 -34.5659608139251,-58.4494569865715 -34.5666937187085,-58.4502098066168 -34.5662758924117,-58.4494703760161 -34.5654710608513)))";;"1086";13_22_3;COMUNA 13;"22";"3";"471";"218";"253";"86,17%";"324";"324";"100,00%";"0";"0,00%";"222";"0";"0";"222";"100,00%";"0";0.000
"MULTIPOLYGON (((-58.4498153975884 -34.5650665024731,-58.4489165691669 -34.5645376485809,-58.4480183479853 -34.5640091402277,-58.4471140945227 -34.5634771031687,-58.4463176814504 -34.564407955578,-58.4472222802462 -34.564941054884,-58.4481177822965 -34.5654687235819,-58.4489527715247 -34.5659608139251,-58.4491650308205 -34.5658292121427,-58.4494703760161 -34.5654710608513,-58.4498153975884 -34.5650665024731)))";;"1087";13_22_4;COMUNA 13;"22";"4";"895";"395";"500";"79,00%";"422";"422";"100,00%";"0";"0,00%";"327";"1";"0.31";"326";"99,69%";"0.31";0.310
"MULTIPOLYGON (((-58.4454095191175 -34.5638727362499,-58.444612402012 -34.5648045633298,-58.4455199733016 -34.5653404222543,-58.4460645046408 -34.565661920262,-58.4464261944977 -34.5658742318632,-58.4473197439936 -34.566398877773,-58.4481177822965 -34.5654687235819,-58.4472222802462 -34.564941054884,-58.4463176814504 -34.564407955578,-58.4471140945227 -34.5634771031687,-58.4462053412044 -34.5629423121583,-58.4454095191175 -34.5638727362499)))";;"1088";13_22_5;COMUNA 13;"22";"5";"1184";"500";"684";"73,10%";"484";"483";"99,79%";"1";"0,21%";"394";"1";"0.25";"393";"99,75%";"0.25";0.250
"MULTIPOLYGON (((-58.4446199023632 -34.5620106377674,-58.4444687658593 -34.5621553400481,-58.4436344269042 -34.562826580491,-58.4454095191175 -34.5638727362499,-58.4462053412044 -34.5629423121583,-58.4449287990542 -34.5621911841215,-58.4446199023632 -34.5620106377674)))";;"1089";13_22_6;COMUNA 13;"22";"6";"1122";"510";"612";"83,33%";"485";"485";"100,00%";"0";"0,00%";"391";"3";"0.77";"388";"99,23%";"0.77";0.770
"MULTIPOLYGON (((-58.4436344269042 -34.562826580491,-58.4428137832569 -34.563486830985,-58.4426218644028 -34.5636261719434,-58.4436461944342 -34.5642340390567,-58.444612402012 -34.5648045633298,-58.4454095191175 -34.5638727362499,-58.4436344269042 -34.562826580491)))";;"1090";13_22_7;COMUNA 13;"22";"7";"1101";"493";"608";"81,09%";"600";"600";"100,00%";"0";"0,00%";"455";"3";"0.66";"452";"99,34%";"0.66";0.660
"MULTIPOLYGON (((-58.4441605209602 -34.5614892638097,-58.4441662435628 -34.5614875039616,-58.4434790798872 -34.561376311659,-58.4434090754481 -34.5614009886374,-58.4432141987445 -34.5614722284767,-58.4425441919205 -34.5616450147386,-58.4418779280356 -34.5618177275309,-58.441420669149 -34.56193237211,-58.4413250620164 -34.5619587650356,-58.4411957431578 -34.561986630892,-58.4411009935163 -34.5620053692427,-58.441164038223 -34.5620987315347,-58.4412201153105 -34.5621817753437,-58.4413445416062 -34.5623507577305,-58.4413448498319 -34.5623511042115,-58.441497306169 -34.562522482136,-58.4419693058384 -34.5630530092994,-58.4425352708136 -34.56368904778,-58.4426218644028 -34.5636261719434,-58.4428137832569 -34.563486830985,-58.4436344269042 -34.562826580491,-58.4428069055759 -34.5623388915629,-58.4429694094987 -34.5621413855439,-58.4441867347741 -34.5617550685002,-58.4441605209602 -34.5614892638097)))";;"1091";13_22_8;COMUNA 13;"22";"8";"797";"376";"421";"89,31%";"543";"543";"100,00%";"0";"0,00%";"377";"3";"0.8";"374";"99,20%";"0.8";0.800
"MULTIPOLYGON (((-58.4446199023632 -34.5620106377674,-58.4444774988063 -34.5619273734485,-58.4441867347741 -34.5617550685002,-58.4429694094987 -34.5621413855439,-58.4428069055759 -34.5623388915629,-58.4436344269042 -34.562826580491,-58.4444687658593 -34.5621553400481,-58.4446199023632 -34.5620106377674)))";;"1092";13_22_9;COMUNA 13;"22";"9";"551";"243";"308";"78,90%";"289";"289";"100,00%";"0";"0,00%";"220";"2";"0.91";"218";"99,09%";"0.91";0.910
"MULTIPOLYGON (((-58.4574750402889 -34.5691092192529,-58.4565755237364 -34.5685828869618,-58.4553592059484 -34.5692828502875,-58.4552539026478 -34.5691582610389,-58.4547656977455 -34.5685815855101,-58.4538381667723 -34.5691172492036,-58.4529189679142 -34.5696481879552,-58.4520803888543 -34.5701325050441,-58.4515897870808 -34.5704157834809,-58.4511938634097 -34.5706443482225,-58.4505129547774 -34.5710373976848,-58.4503407910695 -34.5711264687201,-58.4501750129097 -34.5712122301649,-58.4493949976278 -34.5715742758964,-58.4487816919217 -34.5718589380536,-58.4486400939872 -34.5719232203623,-58.447560093869 -34.5724137460399,-58.4465886449045 -34.5728549081875,-58.4469146317943 -34.5733922976898,-58.446942719626 -34.5734386413255,-58.4470208550499 -34.5735674597013,-58.4470492100506 -34.5736141784781,-58.4470497090474 -34.5736150006436,-58.4482813673933 -34.573102383968,-58.4492058039972 -34.5727157125542,-58.4502613571748 -34.5722655941198,-58.4517815313178 -34.5716171905832,-58.4519120559385 -34.5715705100398,-58.4522817472007 -34.5714382125163,-58.4529404955573 -34.571209031742,-58.4538808894 -34.5708818356816,-58.4539144294666 -34.57092493855,-58.4549843962205 -34.5706037294034,-58.4562164612105 -34.5702339259283,-58.457719768755 -34.5697760189563,-58.457898619674 -34.5701738602378,-58.4581232958341 -34.5700803246631,-58.45809102026 -34.5700210474104,-58.4579845452342 -34.5697937062932,-58.4577856754562 -34.5696007323441,-58.4577133976695 -34.569537768938,-58.4576280378218 -34.568998023694,-58.4574750402889 -34.5691092192529)))";;"1093";13_23_1;COMUNA 13;"23";"1";"1192";"536";"656";"81,71%";"681";"681";"100,00%";"0";"0,00%";"545";"5";"0.92";"540";"99,08%";"0.92";0.920
"MULTIPOLYGON (((-58.4517877665787 -34.5682050012228,-58.4509480040099 -34.5686860005392,-58.4515255553891 -34.5694237628587,-58.4523633643366 -34.5689393086082,-58.4517877665787 -34.5682050012228)))";;"1094";13_23_10;COMUNA 13;"23";"10";"562";"249";"313";"79,55%";"307";"307";"100,00%";"0";"0,00%";"243";"2";"0.82";"241";"99,18%";"0.82";0.820
"MULTIPOLYGON (((-58.450780452318 -34.5669197100658,-58.450162920885 -34.5672569164795,-58.4499299728319 -34.5673812639655,-58.4509480040099 -34.5686860005392,-58.4517877665787 -34.5682050012228,-58.450780452318 -34.5669197100658)))";;"1095";13_23_11;COMUNA 13;"23";"11";"819";"333";"486";"68,52%";"629";"629";"100,00%";"0";"0,00%";"424";"3";"0.71";"421";"99,29%";"0.71";0.710
"MULTIPOLYGON (((-58.4556764441867 -34.568056688874,-58.4547656977455 -34.5685815855101,-58.4552539026478 -34.5691582610389,-58.4553592059484 -34.5692828502875,-58.4565755237364 -34.5685828869618,-58.4556764441867 -34.568056688874)))";;"1096";13_23_2;COMUNA 13;"23";"2";"515";"241";"274";"87,96%";"329";"329";"100,00%";"0";"0,00%";"270";"4";"1.48";"266";"98,52%";"1.48";1.480
"MULTIPOLYGON (((-58.4556764441867 -34.568056688874,-58.4547869956979 -34.5675361892189,-58.453282644131 -34.5684077401541,-58.4538381667723 -34.5691172492036,-58.4547656977455 -34.5685815855101,-58.4556764441867 -34.568056688874)))";;"1097";13_23_3;COMUNA 13;"23";"3";"1099";"480";"619";"77,54%";"707";"707";"100,00%";"0";"0,00%";"538";"2";"0.37";"536";"99,63%";"0.37";0.370
"MULTIPOLYGON (((-58.4547869956979 -34.5675361892189,-58.4538757651729 -34.5670029344303,-58.45271019158 -34.5676766064486,-58.453282644131 -34.5684077401541,-58.4547869956979 -34.5675361892189)))";;"1098";13_23_4;COMUNA 13;"23";"4";"604";"250";"354";"70,62%";"413";"413";"100,00%";"0";"0,00%";"294";"0";"0";"294";"100,00%";"0";0.000
"MULTIPOLYGON (((-58.4522875199713 -34.5661082630446,-58.451718276332 -34.566409705265,-58.45271019158 -34.5676766064486,-58.4538757651729 -34.5670029344303,-58.4522875199713 -34.5661082630446)))";;"1099";13_23_5;COMUNA 13;"23";"5";"494";"226";"268";"84,33%";"348";"348";"100,00%";"0";"0,00%";"236";"1";"0.42";"235";"99,58%";"0.42";0.420
"MULTIPOLYGON (((-58.451718276332 -34.566409705265,-58.4515840956606 -34.5664807525741,-58.450780452318 -34.5669197100658,-58.4517877665787 -34.5682050012228,-58.45271019158 -34.5676766064486,-58.451718276332 -34.566409705265)))";;"1100";13_23_6;COMUNA 13;"23";"6";"762";"326";"436";"74,77%";"461";"461";"100,00%";"0";"0,00%";"368";"3";"0.82";"365";"99,18%";"0.82";0.820
"MULTIPOLYGON (((-58.45271019158 -34.5676766064486,-58.4517877665787 -34.5682050012228,-58.4523633643366 -34.5689393086082,-58.453282644131 -34.5684077401541,-58.45271019158 -34.5676766064486)))";;"1101";13_23_7;COMUNA 13;"23";"7";"529";"222";"307";"72,31%";"326";"325";"99,69%";"1";"0,31%";"257";"1";"0.39";"256";"99,61%";"0.39";0.390
"MULTIPOLYGON (((-58.453282644131 -34.5684077401541,-58.4523633643366 -34.5689393086082,-58.4529189679142 -34.5696481879552,-58.4538381667723 -34.5691172492036,-58.453282644131 -34.5684077401541)))";;"1102";13_23_8;COMUNA 13;"23";"8";"1044";"460";"584";"78,77%";"674";"674";"100,00%";"0";"0,00%";"505";"2";"0.4";"503";"99,60%";"0.4";0.400
"MULTIPOLYGON (((-58.4523633643366 -34.5689393086082,-58.4515255553891 -34.5694237628587,-58.4506398854048 -34.5699358838544,-58.4511938634097 -34.5706443482225,-58.4515897870808 -34.5704157834809,-58.4520803888543 -34.5701325050441,-58.4529189679142 -34.5696481879552,-58.4523633643366 -34.5689393086082)))";;"1103";13_23_9;COMUNA 13;"23";"9";"1024";"455";"569";"79,96%";"495";"494";"99,80%";"1";"0,20%";"429";"4";"0.93";"425";"99,07%";"0.93";0.930
"MULTIPOLYGON (((-58.4605211932026 -34.5739380404752,-58.4597982440242 -34.5742558558693,-58.4595764454157 -34.5743533897577,-58.4594020719008 -34.5744155709155,-58.459850069402 -34.5750210304602,-58.4600439312195 -34.5752831586285,-58.4601784514767 -34.5754748597476,-58.4612613136284 -34.5748861199459,-58.4623557398522 -34.5742926520032,-58.4625225333342 -34.5742021555494,-58.4617302962928 -34.5734321894167,-58.4615491148181 -34.5735079657264,-58.4605211932026 -34.5739380404752)))";;"1104";13_24_1;COMUNA 13;"24";"1";"471";"211";"260";"81,15%";"250";"250";"100,00%";"0";"0,00%";"198";"0";"0";"198";"100,00%";"0";0.000
"MULTIPOLYGON (((-58.4544257922008 -34.5715808475942,-58.4553774346234 -34.5711182828438,-58.4549843962205 -34.5706037294034,-58.4539144294666 -34.57092493855,-58.4538808894 -34.5708818356816,-58.4529404955573 -34.571209031742,-58.4522817472007 -34.5714382125163,-58.4519120559385 -34.5715705100398,-58.4524528601265 -34.572268755636,-58.4526054924697 -34.5724645513954,-58.4527139444439 -34.5726036507825,-58.4533767520434 -34.5734550776444,-58.4543188857147 -34.5729940699263,-58.4549969842387 -34.5725850125822,-58.4551442844641 -34.5725023421898,-58.4544257922008 -34.5715808475942)))";;"1105";13_24_10;COMUNA 13;"24";"10";"805";"356";"449";"79,29%";"359";"358";"99,72%";"1";"0,28%";"283";"4";"1.41";"279";"98,59%";"1.41";1.410
"MULTIPOLYGON (((-58.4608827337304 -34.5726103840278,-58.4607078535783 -34.5726896100447,-58.4595336618355 -34.5732217206761,-58.459762492781 -34.5740169011755,-58.4597982440242 -34.5742558558693,-58.4605211932026 -34.5739380404752,-58.4615491148181 -34.5735079657264,-58.4617302962928 -34.5734321894167,-58.4608827337304 -34.5726103840278)))";;"1106";13_24_2;COMUNA 13;"24";"2";"568";"231";"337";"68,55%";"356";"355";"99,72%";"1";"0,28%";"252";"0";"0";"252";"100,00%";"0";0.000
"MULTIPOLYGON (((-58.4602616525136 -34.572008305126,-58.4596794024341 -34.5714408733504,-58.4595259779209 -34.5715399582275,-58.4588003993511 -34.5720084784672,-58.4579339051305 -34.5724852287266,-58.4581738983494 -34.5727997583754,-58.4587729101959 -34.5735857282034,-58.4592900309773 -34.5742640120916,-58.4594020719008 -34.5744155709155,-58.4595764454157 -34.5743533897577,-58.4597982440242 -34.5742558558693,-58.459762492781 -34.5740169011755,-58.4595336618355 -34.5732217206761,-58.4607078535783 -34.5726896100447,-58.4608827337304 -34.5726103840278,-58.4602616525136 -34.572008305126)))";;"1107";13_24_3;COMUNA 13;"24";"3";"668";"308";"360";"85,56%";"316";"316";"100,00%";"0";"0,00%";"283";"29";"10.25";"254";"89,75%";"10.25";10.250
"MULTIPOLYGON (((-58.45809102026 -34.5700210474104,-58.4581232958341 -34.5700803246631,-58.457898619674 -34.5701738602378,-58.457719768755 -34.5697760189563,-58.4562164612105 -34.5702339259283,-58.4564809588317 -34.5705817011917,-58.4571230156716 -34.5714207120374,-58.4579873744971 -34.5709530522668,-58.458170682686 -34.5708669287317,-58.4582316331649 -34.5710301774524,-58.4588003993511 -34.5720084784672,-58.4595259779209 -34.5715399582275,-58.4596794024341 -34.5714408733504,-58.4587940806495 -34.5705805294617,-58.4579845452342 -34.5697937062932,-58.45809102026 -34.5700210474104)))";;"1108";13_24_4;COMUNA 13;"24";"4";"822";"370";"452";"81,86%";"484";"483";"99,79%";"1";"0,21%";"364";"1";"0.27";"363";"99,73%";"0.27";0.270
"MULTIPOLYGON (((-58.458170682686 -34.5708669287317,-58.4579873744971 -34.5709530522668,-58.4571230156716 -34.5714207120374,-58.4564809588317 -34.5705817011917,-58.4562164612105 -34.5702339259283,-58.4549843962205 -34.5706037294034,-58.4553774346234 -34.5711182828438,-58.4560500463418 -34.5719987817424,-58.4568605022824 -34.5730597137344,-58.4579339051305 -34.5724852287266,-58.4588003993511 -34.5720084784672,-58.4582316331649 -34.5710301774524,-58.458170682686 -34.5708669287317)))";;"1109";13_24_5;COMUNA 13;"24";"5";"726";"354";"372";"95,16%";"353";"353";"100,00%";"0";"0,00%";"286";"1";"0.35";"285";"99,65%";"0.35";0.350
"MULTIPOLYGON (((-58.4579339051305 -34.5724852287266,-58.4568605022824 -34.5730597137344,-58.4572625880146 -34.5735860223969,-58.4576654449086 -34.5741153580195,-58.4582159334403 -34.5748387201077,-58.4589222345789 -34.5757668115273,-58.4598669915775 -34.5756471841588,-58.4601784514767 -34.5754748597476,-58.4600439312195 -34.5752831586285,-58.459850069402 -34.5750210304602,-58.4594020719008 -34.5744155709155,-58.4592900309773 -34.5742640120916,-58.4587729101959 -34.5735857282034,-58.4581738983494 -34.5727997583754,-58.4579339051305 -34.5724852287266)))";;"1110";13_24_6;COMUNA 13;"24";"6";"734";"323";"411";"78,59%";"385";"384";"99,74%";"1";"0,26%";"318";"2";"0.63";"316";"99,37%";"0.63";0.630
"MULTIPOLYGON (((-58.456745114998 -34.5745553353155,-58.4559973664156 -34.5749127765235,-58.4558675187623 -34.5749745325098,-58.4562966812911 -34.5755233818675,-58.4567167399041 -34.5760605385863,-58.4578048019234 -34.5759131160478,-58.4583500660829 -34.5758392603329,-58.4589222345789 -34.5757668115273,-58.4582159334403 -34.5748387201077,-58.4576654449086 -34.5741153580195,-58.4574448356698 -34.5742208461711,-58.456745114998 -34.5745553353155)))";;"1111";13_24_7;COMUNA 13;"24";"7";"943";"443";"500";"88,60%";"402";"402";"100,00%";"0";"0,00%";"367";"18";"4.9";"349";"95,10%";"4.9";4.900
"MULTIPOLYGON (((-58.4553774346234 -34.5711182828438,-58.4544257922008 -34.5715808475942,-58.4551442844641 -34.5725023421898,-58.4559562679076 -34.5735437018916,-58.456745114998 -34.5745553353155,-58.4574448356698 -34.5742208461711,-58.4576654449086 -34.5741153580195,-58.4572625880146 -34.5735860223969,-58.4568605022824 -34.5730597137344,-58.4560500463418 -34.5719987817424,-58.4553774346234 -34.5711182828438)))";;"1112";13_24_8;COMUNA 13;"24";"8";"847";"377";"470";"80,21%";"393";"393";"100,00%";"0";"0,00%";"339";"3";"0.88";"336";"99,12%";"0.88";0.880
"MULTIPOLYGON (((-58.4549129410459 -34.5754284382594,-58.4556416027192 -34.5763642968012,-58.4567167399041 -34.5760605385863,-58.4562966812911 -34.5755233818675,-58.4558675187623 -34.5749745325098,-58.4559973664156 -34.5749127765235,-58.456745114998 -34.5745553353155,-58.4559562679076 -34.5735437018916,-58.4551442844641 -34.5725023421898,-58.4549969842387 -34.5725850125822,-58.4543188857147 -34.5729940699263,-58.4533767520434 -34.5734550776444,-58.4541841254614 -34.5744921526614,-58.4549129410459 -34.5754284382594)))";;"1113";13_24_9;COMUNA 13;"24";"9";"970";"438";"532";"82,33%";"447";"447";"100,00%";"0";"0,00%";"381";"54";"14.17";"327";"85,83%";"14.17";14.170
"MULTIPOLYGON (((-58.4625225333342 -34.5742021555494,-58.4623557398522 -34.5742926520032,-58.4612613136284 -34.5748861199459,-58.4601784514767 -34.5754748597476,-58.4608210070607 -34.576391107265,-58.4618781626544 -34.5758575752849,-58.4619753971987 -34.5758007425103,-58.4631896259131 -34.5751036718882,-58.4633555686456 -34.5750083853759,-58.4629031188665 -34.574592805933,-58.4625225333342 -34.5742021555494)))";;"1114";13_25_1;COMUNA 13;"25";"1";"591";"283";"308";"91,88%";"289";"289";"100,00%";"0";"0,00%";"262";"13";"4.96";"249";"95,04%";"4.96";4.960
"MULTIPOLYGON (((-58.4598669915775 -34.5756471841588,-58.4589222345789 -34.5757668115273,-58.4597918511082 -34.576909418804,-58.4598997312647 -34.5768560387955,-58.4599037281448 -34.5770029464849,-58.4601021605077 -34.5782955403861,-58.4602248561012 -34.5782952612339,-58.4605469730259 -34.5779429286217,-58.4616052644052 -34.5768372623986,-58.4622470884241 -34.5761666747876,-58.4623760820579 -34.5760318807683,-58.4631896259131 -34.5751036718882,-58.4619753971987 -34.5758007425103,-58.4618781626544 -34.5758575752849,-58.4608210070607 -34.576391107265,-58.4601784514767 -34.5754748597476,-58.4598669915775 -34.5756471841588)))";;"1115";13_25_2;COMUNA 13;"25";"2";"701";"310";"391";"79,28%";"348";"348";"100,00%";"0";"0,00%";"279";"2";"0.72";"277";"99,28%";"0.72";0.720
"MULTIPOLYGON (((-58.4589222345789 -34.5757668115273,-58.4583500660829 -34.5758392603329,-58.4578048019234 -34.5759131160478,-58.4567167399041 -34.5760605385863,-58.4575924611454 -34.5771804143393,-58.4586934776645 -34.5770447455067,-58.4597918511082 -34.576909418804,-58.4589222345789 -34.5757668115273)))";;"1116";13_25_3;COMUNA 13;"25";"3";"875";"418";"457";"91,47%";"477";"477";"100,00%";"0";"0,00%";"392";"2";"0.51";"390";"99,49%";"0.51";0.510
"MULTIPOLYGON (((-58.4598997312647 -34.5768560387955,-58.4597918511082 -34.576909418804,-58.4586934776645 -34.5770447455067,-58.4575924611454 -34.5771804143393,-58.4567167399041 -34.5760605385863,-58.4556416027192 -34.5763642968012,-58.4563988015657 -34.5773369144368,-58.4573407699771 -34.5785467285068,-58.4577436891683 -34.5784380085855,-58.4585384469706 -34.5783900080897,-58.4596950759365 -34.5783201095376,-58.4601021605077 -34.5782955403861,-58.4599037281448 -34.5770029464849,-58.4598997312647 -34.5768560387955)))";;"1117";13_25_4;COMUNA 13;"25";"4";"668";"311";"357";"87,11%";"319";"319";"100,00%";"0";"0,00%";"269";"2";"0.74";"267";"99,26%";"0.74";0.740
"MULTIPOLYGON (((-58.4552892532832 -34.577581369436,-58.4559709050067 -34.5789162535979,-58.4571617890572 -34.5785949619729,-58.4573407699771 -34.5785467285068,-58.4563988015657 -34.5773369144368,-58.4556416027192 -34.5763642968012,-58.4547876689869 -34.5766055926467,-58.4550563372038 -34.5771251387014,-58.4552892532832 -34.577581369436)))";;"1118";13_25_5;COMUNA 13;"25";"5";"594";"270";"324";"83,33%";"239";"239";"100,00%";"0";"0,00%";"221";"0";"0";"221";"100,00%";"0";0.000
"MULTIPOLYGON (((-58.4542417425191 -34.5780940693456,-58.4543151245507 -34.578231122408,-58.4548623485548 -34.5792426799602,-58.4553993012505 -34.5790704525436,-58.4559709050067 -34.5789162535979,-58.4552892532832 -34.577581369436,-58.4550563372038 -34.5771251387014,-58.4547876689869 -34.5766055926467,-58.4537207539464 -34.5771219490344,-58.4520100012145 -34.5779477613982,-58.452528336078 -34.5789148884484,-58.4533278223435 -34.5785295842226,-58.4542417425191 -34.5780940693456)))";;"1119";13_25_6;COMUNA 13;"25";"6";"730";"358";"372";"96,24%";"309";"308";"99,68%";"1";"0,32%";"274";"19";"6.93";"255";"93,07%";"6.93";6.930
"MULTIPOLYGON (((-58.4542417425191 -34.5780940693456,-58.4533278223435 -34.5785295842226,-58.452528336078 -34.5789148884484,-58.453020633375 -34.5798333470846,-58.453533496065 -34.5796688727825,-58.4548623485548 -34.5792426799602,-58.4543151245507 -34.578231122408,-58.4542417425191 -34.5780940693456)))";;"1120";13_25_7;COMUNA 13;"25";"7";"1156";"510";"646";"78,95%";"541";"540";"99,82%";"1";"0,19%";"504";"2";"0.4";"502";"99,60%";"0.4";0.400
"MULTIPOLYGON (((-58.4520100012145 -34.5779477613982,-58.4510879807815 -34.5783928366699,-58.4501401492095 -34.5788502971743,-58.4499824458366 -34.578926974191,-58.4504502993346 -34.5796986739631,-58.4505550064929 -34.5798660857662,-58.4509524718763 -34.5805015736322,-58.451017614008 -34.5804757337406,-58.4520223207295 -34.5801534884282,-58.4521930494186 -34.5800987826584,-58.453020633375 -34.5798333470846,-58.452528336078 -34.5789148884484,-58.4520100012145 -34.5779477613982)))";;"1121";13_25_8;COMUNA 13;"25";"8";"783";"352";"431";"81,67%";"438";"438";"100,00%";"0";"0,00%";"364";"3";"0.82";"361";"99,18%";"0.82";0.820
"MULTIPOLYGON (((-58.4532258239917 -34.5762164509039,-58.4516367753788 -34.5769029659049,-58.4514885287636 -34.5769749272408,-58.4520100012145 -34.5779477613982,-58.4537207539464 -34.5771219490344,-58.4547876689869 -34.5766055926467,-58.4556416027192 -34.5763642968012,-58.4549129410459 -34.5754284382594,-58.4541841254614 -34.5744921526614,-58.452668921552 -34.575302987472,-58.4532258239917 -34.5762164509039)))";;"1122";13_26_1;COMUNA 13;"26";"1";"853";"413";"440";"93,86%";"450";"449";"99,78%";"1";"0,22%";"316";"28";"8.86";"288";"91,14%";"8.86";8.860
"MULTIPOLYGON (((-58.4492058039972 -34.5727157125542,-58.4482813673933 -34.573102383968,-58.4488986163359 -34.5742669416067,-58.4495410776007 -34.5754776977647,-58.4504508977528 -34.5750388301851,-58.4498010196354 -34.5738262468799,-58.4492058039972 -34.5727157125542)))";;"1123";13_26_10;COMUNA 13;"26";"10";"938";"420";"518";"81,08%";"531";"531";"100,00%";"0";"0,00%";"436";"1";"0.23";"435";"99,77%";"0.23";0.230
"MULTIPOLYGON (((-58.4477279812018 -34.5748387293529,-58.4483722192742 -34.576041533683,-58.4495410776007 -34.5754776977647,-58.4488986163359 -34.5742669416067,-58.4482813673933 -34.573102383968,-58.4470497090474 -34.5736150006436,-58.4472448786461 -34.5739367997933,-58.4477279812018 -34.5748387293529)))";;"1124";13_26_11;COMUNA 13;"26";"11";"645";"292";"353";"82,72%";"365";"365";"100,00%";"0";"0,00%";"281";"16";"5.69";"265";"94,31%";"5.69";5.690
"MULTIPOLYGON (((-58.4519523362339 -34.5741437927246,-58.4524921148211 -34.5750128900872,-58.452668921552 -34.575302987472,-58.4541841254614 -34.5744921526614,-58.4533767520434 -34.5734550776444,-58.4527139444439 -34.5726036507825,-58.4526054924697 -34.5724645513954,-58.4513022503696 -34.573096998952,-58.4519523362339 -34.5741437927246)))";;"1125";13_26_2;COMUNA 13;"26";"2";"811";"351";"460";"76,30%";"377";"376";"99,73%";"1";"0,27%";"325";"22";"6.77";"303";"93,23%";"6.77";6.770
"MULTIPOLYGON (((-58.4502613571748 -34.5722655941198,-58.4492058039972 -34.5727157125542,-58.4498010196354 -34.5738262468799,-58.450028875395 -34.5737149279698,-58.4508432244971 -34.5733197112258,-58.4513022503696 -34.573096998952,-58.4526054924697 -34.5724645513954,-58.4524528601265 -34.572268755636,-58.4519120559385 -34.5715705100398,-58.4517815313178 -34.5716171905832,-58.4502613571748 -34.5722655941198)))";;"1126";13_26_3;COMUNA 13;"26";"3";"771";"343";"428";"80,14%";"326";"325";"99,69%";"1";"0,31%";"288";"17";"5.9";"271";"94,10%";"5.9";5.900
"MULTIPOLYGON (((-58.4513022503696 -34.573096998952,-58.4508432244971 -34.5733197112258,-58.450028875395 -34.5737149279698,-58.4498010196354 -34.5738262468799,-58.4504508977528 -34.5750388301851,-58.450606890283 -34.5749636312798,-58.4519523362339 -34.5741437927246,-58.4513022503696 -34.573096998952)))";;"1127";13_26_4;COMUNA 13;"26";"4";"967";"445";"522";"85,25%";"469";"467";"99,57%";"2";"0,43%";"419";"24";"5.73";"395";"94,27%";"5.73";5.730
"MULTIPOLYGON (((-58.4519523362339 -34.5741437927246,-58.450606890283 -34.5749636312798,-58.4504508977528 -34.5750388301851,-58.4509743038141 -34.5760154018198,-58.4514885287636 -34.5769749272408,-58.4516367753788 -34.5769029659049,-58.4532258239917 -34.5762164509039,-58.452668921552 -34.575302987472,-58.4524921148211 -34.5750128900872,-58.4519523362339 -34.5741437927246)))";;"1128";13_26_5;COMUNA 13;"26";"5";"751";"346";"405";"85,43%";"376";"374";"99,47%";"2";"0,53%";"317";"31";"9.78";"286";"90,22%";"9.78";9.780
"MULTIPOLYGON (((-58.4505717101656 -34.5774199287367,-58.4510879807815 -34.5783928366699,-58.4520100012145 -34.5779477613982,-58.4514885287636 -34.5769749272408,-58.4509743038141 -34.5760154018198,-58.4500597926973 -34.5764551882755,-58.4505717101656 -34.5774199287367)))";;"1129";13_26_6;COMUNA 13;"26";"6";"785";"329";"456";"72,15%";"303";"301";"99,34%";"2";"0,66%";"265";"5";"1.89";"260";"98,11%";"1.89";1.890
"MULTIPOLYGON (((-58.4505717101656 -34.5774199287367,-58.4496852811054 -34.577850207629,-58.4494125382497 -34.5779836345463,-58.4499824458366 -34.578926974191,-58.4501401492095 -34.5788502971743,-58.4510879807815 -34.5783928366699,-58.4505717101656 -34.5774199287367)))";;"1130";13_26_7;COMUNA 13;"26";"7";"491";"216";"275";"78,55%";"237";"236";"99,58%";"1";"0,42%";"189";"1";"0.53";"188";"99,47%";"0.53";0.530
"MULTIPOLYGON (((-58.4500597926973 -34.5764551882755,-58.4488940750816 -34.5770157898517,-58.4494125382497 -34.5779836345463,-58.4496852811054 -34.577850207629,-58.4505717101656 -34.5774199287367,-58.4500597926973 -34.5764551882755)))";;"1131";13_26_8;COMUNA 13;"26";"8";"467";"214";"253";"84,58%";"274";"274";"100,00%";"0";"0,00%";"214";"16";"7.48";"198";"92,52%";"7.48";7.480
"MULTIPOLYGON (((-58.4495410776007 -34.5754776977647,-58.4483722192742 -34.576041533683,-58.4488940750816 -34.5770157898517,-58.4500597926973 -34.5764551882755,-58.4509743038141 -34.5760154018198,-58.4504508977528 -34.5750388301851,-58.4495410776007 -34.5754776977647)))";;"1132";13_26_9;COMUNA 13;"26";"9";"515";"237";"278";"85,25%";"273";"272";"99,63%";"1";"0,37%";"202";"18";"8.91";"184";"91,09%";"8.91";8.910
"MULTIPOLYGON (((-58.4509480040099 -34.5686860005392,-58.4505378680533 -34.568920900153,-58.4500593592124 -34.5691935394356,-58.4506398854048 -34.5699358838544,-58.4515255553891 -34.5694237628587,-58.4509480040099 -34.5686860005392)))";;"1133";13_27_1;COMUNA 13;"27";"1";"422";"183";"239";"76,57%";"215";"215";"100,00%";"0";"0,00%";"175";"2";"1.14";"173";"98,86%";"1.14";1.140
"MULTIPOLYGON (((-58.4499299728319 -34.5673812639655,-58.449044406335 -34.5678537943786,-58.4500593592124 -34.5691935394356,-58.4505378680533 -34.568920900153,-58.4509480040099 -34.5686860005392,-58.4499299728319 -34.5673812639655)))";;"1134";13_27_2;COMUNA 13;"27";"2";"856";"359";"497";"72,23%";"555";"555";"100,00%";"0";"0,00%";"399";"4";"1";"395";"99,00%";"1";1.000
"MULTIPOLYGON (((-58.449044406335 -34.5678537943786,-58.4486427010004 -34.5680681947491,-58.4481332034997 -34.5683285688924,-58.4492152347499 -34.5696745263,-58.4500593592124 -34.5691935394356,-58.449044406335 -34.5678537943786)))";;"1135";13_27_3;COMUNA 13;"27";"3";"1043";"417";"626";"66,61%";"598";"597";"99,83%";"1";"0,17%";"440";"5";"1.14";"435";"98,86%";"1.14";1.140
"MULTIPOLYGON (((-58.4497966069864 -34.5704244807258,-58.4488631480258 -34.5709667258274,-58.4493949976278 -34.5715742758964,-58.4501750129097 -34.5712122301649,-58.4503407910695 -34.5711264687201,-58.4505129547774 -34.5710373976848,-58.4511938634097 -34.5706443482225,-58.4506398854048 -34.5699358838544,-58.4500593592124 -34.5691935394356,-58.4492152347499 -34.5696745263,-58.4497966069864 -34.5704244807258)))";;"1136";13_27_4;COMUNA 13;"27";"4";"852";"381";"471";"80,89%";"547";"546";"99,82%";"1";"0,18%";"387";"15";"3.88";"372";"96,12%";"3.88";3.880
"MULTIPOLYGON (((-58.4492152347499 -34.5696745263,-58.4482256707772 -34.5702383810361,-58.4488631480258 -34.5709667258274,-58.4497966069864 -34.5704244807258,-58.4492152347499 -34.5696745263)))";;"1137";13_27_5;COMUNA 13;"27";"5";"616";"262";"354";"74,01%";"393";"393";"100,00%";"0";"0,00%";"311";"1";"0.32";"310";"99,68%";"0.32";0.320
"MULTIPOLYGON (((-58.4481332034997 -34.5683285688924,-58.4470421665835 -34.5688861341314,-58.4482256707772 -34.5702383810361,-58.4492152347499 -34.5696745263,-58.4481332034997 -34.5683285688924)))";;"1138";13_27_6;COMUNA 13;"27";"6";"1120";"473";"647";"73,11%";"714";"713";"99,86%";"1";"0,14%";"529";"53";"10.02";"476";"89,98%";"10.02";10.020
"MULTIPOLYGON (((-58.4481992548981 -34.5713523696045,-58.4486400939872 -34.5719232203623,-58.4487816919217 -34.5718589380536,-58.4493949976278 -34.5715742758964,-58.4488631480258 -34.5709667258274,-58.4482256707772 -34.5702383810361,-58.4470421665835 -34.5688861341314,-58.4466911142143 -34.5690656034352,-58.4464968988467 -34.5691609340617,-58.4466408320003 -34.5693337070541,-58.4476100602202 -34.5705891667114,-58.4481992548981 -34.5713523696045)))";;"1139";13_27_7;COMUNA 13;"27";"7";"1058";"466";"592";"78,72%";"699";"697";"99,71%";"2";"0,29%";"497";"53";"10.66";"444";"89,34%";"10.66";10.660
"MULTIPOLYGON (((-58.4476100602202 -34.5705891667114,-58.4466976187984 -34.5711090729277,-58.4472304384658 -34.571915091768,-58.447560093869 -34.5724137460399,-58.4486400939872 -34.5719232203623,-58.4481992548981 -34.5713523696045,-58.4476100602202 -34.5705891667114)))";;"1140";13_27_8;COMUNA 13;"27";"8";"814";"371";"443";"83,75%";"433";"433";"100,00%";"0";"0,00%";"368";"22";"5.98";"346";"94,02%";"5.98";5.980
"MULTIPOLYGON (((-58.4464968988467 -34.5691609340617,-58.4457049621247 -34.5695497869019,-58.4466976187984 -34.5711090729277,-58.4476100602202 -34.5705891667114,-58.4466408320003 -34.5693337070541,-58.4464968988467 -34.5691609340617)))";;"1141";13_27_9;COMUNA 13;"27";"9";"868";"371";"497";"74,65%";"536";"536";"100,00%";"0";"0,00%";"407";"0";"0";"407";"100,00%";"0";0.000
"MULTIPOLYGON (((-58.447560093869 -34.5724137460399,-58.4472304384658 -34.571915091768,-58.4466976187984 -34.5711090729277,-58.4458296138741 -34.5716036252245,-58.4463323693773 -34.5724324616393,-58.4465886449045 -34.5728549081875,-58.447560093869 -34.5724137460399)))";;"1142";13_28_1;COMUNA 13;"28";"1";"527";"239";"288";"82,99%";"358";"358";"100,00%";"0";"0,00%";"268";"80";"29.85";"188";"70,15%";"29.85";29.850
"MULTIPOLYGON (((-58.4419438949339 -34.5714452730906,-58.4414106786584 -34.571739137556,-58.4407445362326 -34.57210621842,-58.4417030525011 -34.5730740341266,-58.4426113937862 -34.5724743725956,-58.4427922598022 -34.5723559464469,-58.4419438949339 -34.5714452730906)))";;"1143";13_28_10;COMUNA 13;"28";"10";"624";"280";"344";"81,40%";"358";"358";"100,00%";"0";"0,00%";"273";"0";"0";"273";"100,00%";"0";0.000
"MULTIPOLYGON (((-58.4457049621247 -34.5695497869019,-58.4448856859876 -34.5699520818779,-58.4453737644629 -34.5708479654638,-58.4456985433295 -34.5713874709837,-58.4458296138741 -34.5716036252245,-58.4466976187984 -34.5711090729277,-58.4457049621247 -34.5695497869019)))";;"1144";13_28_2;COMUNA 13;"28";"2";"441";"193";"248";"77,82%";"274";"273";"99,64%";"1";"0,37%";"213";"16";"7.51";"197";"92,49%";"7.51";7.510
"MULTIPOLYGON (((-58.4443493597639 -34.5713162162198,-58.4448943168677 -34.5721983066512,-58.4458296138741 -34.5716036252245,-58.4456985433295 -34.5713874709837,-58.4453737644629 -34.5708479654638,-58.4448856859876 -34.5699520818779,-58.4441105934294 -34.5703326869862,-58.4438275632544 -34.5704716636445,-58.4443493597639 -34.5713162162198)))";;"1145";13_28_3;COMUNA 13;"28";"3";"667";"303";"364";"83,24%";"379";"379";"100,00%";"0";"0,00%";"318";"19";"5.97";"299";"94,03%";"5.97";5.970
"MULTIPOLYGON (((-58.4458296138741 -34.5716036252245,-58.4448943168677 -34.5721983066512,-58.4454116240149 -34.5730354591128,-58.4463323693773 -34.5724324616393,-58.4458296138741 -34.5716036252245)))";;"1146";13_28_4;COMUNA 13;"28";"4";"389";"170";"219";"77,63%";"272";"272";"100,00%";"0";"0,00%";"201";"16";"7.96";"185";"92,04%";"7.96";7.960
"MULTIPOLYGON (((-58.4434465008786 -34.5748340444229,-58.4436582732886 -34.5750477166321,-58.4436582018152 -34.5750477486714,-58.4436828024297 -34.5750726127161,-58.4439717118523 -34.5753642894674,-58.4443207629542 -34.5751401076674,-58.4450016568791 -34.5747100491903,-58.4451222346674 -34.5746338661934,-58.4460230715047 -34.5740562215379,-58.4460224244267 -34.5740551314462,-58.4470492100506 -34.5736141784781,-58.4470208550499 -34.5735674597013,-58.446942719626 -34.5734386413255,-58.4469146317943 -34.5733922976898,-58.4465886449045 -34.5728549081875,-58.4463323693773 -34.5724324616393,-58.4454116240149 -34.5730354591128,-58.4431391235986 -34.5745237711061,-58.4434465008786 -34.5748340444229)))";;"1147";13_28_5;COMUNA 13;"28";"5";"548";"226";"322";"70,19%";"280";"279";"99,64%";"1";"0,36%";"217";"8";"3.69";"209";"96,31%";"3.69";3.690
"MULTIPOLYGON (((-58.4454116240149 -34.5730354591128,-58.4448943168677 -34.5721983066512,-58.4434909171033 -34.5731058792154,-58.4425745736597 -34.5736985033563,-58.4424204434276 -34.5737982004077,-58.4431391235986 -34.5745237711061,-58.4454116240149 -34.5730354591128)))";;"1148";13_28_6;COMUNA 13;"28";"6";"823";"374";"449";"83,30%";"461";"461";"100,00%";"0";"0,00%";"356";"5";"1.4";"351";"98,60%";"1.4";1.400
"MULTIPOLYGON (((-58.4427922598022 -34.5723559464469,-58.4426113937862 -34.5724743725956,-58.4417030525011 -34.5730740341266,-58.4424204434276 -34.5737982004077,-58.4425745736597 -34.5736985033563,-58.4434909171033 -34.5731058792154,-58.4427922598022 -34.5723559464469)))";;"1149";13_28_7;COMUNA 13;"28";"7";"693";"307";"386";"79,53%";"401";"401";"100,00%";"0";"0,00%";"329";"1";"0.3";"328";"99,70%";"0.3";0.300
"MULTIPOLYGON (((-58.4443493597639 -34.5713162162198,-58.4433384311635 -34.5719984133276,-58.4427922598022 -34.5723559464469,-58.4434909171033 -34.5731058792154,-58.4448943168677 -34.5721983066512,-58.4443493597639 -34.5713162162198)))";;"1150";13_28_8;COMUNA 13;"28";"8";"936";"379";"557";"68,04%";"577";"577";"100,00%";"0";"0,00%";"451";"1";"0.22";"450";"99,78%";"0.22";0.220
"MULTIPOLYGON (((-58.4425441175957 -34.5711271205427,-58.44220343416 -34.5713022826238,-58.4419438949339 -34.5714452730906,-58.4427922598022 -34.5723559464469,-58.4433384311635 -34.5719984133276,-58.4443493597639 -34.5713162162198,-58.4438275632544 -34.5704716636445,-58.4436397274429 -34.5705638215375,-58.4429562396002 -34.5709152773591,-58.4425441175957 -34.5711271205427)))";;"1151";13_28_9;COMUNA 13;"28";"9";"770";"341";"429";"79,49%";"582";"582";"100,00%";"0";"0,00%";"393";"6";"1.53";"387";"98,47%";"1.53";1.530
"MULTIPOLYGON (((-58.4479771665693 -34.5774068963402,-58.4472385584979 -34.5777219590995,-58.4477359128922 -34.5785649437468,-58.4478574682537 -34.5787546144106,-58.4479304187375 -34.5788685716861,-58.4484692620963 -34.5796629646278,-58.4490877102878 -34.5805746223837,-58.4494416747398 -34.5810963731292,-58.4495954627069 -34.5810397676731,-58.4499990078592 -34.5808797332743,-58.4509524718763 -34.5805015736322,-58.4505550064929 -34.5798660857662,-58.4496602065665 -34.5802981945296,-58.4491088558413 -34.5793518977896,-58.4485575176102 -34.5784055984152,-58.4484493284236 -34.5782198738262,-58.4479771665693 -34.5774068963402)))";;"1152";13_29_1;COMUNA 13;"29";"1";"698";"303";"395";"76,71%";"314";"313";"99,68%";"1";"0,32%";"274";"43";"15.69";"231";"84,31%";"15.69";15.690
"MULTIPOLYGON (((-58.4464113900474 -34.5806717633927,-58.4459536697234 -34.5809051618382,-58.4452900057838 -34.5813816380123,-58.4451695854914 -34.5814731034342,-58.4455517632145 -34.5821692428236,-58.4459808963203 -34.5818605572229,-58.4462142005584 -34.5818916465798,-58.4467905849097 -34.5814168442851,-58.4464848500428 -34.5807912851754,-58.4464113900474 -34.5806717633927)))";;"1153";13_29_10;COMUNA 13;"29";"10";"786";"384";"402";"95,52%";"292";"292";"100,00%";"0";"0,00%";"258";"2";"0.78";"256";"99,22%";"0.78";0.780
"MULTIPOLYGON (((-58.4429191824247 -34.5760402788061,-58.4427279199831 -34.5761631401763,-58.4418782017236 -34.5767719675341,-58.4418141615156 -34.5768178740203,-58.4408885540874 -34.5777964152476,-58.4399388906297 -34.5785469071055,-58.4405331508016 -34.5790998564832,-58.4415432664226 -34.5800397932262,-58.4422825227001 -34.5807276941797,-58.4425093927139 -34.5809387970112,-58.4434316971011 -34.5817970097772,-58.4437796861044 -34.5822515195962,-58.4444485951796 -34.5831708142256,-58.4457860098013 -34.582595983241,-58.4455517632145 -34.5821692428236,-58.4451695854914 -34.5814731034342,-58.4452900057838 -34.5813816380123,-58.4459536697234 -34.5809051618382,-58.4464113900474 -34.5806717633927,-58.4459467157516 -34.5799157535818,-58.4463861426742 -34.5795865036153,-58.4455048802611 -34.5786928946346,-58.445383146298 -34.5785694919806,-58.4446159847972 -34.5777475857218,-58.4445229387885 -34.5776643993945,-58.4443856260351 -34.5775416272337,-58.4436941513437 -34.5768336748419,-58.4429191824247 -34.5760402788061)))";;"1154";13_29_11;COMUNA 13;"29";"11";"790";"392";"398";"98,49%";"508";"508";"100,00%";"0";"0,00%";"327";"3";"0.92";"324";"99,08%";"0.92";0.920
"MULTIPOLYGON (((-58.4491088558413 -34.5793518977896,-58.4496602065665 -34.5802981945296,-58.4505550064929 -34.5798660857662,-58.4504502993346 -34.5796986739631,-58.4499824458366 -34.578926974191,-58.4494125382497 -34.5779836345463,-58.4489952050763 -34.5781878223169,-58.4485575176102 -34.5784055984152,-58.4491088558413 -34.5793518977896)))";;"1155";13_29_2;COMUNA 13;"29";"2";"634";"301";"333";"90,39%";"341";"341";"100,00%";"0";"0,00%";"281";"37";"13.17";"244";"86,83%";"13.17";13.170
"MULTIPOLYGON (((-58.4483722192742 -34.576041533683,-58.4474178534926 -34.5764438997121,-58.4479771665693 -34.5774068963402,-58.4484493284236 -34.5782198738262,-58.4485575176102 -34.5784055984152,-58.4489952050763 -34.5781878223169,-58.4494125382497 -34.5779836345463,-58.4488940750816 -34.5770157898517,-58.4483722192742 -34.576041533683)))";;"1156";13_29_3;COMUNA 13;"29";"3";"542";"249";"293";"84,98%";"315";"315";"100,00%";"0";"0,00%";"247";"4";"1.62";"243";"98,38%";"1.62";1.620
"MULTIPOLYGON (((-58.446733774393 -34.575265875004,-58.4458812484233 -34.5756321844845,-58.4462074504788 -34.5759741448677,-58.4466704819274 -34.5767590284125,-58.4472385584979 -34.5777219590995,-58.4479771665693 -34.5774068963402,-58.4474178534926 -34.5764438997121,-58.4483722192742 -34.576041533683,-58.4477279812018 -34.5748387293529,-58.446733774393 -34.575265875004)))";;"1157";13_29_4;COMUNA 13;"29";"4";"844";"396";"448";"88,39%";"440";"439";"99,77%";"1";"0,23%";"382";"24";"6.28";"358";"93,72%";"6.28";6.280
"MULTIPOLYGON (((-58.4460230715047 -34.5740562215379,-58.4451222346674 -34.5746338661934,-58.4450016568791 -34.5747100491903,-58.4458812484233 -34.5756321844845,-58.446733774393 -34.575265875004,-58.4477279812018 -34.5748387293529,-58.4472448786461 -34.5739367997933,-58.4470497090474 -34.5736150006436,-58.4470492100506 -34.5736141784781,-58.4460224244267 -34.5740551314462,-58.4460230715047 -34.5740562215379)))";;"1158";13_29_5;COMUNA 13;"29";"5";"575";"257";"318";"80,82%";"347";"346";"99,71%";"1";"0,29%";"280";"24";"8.57";"256";"91,43%";"8.57";8.570
"MULTIPOLYGON (((-58.4450016568791 -34.5747100491903,-58.4443207629542 -34.5751401076674,-58.4439717118523 -34.5753642894674,-58.4429191824247 -34.5760402788061,-58.4436941513437 -34.5768336748419,-58.4438500762869 -34.5767224971527,-58.4447279592909 -34.5761276748869,-58.4457413899826 -34.5771506799245,-58.4466704819274 -34.5767590284125,-58.4462074504788 -34.5759741448677,-58.4458812484233 -34.5756321844845,-58.4450016568791 -34.5747100491903)))";;"1159";13_29_6;COMUNA 13;"29";"6";"763";"338";"425";"79,53%";"418";"418";"100,00%";"0";"0,00%";"330";"2";"0.61";"328";"99,39%";"0.61";0.610
"MULTIPOLYGON (((-58.4474832510722 -34.5801444854523,-58.4481003305024 -34.5810514294623,-58.448393424506 -34.5814822566561,-58.4484595897346 -34.5814578971885,-58.4491920030256 -34.5811882509685,-58.4494416747398 -34.5810963731292,-58.4490877102878 -34.5805746223837,-58.4484692620963 -34.5796629646278,-58.4479304187375 -34.5788685716861,-58.4478574682537 -34.5787546144106,-58.4477359128922 -34.5785649437468,-58.4472385584979 -34.5777219590995,-58.4466704819274 -34.5767590284125,-58.4457413899826 -34.5771506799245,-58.4462820416428 -34.5781129069319,-58.446819120226 -34.5791243583376,-58.4468850020862 -34.5792400055224,-58.4469656948607 -34.5793815711537,-58.4474210246225 -34.5800529245743,-58.4474832510722 -34.5801444854523)))";;"1160";13_29_7;COMUNA 13;"29";"7";"888";"399";"489";"81,60%";"432";"432";"100,00%";"0";"0,00%";"355";"20";"5.63";"335";"94,37%";"5.63";5.630
"MULTIPOLYGON (((-58.4464113900474 -34.5806717633927,-58.4464848500428 -34.5807912851754,-58.4467905849097 -34.5814168442851,-58.4470924940961 -34.5820344440013,-58.4482796576898 -34.5815241464096,-58.448393424506 -34.5814822566561,-58.4481003305024 -34.5810514294623,-58.4474832510722 -34.5801444854523,-58.4474210246225 -34.5800529245743,-58.4469656948607 -34.5793815711537,-58.4468850020862 -34.5792400055224,-58.446819120226 -34.5791243583376,-58.4462820416428 -34.5781129069319,-58.4457413899826 -34.5771506799245,-58.4447279592909 -34.5761276748869,-58.4438500762869 -34.5767224971527,-58.4436941513437 -34.5768336748419,-58.4443856260351 -34.5775416272337,-58.4445229387885 -34.5776643993945,-58.4446159847972 -34.5777475857218,-58.445383146298 -34.5785694919806,-58.4455048802611 -34.5786928946346,-58.4463861426742 -34.5795865036153,-58.4459467157516 -34.5799157535818,-58.4464113900474 -34.5806717633927)))";;"1161";13_29_8;COMUNA 13;"29";"8";"1103";"517";"586";"88,23%";"501";"501";"100,00%";"0";"0,00%";"420";"6";"1.43";"414";"98,57%";"1.43";1.430
"MULTIPOLYGON (((-58.4470924940961 -34.5820344440013,-58.4467905849097 -34.5814168442851,-58.4462142005584 -34.5818916465798,-58.4459808963203 -34.5818605572229,-58.4455517632145 -34.5821692428236,-58.4457860098013 -34.582595983241,-58.4470924940961 -34.5820344440013)))";;"1162";13_29_9;COMUNA 13;"29";"9";"571";"276";"295";"93,56%";"227";"227";"100,00%";"0";"0,00%";"208";"1";"0.48";"207";"99,52%";"0.48";0.480
"MULTIPOLYGON (((-58.4632541446137 -34.5464761221332,-58.4623721128808 -34.5460370881608,-58.4617863546341 -34.5468348692621,-58.4612171830157 -34.547609900105,-58.4621567630299 -34.5480802116475,-58.4616104823021 -34.5488786960653,-58.4620273795947 -34.5490871595156,-58.4621608930599 -34.5491540271757,-58.4623234988048 -34.5492341394804,-58.4623943156202 -34.5492707611056,-58.4627987897615 -34.5494688692816,-58.4633669379787 -34.5486934087531,-58.4634252417275 -34.5486134046791,-58.463900603825 -34.5479054100274,-58.4644570692908 -34.5470712091861,-58.4639394001786 -34.5468150767265,-58.4637242305246 -34.5467086652605,-58.4632541446137 -34.5464761221332)))";;"1163";13_3_1;COMUNA 13;"3";"1";"833";"375";"458";"81,88%";"494";"494";"100,00%";"0";"0,00%";"377";"0";"0";"377";"100,00%";"0";0.000
"MULTIPOLYGON (((-58.4540229057031 -34.5495186337659,-58.4533932371538 -34.550052767206,-58.4530063264263 -34.550504025691,-58.454277920049 -34.5511648549091,-58.4543621966981 -34.551071194379,-58.4552466583953 -34.5501564907781,-58.4561534030755 -34.5492186821591,-58.4560193500947 -34.5491495871664,-58.4550404722384 -34.5486441539594,-58.4546895101493 -34.5489481597344,-58.4544072404614 -34.5491926593503,-58.4541574870459 -34.5494045534285,-58.4540229057031 -34.5495186337659)))";;"1164";13_3_10;COMUNA 13;"3";"10";"972";"454";"518";"87,64%";"641";"641";"100,00%";"0";"0,00%";"448";"2";"0.45";"446";"99,55%";"0.45";0.450
"MULTIPOLYGON (((-58.4631809702139 -34.5415841550674,-58.4631820708388 -34.5415827889332,-58.4633637692783 -34.5413693194001,-58.4633644360374 -34.5413683469269,-58.463824073494 -34.5406979558645,-58.4643295129948 -34.5398802347462,-58.4648352830245 -34.539062088865,-58.465133055498 -34.5385802994239,-58.4653088749573 -34.5382957749695,-58.4658079029507 -34.5374880480337,-58.4663030068027 -34.536686586979,-58.4665979541656 -34.5362093011244,-58.4667598918545 -34.5359244227831,-58.466806949734 -34.5358416002617,-58.4668071241279 -34.5358414998678,-58.4671522871315 -34.535256831378,-58.467387044116 -34.5348473411111,-58.4660841020972 -34.5342718102616,-58.4637956351483 -34.5332609039391,-58.4616482459405 -34.5308000078819,-58.4588984562068 -34.5276201465165,-58.4588401663277 -34.5276228913051,-58.4587633261278 -34.5276194379751,-58.4587320966029 -34.527615915661,-58.4586729553353 -34.5276278157314,-58.4585596925654 -34.5276670392662,-58.4585037842169 -34.5276911935005,-58.4584440463558 -34.5277197139921,-58.4583890742339 -34.5277389383814,-58.4583419314567 -34.5277454863329,-58.4582911303439 -34.5277379489202,-58.4582457763659 -34.527710340255,-58.4581807659665 -34.5276753361097,-58.4581534511137 -34.5276659684286,-58.4581000135828 -34.5276320914874,-58.4580288763592 -34.5275996223685,-58.4579630140952 -34.5275839852439,-58.4578841318252 -34.5275783480733,-58.4578083983212 -34.5275682741354,-58.4577675530224 -34.5275674273799,-58.4576978607945 -34.527564959633,-58.4576415284665 -34.5275614360094,-58.457560943074 -34.5275765742508,-58.4574677641905 -34.5275833311976,-58.4573682029354 -34.5275943133592,-58.457292298334 -34.5275990285689,-58.4572361354992 -34.5276060686765,-58.4571726558382 -34.5275932482752,-58.457112664859 -34.5275835971738,-58.457022124578 -34.5275797899905,-58.4569391586115 -34.5275629542742,-58.4568683603703 -34.5275578098111,-58.456803263829 -34.5275475244791,-58.4567486331238 -34.5275484373683,-58.4566816634982 -34.5275524483729,-58.4565964831989 -34.5275626559264,-58.4565301079538 -34.5275837804131,-58.4564791353164 -34.5275977221898,-58.4564359064637 -34.5276089881519,-58.4563648511871 -34.5276268727092,-58.4563096236877 -34.5276418705853,-58.4562478440443 -34.5276548257344,-58.4561885317245 -34.527672922087,-58.4561442805494 -34.5276983435314,-58.4560920311361 -34.5277151021205,-58.4560544161621 -34.5277547499572,-58.4559980769376 -34.5278365819715,-58.4559729712572 -34.5278705259564,-58.4559571416635 -34.5278948925033,-58.4559391840751 -34.5279268649455,-58.4559298218359 -34.5279491894904,-58.4559241186548 -34.5279717255157,-58.455915180082 -34.528016234294,-58.4559044563815 -34.5280376432221,-58.4558891361594 -34.528076095001,-58.4558844538004 -34.5281022932364,-58.4558812181864 -34.5281268717528,-58.4558799385972 -34.5281656764434,-58.45588053211 -34.5281920862509,-58.4558845288319 -34.528225820559,-58.4558887811695 -34.5282555405953,-58.4559050292797 -34.5283179389928,-58.4559225555611 -34.5283591392136,-58.4559369336403 -34.5283965362499,-58.4559430579151 -34.5284285804472,-58.4559588806961 -34.5284900632735,-58.4559737693244 -34.5285282350195,-58.4559763204843 -34.5285494334043,-58.4559708726065 -34.5285714060352,-58.4559495956353 -34.5286097870639,-58.4559143620793 -34.5286591537795,-58.4558917250716 -34.5286785901121,-58.4558715563957 -34.5286910543986,-58.4558347925862 -34.5287215468212,-58.4558173468541 -34.5287352084947,-58.4557872214007 -34.5287544331074,-58.4557685846702 -34.5287637987169,-58.4557438211094 -34.5287723892881,-58.455715738905 -34.5287798528477,-58.455684166454 -34.5288030212112,-58.4556638277034 -34.5288133726717,-58.4556398298719 -34.5288232309349,-58.45561149233 -34.5288309761599,-58.4555803464546 -34.5288406931442,-58.4555370307599 -34.528863438228,-58.4555098841183 -34.5288760428972,-58.4554651219459 -34.5288966046624,-58.455432359043 -34.5289082230166,-58.4554118503936 -34.5289145601396,-58.4553900650634 -34.528923643799,-58.4553559406118 -34.5289351916251,-58.4553325384175 -34.5289446273072,-58.4553073493599 -34.5289523022253,-58.4552756078078 -34.528961173983,-58.4551982523385 -34.5289980020834,-58.4551768074991 -34.5290053955002,-58.4551488950144 -34.5290166619465,-58.455122769193 -34.5290317315043,-58.4550991114015 -34.5290439841679,-58.4550553698041 -34.5290687714092,-58.4550300949484 -34.529083418444,-58.4549904373552 -34.529114332985,-58.4549604815981 -34.5291353884806,-58.4549392060061 -34.5291523598095,-58.4549102702739 -34.5291852469345,-58.4548855902215 -34.5292085563815,-58.4548668671771 -34.5292287674594,-58.4548482291538 -34.5292496828003,-58.4548229535508 -34.5292713019709,-58.4548084008303 -34.5292847524074,-58.4547638915978 -34.5293259487638,-58.4546351293817 -34.5294459463202,-58.4545810878591 -34.5295007342067,-58.4545120681725 -34.5295668596594,-58.454458280983 -34.5296297465031,-58.4544029635658 -34.5296765760796,-58.4543339449596 -34.5297290387767,-58.4542888412655 -34.5297534735171,-58.4542338651705 -34.5297893165764,-58.4541748045484 -34.5298235395266,-58.4540990643106 -34.5298635362103,-58.4540567674484 -34.5298998026376,-58.4540314044354 -34.5299398732596,-58.4540211877161 -34.5299889594869,-58.4539891022251 -34.5300268464143,-58.4539713973583 -34.530071847392,-58.4539383753764 -34.5301132555407,-58.4539049301421 -34.5301331132808,-58.453917266831 -34.5301558617802,-58.4539159856489 -34.5302008639288,-58.4538845788174 -34.5302576250552,-58.4538570028317 -34.5303000899642,-58.4538252555188 -34.5303569919019,-58.4538041465547 -34.5304024151617,-58.4537815904913 -34.53045178217,-58.4537438841582 -34.5305281916622,-58.4537207357066 -34.5305462190282,-58.4536933262648 -34.5306209390354,-58.4536674509196 -34.5306735453737,-58.4536303424715 -34.5307277706712,-58.4536029364891 -34.5307693904198,-58.453594507835 -34.5308059409038,-58.45357527103 -34.5308491106271,-58.4535625872325 -34.5308877735714,-58.4535648792447 -34.5309393255992,-58.4535657243022 -34.5309935537076,-58.4535709879014 -34.5311078555507,-58.4535745566272 -34.531157294891,-58.4535718279384 -34.5312081422809,-58.453570035519 -34.5312572290896,-58.4535641588339 -34.5313021604567,-58.4535703649663 -34.5313575157792,-58.4535838062504 -34.5313965328027,-58.4535998011658 -34.5314294229504,-58.4536286452628 -34.5314687228193,-58.453653660275 -34.5315050645045,-58.4536941641717 -34.5315327449263,-58.4537493021798 -34.5315871882976,-58.45377312735 -34.5316099376476,-58.4538467300618 -34.5316814254204,-58.4539000813572 -34.5317343192203,-58.4539417743217 -34.5317859444926,-58.4539752996434 -34.5318203852174,-58.4540349478403 -34.5318789134887,-58.4540825997269 -34.5319126509247,-58.4541408026364 -34.5319589249137,-58.4541810515884 -34.5319868868582,-58.4542110889448 -34.5320123127432,-58.4542573772472 -34.5320673186736,-58.4543080060395 -34.5321185923054,-58.4543718253753 -34.5321687399996,-58.4544460290035 -34.5321974788526,-58.4545049145551 -34.5322289632483,-58.4545759673873 -34.5322805902665,-58.454626768871 -34.5323093978763,-58.4546781667198 -34.5323315854584,-58.4547289672898 -34.5323706752239,-58.4547807892001 -34.5324087086439,-58.454874394 -34.5324572382025,-58.4549576175716 -34.5324971046315,-58.455048583128 -34.5325604937776,-58.4551186154715 -34.5326111344491,-58.4551864344357 -34.5326714937338,-58.4552699106905 -34.532744882746,-58.4553323685971 -34.5328051007701,-58.4553898065018 -34.5328561630798,-58.4554691158042 -34.5328996910758,-58.4555224710842 -34.5329271603671,-58.4556106288965 -34.5329945632077,-58.4556551331514 -34.5330306943257,-58.455694190946 -34.5330679519311,-58.4557078047613 -34.5330942216124,-58.4557193750537 -34.5331340129688,-58.4557458337368 -34.5332237372116,-58.4557477871026 -34.5332711340252,-58.4557412297583 -34.5333266997704,-58.4557123755617 -34.5333887434335,-58.455669481694 -34.5334276161264,-58.4556270113056 -34.5334899406878,-58.4555835209414 -34.5335370531576,-58.4555098168321 -34.5336188838557,-58.4554254742174 -34.5337095875512,-58.4553405369287 -34.5337864876552,-58.4552470896656 -34.5338603588622,-58.4551750887165 -34.5339226814563,-58.4551312578385 -34.5339657090328,-58.4550914258564 -34.5340176105182,-58.4550661465097 -34.5340651464889,-58.4550376331364 -34.534114372475,-58.4550198412113 -34.5341774026239,-58.4550076662666 -34.5342369118238,-58.455008766871 -34.5342990276205,-58.4550149727966 -34.5343694540051,-58.4550263705295 -34.5344332606715,-58.4550605737193 -34.5345164359127,-58.4550903554281 -34.534558552515,-58.4551148609744 -34.5345994715403,-58.455122600501 -34.5346515872538,-58.4551154481279 -34.5346938424038,-58.4550921253482 -34.5347477872611,-58.4550718673221 -34.5347894781829,-58.4550413115182 -34.5348358869969,-58.4549769664476 -34.5349231407435,-58.4549282820743 -34.5349882816928,-58.4549158521514 -34.5350422976325,-58.4549091243178 -34.5350934968949,-58.4549248625292 -34.5351546276527,-58.4549098789281 -34.5352149113402,-58.4549406828669 -34.5352480839395,-58.4550049322374 -34.5352791458633,-58.4550551414798 -34.5352914735637,-58.455085097424 -34.5352923205469,-58.4553604760672 -34.5354348795948,-58.4555624154024 -34.5355385586075,-58.4555781577193 -34.535558067523,-58.4555960276511 -34.5355770835783,-58.455668872276 -34.5356153995267,-58.4557535464831 -34.5356508286397,-58.4558086905771 -34.5356806219528,-58.4558561748225 -34.5357182320954,-58.455882725887 -34.5357304877005,-58.4559362542824 -34.535745984392,-58.4559858669564 -34.5357740870946,-58.4560228851499 -34.535793315416,-58.4561718939955 -34.5358731865296,-58.4564657431612 -34.5360239134708,-58.4565035274044 -34.5360444797783,-58.4565863295178 -34.5360882889074,-58.4567224044718 -34.5361578765053,-58.4569197520465 -34.5362559893849,-58.4569988103901 -34.5362946569596,-58.4570915700565 -34.5363392408945,-58.4571447580157 -34.5363643149711,-58.4571949675344 -34.5363871352591,-58.4572287526727 -34.5364013628234,-58.4572529214231 -34.5364110826876,-58.4572972591357 -34.5364296066873,-58.4573830409118 -34.5364696124029,-58.4574594617433 -34.5365037723012,-58.4575255854283 -34.536532649768,-58.4575957940384 -34.5365630767409,-58.4577079576932 -34.5366120978511,-58.4577770603037 -34.5366388625239,-58.4578100797133 -34.5366530194699,-58.457833312422 -34.5366634434411,-58.4578631830816 -34.5366764030058,-58.4579124569875 -34.5366966876258,-58.457933136375 -34.5367111961839,-58.4579598582947 -34.5367229583605,-58.4579948353065 -34.5367344391456,-58.4580182382291 -34.5367455673477,-58.4580704905317 -34.5367715565211,-58.4582328645683 -34.536848115593,-58.4582889467534 -34.5368726962933,-58.4583184769617 -34.5368891066061,-58.4583643465316 -34.536917349055,-58.4583948980693 -34.5369327734219,-58.4584417894572 -34.5369508041127,-58.4584854468089 -34.5369708770269,-58.458562719499 -34.5370068673365,-58.458603823824 -34.537026165436,-58.4586570128098 -34.5370484218127,-58.4586809264992 -34.5370602541638,-58.4587475623533 -34.5370746936609,-58.4587749647519 -34.5370989210757,-58.4586661843956 -34.5371596525757,-58.4588772294948 -34.5373317427562,-58.4594464573651 -34.5377958965945,-58.4594426648329 -34.5377987634565,-58.4582841749552 -34.5385976390323,-58.4574942836567 -34.5390043177336,-58.4547470177849 -34.5403259236206,-58.4532152008306 -34.5407927381157,-58.453060214344 -34.5408356153642,-58.4529724653514 -34.5408585672554,-58.4528532253642 -34.5408898268065,-58.4526386601915 -34.5409548828648,-58.4525813803466 -34.5409722029077,-58.4523437483847 -34.5410538066237,-58.452087475065 -34.5411525921808,-58.451925930788 -34.5412203277648,-58.4517065084119 -34.5413192566172,-58.4517041254664 -34.5413193893073,-58.4500053908947 -34.5422393469607,-58.4492696317695 -34.5426517745115,-58.4494075874194 -34.5427586166845,-58.4500032123549 -34.5435914428061,-58.4503692723978 -34.5440648024625,-58.4504479227441 -34.5441644571416,-58.4505139509373 -34.5442440204368,-58.4507485654891 -34.5445279243806,-58.4507496083091 -34.5445292811905,-58.4509152828287 -34.5447448391217,-58.4520402025335 -34.5461190919939,-58.4521240182848 -34.5462843183419,-58.4521749886493 -34.5463846795895,-58.452847198494 -34.5472558330139,-58.4536634174402 -34.5483134809643,-58.4538186413127 -34.5485672366223,-58.4539581260556 -34.5487597204772,-58.4541211852995 -34.5489847425565,-58.4541610831408 -34.5491970792111,-58.4541574870459 -34.5494045534285,-58.4544072404614 -34.5491926593503,-58.4546895101493 -34.5489481597344,-58.4550404722384 -34.5486441539594,-58.4557399202388 -34.5480382519711,-58.4563012078039 -34.5475519218334,-58.456513497759 -34.547367980473,-58.4565941927555 -34.5472812903207,-58.4572936152407 -34.5467194658775,-58.4580435028266 -34.5461170740166,-58.4581166184467 -34.5460577782101,-58.4589242880867 -34.5454020002231,-58.4598965132801 -34.5458883874282,-58.4607084827631 -34.5462944788701,-58.4608510463477 -34.5463660337814,-58.4617863546341 -34.5468348692621,-58.4623721128808 -34.5460370881608,-58.4614272776284 -34.54556649636,-58.4604773463396 -34.5450934322141,-58.45979543953 -34.5447187522585,-58.4606222358845 -34.5439509157705,-58.4612942839936 -34.5433267407221,-58.4619831739576 -34.5426869978878,-58.4626020084246 -34.5421123245999,-58.4631809702139 -34.5415841550674)))";;"1165";13_3_2;COMUNA 13;"3";"2";"654";"312";"342";"91,23%";"378";"377";"99,74%";"1";"0,27%";"270";"3";"1.11";"267";"98,89%";"1.11";1.110
"MULTIPOLYGON (((-58.4608510463477 -34.5463660337814,-58.4607084827631 -34.5462944788701,-58.4598965132801 -34.5458883874282,-58.4593292881496 -34.546664818153,-58.4589843004866 -34.5471370134602,-58.4587649457159 -34.547455401831,-58.4597089361183 -34.5479276338602,-58.4606414467138 -34.5483940130181,-58.4612171830157 -34.547609900105,-58.4617863546341 -34.5468348692621,-58.4608510463477 -34.5463660337814)))";;"1166";13_3_3;COMUNA 13;"3";"3";"781";"363";"418";"86,84%";"462";"462";"100,00%";"0";"0,00%";"353";"1";"0.28";"352";"99,72%";"0.28";0.280
"MULTIPOLYGON (((-58.4562007259602 -34.5492430520216,-58.4563468653383 -34.5493182040643,-58.4571219957891 -34.5497157252556,-58.4572920734783 -34.5495010045886,-58.4576542751302 -34.5490093070054,-58.4577984736163 -34.5488135290833,-58.458226894151 -34.5482301379514,-58.4582945658268 -34.5481380938463,-58.4587649457159 -34.547455401831,-58.4589843004866 -34.5471370134602,-58.4593292881496 -34.546664818153,-58.4598965132801 -34.5458883874282,-58.4589242880867 -34.5454020002231,-58.4581166184467 -34.5460577782101,-58.4580435028266 -34.5461170740166,-58.4572936152407 -34.5467194658775,-58.4565941927555 -34.5472812903207,-58.456513497759 -34.547367980473,-58.4563012078039 -34.5475519218334,-58.4557399202388 -34.5480382519711,-58.4550404722384 -34.5486441539594,-58.4560193500947 -34.5491495871664,-58.4561534030755 -34.5492186821591,-58.4562007259602 -34.5492430520216)))";;"1167";13_3_4;COMUNA 13;"3";"4";"1069";"509";"560";"90,89%";"754";"754";"100,00%";"0";"0,00%";"433";"3";"0.69";"430";"99,31%";"0.69";0.690
"MULTIPOLYGON (((-58.4606414467138 -34.5483940130181,-58.4597089361183 -34.5479276338602,-58.4587649457159 -34.547455401831,-58.4582945658268 -34.5481380938463,-58.458226894151 -34.5482301379514,-58.4591482497751 -34.548693781473,-58.4600778717871 -34.5491615028831,-58.4597630958974 -34.5495956004749,-58.4609969378042 -34.5502132583104,-58.4610781392922 -34.5502456552889,-58.4614389586335 -34.5498464156159,-58.4620273795947 -34.5490871595156,-58.4616104823021 -34.5488786960653,-58.4621567630299 -34.5480802116475,-58.4612171830157 -34.547609900105,-58.4606414467138 -34.5483940130181)))";;"1168";13_3_5;COMUNA 13;"3";"5";"798";"392";"406";"96,55%";"446";"446";"100,00%";"0";"0,00%";"312";"1";"0.32";"311";"99,68%";"0.32";0.320
"MULTIPOLYGON (((-58.4601114281587 -34.5512484316537,-58.4603998909571 -34.5513959090495,-58.4604616862947 -34.5514279539356,-58.4605389758545 -34.5513611916723,-58.4606584855386 -34.5512366809176,-58.4610318232997 -34.550849062979,-58.4611242634791 -34.5507511019135,-58.4612066593288 -34.5506639158023,-58.4616750701277 -34.5501300225768,-58.4617732118134 -34.5500145954546,-58.4618629265255 -34.5499090982336,-58.4620861909304 -34.5496428195502,-58.4623943156202 -34.5492707611056,-58.4623234988048 -34.5492341394804,-58.4621608930599 -34.5491540271757,-58.4620273795947 -34.5490871595156,-58.4614389586335 -34.5498464156159,-58.4610781392922 -34.5502456552889,-58.4609969378042 -34.5502132583104,-58.4597630958974 -34.5495956004749,-58.4600778717871 -34.5491615028831,-58.4591482497751 -34.548693781473,-58.458226894151 -34.5482301379514,-58.4577984736163 -34.5488135290833,-58.4576542751302 -34.5490093070054,-58.4572920734783 -34.5495010045886,-58.4571219957891 -34.5497157252556,-58.4580515322194 -34.5501922652371,-58.4589736741502 -34.5506650653124,-58.4601114281587 -34.5512484316537)))";;"1169";13_3_6;COMUNA 13;"3";"6";"651";"294";"357";"82,35%";"382";"382";"100,00%";"0";"0,00%";"271";"0";"0";"271";"100,00%";"0";0.000
"MULTIPOLYGON (((-58.4589736741502 -34.5506650653124,-58.4580515322194 -34.5501922652371,-58.4572959625419 -34.5512245355844,-58.4582122381191 -34.5517020595989,-58.4578297833317 -34.5522228182314,-58.4574054954085 -34.5528005287107,-58.4575927538283 -34.5528975129867,-58.4581171648307 -34.5531691660226,-58.4581593019354 -34.5531242359513,-58.4581789654878 -34.5531109262091,-58.4581503658139 -34.5530961357335,-58.4586859746089 -34.5526543078846,-58.4587690453083 -34.5525857815887,-58.4589254160103 -34.5524667669478,-58.4590166684333 -34.552376483878,-58.4591310735121 -34.5522788771357,-58.45920027836 -34.5522169748719,-58.4591485268119 -34.5521900003009,-58.4601114281587 -34.5512484316537,-58.4589736741502 -34.5506650653124)))";;"1170";13_3_7;COMUNA 13;"3";"7";"663";"301";"362";"83,15%";"357";"357";"100,00%";"0";"0,00%";"290";"14";"4.83";"276";"95,17%";"4.83";4.830
"MULTIPOLYGON (((-58.4572959625419 -34.5512245355844,-58.4563630149557 -34.5507382709932,-58.4554579488299 -34.5517879171932,-58.4557418086375 -34.5519377997843,-58.4564898931534 -34.5523257453677,-58.4572777343475 -34.5527343228694,-58.4574054954085 -34.5528005287107,-58.4578297833317 -34.5522228182314,-58.4582122381191 -34.5517020595989,-58.4572959625419 -34.5512245355844)))";;"1171";13_3_8;COMUNA 13;"3";"8";"625";"278";"347";"80,12%";"361";"361";"100,00%";"0";"0,00%";"278";"3";"1.08";"275";"98,92%";"1.08";1.080
"MULTIPOLYGON (((-58.4562007259602 -34.5492430520216,-58.4561534030755 -34.5492186821591,-58.4552466583953 -34.5501564907781,-58.4543621966981 -34.551071194379,-58.454277920049 -34.5511648549091,-58.4554579488299 -34.5517879171932,-58.4563630149557 -34.5507382709932,-58.4572959625419 -34.5512245355844,-58.4580515322194 -34.5501922652371,-58.4571219957891 -34.5497157252556,-58.4563468653383 -34.5493182040643,-58.4562007259602 -34.5492430520216)))";;"1172";13_3_9;COMUNA 13;"3";"9";"950";"461";"489";"94,27%";"416";"416";"100,00%";"0";"0,00%";"354";"15";"4.24";"339";"95,76%";"4.24";4.240
"MULTIPOLYGON (((-58.4670619761867 -34.5483771911112,-58.4661221099378 -34.5479079737323,-58.465529905913 -34.5487163366016,-58.4664707141641 -34.5491845724858,-58.4675597258582 -34.5497266015322,-58.4681892848515 -34.5489399888592,-58.4670619761867 -34.5483771911112)))";;"1173";13_4_1;COMUNA 13;"4";"1";"610";"271";"339";"79,94%";"424";"424";"100,00%";"0";"0,00%";"291";"2";"0.69";"289";"99,31%";"0.69";0.690
"MULTIPOLYGON (((-58.4636360384207 -34.5530552995338,-58.4634756707926 -34.5529731137744,-58.4626791995721 -34.5540298549584,-58.4633108879574 -34.554359023457,-58.4635423351998 -34.5544799431134,-58.4645195982966 -34.5535122824197,-58.4642799806141 -34.5533853785117,-58.4636360384207 -34.5530552995338)))";;"1174";13_4_10;COMUNA 13;"4";"10";"440";"186";"254";"73,23%";"316";"315";"99,68%";"1";"0,32%";"237";"1";"0.42";"236";"99,58%";"0.42";0.420
"MULTIPOLYGON (((-58.4617636553644 -34.5520953961014,-58.4612455379589 -34.5518298153723,-58.4603776351099 -34.5528304819478,-58.4613130978855 -34.5533179833911,-58.4619246019256 -34.5536366654294,-58.4622575943941 -34.5538101961881,-58.4626791995721 -34.5540298549584,-58.4634756707926 -34.5529731137744,-58.4627015864752 -34.5525762669608,-58.4617636553644 -34.5520953961014)))";;"1175";13_4_11;COMUNA 13;"4";"11";"824";"378";"446";"84,75%";"398";"398";"100,00%";"0";"0,00%";"370";"58";"15.68";"312";"84,32%";"15.68";15.680
"MULTIPOLYGON (((-58.4613130978855 -34.5533179833911,-58.4603776351099 -34.5528304819478,-58.4612455379589 -34.5518298153723,-58.4604616862947 -34.5514279539356,-58.4603998909571 -34.5513959090495,-58.4601114281587 -34.5512484316537,-58.4591485268119 -34.5521900003009,-58.45920027836 -34.5522169748719,-58.4591310735121 -34.5522788771357,-58.4590166684333 -34.552376483878,-58.4589254160103 -34.5524667669478,-58.4587690453083 -34.5525857815887,-58.4586859746089 -34.5526543078846,-58.4581503658139 -34.5530961357335,-58.4581789654878 -34.5531109262091,-58.4581593019354 -34.5531242359513,-58.4581171648307 -34.5531691660226,-58.4582619624561 -34.5532445821822,-58.4582621211115 -34.5532442452549,-58.4585339893126 -34.5533851768095,-58.4587547020286 -34.5534994851712,-58.4594721713073 -34.553875650288,-58.4604096833109 -34.5543671728922,-58.4613130978855 -34.5533179833911)))";;"1176";13_4_12;COMUNA 13;"4";"12";"1400";"632";"768";"82,29%";"793";"793";"100,00%";"0";"0,00%";"613";"15";"2.45";"598";"97,55%";"2.45";2.450
"MULTIPOLYGON (((-58.4619246019256 -34.5536366654294,-58.4613130978855 -34.5533179833911,-58.4604096833109 -34.5543671728922,-58.4613538458221 -34.554862139194,-58.4622575943941 -34.5538101961881,-58.4619246019256 -34.5536366654294)))";;"1177";13_4_13;COMUNA 13;"4";"13";"707";"305";"402";"75,87%";"433";"433";"100,00%";"0";"0,00%";"337";"22";"6.53";"315";"93,47%";"6.53";6.530
"MULTIPOLYGON (((-58.4626791995721 -34.5540298549584,-58.4622575943941 -34.5538101961881,-58.4613538458221 -34.554862139194,-58.4625330432147 -34.5554802733402,-58.4635423351998 -34.5544799431134,-58.4633108879574 -34.554359023457,-58.4626791995721 -34.5540298549584)))";;"1178";13_4_14;COMUNA 13;"4";"14";"758";"319";"439";"72,67%";"427";"425";"99,53%";"2";"0,47%";"327";"5";"1.53";"322";"98,47%";"1.53";1.530
"MULTIPOLYGON (((-58.4651867651464 -34.5474329740717,-58.4644570692908 -34.5470712091861,-58.463900603825 -34.5479054100274,-58.4634252417275 -34.5486134046791,-58.4633669379787 -34.5486934087531,-58.4640210594201 -34.5490207426697,-58.4645885975017 -34.5482478117367,-58.465529905913 -34.5487163366016,-58.4661221099378 -34.5479079737323,-58.4651867651464 -34.5474329740717)))";;"1179";13_4_2;COMUNA 13;"4";"2";"777";"344";"433";"79,45%";"438";"438";"100,00%";"0";"0,00%";"350";"4";"1.14";"346";"98,86%";"1.14";1.140
"MULTIPOLYGON (((-58.4675597258582 -34.5497266015322,-58.4664707141641 -34.5491845724858,-58.465529905913 -34.5487163366016,-58.4645885975017 -34.5482478117367,-58.4640210594201 -34.5490207426697,-58.4649618627149 -34.5494915254859,-58.4659015700632 -34.5499618080647,-58.4669509224272 -34.5504868708855,-58.46702088476 -34.5503998221309,-58.4673134141682 -34.5500343718968,-58.4675597258582 -34.5497266015322)))";;"1180";13_4_3;COMUNA 13;"4";"3";"679";"341";"338";"100,89%";"381";"380";"99,74%";"1";"0,26%";"304";"40";"13.16";"264";"86,84%";"13.16";13.160
"MULTIPOLYGON (((-58.4669509224272 -34.5504868708855,-58.4659015700632 -34.5499618080647,-58.4649618627149 -34.5494915254859,-58.4640210594201 -34.5490207426697,-58.4633669379787 -34.5486934087531,-58.4627987897615 -34.5494688692816,-58.46344993597 -34.5497986711221,-58.4643916811032 -34.5502697399688,-58.4653318195766 -34.5507398155889,-58.4663417673525 -34.5512449539196,-58.4666773700104 -34.5508272480214,-58.4669509224272 -34.5504868708855)))";;"1181";13_4_4;COMUNA 13;"4";"4";"995";"446";"549";"81,24%";"548";"548";"100,00%";"0";"0,00%";"430";"7";"1.63";"423";"98,37%";"1.63";1.630
"MULTIPOLYGON (((-58.4663417673525 -34.5512449539196,-58.4653318195766 -34.5507398155889,-58.464763505454 -34.5515157779833,-58.4641990961884 -34.552286455652,-58.4651328720414 -34.5527492084448,-58.4657330268022 -34.5520023999784,-58.4660344194375 -34.5516273043499,-58.4663417673525 -34.5512449539196)))";;"1182";13_4_5;COMUNA 13;"4";"5";"758";"336";"422";"79,62%";"476";"476";"100,00%";"0";"0,00%";"363";"1";"0.28";"362";"99,72%";"0.28";0.280
"MULTIPOLYGON (((-58.4653318195766 -34.5507398155889,-58.4643916811032 -34.5502697399688,-58.46344993597 -34.5497986711221,-58.4627987897615 -34.5494688692816,-58.4623943156202 -34.5492707611056,-58.4620861909304 -34.5496428195502,-58.4618629265255 -34.5499090982336,-58.4617732118134 -34.5500145954546,-58.4619732366412 -34.5501152352951,-58.4628824619482 -34.5505715965662,-58.4638241274952 -34.5510442895242,-58.464763505454 -34.5515157779833,-58.4653318195766 -34.5507398155889)))";;"1183";13_4_6;COMUNA 13;"4";"6";"879";"382";"497";"76,86%";"517";"517";"100,00%";"0";"0,00%";"400";"3";"0.75";"397";"99,25%";"0.75";0.750
"MULTIPOLYGON (((-58.4638241274952 -34.5510442895242,-58.4628824619482 -34.5505715965662,-58.4623121684981 -34.5513482518334,-58.462745082214 -34.5515658681522,-58.4632563080141 -34.5518192588991,-58.4641990961884 -34.552286455652,-58.464763505454 -34.5515157779833,-58.4638241274952 -34.5510442895242)))";;"1184";13_4_7;COMUNA 13;"4";"7";"730";"351";"379";"92,61%";"351";"349";"99,43%";"2";"0,57%";"296";"0";"0";"296";"100,00%";"0";0.000
"MULTIPOLYGON (((-58.4611242634791 -34.5507511019135,-58.4610318232997 -34.550849062979,-58.4606584855386 -34.5512366809176,-58.4605389758545 -34.5513611916723,-58.4604616862947 -34.5514279539356,-58.4612455379589 -34.5518298153723,-58.4617636553644 -34.5520953961014,-58.4627015864752 -34.5525762669608,-58.4632563080141 -34.5518192588991,-58.462745082214 -34.5515658681522,-58.4623121684981 -34.5513482518334,-58.4628824619482 -34.5505715965662,-58.4619732366412 -34.5501152352951,-58.4617732118134 -34.5500145954546,-58.4616750701277 -34.5501300225768,-58.4612066593288 -34.5506639158023,-58.4611242634791 -34.5507511019135)))";;"1185";13_4_8;COMUNA 13;"4";"8";"624";"280";"344";"81,40%";"359";"359";"100,00%";"0";"0,00%";"265";"1";"0.38";"264";"99,62%";"0.38";0.380
"MULTIPOLYGON (((-58.4651328720414 -34.5527492084448,-58.4641990961884 -34.552286455652,-58.4632563080141 -34.5518192588991,-58.4627015864752 -34.5525762669608,-58.4634756707926 -34.5529731137744,-58.4636360384207 -34.5530552995338,-58.4642799806141 -34.5533853785117,-58.4645195982966 -34.5535122824197,-58.4651328720414 -34.5527492084448)))";;"1186";13_4_9;COMUNA 13;"4";"9";"714";"331";"383";"86,42%";"449";"449";"100,00%";"0";"0,00%";"341";"1";"0.29";"340";"99,71%";"0.29";0.290
"MULTIPOLYGON (((-58.4727255369148 -34.5530546098166,-58.4725826418887 -34.5532419540319,-58.4721245915134 -34.5538514548786,-58.4720306316271 -34.5539763974072,-58.471588147662 -34.5545589923376,-58.4724494649163 -34.5550166235974,-58.4727430066224 -34.5546379909341,-58.4729836929285 -34.5543227451922,-58.473586166729 -34.5535337835141,-58.4744359426856 -34.5524209070665,-58.4735728512412 -34.5519435705605,-58.4727255369148 -34.5530546098166)))";;"1187";13_5_1;COMUNA 13;"5";"1";"744";"360";"384";"93,75%";"410";"410";"100,00%";"0";"0,00%";"344";"26";"7.56";"318";"92,44%";"7.56";7.560
"MULTIPOLYGON (((-58.4718635523529 -34.550998033219,-58.4710076405789 -34.5505246217725,-58.4701672005947 -34.5516292343198,-58.4706184401137 -34.5518814006538,-58.471016905266 -34.5521032858266,-58.4718722377298 -34.5525795141593,-58.4727255369148 -34.5530546098166,-58.4735728512412 -34.5519435705605,-58.4727035555603 -34.5514627071339,-58.4718635523529 -34.550998033219)))";;"1188";13_5_2;COMUNA 13;"5";"2";"1196";"496";"700";"70,86%";"501";"495";"98,80%";"6";"1,21%";"403";"2";"0.5";"401";"99,50%";"0.5";0.500
"MULTIPOLYGON (((-58.4701573565151 -34.550054232255,-58.4693026557534 -34.5495814425405,-58.4683729748813 -34.5490757614531,-58.4681892848515 -34.5489399888592,-58.4675597258582 -34.5497266015322,-58.4673134141682 -34.5500343718968,-58.4684615210836 -34.5506760430923,-58.4693169947666 -34.5511541205025,-58.4701672005947 -34.5516292343198,-58.4710076405789 -34.5505246217725,-58.4701573565151 -34.550054232255)))";;"1189";13_5_3;COMUNA 13;"5";"3";"1189";"539";"650";"82,92%";"745";"744";"99,87%";"1";"0,13%";"530";"4";"0.75";"526";"99,25%";"0.75";0.750
"MULTIPOLYGON (((-58.4701672005947 -34.5516292343198,-58.4693169947666 -34.5511541205025,-58.4684615210836 -34.5506760430923,-58.4673134141682 -34.5500343718968,-58.46702088476 -34.5503998221309,-58.4669509224272 -34.5504868708855,-58.4666773700104 -34.5508272480214,-58.4678479549535 -34.5514795584634,-58.4687039439871 -34.5519565132712,-58.4695418114511 -34.5524233921697,-58.4700774104996 -34.5517472029823,-58.4701672005947 -34.5516292343198)))";;"1190";13_5_4;COMUNA 13;"5";"4";"1008";"441";"567";"77,78%";"602";"602";"100,00%";"0";"0,00%";"478";"2";"0.42";"476";"99,58%";"0.42";0.420
"MULTIPOLYGON (((-58.4695418114511 -34.5524233921697,-58.4689583705676 -34.5531600771372,-58.4698308955551 -34.5536244872757,-58.4705087477668 -34.5539853778718,-58.4707039409875 -34.554089102386,-58.471588147662 -34.5545589923376,-58.4720306316271 -34.5539763974072,-58.4721245915134 -34.5538514548786,-58.4725826418887 -34.5532419540319,-58.4727255369148 -34.5530546098166,-58.4718722377298 -34.5525795141593,-58.471016905266 -34.5521032858266,-58.4706184401137 -34.5518814006538,-58.4701672005947 -34.5516292343198,-58.4700774104996 -34.5517472029823,-58.4695418114511 -34.5524233921697)))";;"1191";13_5_5;COMUNA 13;"5";"5";"888";"406";"482";"84,23%";"434";"434";"100,00%";"0";"0,00%";"359";"16";"4.46";"343";"95,54%";"4.46";4.460
"MULTIPOLYGON (((-58.4666773700104 -34.5508272480214,-58.4663417673525 -34.5512449539196,-58.4660344194375 -34.5516273043499,-58.4672506337303 -34.5522620127313,-58.4681227136512 -34.5527171389594,-58.4683035150064 -34.5528114309168,-58.4689583705676 -34.5531600771372,-58.4695418114511 -34.5524233921697,-58.4687039439871 -34.5519565132712,-58.4678479549535 -34.5514795584634,-58.4666773700104 -34.5508272480214)))";;"1192";13_5_6;COMUNA 13;"5";"6";"953";"425";"528";"80,49%";"542";"542";"100,00%";"0";"0,00%";"437";"4";"0.92";"433";"99,08%";"0.92";0.920
"MULTIPOLYGON (((-58.4660344194375 -34.5516273043499,-58.4657330268022 -34.5520023999784,-58.4651328720414 -34.5527492084448,-58.4645195982966 -34.5535122824197,-58.4652539480375 -34.5539013716493,-58.4656166566644 -34.5540979218395,-58.4662326560116 -34.5535113293378,-58.4663513114001 -34.5534399141131,-58.4672506337303 -34.5522620127313,-58.4660344194375 -34.5516273043499)))";;"1193";13_5_7;COMUNA 13;"5";"7";"777";"352";"425";"82,82%";"438";"438";"100,00%";"0";"0,00%";"327";"4";"1.22";"323";"98,78%";"1.22";1.220
"MULTIPOLYGON (((-58.4681227136512 -34.5527171389594,-58.4672506337303 -34.5522620127313,-58.4663513114001 -34.5534399141131,-58.4662326560116 -34.5535113293378,-58.4656166566644 -34.5540979218395,-58.4661939636162 -34.5544108787797,-58.4663835345799 -34.5545179907912,-58.4672254414241 -34.5538913140347,-58.4681227136512 -34.5527171389594)))";;"1194";13_5_8;COMUNA 13;"5";"8";"883";"407";"476";"85,50%";"550";"550";"100,00%";"0";"0,00%";"417";"0";"0";"417";"100,00%";"0";0.000
"MULTIPOLYGON (((-58.4689583705676 -34.5531600771372,-58.4683035150064 -34.5528114309168,-58.4681227136512 -34.5527171389594,-58.4672254414241 -34.5538913140347,-58.4675502739182 -34.5540590557406,-58.4678516985572 -34.5542151773164,-58.4687676414048 -34.554689734442,-58.4693645421019 -34.5549990132449,-58.4696724434566 -34.5551625950775,-58.4697724522584 -34.5550419500084,-58.4706068255199 -34.5541750281475,-58.4707039409875 -34.554089102386,-58.4705087477668 -34.5539853778718,-58.4698308955551 -34.5536244872757,-58.4689583705676 -34.5531600771372)))";;"1195";13_6_1;COMUNA 13;"6";"1";"688";"314";"374";"83,96%";"325";"325";"100,00%";"0";"0,00%";"283";"0";"0";"283";"100,00%";"0";0.000
"MULTIPOLYGON (((-58.4706021136731 -34.5556565750878,-58.4704914650075 -34.555777996187,-58.4698802566324 -34.556490883025,-58.4690832272844 -34.5574204061188,-58.4700684235224 -34.5579443884503,-58.4708720881087 -34.5570301409452,-58.4715559712858 -34.556162941157,-58.4718499473139 -34.555790085591,-58.4724494649163 -34.5550166235974,-58.471588147662 -34.5545589923376,-58.4707039409875 -34.554089102386,-58.4706068255199 -34.5541750281475,-58.4697724522584 -34.5550419500084,-58.4696724434566 -34.5551625950775,-58.4706021136731 -34.5556565750878)))";;"1196";13_6_2;COMUNA 13;"6";"2";"1061";"479";"582";"82,30%";"468";"468";"100,00%";"0";"0,00%";"425";"15";"3.53";"410";"96,47%";"3.53";3.530
"MULTIPOLYGON (((-58.4696724434566 -34.5551625950775,-58.4693645421019 -34.5549990132449,-58.4687676414048 -34.554689734442,-58.4680139330082 -34.5554388883249,-58.4670880150348 -34.5563593191758,-58.4677740497331 -34.5567239570619,-58.4680609279192 -34.5568765573695,-58.4690832272844 -34.5574204061188,-58.4698802566324 -34.556490883025,-58.4704914650075 -34.555777996187,-58.4706021136731 -34.5556565750878,-58.4696724434566 -34.5551625950775)))";;"1197";13_6_3;COMUNA 13;"6";"3";"932";"429";"503";"85,29%";"428";"428";"100,00%";"0";"0,00%";"368";"15";"4.08";"353";"95,92%";"4.08";4.080
"MULTIPOLYGON (((-58.4678516985572 -34.5542151773164,-58.4675502739182 -34.5540590557406,-58.4672254414241 -34.5538913140347,-58.4663835345799 -34.5545179907912,-58.4652262428831 -34.5553696788907,-58.4661533353786 -34.5558624955759,-58.4671140725732 -34.5549305910859,-58.4680139330082 -34.5554388883249,-58.4687676414048 -34.554689734442,-58.4678516985572 -34.5542151773164)))";;"1198";13_6_4;COMUNA 13;"6";"4";"904";"411";"493";"83,37%";"530";"530";"100,00%";"0";"0,00%";"419";"18";"4.3";"401";"95,70%";"4.3";4.300
"MULTIPOLYGON (((-58.4663835345799 -34.5545179907912,-58.4661939636162 -34.5544108787797,-58.4656166566644 -34.5540979218395,-58.4652539480375 -34.5539013716493,-58.4645195982966 -34.5535122824197,-58.4635423351998 -34.5544799431134,-58.4641356399437 -34.5547899517732,-58.4646159051557 -34.5550452385489,-58.4652262428831 -34.5553696788907,-58.4663835345799 -34.5545179907912)))";;"1199";13_6_5;COMUNA 13;"6";"5";"939";"412";"527";"78,18%";"559";"559";"100,00%";"0";"0,00%";"454";"10";"2.2";"444";"97,80%";"2.2";2.200
"MULTIPOLYGON (((-58.4652262428831 -34.5553696788907,-58.4646159051557 -34.5550452385489,-58.4641356399437 -34.5547899517732,-58.4635423351998 -34.5544799431134,-58.4625330432147 -34.5554802733402,-58.4628375280005 -34.5556140118748,-58.4634127919559 -34.5559149390874,-58.4637323469997 -34.55608212752,-58.4643420077714 -34.5564010790249,-58.4652262428831 -34.5553696788907)))";;"1200";13_6_6;COMUNA 13;"6";"6";"864";"364";"500";"72,80%";"443";"436";"98,42%";"7";"1,61%";"368";"0";"0";"368";"100,00%";"0";0.000
"MULTIPOLYGON (((-58.4661533353786 -34.5558624955759,-58.4652262428831 -34.5553696788907,-58.4643420077714 -34.5564010790249,-58.4652752353036 -34.5568892541132,-58.4662178376763 -34.5573823515601,-58.4670880150348 -34.5563593191758,-58.4680139330082 -34.5554388883249,-58.4671140725732 -34.5549305910859,-58.4661533353786 -34.5558624955759)))";;"1201";13_6_7;COMUNA 13;"6";"7";"977";"445";"532";"83,65%";"497";"497";"100,00%";"0";"0,00%";"425";"34";"8";"391";"92,00%";"8";8.000
"MULTIPOLYGON (((-58.4700684235224 -34.5579443884503,-58.4690832272844 -34.5574204061188,-58.4680609279192 -34.5568765573695,-58.4677740497331 -34.5567239570619,-58.4670880150348 -34.5563593191758,-58.4662178376763 -34.5573823515601,-58.4671811372083 -34.5578862864926,-58.4677581350142 -34.5581881085889,-58.468219531833 -34.5584276768917,-58.4691842172671 -34.5589284971383,-58.4696496461906 -34.5584207725671,-58.4700684235224 -34.5579443884503)))";;"1202";13_6_8;COMUNA 13;"6";"8";"794";"354";"440";"80,45%";"387";"387";"100,00%";"0";"0,00%";"339";"18";"5.31";"321";"94,69%";"5.31";5.310
"MULTIPOLYGON (((-58.468219531833 -34.5584276768917,-58.4677581350142 -34.5581881085889,-58.4671811372083 -34.5578862864926,-58.4665045116981 -34.558672542164,-58.4663747009679 -34.5588233275901,-58.4658262561908 -34.5594627378658,-58.4668434662804 -34.560032310648,-58.467738612413 -34.5605334966537,-58.4684648689601 -34.5597241324192,-58.4689299653913 -34.559205846817,-58.4691842172671 -34.5589284971383,-58.468219531833 -34.5584276768917)))";;"1203";13_7_1;COMUNA 13;"7";"1";"779";"335";"444";"75,45%";"341";"340";"99,71%";"1";"0,29%";"271";"8";"2.95";"263";"97,05%";"2.95";2.950
"MULTIPOLYGON (((-58.4662178376763 -34.5573823515601,-58.4652752353036 -34.5568892541132,-58.4646163907181 -34.5576595828593,-58.4655495492073 -34.5581602211031,-58.4665045116981 -34.558672542164,-58.4671811372083 -34.5578862864926,-58.4662178376763 -34.5573823515601)))";;"1204";13_7_2;COMUNA 13;"7";"2";"586";"268";"318";"84,28%";"273";"272";"99,63%";"1";"0,37%";"221";"1";"0.45";"220";"99,55%";"0.45";0.450
"MULTIPOLYGON (((-58.4634127919559 -34.5559149390874,-58.4628375280005 -34.5556140118748,-58.4625330432147 -34.5554802733402,-58.4618758876021 -34.556182767489,-58.4627699411998 -34.5566649752862,-58.4636903939042 -34.5571613318588,-58.4642206402354 -34.5574473252913,-58.4646163907181 -34.5576595828593,-58.4652752353036 -34.5568892541132,-58.4643420077714 -34.5564010790249,-58.4637323469997 -34.55608212752,-58.4634127919559 -34.5559149390874)))";;"1205";13_7_3;COMUNA 13;"7";"3";"1016";"447";"569";"78,56%";"567";"566";"99,82%";"1";"0,18%";"457";"2";"0.44";"455";"99,56%";"0.44";0.440
"MULTIPOLYGON (((-58.4636903939042 -34.5571613318588,-58.4627699411998 -34.5566649752862,-58.4618758876021 -34.556182767489,-58.4616499665206 -34.5564248190252,-58.4612211895652 -34.5568842016635,-58.4621406138638 -34.5573990214304,-58.4630500898 -34.5579083410527,-58.4636903939042 -34.5571613318588)))";;"1206";13_7_4;COMUNA 13;"7";"4";"753";"344";"409";"84,11%";"508";"508";"100,00%";"0";"0,00%";"344";"1";"0.29";"343";"99,71%";"0.29";0.290
"MULTIPOLYGON (((-58.4612211895652 -34.5568842016635,-58.460778191707 -34.5573587944957,-58.4605646928635 -34.5575875337096,-58.4615114457238 -34.5581329938182,-58.4624125834213 -34.5586521072209,-58.4630500898 -34.5579083410527,-58.4621406138638 -34.5573990214304,-58.4612211895652 -34.5568842016635)))";;"1207";13_7_5;COMUNA 13;"7";"5";"1048";"438";"610";"71,80%";"664";"664";"100,00%";"0";"0,00%";"476";"1";"0.21";"475";"99,79%";"0.21";0.210
"MULTIPOLYGON (((-58.4646163907181 -34.5576595828593,-58.4642206402354 -34.5574473252913,-58.4636903939042 -34.5571613318588,-58.4630500898 -34.5579083410527,-58.4624125834213 -34.5586521072209,-58.4633202870949 -34.559175016883,-58.4639653654303 -34.5584208229548,-58.4646163907181 -34.5576595828593)))";;"1208";13_7_6;COMUNA 13;"7";"6";"829";"372";"457";"81,40%";"480";"480";"100,00%";"0";"0,00%";"381";"1";"0.26";"380";"99,74%";"0.26";0.260
"MULTIPOLYGON (((-58.4655495492073 -34.5581602211031,-58.4646163907181 -34.5576595828593,-58.4639653654303 -34.5584208229548,-58.4633202870949 -34.559175016883,-58.4640145863468 -34.5595749589603,-58.4642255334125 -34.559696370417,-58.4648823548408 -34.5589342838813,-58.4655495492073 -34.5581602211031)))";;"1209";13_7_7;COMUNA 13;"7";"7";"805";"382";"423";"90,31%";"418";"418";"100,00%";"0";"0,00%";"346";"2";"0.58";"344";"99,42%";"0.58";0.580
"MULTIPOLYGON (((-58.4665045116981 -34.558672542164,-58.4655495492073 -34.5581602211031,-58.4648823548408 -34.5589342838813,-58.4642255334125 -34.559696370417,-58.4651628847134 -34.5602360272314,-58.4658262561908 -34.5594627378658,-58.4663747009679 -34.5588233275901,-58.4665045116981 -34.558672542164)))";;"1210";13_7_8;COMUNA 13;"7";"8";"776";"346";"430";"80,47%";"417";"416";"99,76%";"1";"0,24%";"309";"1";"0.32";"308";"99,68%";"0.32";0.320
"MULTIPOLYGON (((-58.4668434662804 -34.560032310648,-58.4658262561908 -34.5594627378658,-58.4651628847134 -34.5602360272314,-58.4661710765455 -34.560816451281,-58.4670371979829 -34.5613151078622,-58.467738612413 -34.5605334966537,-58.4668434662804 -34.560032310648)))";;"1211";13_7_9;COMUNA 13;"7";"9";"818";"360";"458";"78,60%";"434";"433";"99,77%";"1";"0,23%";"373";"3";"0.8";"370";"99,20%";"0.8";0.800
"MULTIPOLYGON (((-58.4625330432147 -34.5554802733402,-58.4613538458221 -34.554862139194,-58.4605326466152 -34.5558181569565,-58.4616499665206 -34.5564248190252,-58.4618758876021 -34.556182767489,-58.4625330432147 -34.5554802733402)))";;"1212";13_8_1;COMUNA 13;"8";"1";"640";"268";"372";"72,04%";"406";"406";"100,00%";"0";"0,00%";"314";"3";"0.96";"311";"99,04%";"0.96";0.960
"MULTIPOLYGON (((-58.4616499665206 -34.5564248190252,-58.4605326466152 -34.5558181569565,-58.4597247936788 -34.5567584644323,-58.460778191707 -34.5573587944957,-58.4612211895652 -34.5568842016635,-58.4616499665206 -34.5564248190252)))";;"1213";13_8_10;COMUNA 13;"8";"10";"650";"289";"361";"80,06%";"382";"382";"100,00%";"0";"0,00%";"292";"1";"0.34";"291";"99,66%";"0.34";0.340
"MULTIPOLYGON (((-58.4613538458221 -34.554862139194,-58.4604096833109 -34.5543671728922,-58.4595974165299 -34.5553103671222,-58.4605326466152 -34.5558181569565,-58.4613538458221 -34.554862139194)))";;"1214";13_8_2;COMUNA 13;"8";"2";"563";"248";"315";"78,73%";"388";"387";"99,74%";"1";"0,26%";"275";"1";"0.36";"274";"99,64%";"0.36";0.360
"MULTIPOLYGON (((-58.4586709651686 -34.554807288898,-58.4578853203664 -34.5557100481658,-58.4588028380973 -34.5562329920515,-58.4595974165299 -34.5553103671222,-58.4604096833109 -34.5543671728922,-58.4594721713073 -34.553875650288,-58.4587915046836 -34.5546687653492,-58.4586709651686 -34.554807288898)))";;"1215";13_8_3;COMUNA 13;"8";"3";"929";"427";"502";"85,06%";"516";"516";"100,00%";"0";"0,00%";"411";"1";"0.24";"410";"99,76%";"0.24";0.240
"MULTIPOLYGON (((-58.4577436739406 -34.5543008935579,-58.4569751343763 -34.5551912528042,-58.4578853203664 -34.5557100481658,-58.4586709651686 -34.554807288898,-58.4587915046836 -34.5546687653492,-58.4594721713073 -34.553875650288,-58.4587547020286 -34.5534994851712,-58.4585339893126 -34.5533851768095,-58.4582621211115 -34.5532442452549,-58.4582619624561 -34.5532445821822,-58.4582284946504 -34.5533156557642,-58.4578195567597 -34.5536262177626,-58.4577681414203 -34.5536644568903,-58.4575816325638 -34.5538059345862,-58.4573661803915 -34.5539698765528,-58.4572697332416 -34.5540416361579,-58.4577436739406 -34.5543008935579)))";;"1216";13_8_4;COMUNA 13;"8";"4";"879";"411";"468";"87,82%";"476";"476";"100,00%";"0";"0,00%";"388";"3";"0.77";"385";"99,23%";"0.77";0.770
"MULTIPOLYGON (((-58.4577436739406 -34.5543008935579,-58.4572697332416 -34.5540416361579,-58.4571938863344 -34.5540981142255,-58.4568963731032 -34.5542948700328,-58.4566394635687 -34.5544645836385,-58.4563895333265 -34.5546299306627,-58.4562031066752 -34.5547511940419,-58.45578061148 -34.5550160347645,-58.4553160631871 -34.5555519548627,-58.4545021102123 -34.5564934951141,-58.4553912680953 -34.5570259701359,-58.4562067486992 -34.556081395813,-58.4563450014335 -34.5559213253716,-58.4569751343763 -34.5551912528042,-58.4577436739406 -34.5543008935579)))";;"1217";13_8_5;COMUNA 13;"8";"5";"955";"439";"516";"85,08%";"656";"655";"99,85%";"1";"0,15%";"452";"5";"1.11";"447";"98,89%";"1.11";1.110
"MULTIPOLYGON (((-58.4578853203664 -34.5557100481658,-58.4569751343763 -34.5551912528042,-58.4563450014335 -34.5559213253716,-58.4562067486992 -34.556081395813,-58.4571001693248 -34.5566129431179,-58.4572415710088 -34.5564498435128,-58.4578853203664 -34.5557100481658)))";;"1218";13_8_6;COMUNA 13;"8";"6";"676";"317";"359";"88,30%";"355";"355";"100,00%";"0";"0,00%";"295";"1";"0.34";"294";"99,66%";"0.34";0.340
"MULTIPOLYGON (((-58.4588028380973 -34.5562329920515,-58.4578853203664 -34.5557100481658,-58.4572415710088 -34.5564498435128,-58.4571001693248 -34.5566129431179,-58.458008923227 -34.5571536397745,-58.458154069757 -34.5569863137269,-58.4588028380973 -34.5562329920515)))";;"1219";13_8_7;COMUNA 13;"8";"7";"808";"354";"454";"77,97%";"413";"413";"100,00%";"0";"0,00%";"364";"3";"0.82";"361";"99,18%";"0.82";0.820
"MULTIPOLYGON (((-58.4597247936788 -34.5567584644323,-58.4588028380973 -34.5562329920515,-58.458154069757 -34.5569863137269,-58.458008923227 -34.5571536397745,-58.4589195615945 -34.5576953860638,-58.4597274672304 -34.5581759935314,-58.4599146547921 -34.5582871297288,-58.4599589218408 -34.5582364946395,-58.4605646928635 -34.5575875337096,-58.460778191707 -34.5573587944957,-58.4597247936788 -34.5567584644323)))";;"1220";13_8_8;COMUNA 13;"8";"8";"993";"428";"565";"75,75%";"513";"513";"100,00%";"0";"0,00%";"439";"11";"2.51";"428";"97,49%";"2.51";2.510
"MULTIPOLYGON (((-58.4605326466152 -34.5558181569565,-58.4595974165299 -34.5553103671222,-58.4588028380973 -34.5562329920515,-58.4597247936788 -34.5567584644323,-58.4605326466152 -34.5558181569565)))";;"1221";13_8_9;COMUNA 13;"8";"9";"708";"309";"399";"77,44%";"440";"440";"100,00%";"0";"0,00%";"326";"3";"0.92";"323";"99,08%";"0.92";0.920
"MULTIPOLYGON (((-58.4571001693248 -34.5566129431179,-58.4562067486992 -34.556081395813,-58.4553912680953 -34.5570259701359,-58.4556897845841 -34.5572047281462,-58.4562819697223 -34.557556325946,-58.4571001693248 -34.5566129431179)))";;"1222";13_9_1;COMUNA 13;"9";"1";"673";"307";"366";"83,88%";"353";"353";"100,00%";"0";"0,00%";"287";"4";"1.39";"283";"98,61%";"1.39";1.390
"MULTIPOLYGON (((-58.4582963158187 -34.5601570958732,-58.4573049572104 -34.559568367669,-58.4563869031634 -34.5590230878339,-58.4555817828539 -34.559950972617,-58.4557374732076 -34.5600438026648,-58.4565053751907 -34.5604958361507,-58.4575068694265 -34.5610852754467,-58.4582963158187 -34.5601570958732)))";;"1223";13_9_10;COMUNA 13;"9";"10";"537";"219";"318";"68,87%";"336";"335";"99,70%";"1";"0,30%";"239";"25";"10.46";"214";"89,54%";"10.46";10.460
"MULTIPOLYGON (((-58.458008923227 -34.5571536397745,-58.4571001693248 -34.5566129431179,-58.4562819697223 -34.557556325946,-58.457191069141 -34.5580962539419,-58.4581057984565 -34.5586393444905,-58.4589195615945 -34.5576953860638,-58.458008923227 -34.5571536397745)))";;"1224";13_9_2;COMUNA 13;"9";"2";"699";"304";"395";"76,96%";"434";"434";"100,00%";"0";"0,00%";"303";"3";"0.99";"300";"99,01%";"0.99";0.990
"MULTIPOLYGON (((-58.4599146547921 -34.5582871297288,-58.4597274672304 -34.5581759935314,-58.4589195615945 -34.5576953860638,-58.4581057984565 -34.5586393444905,-58.4589357557733 -34.5591322120239,-58.4590958748377 -34.5592268690063,-58.4592432362196 -34.5590562317779,-58.4599146547921 -34.5582871297288)))";;"1225";13_9_3;COMUNA 13;"9";"3";"506";"213";"293";"72,70%";"354";"354";"100,00%";"0";"0,00%";"247";"3";"1.21";"244";"98,79%";"1.21";1.210
"MULTIPOLYGON (((-58.4590958748377 -34.5592268690063,-58.4589357557733 -34.5591322120239,-58.4581057984565 -34.5586393444905,-58.4573049572104 -34.559568367669,-58.4582963158187 -34.5601570958732,-58.4585324737748 -34.5598793452119,-58.4590958748377 -34.5592268690063)))";;"1226";13_9_4;COMUNA 13;"9";"4";"572";"246";"326";"75,46%";"401";"401";"100,00%";"0";"0,00%";"293";"2";"0.68";"291";"99,32%";"0.68";0.680
"MULTIPOLYGON (((-58.4581057984565 -34.5586393444905,-58.457191069141 -34.5580962539419,-58.4562819697223 -34.557556325946,-58.4554779690991 -34.558483294793,-58.4563869031634 -34.5590230878339,-58.4573049572104 -34.559568367669,-58.4581057984565 -34.5586393444905)))";;"1227";13_9_5;COMUNA 13;"9";"5";"1175";"502";"673";"74,59%";"620";"619";"99,84%";"1";"0,16%";"488";"4";"0.82";"484";"99,18%";"0.82";0.820
"MULTIPOLYGON (((-58.4562819697223 -34.557556325946,-58.4556897845841 -34.5572047281462,-58.4553912680953 -34.5570259701359,-58.4545021102123 -34.5564934951141,-58.454011311802 -34.5570611630207,-58.4536977589774 -34.5574260160076,-58.4545889649724 -34.557955327785,-58.4554779690991 -34.558483294793,-58.4562819697223 -34.557556325946)))";;"1228";13_9_6;COMUNA 13;"9";"6";"685";"311";"374";"83,16%";"430";"430";"100,00%";"0";"0,00%";"320";"1";"0.31";"319";"99,69%";"0.31";0.310
"MULTIPOLYGON (((-58.4545889649724 -34.557955327785,-58.4536977589774 -34.5574260160076,-58.4529024990943 -34.5583513487648,-58.4537346356846 -34.5588484773942,-58.4537895386668 -34.558881229369,-58.4545889649724 -34.557955327785)))";;"1229";13_9_7;COMUNA 13;"9";"7";"677";"318";"359";"88,58%";"364";"363";"99,73%";"1";"0,28%";"296";"2";"0.68";"294";"99,32%";"0.68";0.680
"MULTIPOLYGON (((-58.4554779690991 -34.558483294793,-58.4545889649724 -34.557955327785,-58.4537895386668 -34.558881229369,-58.4545254129656 -34.5593208077016,-58.4546768448704 -34.5594111035008,-58.4553325592073 -34.5586508993045,-58.4554779690991 -34.558483294793)))";;"1230";13_9_8;COMUNA 13;"9";"8";"788";"337";"451";"74,72%";"429";"429";"100,00%";"0";"0,00%";"344";"1";"0.29";"343";"99,71%";"0.29";0.290
"MULTIPOLYGON (((-58.4563869031634 -34.5590230878339,-58.4554779690991 -34.558483294793,-58.4553325592073 -34.5586508993045,-58.4546768448704 -34.5594111035008,-58.4555817828539 -34.559950972617,-58.4563869031634 -34.5590230878339)))";;"1231";13_9_9;COMUNA 13;"9";"9";"868";"357";"511";"69,86%";"431";"431";"100,00%";"0";"0,00%";"363";"0";"0";"363";"100,00%";"0";0.000
"MULTIPOLYGON (((-58.4483860765979 -34.5672225646436,-58.4475316617536 -34.5676996654074,-58.4481332034997 -34.5683285688924,-58.4486427010004 -34.5680681947491,-58.449044406335 -34.5678537943786,-58.4483860765979 -34.5672225646436)))";;"1232";14_1_1;COMUNA 14;"1";"1";"429";"186";"243";"76,54%";"304";"304";"100,00%";"0";"0,00%";"210";"0";"0";"210";"100,00%";"0";0.000
"MULTIPOLYGON (((-58.4403825433069 -34.565333604984,-58.4403254915008 -34.5653812022695,-58.4395009578125 -34.5660694588935,-58.4394712392693 -34.5660942430624,-58.4394138457914 -34.5661421919788,-58.4406010110909 -34.5672014026902,-58.4415163892022 -34.5664966045413,-58.4403825433069 -34.565333604984)))";;"1233";14_1_10;COMUNA 14;"1";"10";"1210";"531";"679";"78,20%";"561";"561";"100,00%";"0";"0,00%";"462";"2";"0.43";"460";"99,57%";"0.43";0.430
"MULTIPOLYGON (((-58.4475316617536 -34.5676996654074,-58.4465054144301 -34.5682728684241,-58.4470421665835 -34.5688861341314,-58.4481332034997 -34.5683285688924,-58.4475316617536 -34.5676996654074)))";;"1234";14_1_2;COMUNA 14;"1";"2";"562";"244";"318";"76,73%";"333";"333";"100,00%";"0";"0,00%";"255";"27";"10.59";"228";"89,41%";"10.59";10.590
"MULTIPOLYGON (((-58.4475316617536 -34.5676996654074,-58.4470374628768 -34.5671829607183,-58.4468316477838 -34.5669677838838,-58.4461046854894 -34.5678149777536,-58.4461543933494 -34.5678717475396,-58.4456820016487 -34.5681657094958,-58.4456225718445 -34.5681902093059,-58.4464968988467 -34.5691609340617,-58.4466911142143 -34.5690656034352,-58.4470421665835 -34.5688861341314,-58.4465054144301 -34.5682728684241,-58.4475316617536 -34.5676996654074)))";;"1235";14_1_3;COMUNA 14;"1";"3";"862";"375";"487";"77,00%";"495";"495";"100,00%";"0";"0,00%";"400";"2";"0.5";"398";"99,50%";"0.5";0.500
"MULTIPOLYGON (((-58.4464261944977 -34.5658742318632,-58.4460645046408 -34.565661920262,-58.4455199733016 -34.5653404222543,-58.4447251426372 -34.5662694331408,-58.4451297722502 -34.5667298643374,-58.4454229083969 -34.5670516103952,-58.4457709466453 -34.5674337181075,-58.4461046854894 -34.5678149777536,-58.4468316477838 -34.5669677838838,-58.4470374628768 -34.5671829607183,-58.4475316617536 -34.5676996654074,-58.4483860765979 -34.5672225646436,-58.4478545000505 -34.5667128309692,-58.4477957635211 -34.5666783152585,-58.4473197439936 -34.566398877773,-58.4464261944977 -34.5658742318632)))";;"1236";14_1_4;COMUNA 14;"1";"4";"944";"424";"520";"81,54%";"455";"455";"100,00%";"0";"0,00%";"362";"1";"0.28";"361";"99,72%";"0.28";0.280
"MULTIPOLYGON (((-58.4461046854894 -34.5678149777536,-58.4457709466453 -34.5674337181075,-58.4454229083969 -34.5670516103952,-58.4444437788169 -34.5682005321219,-58.4457049621247 -34.5695497869019,-58.4464968988467 -34.5691609340617,-58.4456225718445 -34.5681902093059,-58.4456820016487 -34.5681657094958,-58.4461543933494 -34.5678717475396,-58.4461046854894 -34.5678149777536)))";;"1237";14_1_5;COMUNA 14;"1";"5";"1356";"612";"744";"82,26%";"774";"774";"100,00%";"0";"0,00%";"585";"29";"4.96";"556";"95,04%";"4.96";4.960
"MULTIPOLYGON (((-58.4437136140308 -34.5687500925378,-58.4448856859876 -34.5699520818779,-58.4457049621247 -34.5695497869019,-58.4444437788169 -34.5682005321219,-58.4442828248872 -34.5680283877716,-58.4437435440871 -34.5674167292458,-58.4429805116759 -34.5679981830381,-58.4437136140308 -34.5687500925378)))";;"1238";14_1_6;COMUNA 14;"1";"6";"1000";"455";"545";"83,49%";"562";"562";"100,00%";"0";"0,00%";"446";"0";"0";"446";"100,00%";"0";0.000
"MULTIPOLYGON (((-58.4429805116759 -34.5679981830381,-58.4421907260109 -34.5686197701021,-58.4429651325782 -34.5693107023928,-58.4441105934294 -34.5703326869862,-58.4448856859876 -34.5699520818779,-58.4437136140308 -34.5687500925378,-58.4429805116759 -34.5679981830381)))";;"1239";14_1_7;COMUNA 14;"1";"7";"849";"371";"478";"77,62%";"472";"472";"100,00%";"0";"0,00%";"367";"3";"0.82";"364";"99,18%";"0.82";0.820
"MULTIPOLYGON (((-58.444612402012 -34.5648045633298,-58.4436461944342 -34.5642340390567,-58.4423531619855 -34.5658400983496,-58.4415163892022 -34.5664966045413,-58.4406010110909 -34.5672014026902,-58.4421907260109 -34.5686197701021,-58.4429805116759 -34.5679981830381,-58.4437435440871 -34.5674167292458,-58.4442828248872 -34.5680283877716,-58.4444437788169 -34.5682005321219,-58.4454229083969 -34.5670516103952,-58.4451297722502 -34.5667298643374,-58.4447251426372 -34.5662694331408,-58.4455199733016 -34.5653404222543,-58.444612402012 -34.5648045633298)))";;"1240";14_1_8;COMUNA 14;"1";"8";"952";"415";"537";"77,28%";"392";"390";"99,49%";"2";"0,51%";"299";"0";"0";"299";"100,00%";"0";0.000
"MULTIPOLYGON (((-58.4412678561414 -34.5646092246505,-58.4411323854243 -34.56470765584,-58.4403825433069 -34.565333604984,-58.4415163892022 -34.5664966045413,-58.4423531619855 -34.5658400983496,-58.4412678561414 -34.5646092246505)))";;"1241";14_1_9;COMUNA 14;"1";"9";"1012";"439";"573";"76,61%";"465";"465";"100,00%";"0";"0,00%";"398";"0";"0";"398";"100,00%";"0";0.000
"MULTIPOLYGON (((-58.4348584978648 -34.562089157581,-58.4349578575982 -34.5617921951392,-58.4338756858189 -34.5615684837637,-58.4332704554836 -34.5614621374461,-58.432426769756 -34.5613860826971,-58.4318092541303 -34.5613606451914,-58.4311949074164 -34.5614077072922,-58.4310837164652 -34.5611573776232,-58.4310124276812 -34.5611894474223,-58.4309521488089 -34.561209855209,-58.4308906791237 -34.5612275864797,-58.4308281038132 -34.5612425004037,-58.4307646782427 -34.5612546674716,-58.4307005727294 -34.5612639468754,-58.4306359574833 -34.5612704795103,-58.4305710028493 -34.561274054143,-58.4305058790648 -34.5612747412438,-58.4304408414957 -34.5612726113054,-58.4303759753045 -34.5612675939249,-58.430311621013 -34.561259689193,-58.4302144086234 -34.5612476909988,-58.4301264760078 -34.5612338641359,-58.4300393107085 -34.561217149962,-58.4299529978351 -34.5611976189273,-58.4298676224693 -34.5611754119078,-58.4297834400597 -34.561150388123,-58.4297004505583 -34.5611226884266,-58.4296187390725 -34.5610923832699,-58.4295386461507 -34.561059402322,-58.4294600866142 -34.5610238864144,-58.4293833158255 -34.5609859060454,-58.4293084189174 -34.5609454612415,-58.4291990539751 -34.5608828228479,-58.4291265416344 -34.560840406667,-58.4290544552356 -34.5607974271546,-58.4289829650644 -34.560753813933,-58.4289119859365 -34.5607097078308,-58.4288415179092 -34.5606649679976,-58.4287715609549 -34.56061966486,-58.4287022002021 -34.5605737984425,-58.4286333505232 -34.5605273687224,-58.4285650970181 -34.56048044615,-58.4284973546165 -34.5604328898512,-58.4284302083894 -34.5603848407019,-58.4281455670719 -34.560115382205,-58.4280039708749 -34.5599801951422,-58.4279141119926 -34.5598943910768,-58.4277474194483 -34.5597222934939,-58.4275398068324 -34.5594899699286,-58.4273549134207 -34.5592831466852,-58.42728789605 -34.5593365099463,-58.4270737294283 -34.5595070186827,-58.4239023500394 -34.5620170093619,-58.423789575346 -34.5621526837324,-58.4235467647973 -34.5624478627686,-58.4233730602174 -34.5626751811825,-58.4233722573269 -34.5626756116613,-58.4234590463469 -34.5624523095699,-58.4231325493864 -34.5623221279856,-58.422118647415 -34.5626839239228,-58.4213109633143 -34.5629642285923,-58.4211432177898 -34.5630414989775,-58.420900008608 -34.5631938874897,-58.420710491665 -34.5633949581179,-58.4206182233944 -34.5635368340342,-58.4202966512442 -34.5641031562404,-58.4200545052178 -34.5646653502043,-58.4198864260768 -34.5649697050716,-58.4185713782176 -34.5639320443068,-58.4179579918755 -34.5634418356655,-58.4178021783266 -34.5633162816454,-58.4173947935983 -34.5629970354336,-58.4170092370367 -34.5626928477038,-58.4168020175887 -34.5623345398494,-58.41663545698 -34.5624702458547,-58.4164199047217 -34.5626405139984,-58.4161891012123 -34.5628229943736,-58.4160448218126 -34.5629081018893,-58.4158325177472 -34.5630397869703,-58.4156300946802 -34.5631599256821,-58.4154555138617 -34.5632711307759,-58.4153117638681 -34.563357839463,-58.4151115519663 -34.5634792458281,-58.415038656965 -34.5635192895851,-58.4149092126145 -34.5635981861316,-58.4147300375248 -34.5637012190056,-58.4146630181486 -34.5637378844143,-58.4144906560138 -34.5638356376915,-58.4142617501343 -34.5639610455794,-58.4139390887417 -34.5641290935622,-58.4135892647315 -34.5643043836036,-58.4135255699035 -34.5643318943882,-58.4132760578563 -34.564459686586,-58.4130773862475 -34.5645583427339,-58.4129287025906 -34.5646304684826,-58.4127393137113 -34.5647222261493,-58.4126254567887 -34.5647807032016,-58.412466459257 -34.5648728954584,-58.4123394007997 -34.5649406629926,-58.4115648846984 -34.5653260621943,-58.4109197907046 -34.5656684813638,-58.4107641157567 -34.5657510949132,-58.4102022153539 -34.5660544594116,-58.4093434368251 -34.5665098112324,-58.4086717621038 -34.5668530519338,-58.4078598177178 -34.5672680600989,-58.4076452430448 -34.5670624616051,-58.4075357440479 -34.5669574780213,-58.4074798535305 -34.566892590769,-58.40744080774 -34.5668458104977,-58.4073985272598 -34.5667984653434,-58.4073490960104 -34.566750412676,-58.4072971947561 -34.5667041195075,-58.4072430787601 -34.5666597972275,-58.4071865778006 -34.5666173753302,-58.4071280323672 -34.5665769243929,-58.4070674423178 -34.5665386556894,-58.4070062544604 -34.5665032741329,-58.4069410626756 -34.5664719049767,-58.4068876984979 -34.5664496260975,-58.4068329706505 -34.566429670616,-58.4067771344373 -34.5664121794986,-58.4067201899487 -34.5663970118926,-58.4066623924406 -34.5663843791904,-58.406603912176 -34.5663742814692,-58.4065378538218 -34.5663659408742,-58.4064075158062 -34.5663628525401,-58.4062400491261 -34.5663749588329,-58.4061784921854 -34.5663824658879,-58.406117955124 -34.5663925087065,-58.4060580974486 -34.5664050167068,-58.4059990042403 -34.5664200603548,-58.405941016126 -34.5664374989587,-58.4058841331014 -34.56645733252,-58.4058284402963 -34.5664795610801,-58.4057742782912 -34.5665041143736,-58.405718921927 -34.5665322587916,-58.405611531148 -34.5665858729323,-58.4053111571123 -34.5667398233242,-58.4050812980863 -34.5668578892167,-58.4046471291583 -34.5670786790664,-58.4045003042595 -34.5671543166782,-58.4044486104826 -34.5671786592803,-58.4043956404402 -34.5672018744412,-58.4043236807292 -34.5672316300806,-58.4042699465232 -34.5672518165205,-58.4042027591593 -34.567274602238,-58.4041443443047 -34.5672921806322,-58.4040647286124 -34.5673129179689,-58.4039930338925 -34.5673287292712,-58.4039356453809 -34.5673394767758,-58.4038466699576 -34.5673528147762,-58.4037572710177 -34.5673630537809,-58.4036677890611 -34.5673702643791,-58.4035984856199 -34.5673753014892,-58.4031514375458 -34.5671423980518,-58.4030238705142 -34.5665957626388,-58.4027530706974 -34.5669348701027,-58.4027183897515 -34.5669783056646,-58.402677147485 -34.5670299777859,-58.4025983126469 -34.5671485357121,-58.4024819145357 -34.5672928508307,-58.4023694275538 -34.5674436469228,-58.4023304046645 -34.5674865872455,-58.4022726370321 -34.5675502234035,-58.4017998226579 -34.5680979699829,-58.4013058895436 -34.568528163759,-58.4004853202041 -34.5691359436281,-58.4001256522954 -34.5693507965668,-58.3999877931814 -34.5696113942161,-58.399775412328 -34.5699766723634,-58.3996686946237 -34.5702556433974,-58.3996595777738 -34.5704906487924,-58.3997215237438 -34.5707623825773,-58.399916627017 -34.5710341848782,-58.4002861573351 -34.5714520683337,-58.4003778599433 -34.5715557815968,-58.4005334262456 -34.5717618556514,-58.4005552854893 -34.5717908821073,-58.4017574066073 -34.5731277544786,-58.4017766023223 -34.5731549644755,-58.401827550038 -34.573226405823,-58.40189895718 -34.5733265897959,-58.4020393637354 -34.5735252955798,-58.4021409598515 -34.5736319406858,-58.4025155826194 -34.5740112367831,-58.4026447150819 -34.5741387196367,-58.4026470909426 -34.5741409682823,-58.4027839867299 -34.574276397942,-58.4034418573903 -34.5734671072664,-58.403576575612 -34.5733117434489,-58.4036449994688 -34.5732331112532,-58.4043065468848 -34.5723776183934,-58.4048066877973 -34.5717230398989,-58.4049602758934 -34.5715821956893,-58.4051276495181 -34.5716281528957,-58.4060791889683 -34.5722941010998,-58.4060852915344 -34.5723807099568,-58.4061847458687 -34.5726202730364,-58.4063512653429 -34.5728589766084,-58.4066907357686 -34.5733098719325,-58.4073290000458 -34.5740772681477,-58.4074183106393 -34.5742106945684,-58.4076063652079 -34.5745052286927,-58.407812027601 -34.574827165958,-58.4079955527841 -34.5750216227645,-58.4082150693899 -34.5752542659869,-58.4083244027567 -34.575370094279,-58.4084493089004 -34.5754993806655,-58.4085433412669 -34.5755779468628,-58.4087729357704 -34.5757672818479,-58.408852846621 -34.5758276717839,-58.4089417792322 -34.5758936292554,-58.4090040777585 -34.5759350668729,-58.4090789706105 -34.5759874259444,-58.4091526708207 -34.5760409112545,-58.4092252635787 -34.5760954524169,-58.4092969189927 -34.5761513312102,-58.4093495101267 -34.5761948771673,-58.4093893349302 -34.5762302481683,-58.409427796789 -34.5762666749439,-58.4094648957478 -34.5763040870697,-58.4095005467066 -34.5763424140844,-58.4095347496648 -34.5763816559892,-58.409567419522 -34.5764217423228,-58.4095985562769 -34.5764626730865,-58.4096282449831 -34.5765045891693,-58.4096677127927 -34.5765662286326,-58.4096980746348 -34.5766208920048,-58.4097244340126 -34.5766766804398,-58.4097467057301 -34.5767336643287,-58.4097688865747 -34.5767997330623,-58.4097810317224 -34.5768479093655,-58.4099556713709 -34.5772396915329,-58.4107246594177 -34.5768968379936,-58.4109391138689 -34.5767998827951,-58.4117470183255 -34.5764347848257,-58.4131588327311 -34.5757967475574,-58.4145027489977 -34.5751893021901,-58.4146885785905 -34.5751064141696,-58.4146236083855 -34.574969270119,-58.4146769126913 -34.5748125943269,-58.4147954133718 -34.5746951711261,-58.4149863622269 -34.5745910865723,-58.4151802389302 -34.5745777813546,-58.4155175866029 -34.5745534745639,-58.4159971709794 -34.5744410485915,-58.4162599696398 -34.5743514267419,-58.417463003461 -34.5737672762136,-58.4179491992403 -34.5735379386193,-58.4181732622961 -34.5734322414059,-58.4192044767042 -34.5729714667927,-58.4195000683993 -34.5728393830212,-58.4200221862181 -34.5726025847306,-58.4205481332696 -34.57236402488,-58.4217412963943 -34.5718227881523,-58.4221174405909 -34.5716522022373,-58.4225150884286 -34.5714718037356,-58.4226085080413 -34.5714294348098,-58.422614640408 -34.5714266415228,-58.4226949812076 -34.5713901985252,-58.4229986455062 -34.5712675459139,-58.4232447440543 -34.5711681848127,-58.4234090933122 -34.5711017560917,-58.4235232860583 -34.5710556640498,-58.4236024822923 -34.5710189272967,-58.4236025499748 -34.5710189662867,-58.4236062752038 -34.5710240630335,-58.4237698253135 -34.5709495638382,-58.4237607042084 -34.5709455944324,-58.4238870772874 -34.5708867589061,-58.424103460822 -34.5707863302315,-58.424199347248 -34.5707418515529,-58.4243741787531 -34.5706496490747,-58.4244024515225 -34.5706347277275,-58.4258892271244 -34.5698504329539,-58.4261969913097 -34.5696738275931,-58.4297198361905 -34.5676523480048,-58.4301749859636 -34.5673911911203,-58.4306788406815 -34.5671020863444,-58.4312269757943 -34.5667758765989,-58.4322453189086 -34.5661698407384,-58.4333101396621 -34.5655362006698,-58.4337983083943 -34.5652456706344,-58.4344095128686 -34.5648883332762,-58.4354897950313 -34.5642541846563,-58.436476744192 -34.5636609236989,-58.4366673887005 -34.563546311537,-58.4368788084973 -34.56341923813,-58.4380452333742 -34.5629767835772,-58.4381759176256 -34.5629464564394,-58.4389223059151 -34.5627732865384,-58.4395256521549 -34.5626733981169,-58.4399279956942 -34.5626067807241,-58.4408579162003 -34.5624387037225,-58.4413445416062 -34.5623507577305,-58.4412201153105 -34.5621817753437,-58.441164038223 -34.5620987315347,-58.4409659222122 -34.5621363264067,-58.4408161802295 -34.5621650016206,-58.440657916399 -34.5621946821988,-58.4405100005056 -34.5622223502801,-58.4403766949273 -34.562241964163,-58.4402287804825 -34.562263589385,-58.4400906050779 -34.5622842091453,-58.4399475600449 -34.5623053313849,-58.4398197328566 -34.5623229315074,-58.4396663402985 -34.5623435479344,-58.4395506872566 -34.5623586323552,-58.4394021655389 -34.5623737103984,-58.4392469478799 -34.5623902976043,-58.4390880782297 -34.5624063803632,-58.4389328605912 -34.5624224636265,-58.4387861646855 -34.5624375412755,-58.4386589474687 -34.5624490977831,-58.4385250346016 -34.5624611563757,-58.4383612956851 -34.5624757265947,-58.4382219041769 -34.5624892943919,-58.4380910345793 -34.5625013531185,-58.4379595577556 -34.5625083761497,-58.4378347763838 -34.5625154004032,-58.4376953880396 -34.5625178896495,-58.4375706079945 -34.5625203817446,-58.4374251325348 -34.5625238765156,-58.4372790488432 -34.5625258603571,-58.4371250526191 -34.56252683528,-58.4369789687604 -34.5625293223055,-58.4368207113021 -34.5625318065763,-58.4359489125221 -34.5625421768371,-58.4354104876816 -34.5625437512917,-58.4353191559495 -34.5624683711467,-58.4353191802043 -34.5624683631464,-58.4349447107172 -34.5621597437334,-58.4348584978648 -34.562089157581)))";;"1242";14_10_1;COMUNA 14;"10";"1";"25";"17";"8";"212,50%";"21";"20";"95,24%";"1";"5,00%";"6";"0";"0";"6";"100,00%";"0";0.000
;"58.407645243044826 -34.567062461605147,-58.407859817717835 -34.567268060098904,-58.408671762103793 -34.566853051933762,-58.40934343682509 -34.566509811232372,-58.410202215353948 -34.566054459411575,-58.41076411575672 -34.565751094913189,-58.410919790704583 -34.565668481363801,-58.411564884698365 -34.56532606219433,-58.412339400799652 -34.564940662992633,-58.412466459257033 -34.564872895458436,-58.41262545678871 -34.564780703201578,-58.412739313711349 -34.564722226149307,-58.412928702590555 -34.564630468482619,-58.413077386247451 -34.564558342733896,-58.413276057856322 -34.564459686586005,-58.413525569903463 -34.564331894388182,-58.413589264731456 -34.564304383603577,-58.413939088741735 -34.564129093562151,-58.41426175013433 -34.563961045579447,-58.414490656013776 -34.563835637691533,-58.414663018148637 -34.563737884414302,-58.414730037524812 -34.563701219005559,-58.414909212614468 -34.563598186131635,-58.415038656965024 -34.563519289585095,-58.415111551966284 -34.563479245828056,-58.415311763868146 -34.563357839462981,-58.415455513861708 -34.563271130775895,-58.415630094680218 -34.563159925682143,-58.415832517747226 -34.563039786970315,-58.416044821812584 -34.562908101889256,-58.416189101212296 -34.56282299437364,-58.416419904721721 -34.562640513998382,-58.416635456980032 -34.562470245854655,-58.416802017588665 -34.562334539849424,-58.417009237036702 -34.562692847703779,-58.417394793598298 -34.562997035433597)))""";"1243";14_10_2;COMUNA 14;"10";"2";"0";"0";"0";"0,00%";"0";"0";"0,00%";"0";"0,00%";"0";"0";"0";"0";"0,00%";"0";0.000
"MULTIPOLYGON (((-58.4242768267056 -34.5748057115928,-58.4235293221322 -34.5750680907644,-58.4242546551726 -34.5763601365164,-58.4235298746104 -34.5767945722688,-58.4243510272302 -34.5776821942361,-58.4246956969229 -34.5780548528606,-58.425252448352 -34.5786635010942,-58.4259509753483 -34.5783105296294,-58.4262024389153 -34.5782487715085,-58.4265312229552 -34.5781679504994,-58.4267814935005 -34.5781064725322,-58.4267174328779 -34.5779805328977,-58.4266562649694 -34.5778602281201,-58.4257146925106 -34.5760088122526,-58.4252486006922 -34.5750922229346,-58.4249874541523 -34.5745562043135,-58.424409926001 -34.5747589204458,-58.4244089524223 -34.5747570888612,-58.4244068486345 -34.5747599866115,-58.4242767192992 -34.5748055044176,-58.4242768267056 -34.5748057115928)))";;"1244";14_11_1;COMUNA 14;"11";"1";"1047";"484";"563";"85,97%";"404";"402";"99,50%";"2";"0,50%";"284";"4";"1.41";"280";"98,59%";"1.41";1.410
"MULTIPOLYGON (((-58.4242556852766 -34.5791627899058,-58.4250978448346 -34.5786907632538,-58.425252448352 -34.5786635010942,-58.4246956969229 -34.5780548528606,-58.4243510272302 -34.5776821942361,-58.4234156074984 -34.5782489627558,-58.4237361916887 -34.5785942207895,-58.4242556852766 -34.5791627899058)))";;"1245";14_11_10;COMUNA 14;"11";"10";"444";"210";"234";"89,74%";"315";"313";"99,37%";"2";"0,64%";"208";"1";"0.48";"207";"99,52%";"0.48";0.480
"MULTIPOLYGON (((-58.4234032239142 -34.579642607959,-58.4241278947527 -34.579251392415,-58.4242556852766 -34.5791627899058,-58.4237361916887 -34.5785942207895,-58.4234156074984 -34.5782489627558,-58.4225282118078 -34.5787865837183,-58.4225708364853 -34.578856882363,-58.4226692098132 -34.5787966304603,-58.4229641316005 -34.5792094905227,-58.4228438694426 -34.5792817782685,-58.4231205607801 -34.5797187879009,-58.423346528281 -34.579568220898,-58.4234032239142 -34.579642607959)))";;"1246";14_11_11;COMUNA 14;"11";"11";"526";"233";"293";"79,52%";"467";"467";"100,00%";"0";"0,00%";"316";"5";"1.58";"311";"98,42%";"1.58";1.580
"MULTIPOLYGON (((-58.4205857356285 -34.5807932150678,-58.4207259002645 -34.5807126407495,-58.4209472773601 -34.5806690461041,-58.4212843845272 -34.5806741998711,-58.4214650921224 -34.5807389271015,-58.4215970409138 -34.5808447887726,-58.4223234299931 -34.5803591986164,-58.4234032239142 -34.579642607959,-58.423346528281 -34.579568220898,-58.4231205607801 -34.5797187879009,-58.4228438694426 -34.5792817782685,-58.4229641316005 -34.5792094905227,-58.4226692098132 -34.5787966304603,-58.4225708364853 -34.578856882363,-58.4225282118078 -34.5787865837183,-58.4234156074984 -34.5782489627558,-58.4228723990675 -34.5776639734918,-58.422588415138 -34.5773588677026,-58.4212123403703 -34.5759041915999,-58.4209887121983 -34.5759859498245,-58.4208724699766 -34.5760278132223,-58.4202246623575 -34.5762609796353,-58.4200253228486 -34.5762947847719,-58.4197197686037 -34.5762405907753,-58.4183494902206 -34.5758640283809,-58.4181968624717 -34.5762780043702,-58.4180100466992 -34.5766142883032,-58.4177372524204 -34.5769149049894,-58.4172693079338 -34.5773487678462,-58.4202203859078 -34.580416849642,-58.4205857356285 -34.5807932150678)))";;"1247";14_11_12;COMUNA 14;"11";"12";"727";"344";"383";"89,82%";"514";"513";"99,81%";"1";"0,19%";"362";"3";"0.83";"359";"99,17%";"0.83";0.830
"MULTIPOLYGON (((-58.4183494902206 -34.5758640283809,-58.4197197686037 -34.5762405907753,-58.4200253228486 -34.5762947847719,-58.4202246623575 -34.5762609796353,-58.4208724699766 -34.5760278132223,-58.4209887121983 -34.5759859498245,-58.4212123403703 -34.5759041915999,-58.4205850363325 -34.5749912621281,-58.4194272565426 -34.5755006674699,-58.4188261386604 -34.5747023909362,-58.4200242783547 -34.5741733566217,-58.4192044767042 -34.5729714667927,-58.4181732622961 -34.5734322414059,-58.4179491992403 -34.5735379386193,-58.417463003461 -34.5737672762136,-58.4162599696398 -34.5743514267419,-58.4159971709794 -34.5744410485915,-58.4155175866029 -34.5745534745639,-58.4151802389302 -34.5745777813546,-58.4149863622269 -34.5745910865723,-58.4147954133718 -34.5746951711261,-58.4146769126913 -34.5748125943269,-58.4146236083855 -34.574969270119,-58.4146885785905 -34.5751064141696,-58.4149194103867 -34.5752386934353,-58.4155735626351 -34.5755431155319,-58.4172693079338 -34.5773487678462,-58.4177372524204 -34.5769149049894,-58.4180100466992 -34.5766142883032,-58.4181968624717 -34.5762780043702,-58.4183494902206 -34.5758640283809)))";;"1248";14_11_13;COMUNA 14;"11";"13";"776";"344";"432";"79,63%";"673";"673";"100,00%";"0";"0,00%";"399";"2";"0.5";"397";"99,50%";"0.5";0.500
"MULTIPOLYGON (((-58.4200242783547 -34.5741733566217,-58.4188261386604 -34.5747023909362,-58.4194272565426 -34.5755006674699,-58.4205850363325 -34.5749912621281,-58.4201980936434 -34.5744281463936,-58.4200242783547 -34.5741733566217)))";;"1249";14_11_14;COMUNA 14;"11";"14";"523";"238";"285";"83,51%";"333";"333";"100,00%";"0";"0,00%";"231";"2";"0.87";"229";"99,13%";"0.87";0.870
"MULTIPOLYGON (((-58.4229116242676 -34.5739676330147,-58.4235293221322 -34.5750680907644,-58.4242768267056 -34.5748057115928,-58.4242767192992 -34.5748055044176,-58.4244068486345 -34.5747599866115,-58.4244089524223 -34.5747570888612,-58.424409926001 -34.5747589204458,-58.4249874541523 -34.5745562043135,-58.4248534796167 -34.5742812215945,-58.4232447440543 -34.5711681848127,-58.4229986455062 -34.5712675459139,-58.4226949812076 -34.5713901985252,-58.422614640408 -34.5714266415228,-58.4226085080413 -34.5714294348098,-58.4225150884286 -34.5714718037356,-58.4221174405909 -34.5716522022373,-58.4217412963943 -34.5718227881523,-58.4224306461299 -34.5731108190752,-58.4229116242676 -34.5739676330147)))";;"1250";14_11_2;COMUNA 14;"11";"2";"955";"469";"486";"96,50%";"760";"760";"100,00%";"0";"0,00%";"468";"4";"0.85";"464";"99,15%";"0.85";0.850
"MULTIPOLYGON (((-58.4217412963943 -34.5718227881523,-58.4205481332696 -34.57236402488,-58.4212568075419 -34.5736291102602,-58.4224306461299 -34.5731108190752,-58.4217412963943 -34.5718227881523)))";;"1251";14_11_3;COMUNA 14;"11";"3";"507";"225";"282";"79,79%";"334";"334";"100,00%";"0";"0,00%";"237";"1";"0.42";"236";"99,58%";"0.42";0.420
"MULTIPOLYGON (((-58.4205481332696 -34.57236402488,-58.4200221862181 -34.5726025847306,-58.4195000683993 -34.5728393830212,-58.4192044767042 -34.5729714667927,-58.4200242783547 -34.5741733566217,-58.4208161033223 -34.5738237568602,-58.4212568075419 -34.5736291102602,-58.4205481332696 -34.57236402488)))";;"1252";14_11_4;COMUNA 14;"11";"4";"710";"300";"410";"73,17%";"387";"387";"100,00%";"0";"0,00%";"279";"0";"0";"279";"100,00%";"0";0.000
"MULTIPOLYGON (((-58.4212568075419 -34.5736291102602,-58.4208161033223 -34.5738237568602,-58.4200242783547 -34.5741733566217,-58.4201980936434 -34.5744281463936,-58.4205850363325 -34.5749912621281,-58.421734456237 -34.5744855755039,-58.4229116242676 -34.5739676330147,-58.4224306461299 -34.5731108190752,-58.4212568075419 -34.5736291102602)))";;"1253";14_11_5;COMUNA 14;"11";"5";"799";"375";"424";"88,44%";"553";"553";"100,00%";"0";"0,00%";"379";"1";"0.26";"378";"99,74%";"0.26";0.260
"MULTIPOLYGON (((-58.4229116242676 -34.5739676330147,-58.421734456237 -34.5744855755039,-58.4205850363325 -34.5749912621281,-58.4212123403703 -34.5759041915999,-58.4221281383174 -34.5755693444373,-58.4223028826295 -34.5755070053916,-58.4232557114258 -34.5751670913567,-58.4235293221322 -34.5750680907644,-58.4229116242676 -34.5739676330147)))";;"1254";14_11_6;COMUNA 14;"11";"6";"911";"435";"476";"91,39%";"504";"504";"100,00%";"0";"0,00%";"353";"3";"0.85";"350";"99,15%";"0.85";0.850
"MULTIPOLYGON (((-58.4235293221322 -34.5750680907644,-58.4232557114258 -34.5751670913567,-58.4223028826295 -34.5755070053916,-58.4235298746104 -34.5767945722688,-58.4242546551726 -34.5763601365164,-58.4235293221322 -34.5750680907644)))";;"1255";14_11_7;COMUNA 14;"11";"7";"561";"259";"302";"85,76%";"428";"426";"99,53%";"2";"0,47%";"267";"18";"6.74";"249";"93,26%";"6.74";6.740
"MULTIPOLYGON (((-58.4223028826295 -34.5755070053916,-58.4221281383174 -34.5755693444373,-58.4212123403703 -34.5759041915999,-58.422588415138 -34.5773588677026,-58.4235298746104 -34.5767945722688,-58.4223028826295 -34.5755070053916)))";;"1256";14_11_8;COMUNA 14;"11";"8";"1045";"479";"566";"84,63%";"746";"745";"99,87%";"1";"0,13%";"529";"1";"0.19";"528";"99,81%";"0.19";0.190
"MULTIPOLYGON (((-58.4235298746104 -34.5767945722688,-58.422588415138 -34.5773588677026,-58.4228723990675 -34.5776639734918,-58.4234156074984 -34.5782489627558,-58.4243510272302 -34.5776821942361,-58.4235298746104 -34.5767945722688)))";;"1257";14_11_9;COMUNA 14;"11";"9";"694";"322";"372";"86,56%";"607";"607";"100,00%";"0";"0,00%";"412";"20";"4.85";"392";"95,15%";"4.85";4.850
"MULTIPOLYGON (((-58.427995677406 -34.5817871880603,-58.4283119451582 -34.5815275485444,-58.4285273604469 -34.5813507003278,-58.4287604065756 -34.5811593489871,-58.4288266746178 -34.5811049285242,-58.429010061146 -34.5809544096685,-58.4289217098766 -34.5808722691722,-58.4284778369545 -34.5804383247211,-58.4280649716708 -34.5799822034086,-58.4278430084109 -34.5797370596068,-58.4265312229552 -34.5781679504994,-58.4262024389153 -34.5782487715085,-58.4259509753483 -34.5783105296294,-58.425252448352 -34.5786635010942,-58.4250978448346 -34.5786907632538,-58.4242556852766 -34.5791627899058,-58.4243773742841 -34.579291182987,-58.4245691912991 -34.5795001554369,-58.4253340291054 -34.5803526809262,-58.4261937026742 -34.5797294644741,-58.427072082992 -34.5807325121502,-58.427995677406 -34.5817871880603)))";;"1258";14_12_1;COMUNA 14;"12";"1";"434";"187";"247";"75,71%";"315";"315";"100,00%";"0";"0,00%";"230";"15";"6.52";"215";"93,48%";"6.52";6.520
"MULTIPOLYGON (((-58.4237567209399 -34.5814959675901,-58.4228993108856 -34.5821174067865,-58.4240194688545 -34.583016184158,-58.4246722879755 -34.5825282002314,-58.4248693937053 -34.5823790299928,-58.4237567209399 -34.5814959675901)))";;"1259";14_12_10;COMUNA 14;"12";"10";"743";"341";"402";"84,83%";"604";"604";"100,00%";"0";"0,00%";"352";"2";"0.57";"350";"99,43%";"0.57";0.570
"MULTIPOLYGON (((-58.4215970409138 -34.5808447887726,-58.4216619690829 -34.5809607056081,-58.4217335550526 -34.5811820529076,-58.4228993108856 -34.5821174067865,-58.4237567209399 -34.5814959675901,-58.4226022797042 -34.5805797812461,-58.4223234299931 -34.5803591986164,-58.4215970409138 -34.5808447887726)))";;"1260";14_12_11;COMUNA 14;"12";"11";"606";"285";"321";"88,79%";"357";"355";"99,44%";"2";"0,56%";"274";"22";"8.03";"252";"91,97%";"8.03";8.030
"MULTIPOLYGON (((-58.4261937026742 -34.5797294644741,-58.4253340291054 -34.5803526809262,-58.4262353100472 -34.5813574317401,-58.427072082992 -34.5807325121502,-58.4261937026742 -34.5797294644741)))";;"1261";14_12_2;COMUNA 14;"12";"2";"841";"381";"460";"82,83%";"526";"524";"99,62%";"2";"0,38%";"382";"48";"12.57";"334";"87,43%";"12.57";12.570
"MULTIPOLYGON (((-58.427072082992 -34.5807325121502,-58.4262353100472 -34.5813574317401,-58.425436854816 -34.5819536940761,-58.4263940743456 -34.5830137444863,-58.4271807847827 -34.5824112751373,-58.427995677406 -34.5817871880603,-58.427072082992 -34.5807325121502)))";;"1262";14_12_3;COMUNA 14;"12";"3";"633";"312";"321";"97,20%";"559";"559";"100,00%";"0";"0,00%";"329";"10";"3.04";"319";"96,96%";"3.04";3.040
"MULTIPOLYGON (((-58.4253340291054 -34.5803526809262,-58.4245247675695 -34.5809392857992,-58.4253041720314 -34.5818066756021,-58.425436854816 -34.5819536940761,-58.4262353100472 -34.5813574317401,-58.4253340291054 -34.5803526809262)))";;"1263";14_12_4;COMUNA 14;"12";"4";"767";"290";"477";"60,80%";"463";"460";"99,35%";"3";"0,65%";"344";"66";"19.19";"278";"80,81%";"19.19";19.190
"MULTIPOLYGON (((-58.4236117017085 -34.5798800092127,-58.4243961733612 -34.5807961409934,-58.4245247675695 -34.5809392857992,-58.4253340291054 -34.5803526809262,-58.4245691912991 -34.5795001554369,-58.4243773742841 -34.579291182987,-58.4242556852766 -34.5791627899058,-58.4241278947527 -34.579251392415,-58.4234032239142 -34.579642607959,-58.4236117017085 -34.5798800092127)))";;"1264";14_12_5;COMUNA 14;"12";"5";"829";"353";"476";"74,16%";"501";"500";"99,80%";"1";"0,20%";"380";"6";"1.58";"374";"98,42%";"1.58";1.580
"MULTIPOLYGON (((-58.4236117017085 -34.5798800092127,-58.4234032239142 -34.579642607959,-58.4223234299931 -34.5803591986164,-58.4226022797042 -34.5805797812461,-58.4237567209399 -34.5814959675901,-58.4245247675695 -34.5809392857992,-58.4243961733612 -34.5807961409934,-58.4236117017085 -34.5798800092127)))";;"1265";14_12_6;COMUNA 14;"12";"6";"551";"228";"323";"70,59%";"357";"356";"99,72%";"1";"0,28%";"264";"6";"2.27";"258";"97,73%";"2.27";2.270
"MULTIPOLYGON (((-58.4245247675695 -34.5809392857992,-58.4237567209399 -34.5814959675901,-58.4248693937053 -34.5823790299928,-58.4250245905329 -34.5822616083739,-58.425436854816 -34.5819536940761,-58.4253041720314 -34.5818066756021,-58.4245247675695 -34.5809392857992)))";;"1266";14_12_7;COMUNA 14;"12";"7";"324";"149";"175";"85,14%";"187";"186";"99,47%";"1";"0,54%";"145";"2";"1.38";"143";"98,62%";"1.38";1.380
"MULTIPOLYGON (((-58.425436854816 -34.5819536940761,-58.4250245905329 -34.5822616083739,-58.4248693937053 -34.5823790299928,-58.4260252466558 -34.5832962514456,-58.4263940743456 -34.5830137444863,-58.425436854816 -34.5819536940761)))";;"1267";14_12_8;COMUNA 14;"12";"8";"332";"145";"187";"77,54%";"281";"281";"100,00%";"0";"0,00%";"188";"0";"0";"188";"100,00%";"0";0.000
"MULTIPOLYGON (((-58.4248693937053 -34.5823790299928,-58.4246722879755 -34.5825282002314,-58.4240194688545 -34.583016184158,-58.4251776149936 -34.5839453865896,-58.4260252466558 -34.5832962514456,-58.4248693937053 -34.5823790299928)))";;"1268";14_12_9;COMUNA 14;"12";"9";"671";"313";"358";"87,43%";"399";"394";"98,75%";"5";"1,27%";"327";"74";"22.63";"253";"77,37%";"22.63";22.630
"MULTIPOLYGON (((-58.4378658218065 -34.5877394157562,-58.4379175218298 -34.5877041431526,-58.4379180584624 -34.5877037772497,-58.4367007880317 -34.586807451171,-58.4366666161718 -34.5867822961958,-58.4357013612324 -34.586070930891,-58.4347532343449 -34.5853721679433,-58.434364234361 -34.5856804006486,-58.4342385116387 -34.5857857277889,-58.4340374965181 -34.5859377996009,-58.4336659522832 -34.5862333575784,-58.4335119653099 -34.5863558394052,-58.4335116099096 -34.5863560722194,-58.4333078638245 -34.5865175791636,-58.4329020732408 -34.5868381979705,-58.4339461859347 -34.5874953059611,-58.4341126290932 -34.5876000675974,-58.4348695042775 -34.5880749095588,-58.4361950356558 -34.5889065760834,-58.4362746276183 -34.5890006816254,-58.4371243928533 -34.5896120139141,-58.4380514326887 -34.588990067068,-58.4381233194337 -34.5889418401936,-58.4382498876198 -34.588856862205,-58.4382513161777 -34.5888559265536,-58.4382614131552 -34.5888488680774,-58.4382753180795 -34.5888393296469,-58.4382889345329 -34.5888299342752,-58.438303358743 -34.5888199665907,-58.4383180137182 -34.5888099035384,-58.4383323802223 -34.5887999835449,-58.4383458812786 -34.5887906358499,-58.4383601900631 -34.5887808112538,-58.4383737488122 -34.5887714158611,-58.4383874806415 -34.5887619250892,-58.4383983853129 -34.5887544374079,-58.4384128666407 -34.5887463302584,-58.4384255019724 -34.5887384612705,-58.4384980577219 -34.5886900044596,-58.438498470381 -34.5886900045414,-58.4385131991696 -34.5886839029359,-58.4385265268416 -34.5886755570139,-58.4385333892091 -34.5886712576826,-58.4385410661182 -34.5886664480331,-58.4385543938121 -34.5886580066959,-58.4385685869034 -34.5886491361737,-58.4385827799916 -34.5886402656497,-58.4385951845511 -34.5886323965985,-58.4386090314684 -34.5886237168274,-58.4386143422687 -34.5886203758809,-58.4382715487486 -34.5884590336584,-58.438081932004 -34.5883682172576,-58.4378658218065 -34.5877394157562)))";;"1269";14_13_1;COMUNA 14;"13";"1";"697";"319";"378";"84,39%";"299";"299";"100,00%";"0";"0,00%";"267";"36";"13.48";"231";"86,52%";"13.48";13.480
"MULTIPOLYGON (((-58.4353108185579 -34.5908218799388,-58.436036696171 -34.5903418102852,-58.4361739156558 -34.5902497238368,-58.4360614536768 -34.5901489206697,-58.4352614104643 -34.589575128937,-58.4351341295971 -34.5894848853751,-58.4339764214523 -34.5887171932513,-58.4330842618401 -34.5893588367328,-58.4343665286112 -34.5902105132344,-58.4334329724872 -34.5908415856857,-58.4343632128599 -34.5914486603437,-58.4353108185579 -34.5908218799388)))";;"1270";14_13_10;COMUNA 14;"13";"10";"735";"326";"409";"79,71%";"366";"364";"99,45%";"2";"0,55%";"294";"9";"3.06";"285";"96,94%";"3.06";3.060
"MULTIPOLYGON (((-58.4321852178125 -34.5887616899068,-58.431207891718 -34.5893894949684,-58.4317131787714 -34.5897192149624,-58.4321693452809 -34.5900169474612,-58.4334329724872 -34.5908415856857,-58.4343665286112 -34.5902105132344,-58.4330842618401 -34.5893588367328,-58.4339764214523 -34.5887171932513,-58.4331294809576 -34.5881554895316,-58.4321852178125 -34.5887616899068)))";;"1271";14_13_11;COMUNA 14;"13";"11";"621";"262";"359";"72,98%";"324";"323";"99,69%";"1";"0,31%";"260";"38";"14.62";"222";"85,38%";"14.62";14.620
"MULTIPOLYGON (((-58.4317131787714 -34.5897192149624,-58.431207891718 -34.5893894949684,-58.4302506532686 -34.5900043392133,-58.4307684573036 -34.590337305979,-58.4312728988091 -34.5906616047735,-58.4325165234973 -34.5914611054045,-58.4334455752895 -34.5920583975817,-58.4341326337843 -34.591601077426,-58.4343632128599 -34.5914486603437,-58.4334329724872 -34.5908415856857,-58.4321693452809 -34.5900169474612,-58.4317131787714 -34.5897192149624)))";;"1272";14_13_12;COMUNA 14;"13";"12";"559";"248";"311";"79,74%";"320";"320";"100,00%";"0";"0,00%";"247";"4";"1.62";"243";"98,38%";"1.62";1.620
"MULTIPOLYGON (((-58.4335119653099 -34.5863558394052,-58.4336659522832 -34.5862333575784,-58.4340374965181 -34.5859377996009,-58.4342385116387 -34.5857857277889,-58.434364234361 -34.5856804006486,-58.4347532343449 -34.5853721679433,-58.4338168713973 -34.5846820626639,-58.4329300693498 -34.5840284425916,-58.4316705908299 -34.5831001330949,-58.4306894172961 -34.5823769626484,-58.430166404102 -34.5819914563609,-58.4300412774777 -34.5818796577695,-58.4291100736561 -34.5810473284036,-58.429010061146 -34.5809544096685,-58.4288266746178 -34.5811049285242,-58.4287604065756 -34.5811593489871,-58.4285273604469 -34.5813507003278,-58.4283119451582 -34.5815275485444,-58.427995677406 -34.5817871880603,-58.4271807847827 -34.5824112751373,-58.4272763634108 -34.5825177861709,-58.4280987061222 -34.5834366513569,-58.4283525959954 -34.5837202558165,-58.4286195098895 -34.584018441434,-58.4287149218309 -34.5841250921183,-58.4293961767438 -34.5848829164845,-58.4301734338951 -34.584273664609,-58.4311609446937 -34.5853996035013,-58.4318354157685 -34.5861685395616,-58.4329020732408 -34.5868381979705,-58.4333078638245 -34.5865175791636,-58.4335116099096 -34.5863560722194,-58.4335119653099 -34.5863558394052)))";;"1273";14_13_2;COMUNA 14;"13";"2";"676";"331";"345";"95,94%";"446";"445";"99,78%";"1";"0,22%";"313";"51";"16.29";"262";"83,71%";"16.29";16.290
"MULTIPOLYGON (((-58.4271807847827 -34.5824112751373,-58.4263940743456 -34.5830137444863,-58.4260252466558 -34.5832962514456,-58.4271516722847 -34.584190142443,-58.4273290181158 -34.58404787421,-58.4280987061222 -34.5834366513569,-58.4272763634108 -34.5825177861709,-58.4271807847827 -34.5824112751373)))";;"1274";14_13_3;COMUNA 14;"13";"3";"749";"357";"392";"91,07%";"591";"591";"100,00%";"0";"0,00%";"406";"20";"4.93";"386";"95,07%";"4.93";4.930
"MULTIPOLYGON (((-58.4271516722847 -34.584190142443,-58.4263136549141 -34.5848568241077,-58.4269899999451 -34.5853107043236,-58.4279970000759 -34.5859796839575,-58.4288456588533 -34.5853144727421,-58.4293961767438 -34.5848829164845,-58.4287149218309 -34.5841250921183,-58.4286195098895 -34.584018441434,-58.4283525959954 -34.5837202558165,-58.4280987061222 -34.5834366513569,-58.4273290181158 -34.58404787421,-58.4271516722847 -34.584190142443)))";;"1275";14_13_4;COMUNA 14;"13";"4";"595";"275";"320";"85,94%";"316";"315";"99,68%";"1";"0,32%";"242";"33";"13.64";"209";"86,36%";"13.64";13.640
"MULTIPOLYGON (((-58.4303481158693 -34.5859418071532,-58.4310719598453 -34.5867469590895,-58.4312138651324 -34.5866476255632,-58.4318354157685 -34.5861685395616,-58.4311609446937 -34.5853996035013,-58.4301734338951 -34.584273664609,-58.4293961767438 -34.5848829164845,-58.4288456588533 -34.5853144727421,-58.4279970000759 -34.5859796839575,-58.4291465271757 -34.5867433462002,-58.4300706120179 -34.5861268816347,-58.4303481158693 -34.5859418071532)))";;"1276";14_13_5;COMUNA 14;"13";"5";"723";"332";"391";"84,91%";"435";"432";"99,31%";"3";"0,69%";"301";"1";"0.33";"300";"99,67%";"0.33";0.330
"MULTIPOLYGON (((-58.4291488982263 -34.5880475544106,-58.4301230841513 -34.5873920172628,-58.4308229860176 -34.5869210562876,-58.4310719598453 -34.5867469590895,-58.4303481158693 -34.5859418071532,-58.4300706120179 -34.5861268816347,-58.4291465271757 -34.5867433462002,-58.4281571816935 -34.587403237706,-58.427369016059 -34.5879289487681,-58.4272047032482 -34.5880393984941,-58.4276927706795 -34.5883549042664,-58.4282015293208 -34.5886838651666,-58.4287125055115 -34.5890141626288,-58.4290624950078 -34.5892404658444,-58.429228168387 -34.5893469945333,-58.4299528016194 -34.5888723783903,-58.429790470108 -34.5884643655757,-58.4296606398196 -34.5883800313342,-58.4291488982263 -34.5880475544106)))";;"1277";14_13_6;COMUNA 14;"13";"6";"584";"281";"303";"92,74%";"408";"407";"99,75%";"1";"0,25%";"278";"3";"1.08";"275";"98,92%";"1.08";1.080
"MULTIPOLYGON (((-58.4305307717128 -34.5876626513488,-58.430529341777 -34.5876618542194,-58.4301230841513 -34.5873920172628,-58.4291488982263 -34.5880475544106,-58.4296606398196 -34.5883800313342,-58.429790470108 -34.5884643655757,-58.4299528016194 -34.5888723783903,-58.429228168387 -34.5893469945333,-58.4297335344329 -34.5896718633962,-58.4302506532686 -34.5900043392133,-58.431207891718 -34.5893894949684,-58.4321852178125 -34.5887616899068,-58.4317939333249 -34.5885018627027,-58.431643669169 -34.5884020318137,-58.4311621451859 -34.5880821771579,-58.4305307717128 -34.5876626513488)))";;"1278";14_13_7;COMUNA 14;"13";"7";"385";"170";"215";"79,07%";"192";"188";"97,92%";"4";"2,13%";"147";"12";"8.16";"135";"91,84%";"8.16";8.160
"MULTIPOLYGON (((-58.4318354157685 -34.5861685395616,-58.4312138651324 -34.5866476255632,-58.4310719598453 -34.5867469590895,-58.4308229860176 -34.5869210562876,-58.4301230841513 -34.5873920172628,-58.430529341777 -34.5876618542194,-58.4305307717128 -34.5876626513488,-58.4311621451859 -34.5880821771579,-58.431643669169 -34.5884020318137,-58.4317939333249 -34.5885018627027,-58.4321852178125 -34.5887616899068,-58.4331294809576 -34.5881554895316,-58.4339461859347 -34.5874953059611,-58.4329020732408 -34.5868381979705,-58.4318354157685 -34.5861685395616)))";;"1279";14_13_8;COMUNA 14;"13";"8";"662";"308";"354";"87,01%";"352";"350";"99,43%";"2";"0,57%";"275";"30";"10.91";"245";"89,09%";"10.91";10.910
"MULTIPOLYGON (((-58.4352614104643 -34.589575128937,-58.4360614536768 -34.5901489206697,-58.4361739156558 -34.5902497238368,-58.4371243928533 -34.5896120139141,-58.4362746276183 -34.5890006816254,-58.4361950356558 -34.5889065760834,-58.4348695042775 -34.5880749095588,-58.4341126290932 -34.5876000675974,-58.4339461859347 -34.5874953059611,-58.4331294809576 -34.5881554895316,-58.4339764214523 -34.5887171932513,-58.4351341295971 -34.5894848853751,-58.4352614104643 -34.589575128937)))";;"1280";14_13_9;COMUNA 14;"13";"9";"769";"332";"437";"75,97%";"432";"431";"99,77%";"1";"0,23%";"337";"12";"3.56";"325";"96,44%";"3.56";3.560
"MULTIPOLYGON (((-58.4260252466558 -34.5832962514456,-58.4251776149936 -34.5839453865896,-58.4263136549141 -34.5848568241077,-58.4271516722847 -34.584190142443,-58.4260252466558 -34.5832962514456)))";;"1281";14_14_1;COMUNA 14;"14";"1";"878";"390";"488";"79,92%";"613";"611";"99,67%";"2";"0,33%";"460";"15";"3.26";"445";"96,74%";"3.26";3.260
"MULTIPOLYGON (((-58.4212357118361 -34.5869639520669,-58.4203870686241 -34.5876137574323,-58.4201672782045 -34.5877881951004,-58.4214884034446 -34.5886141745103,-58.4225692535563 -34.5878186576562,-58.4212357118361 -34.5869639520669)))";;"1282";14_14_10;COMUNA 14;"14";"10";"684";"298";"386";"77,20%";"465";"463";"99,57%";"2";"0,43%";"349";"4";"1.15";"345";"98,85%";"1.15";1.150
"MULTIPOLYGON (((-58.4201672782045 -34.5877881951004,-58.4193691245945 -34.5884216017694,-58.4202950893953 -34.5889766675795,-58.4214884034446 -34.5886141745103,-58.4201672782045 -34.5877881951004)))";;"1283";14_14_11;COMUNA 14;"14";"11";"833";"352";"481";"73,18%";"529";"529";"100,00%";"0";"0,00%";"411";"2";"0.49";"409";"99,51%";"0.49";0.490
"MULTIPOLYGON (((-58.4251776149936 -34.5839453865896,-58.4242317546094 -34.5846696991871,-58.4253824330878 -34.5855976294208,-58.4263136549141 -34.5848568241077,-58.4251776149936 -34.5839453865896)))";;"1284";14_14_2;COMUNA 14;"14";"2";"596";"271";"325";"83,38%";"435";"435";"100,00%";"0";"0,00%";"290";"17";"5.86";"273";"94,14%";"5.86";5.860
"MULTIPOLYGON (((-58.4242317546094 -34.5846696991871,-58.4232589596027 -34.5854146303028,-58.4233897965039 -34.5855077748907,-58.4243342638395 -34.5861835958206,-58.4245054582414 -34.5862942878035,-58.4246968688031 -34.5861430033947,-58.4253824330878 -34.5855976294208,-58.4242317546094 -34.5846696991871)))";;"1285";14_14_3;COMUNA 14;"14";"3";"726";"328";"398";"82,41%";"541";"541";"100,00%";"0";"0,00%";"358";"4";"1.12";"354";"98,88%";"1.12";1.120
"MULTIPOLYGON (((-58.4269899999451 -34.5853107043236,-58.4263136549141 -34.5848568241077,-58.4253824330878 -34.5855976294208,-58.4246968688031 -34.5861430033947,-58.4245054582414 -34.5862942878035,-58.4251876865078 -34.5867353623223,-58.4260636365689 -34.5860429947286,-58.4269899999451 -34.5853107043236)))";;"1286";14_14_4;COMUNA 14;"14";"4";"417";"195";"222";"87,84%";"252";"250";"99,21%";"2";"0,80%";"194";"15";"7.73";"179";"92,27%";"7.73";7.730
"MULTIPOLYGON (((-58.4279970000759 -34.5859796839575,-58.4269899999451 -34.5853107043236,-58.4260636365689 -34.5860429947286,-58.4251876865078 -34.5867353623223,-58.4261988686547 -34.5873890756162,-58.4270766035552 -34.5867011381588,-58.4279970000759 -34.5859796839575)))";;"1287";14_14_5;COMUNA 14;"14";"5";"416";"194";"222";"87,39%";"241";"241";"100,00%";"0";"0,00%";"197";"33";"16.75";"164";"83,25%";"16.75";16.750
"MULTIPOLYGON (((-58.4270766035552 -34.5867011381588,-58.4261988686547 -34.5873890756162,-58.4272047032482 -34.5880393984941,-58.427369016059 -34.5879289487681,-58.4281571816935 -34.587403237706,-58.4291465271757 -34.5867433462002,-58.4279970000759 -34.5859796839575,-58.4270766035552 -34.5867011381588)))";;"1288";14_14_6;COMUNA 14;"14";"6";"467";"218";"249";"87,55%";"271";"270";"99,63%";"1";"0,37%";"202";"2";"0.99";"200";"99,01%";"0.99";0.990
"MULTIPOLYGON (((-58.4251876865078 -34.5867353623223,-58.4245054582414 -34.5862942878035,-58.4236021477521 -34.5870082560093,-58.424281481657 -34.5874496163168,-58.4246122126246 -34.587664446947,-58.4252840621161 -34.5881088275848,-58.426199906976 -34.5887146222168,-58.4272047032482 -34.5880393984941,-58.4261988686547 -34.5873890756162,-58.4251876865078 -34.5867353623223)))";;"1289";14_14_7;COMUNA 14;"14";"7";"523";"254";"269";"94,42%";"276";"275";"99,64%";"1";"0,36%";"210";"0";"0";"210";"100,00%";"0";0.000
"MULTIPOLYGON (((-58.4232589596027 -34.5854146303028,-58.4222888731565 -34.5861575121278,-58.4224953085748 -34.586289134934,-58.4236021477521 -34.5870082560093,-58.4245054582414 -34.5862942878035,-58.4243342638395 -34.5861835958206,-58.4233897965039 -34.5855077748907,-58.4232589596027 -34.5854146303028)))";;"1290";14_14_8;COMUNA 14;"14";"8";"942";"408";"534";"76,40%";"607";"607";"100,00%";"0";"0,00%";"462";"5";"1.08";"457";"98,92%";"1.08";1.080
"MULTIPOLYGON (((-58.4222888731565 -34.5861575121278,-58.4212357118361 -34.5869639520669,-58.4225692535563 -34.5878186576562,-58.4235036720252 -34.5870860444661,-58.4236021477521 -34.5870082560093,-58.4224953085748 -34.586289134934,-58.4222888731565 -34.5861575121278)))";;"1291";14_14_9;COMUNA 14;"14";"9";"982";"445";"537";"82,87%";"712";"712";"100,00%";"0";"0,00%";"483";"5";"1.04";"478";"98,96%";"1.04";1.040
"MULTIPOLYGON (((-58.4240194688545 -34.583016184158,-58.4230656100256 -34.583729287652,-58.4242317546094 -34.5846696991871,-58.4251776149936 -34.5839453865896,-58.4240194688545 -34.583016184158)))";;"1292";14_15_1;COMUNA 14;"15";"1";"704";"302";"402";"75,12%";"418";"415";"99,28%";"3";"0,72%";"319";"3";"0.94";"316";"99,06%";"0.94";0.940
"MULTIPOLYGON (((-58.4228993108856 -34.5821174067865,-58.421934304664 -34.5828169058009,-58.4230656100256 -34.583729287652,-58.4240194688545 -34.583016184158,-58.4228993108856 -34.5821174067865)))";;"1293";14_15_2;COMUNA 14;"15";"2";"749";"324";"425";"76,24%";"527";"527";"100,00%";"0";"0,00%";"351";"12";"3.42";"339";"96,58%";"3.42";3.420
"MULTIPOLYGON (((-58.4217335550526 -34.5811820529076,-58.4207514441656 -34.5818628741938,-58.421934304664 -34.5828169058009,-58.4228993108856 -34.5821174067865,-58.4217335550526 -34.5811820529076)))";;"1294";14_15_3;COMUNA 14;"15";"3";"679";"280";"399";"70,18%";"489";"488";"99,80%";"1";"0,20%";"350";"0";"0";"350";"100,00%";"0";0.000
"MULTIPOLYGON (((-58.4207514441656 -34.5818628741938,-58.4202063784838 -34.5822407293811,-58.4200524581146 -34.5823465251208,-58.4212327506154 -34.5833253523023,-58.421934304664 -34.5828169058009,-58.4207514441656 -34.5818628741938)))";;"1295";14_15_4;COMUNA 14;"15";"4";"814";"331";"483";"68,53%";"511";"510";"99,80%";"1";"0,20%";"379";"8";"2.11";"371";"97,89%";"2.11";2.110
"MULTIPOLYGON (((-58.421934304664 -34.5828169058009,-58.4212327506154 -34.5833253523023,-58.4223579142933 -34.5842583027701,-58.4230656100256 -34.583729287652,-58.421934304664 -34.5828169058009)))";;"1296";14_15_5;COMUNA 14;"15";"5";"915";"394";"521";"75,62%";"607";"606";"99,84%";"1";"0,17%";"443";"6";"1.35";"437";"98,65%";"1.35";1.350
"MULTIPOLYGON (((-58.4230656100256 -34.583729287652,-58.4223579142933 -34.5842583027701,-58.422006277011 -34.5845228447216,-58.4232589596027 -34.5854146303028,-58.4242317546094 -34.5846696991871,-58.4230656100256 -34.583729287652)))";;"1297";14_15_6;COMUNA 14;"15";"6";"943";"424";"519";"81,70%";"571";"570";"99,82%";"1";"0,18%";"440";"76";"17.27";"364";"82,73%";"17.27";17.270
"MULTIPOLYGON (((-58.4212327506154 -34.5833253523023,-58.4204110798716 -34.5839209398287,-58.4217773890968 -34.5846925638463,-58.422006277011 -34.5845228447216,-58.4223579142933 -34.5842583027701,-58.4212327506154 -34.5833253523023)))";;"1298";14_15_7;COMUNA 14;"15";"7";"637";"272";"365";"74,52%";"489";"489";"100,00%";"0";"0,00%";"348";"2";"0.57";"346";"99,43%";"0.57";0.570
"MULTIPOLYGON (((-58.4212327506154 -34.5833253523023,-58.4200524581146 -34.5823465251208,-58.4182564925931 -34.5835814984326,-58.4196488561207 -34.5844733015442,-58.4204110798716 -34.5839209398287,-58.4212327506154 -34.5833253523023)))";;"1299";14_15_8;COMUNA 14;"15";"8";"1904";"831";"1073";"77,45%";"1156";"1155";"99,91%";"1";"0,09%";"886";"4";"0.45";"882";"99,55%";"0.45";0.450
"MULTIPOLYGON (((-58.4204362842395 -34.5809132066771,-58.4205857356285 -34.5807932150678,-58.4202203859078 -34.580416849642,-58.4172693079338 -34.5773487678462,-58.4155735626351 -34.5755431155319,-58.4149194103867 -34.5752386934353,-58.4146885785905 -34.5751064141696,-58.4145027489977 -34.5751893021901,-58.4131588327311 -34.5757967475574,-58.4139765909568 -34.5770427629511,-58.4143567680215 -34.5776218820603,-58.4146733168347 -34.5781041398788,-58.4147198622933 -34.5781833018204,-58.4148060284884 -34.5783063835751,-58.4154325043285 -34.5792608929403,-58.415969409955 -34.5800788801507,-58.41447045166 -34.5805450769542,-58.4152255810866 -34.5816846454375,-58.4169507723541 -34.5815738912472,-58.4197322717695 -34.5813953172774,-58.4201165596899 -34.5813704996072,-58.4201448273266 -34.581240685518,-58.4202301890671 -34.5811063442578,-58.4203073966772 -34.5810324670514,-58.4204362842395 -34.5809132066771)))";;"1300";14_16_1;COMUNA 14;"16";"1";"1306";"575";"731";"78,66%";"737";"737";"100,00%";"0";"0,00%";"591";"4";"0.68";"587";"99,32%";"0.68";0.680
"MULTIPOLYGON (((-58.4154325043285 -34.5792608929403,-58.4139306607424 -34.5797304624869,-58.41447045166 -34.5805450769542,-58.415969409955 -34.5800788801507,-58.4154325043285 -34.5792608929403)))";;"1301";14_16_2;COMUNA 14;"16";"2";"790";"353";"437";"80,78%";"556";"556";"100,00%";"0";"0,00%";"331";"4";"1.21";"327";"98,79%";"1.21";1.210
"MULTIPOLYGON (((-58.4148060284884 -34.5783063835751,-58.4147198622933 -34.5781833018204,-58.4132489043301 -34.5787010670457,-58.4133386468396 -34.5788370183181,-58.4139306607424 -34.5797304624869,-58.4154325043285 -34.5792608929403,-58.4148060284884 -34.5783063835751)))";;"1302";14_16_3;COMUNA 14;"16";"3";"1101";"515";"586";"87,88%";"747";"747";"100,00%";"0";"0,00%";"524";"2";"0.38";"522";"99,62%";"0.38";0.380
"MULTIPOLYGON (((-58.4139765909568 -34.5770427629511,-58.4125329532215 -34.5776210052292,-58.412967485518 -34.5782768442811,-58.4132489043301 -34.5787010670457,-58.4147198622933 -34.5781833018204,-58.4146733168347 -34.5781041398788,-58.4143567680215 -34.5776218820603,-58.4139765909568 -34.5770427629511)))";;"1303";14_16_4;COMUNA 14;"16";"4";"945";"457";"488";"93,65%";"611";"611";"100,00%";"0";"0,00%";"397";"1";"0.25";"396";"99,75%";"0.25";0.250
"MULTIPOLYGON (((-58.4131588327311 -34.5757967475574,-58.4117470183255 -34.5764347848257,-58.4125329532215 -34.5776210052292,-58.4139765909568 -34.5770427629511,-58.4131588327311 -34.5757967475574)))";;"1304";14_16_5;COMUNA 14;"16";"5";"929";"424";"505";"83,96%";"521";"521";"100,00%";"0";"0,00%";"374";"3";"0.8";"371";"99,20%";"0.8";0.800
"MULTIPOLYGON (((-58.4117470183255 -34.5764347848257,-58.4109391138689 -34.5767998827951,-58.4117047112969 -34.5779526477276,-58.4125329532215 -34.5776210052292,-58.4117470183255 -34.5764347848257)))";;"1305";14_16_6;COMUNA 14;"16";"6";"299";"135";"164";"82,32%";"180";"179";"99,44%";"1";"0,56%";"122";"0";"0";"122";"100,00%";"0";0.000
"MULTIPOLYGON (((-58.4125329532215 -34.5776210052292,-58.4117047112969 -34.5779526477276,-58.4124047973779 -34.579006787247,-58.4132489043301 -34.5787010670457,-58.412967485518 -34.5782768442811,-58.4125329532215 -34.5776210052292)))";;"1306";14_16_7;COMUNA 14;"16";"7";"721";"320";"401";"79,80%";"429";"429";"100,00%";"0";"0,00%";"324";"4";"1.23";"320";"98,77%";"1.23";1.230
"MULTIPOLYGON (((-58.41447045166 -34.5805450769542,-58.4136051003173 -34.5808141797123,-58.4142258877065 -34.5817488326188,-58.4152255810866 -34.5816846454375,-58.41447045166 -34.5805450769542)))";;"1307";14_17_1;COMUNA 14;"17";"1";"809";"373";"436";"85,55%";"454";"454";"100,00%";"0";"0,00%";"352";"1";"0.28";"351";"99,72%";"0.28";0.280
"MULTIPOLYGON (((-58.413065144894 -34.58000111075,-58.4136051003173 -34.5808141797123,-58.41447045166 -34.5805450769542,-58.4139306607424 -34.5797304624869,-58.4133386468396 -34.5788370183181,-58.4132489043301 -34.5787010670457,-58.4124047973779 -34.579006787247,-58.4124947448723 -34.5791422502229,-58.413065144894 -34.58000111075)))";;"1308";14_17_2;COMUNA 14;"17";"2";"900";"390";"510";"76,47%";"559";"558";"99,82%";"1";"0,18%";"390";"3";"0.77";"387";"99,23%";"0.77";0.770
"MULTIPOLYGON (((-58.4123269488647 -34.5812117035098,-58.4127059081013 -34.5818463221096,-58.4142258877065 -34.5817488326188,-58.4136051003173 -34.5808141797123,-58.413065144894 -34.58000111075,-58.4118340128858 -34.5803859719736,-58.4123269488647 -34.5812117035098)))";;"1309";14_17_3;COMUNA 14;"17";"3";"820";"348";"472";"73,73%";"440";"439";"99,77%";"1";"0,23%";"338";"1";"0.3";"337";"99,70%";"0.3";0.300
"MULTIPOLYGON (((-58.4124047973779 -34.579006787247,-58.4113180855219 -34.5794046189632,-58.4112276820068 -34.5793702652581,-58.4113405761976 -34.579559533874,-58.4118340128858 -34.5803859719736,-58.413065144894 -34.58000111075,-58.4124947448723 -34.5791422502229,-58.4124047973779 -34.579006787247)))";;"1310";14_17_4;COMUNA 14;"17";"4";"420";"189";"231";"81,82%";"371";"371";"100,00%";"0";"0,00%";"208";"1";"0.48";"207";"99,52%";"0.48";0.480
"MULTIPOLYGON (((-58.4112276820068 -34.5793702652581,-58.4113180855219 -34.5794046189632,-58.4124047973779 -34.579006787247,-58.4117047112969 -34.5779526477276,-58.4112442996032 -34.5781370396815,-58.4106369716123 -34.5783810176916,-58.4112276820068 -34.5793702652581)))";;"1311";14_17_5;COMUNA 14;"17";"5";"729";"333";"396";"84,09%";"511";"511";"100,00%";"0";"0,00%";"328";"6";"1.83";"322";"98,17%";"1.83";1.830
"MULTIPOLYGON (((-58.4109391138689 -34.5767998827951,-58.4107246594177 -34.5768968379936,-58.4099556713709 -34.5772396915329,-58.4098636887645 -34.5772807098098,-58.4086165490829 -34.577836736179,-58.409268149878 -34.5789308012074,-58.4106369716123 -34.5783810176916,-58.4112442996032 -34.5781370396815,-58.4117047112969 -34.5779526477276,-58.4109391138689 -34.5767998827951)))";;"1312";14_17_6;COMUNA 14;"17";"6";"675";"272";"403";"67,49%";"383";"383";"100,00%";"0";"0,00%";"274";"4";"1.46";"270";"98,54%";"1.46";1.460
"MULTIPOLYGON (((-58.4106369716123 -34.5783810176916,-58.409268149878 -34.5789308012074,-58.4098319885127 -34.5798773536802,-58.4103973709645 -34.5808265098106,-58.410826087499 -34.5807010537746,-58.4118340128858 -34.5803859719736,-58.4113405761976 -34.579559533874,-58.4112276820068 -34.5793702652581,-58.4106369716123 -34.5783810176916)))";;"1313";14_17_7;COMUNA 14;"17";"7";"762";"327";"435";"75,17%";"435";"435";"100,00%";"0";"0,00%";"316";"3";"0.95";"313";"99,05%";"0.95";0.950
"MULTIPOLYGON (((-58.4118340128858 -34.5803859719736,-58.410826087499 -34.5807010537746,-58.4103973709645 -34.5808265098106,-58.4110960707509 -34.5819779814696,-58.4127059081013 -34.5818463221096,-58.4123269488647 -34.5812117035098,-58.4118340128858 -34.5803859719736)))";;"1314";14_17_8;COMUNA 14;"17";"8";"1335";"572";"763";"74,97%";"818";"818";"100,00%";"0";"0,00%";"623";"1";"0.16";"622";"99,84%";"0.16";0.160
"MULTIPOLYGON (((-58.4160639438812 -34.5838545647706,-58.4149961744572 -34.5845399547306,-58.4156316905282 -34.5849522605127,-58.4159511575892 -34.5851519688841,-58.4164022091865 -34.5848529737201,-58.4167338341658 -34.5846258362915,-58.4171123938145 -34.5843666015067,-58.4176870435579 -34.5839730663273,-58.4182564925931 -34.5835814984326,-58.4200524581146 -34.5823465251208,-58.4202063784838 -34.5822407293811,-58.4207514441656 -34.5818628741938,-58.4217335550526 -34.5811820529076,-58.4216619690829 -34.5809607056081,-58.4215970409138 -34.5808447887726,-58.4214650921224 -34.5807389271015,-58.4212843845272 -34.5806741998711,-58.4209472773601 -34.5806690461041,-58.4207259002645 -34.5807126407495,-58.4205857356285 -34.5807932150678,-58.4204362842395 -34.5809132066771,-58.4203073966772 -34.5810324670514,-58.4202301890671 -34.5811063442578,-58.4201448273266 -34.581240685518,-58.4201165596899 -34.5813704996072,-58.4197322717695 -34.5813953172774,-58.4169507723541 -34.5815738912472,-58.4152255810866 -34.5816846454375,-58.4142258877065 -34.5817488326188,-58.4148421408633 -34.5824476961184,-58.4155254536629 -34.5832345437207,-58.4160639438812 -34.5838545647706)))";;"1315";14_18_1;COMUNA 14;"18";"1";"741";"327";"414";"78,99%";"518";"518";"100,00%";"0";"0,00%";"355";"9";"2.54";"346";"97,46%";"2.54";2.540
"MULTIPOLYGON (((-58.4160639438812 -34.5838545647706,-58.4155254536629 -34.5832345437207,-58.4142759702327 -34.584072680222,-58.4149961744572 -34.5845399547306,-58.4160639438812 -34.5838545647706)))";;"1316";14_18_2;COMUNA 14;"18";"2";"741";"305";"436";"69,95%";"411";"411";"100,00%";"0";"0,00%";"314";"0";"0";"314";"100,00%";"0";0.000
"MULTIPOLYGON (((-58.4148421408633 -34.5824476961184,-58.4141136336933 -34.5829653872968,-58.413376598772 -34.5834891272187,-58.4142759702327 -34.584072680222,-58.4155254536629 -34.5832345437207,-58.4148421408633 -34.5824476961184)))";;"1317";14_18_3;COMUNA 14;"18";"3";"1081";"468";"613";"76,35%";"587";"587";"100,00%";"0";"0,00%";"476";"4";"0.84";"472";"99,16%";"0.84";0.840
"MULTIPOLYGON (((-58.4142258877065 -34.5817488326188,-58.4127059081013 -34.5818463221096,-58.4128067947553 -34.5820152435858,-58.4141136336933 -34.5829653872968,-58.4148421408633 -34.5824476961184,-58.4142258877065 -34.5817488326188)))";;"1318";14_18_4;COMUNA 14;"18";"4";"900";"387";"513";"75,44%";"514";"514";"100,00%";"0";"0,00%";"391";"2";"0.51";"389";"99,49%";"0.51";0.510
"MULTIPOLYGON (((-58.4127059081013 -34.5818463221096,-58.4110960707509 -34.5819779814696,-58.4121050216728 -34.5826640658785,-58.413376598772 -34.5834891272187,-58.4141136336933 -34.5829653872968,-58.4128067947553 -34.5820152435858,-58.4127059081013 -34.5818463221096)))";;"1319";14_18_5;COMUNA 14;"18";"5";"996";"437";"559";"78,18%";"716";"716";"100,00%";"0";"0,00%";"466";"5";"1.07";"461";"98,93%";"1.07";1.070
"MULTIPOLYGON (((-58.413376598772 -34.5834891272187,-58.4125692742314 -34.5840628358311,-58.4134032421709 -34.5846579885205,-58.4142759702327 -34.584072680222,-58.413376598772 -34.5834891272187)))";;"1320";14_18_6;COMUNA 14;"18";"6";"828";"360";"468";"76,92%";"454";"454";"100,00%";"0";"0,00%";"354";"8";"2.26";"346";"97,74%";"2.26";2.260
"MULTIPOLYGON (((-58.4149961744572 -34.5845399547306,-58.4142759702327 -34.584072680222,-58.4134032421709 -34.5846579885205,-58.4140703910159 -34.5851341206059,-58.4149961744572 -34.5845399547306)))";;"1321";14_18_7;COMUNA 14;"18";"7";"606";"276";"330";"83,64%";"381";"381";"100,00%";"0";"0,00%";"282";"3";"1.06";"279";"98,94%";"1.06";1.060
"MULTIPOLYGON (((-58.4149961744572 -34.5845399547306,-58.4140703910159 -34.5851341206059,-58.4149890737893 -34.5857896506503,-58.4151786123699 -34.5856641561253,-58.4159511575892 -34.5851519688841,-58.4156316905282 -34.5849522605127,-58.4149961744572 -34.5845399547306)))";;"1322";14_18_8;COMUNA 14;"18";"8";"912";"356";"556";"64,03%";"678";"678";"100,00%";"0";"0,00%";"489";"0";"0";"489";"100,00%";"0";0.000
"MULTIPOLYGON (((-58.4204110798716 -34.5839209398287,-58.4196488561207 -34.5844733015442,-58.4199270429573 -34.5846515052101,-58.4209562950151 -34.5853078037859,-58.4210843278421 -34.5852126323702,-58.4217773890968 -34.5846925638463,-58.4204110798716 -34.5839209398287)))";;"1323";14_19_1;COMUNA 14;"19";"1";"542";"235";"307";"76,55%";"363";"363";"100,00%";"0";"0,00%";"276";"1";"0.36";"275";"99,64%";"0.36";0.360
"MULTIPOLYGON (((-58.422006277011 -34.5845228447216,-58.4217773890968 -34.5846925638463,-58.4210843278421 -34.5852126323702,-58.4209562950151 -34.5853078037859,-58.4222888731565 -34.5861575121278,-58.4232589596027 -34.5854146303028,-58.422006277011 -34.5845228447216)))";;"1324";14_19_2;COMUNA 14;"19";"2";"969";"419";"550";"76,18%";"758";"758";"100,00%";"0";"0,00%";"529";"3";"0.57";"526";"99,43%";"0.57";0.570
"MULTIPOLYGON (((-58.4209562950151 -34.5853078037859,-58.4198853398479 -34.5861035214371,-58.4202347009442 -34.5863223143274,-58.4212357118361 -34.5869639520669,-58.4222888731565 -34.5861575121278,-58.4209562950151 -34.5853078037859)))";;"1325";14_19_3;COMUNA 14;"19";"3";"1060";"463";"597";"77,55%";"757";"757";"100,00%";"0";"0,00%";"546";"3";"0.55";"543";"99,45%";"0.55";0.550
"MULTIPOLYGON (((-58.4196488561207 -34.5844733015442,-58.4186981918476 -34.5851622863541,-58.4185515873559 -34.5852680827849,-58.4198853398479 -34.5861035214371,-58.4209562950151 -34.5853078037859,-58.4199270429573 -34.5846515052101,-58.4196488561207 -34.5844733015442)))";;"1326";14_19_4;COMUNA 14;"19";"4";"1224";"526";"698";"75,36%";"902";"901";"99,89%";"1";"0,11%";"628";"4";"0.64";"624";"99,36%";"0.64";0.640
"MULTIPOLYGON (((-58.4182564925931 -34.5835814984326,-58.4176870435579 -34.5839730663273,-58.4171123938145 -34.5843666015067,-58.4185515873559 -34.5852680827849,-58.4186981918476 -34.5851622863541,-58.4196488561207 -34.5844733015442,-58.4182564925931 -34.5835814984326)))";;"1327";14_19_5;COMUNA 14;"19";"5";"1426";"605";"821";"73,69%";"829";"829";"100,00%";"0";"0,00%";"652";"2";"0.31";"650";"99,69%";"0.31";0.310
"MULTIPOLYGON (((-58.4426218644028 -34.5636261719434,-58.4425352708136 -34.56368904778,-58.4412678561414 -34.5646092246505,-58.4423531619855 -34.5658400983496,-58.4436461944342 -34.5642340390567,-58.4426218644028 -34.5636261719434)))";;"1328";14_2_1;COMUNA 14;"2";"1";"1172";"508";"664";"76,51%";"635";"635";"100,00%";"0";"0,00%";"505";"3";"0.59";"502";"99,41%";"0.59";0.590
"MULTIPOLYGON (((-58.4374153178639 -34.5644982009547,-58.4362754391262 -34.5651801727121,-58.4370194002087 -34.5660570601532,-58.4371736898053 -34.5659673702654,-58.4377922974557 -34.5655907913613,-58.4383007172266 -34.5652842608315,-58.4384575594141 -34.5651897104503,-58.4384896600813 -34.5651703497709,-58.4376077508949 -34.5643831651567,-58.4375753097982 -34.5644025255367,-58.4374153178639 -34.5644982009547)))";;"1329";14_2_10;COMUNA 14;"2";"10";"1135";"521";"614";"84,85%";"627";"627";"100,00%";"0";"0,00%";"474";"2";"0.42";"472";"99,58%";"0.42";0.420
"MULTIPOLYGON (((-58.4425352708136 -34.56368904778,-58.4419693058384 -34.5630530092994,-58.4405990750724 -34.5638999191441,-58.4412678561414 -34.5646092246505,-58.4425352708136 -34.56368904778)))";;"1330";14_2_2;COMUNA 14;"2";"2";"540";"246";"294";"83,67%";"429";"429";"100,00%";"0";"0,00%";"271";"0";"0";"271";"100,00%";"0";0.000
"MULTIPOLYGON (((-58.4413445416062 -34.5623507577305,-58.4408579162003 -34.5624387037225,-58.4398487054914 -34.5630424894866,-58.4405990750724 -34.5638999191441,-58.4419693058384 -34.5630530092994,-58.441497306169 -34.562522482136,-58.4413448498319 -34.5623511042115,-58.4413445416062 -34.5623507577305)))";;"1331";14_2_3;COMUNA 14;"2";"3";"866";"372";"494";"75,30%";"447";"447";"100,00%";"0";"0,00%";"349";"0";"0";"349";"100,00%";"0";0.000
"MULTIPOLYGON (((-58.4398487054914 -34.5630424894866,-58.4388095088811 -34.5636642195223,-58.4395662583583 -34.5645213749853,-58.4400679385971 -34.5642189204492,-58.4405990750724 -34.5638999191441,-58.4398487054914 -34.5630424894866)))";;"1332";14_2_4;COMUNA 14;"2";"4";"658";"283";"375";"75,47%";"441";"441";"100,00%";"0";"0,00%";"320";"4";"1.25";"316";"98,75%";"1.25";1.250
"MULTIPOLYGON (((-58.4405990750724 -34.5638999191441,-58.4400679385971 -34.5642189204492,-58.4395662583583 -34.5645213749853,-58.4403254915008 -34.5653812022695,-58.4403825433069 -34.565333604984,-58.4411323854243 -34.56470765584,-58.4412678561414 -34.5646092246505,-58.4405990750724 -34.5638999191441)))";;"1333";14_2_5;COMUNA 14;"2";"5";"720";"310";"410";"75,61%";"445";"445";"100,00%";"0";"0,00%";"340";"0";"0";"340";"100,00%";"0";0.000
"MULTIPOLYGON (((-58.4395662583583 -34.5645213749853,-58.4384896600813 -34.5651703497709,-58.4395009578125 -34.5660694588935,-58.4403254915008 -34.5653812022695,-58.4395662583583 -34.5645213749853)))";;"1334";14_2_6;COMUNA 14;"2";"6";"673";"298";"375";"79,47%";"448";"448";"100,00%";"0";"0,00%";"268";"2";"0.75";"266";"99,25%";"0.75";0.750
"MULTIPOLYGON (((-58.4388095088811 -34.5636642195223,-58.4376077508949 -34.5643831651567,-58.4384896600813 -34.5651703497709,-58.4395662583583 -34.5645213749853,-58.4388095088811 -34.5636642195223)))";;"1335";14_2_7;COMUNA 14;"2";"7";"704";"309";"395";"78,23%";"422";"422";"100,00%";"0";"0,00%";"317";"2";"0.63";"315";"99,37%";"0.63";0.630
"MULTIPOLYGON (((-58.4395256521549 -34.5626733981169,-58.4389223059151 -34.5627732865384,-58.4381759176256 -34.5629464564394,-58.4380452333742 -34.5629767835772,-58.4368788084973 -34.56341923813,-58.4366673887005 -34.563546311537,-58.4376077508949 -34.5643831651567,-58.4388095088811 -34.5636642195223,-58.4398487054914 -34.5630424894866,-58.4408579162003 -34.5624387037225,-58.4399279956942 -34.5626067807241,-58.4395256521549 -34.5626733981169)))";;"1336";14_2_8;COMUNA 14;"2";"8";"932";"390";"542";"71,96%";"536";"536";"100,00%";"0";"0,00%";"402";"2";"0.5";"400";"99,50%";"0.5";0.500
"MULTIPOLYGON (((-58.4366673887005 -34.563546311537,-58.436476744192 -34.5636609236989,-58.4354897950313 -34.5642541846563,-58.4362754391262 -34.5651801727121,-58.4374153178639 -34.5644982009547,-58.4375753097982 -34.5644025255367,-58.4376077508949 -34.5643831651567,-58.4366673887005 -34.563546311537)))";;"1337";14_2_9;COMUNA 14;"2";"9";"909";"398";"511";"77,89%";"486";"486";"100,00%";"0";"0,00%";"380";"2";"0.53";"378";"99,47%";"0.53";0.530
"MULTIPOLYGON (((-58.4198853398479 -34.5861035214371,-58.4187830149284 -34.5869226699458,-58.4194727168337 -34.5873539194935,-58.4201672782045 -34.5877881951004,-58.4203870686241 -34.5876137574323,-58.4212357118361 -34.5869639520669,-58.4202347009442 -34.5863223143274,-58.4198853398479 -34.5861035214371)))";;"1338";14_20_1;COMUNA 14;"20";"1";"1265";"577";"688";"83,87%";"734";"734";"100,00%";"0";"0,00%";"604";"9";"1.49";"595";"98,51%";"1.49";1.490
"MULTIPOLYGON (((-58.4185515873559 -34.5852680827849,-58.4174305320481 -34.5860770007308,-58.4187830149284 -34.5869226699458,-58.4198853398479 -34.5861035214371,-58.4185515873559 -34.5852680827849)))";;"1339";14_20_2;COMUNA 14;"20";"2";"1306";"550";"756";"72,75%";"956";"956";"100,00%";"0";"0,00%";"661";"2";"0.3";"659";"99,70%";"0.3";0.300
"MULTIPOLYGON (((-58.4171123938145 -34.5843666015067,-58.4167338341658 -34.5846258362915,-58.4164022091865 -34.5848529737201,-58.4159511575892 -34.5851519688841,-58.4174305320481 -34.5860770007308,-58.4185515873559 -34.5852680827849,-58.4171123938145 -34.5843666015067)))";;"1340";14_20_3;COMUNA 14;"20";"3";"957";"398";"559";"71,20%";"635";"635";"100,00%";"0";"0,00%";"470";"3";"0.64";"467";"99,36%";"0.64";0.640
"MULTIPOLYGON (((-58.4159511575892 -34.5851519688841,-58.4151786123699 -34.5856641561253,-58.4149890737893 -34.5857896506503,-58.4165355462886 -34.5867228183805,-58.4174305320481 -34.5860770007308,-58.4159511575892 -34.5851519688841)))";;"1341";14_20_4;COMUNA 14;"20";"4";"800";"336";"464";"72,41%";"448";"448";"100,00%";"0";"0,00%";"374";"2";"0.53";"372";"99,47%";"0.53";0.530
"MULTIPOLYGON (((-58.4174305320481 -34.5860770007308,-58.4165355462886 -34.5867228183805,-58.417922951773 -34.5875546364444,-58.4185688513339 -34.5870817540468,-58.4187830149284 -34.5869226699458,-58.4174305320481 -34.5860770007308)))";;"1342";14_20_5;COMUNA 14;"20";"5";"765";"339";"426";"79,58%";"503";"503";"100,00%";"0";"0,00%";"375";"4";"1.07";"371";"98,93%";"1.07";1.070
"MULTIPOLYGON (((-58.4194727168337 -34.5873539194935,-58.4187830149284 -34.5869226699458,-58.4185688513339 -34.5870817540468,-58.417922951773 -34.5875546364444,-58.418659399739 -34.5879960489392,-58.4194727168337 -34.5873539194935)))";;"1343";14_20_6;COMUNA 14;"20";"6";"507";"221";"286";"77,27%";"407";"407";"100,00%";"0";"0,00%";"275";"1";"0.36";"274";"99,64%";"0.36";0.360
"MULTIPOLYGON (((-58.4201672782045 -34.5877881951004,-58.4194727168337 -34.5873539194935,-58.418659399739 -34.5879960489392,-58.4187756861558 -34.5880658119607,-58.4193691245945 -34.5884216017694,-58.4201672782045 -34.5877881951004)))";;"1344";14_20_7;COMUNA 14;"20";"7";"320";"133";"187";"71,12%";"220";"220";"100,00%";"0";"0,00%";"168";"6";"3.57";"162";"96,43%";"3.57";3.570
"MULTIPOLYGON (((-58.4302536042809 -34.5913946066194,-58.4291643550369 -34.5921780051851,-58.4303216414142 -34.5929448268831,-58.4312194405607 -34.5935397331063,-58.432358668529 -34.5927816819221,-58.4334455752895 -34.5920583975817,-58.4325165234973 -34.5914611054045,-58.4312728988091 -34.5906616047735,-58.4302536042809 -34.5913946066194)))";;"1345";14_21_1;COMUNA 14;"21";"1";"950";"412";"538";"76,58%";"573";"567";"98,95%";"6";"1,06%";"399";"30";"7.52";"369";"92,48%";"7.52";7.520
"MULTIPOLYGON (((-58.4260828170193 -34.5927894675941,-58.426993095762 -34.5934013107336,-58.427222114923 -34.5935551159737,-58.4275919099211 -34.5932982409768,-58.4280560051118 -34.592971388895,-58.4277827142604 -34.5927890502935,-58.4268648563158 -34.5921791122411,-58.4258898864306 -34.5915311203377,-58.4251316870231 -34.5921502095886,-58.4260828170193 -34.5927894675941)))";;"1346";14_21_10;COMUNA 14;"21";"10";"545";"248";"297";"83,50%";"330";"329";"99,70%";"1";"0,30%";"252";"33";"13.1";"219";"86,90%";"13.1";13.100
"MULTIPOLYGON (((-58.4280560051118 -34.592971388895,-58.4275919099211 -34.5932982409768,-58.427222114923 -34.5935551159737,-58.4281891130083 -34.5942043624305,-58.4288531134383 -34.5946501996774,-58.4291690702415 -34.5948552949287,-58.4293488081426 -34.5947454103037,-58.4300594956334 -34.59430234566,-58.4302822494525 -34.5941633854991,-58.4312194405607 -34.5935397331063,-58.4303216414142 -34.5929448268831,-58.4291643550369 -34.5921780051851,-58.4283015106747 -34.5927984937746,-58.4280560051118 -34.592971388895)))";;"1347";14_21_11;COMUNA 14;"21";"11";"705";"324";"381";"85,04%";"350";"350";"100,00%";"0";"0,00%";"284";"23";"8.1";"261";"91,90%";"8.1";8.100
"MULTIPOLYGON (((-58.4291853064241 -34.5906886560522,-58.4280333969901 -34.5914285749608,-58.4268648563158 -34.5921791122411,-58.4277827142604 -34.5927890502935,-58.4280560051118 -34.592971388895,-58.4283015106747 -34.5927984937746,-58.4291643550369 -34.5921780051851,-58.4302536042809 -34.5913946066194,-58.4312728988091 -34.5906616047735,-58.4307684573036 -34.590337305979,-58.4302506532686 -34.5900043392133,-58.4291853064241 -34.5906886560522)))";;"1348";14_21_2;COMUNA 14;"21";"2";"681";"301";"380";"79,21%";"370";"369";"99,73%";"1";"0,27%";"303";"17";"5.61";"286";"94,39%";"5.61";5.610
"MULTIPOLYGON (((-58.4270463368158 -34.5907745322026,-58.4258898864306 -34.5915311203377,-58.4268648563158 -34.5921791122411,-58.4280333969901 -34.5914285749608,-58.4291853064241 -34.5906886560522,-58.4302506532686 -34.5900043392133,-58.4297335344329 -34.5896718633962,-58.429228168387 -34.5893469945333,-58.4281866670219 -34.5900284218268,-58.4270463368158 -34.5907745322026)))";;"1349";14_21_3;COMUNA 14;"21";"3";"332";"136";"196";"69,39%";"222";"220";"99,10%";"2";"0,91%";"145";"1";"0.69";"144";"99,31%";"0.69";0.690
"MULTIPOLYGON (((-58.4270463368158 -34.5907745322026,-58.4260525666276 -34.5901159017336,-58.425076860057 -34.5894693818369,-58.4239387151369 -34.5902341970515,-58.4249080358846 -34.590878540804,-58.4257426887307 -34.5914333254925,-58.4258898864306 -34.5915311203377,-58.4270463368158 -34.5907745322026)))";;"1350";14_21_4;COMUNA 14;"21";"4";"529";"246";"283";"86,93%";"340";"340";"100,00%";"0";"0,00%";"254";"0";"0";"254";"100,00%";"0";0.000
"MULTIPOLYGON (((-58.4281866670219 -34.5900284218268,-58.429228168387 -34.5893469945333,-58.4290624950078 -34.5892404658444,-58.4287125055115 -34.5890141626288,-58.4282015293208 -34.5886838651666,-58.4276927706795 -34.5883549042664,-58.4272047032482 -34.5880393984941,-58.426199906976 -34.5887146222168,-58.425076860057 -34.5894693818369,-58.4260525666276 -34.5901159017336,-58.4270463368158 -34.5907745322026,-58.4281866670219 -34.5900284218268)))";;"1351";14_21_5;COMUNA 14;"21";"5";"409";"173";"236";"73,31%";"251";"249";"99,20%";"2";"0,80%";"158";"7";"4.43";"151";"95,57%";"4.43";4.430
"MULTIPOLYGON (((-58.4252840621161 -34.5881088275848,-58.4246122126246 -34.587664446947,-58.424281481657 -34.5874496163168,-58.4236021477521 -34.5870082560093,-58.4235036720252 -34.5870860444661,-58.4225692535563 -34.5878186576562,-58.4230841194943 -34.5881486278738,-58.423252505641 -34.5882603066229,-58.424250998995 -34.5889220602823,-58.4232043705907 -34.589745984383,-58.4239387151369 -34.5902341970515,-58.425076860057 -34.5894693818369,-58.426199906976 -34.5887146222168,-58.4252840621161 -34.5881088275848)))";;"1352";14_21_6;COMUNA 14;"21";"6";"559";"266";"293";"90,78%";"345";"345";"100,00%";"0";"0,00%";"246";"17";"6.91";"229";"93,09%";"6.91";6.910
"MULTIPOLYGON (((-58.423252505641 -34.5882603066229,-58.4230841194943 -34.5881486278738,-58.4225692535563 -34.5878186576562,-58.4214884034446 -34.5886141745103,-58.4202950893953 -34.5889766675795,-58.4214304921368 -34.5896572248702,-58.4222486594857 -34.5893636138168,-58.4224958290213 -34.589274959549,-58.4222076644031 -34.589083377738,-58.423252505641 -34.5882603066229)))";;"1353";14_21_7;COMUNA 14;"21";"7";"696";"316";"380";"83,16%";"400";"400";"100,00%";"0";"0,00%";"309";"28";"9.06";"281";"90,94%";"9.06";9.060
"MULTIPOLYGON (((-58.4222486594857 -34.5893636138168,-58.4214304921368 -34.5896572248702,-58.4223674323778 -34.5902896760166,-58.422446263435 -34.5903427323263,-58.4232043705907 -34.589745984383,-58.424250998995 -34.5889220602823,-58.423252505641 -34.5882603066229,-58.4222076644031 -34.589083377738,-58.4224958290213 -34.589274959549,-58.4222486594857 -34.5893636138168)))";;"1354";14_21_8;COMUNA 14;"21";"8";"687";"286";"401";"71,32%";"425";"424";"99,76%";"1";"0,24%";"323";"1";"0.31";"322";"99,69%";"0.31";0.310
"MULTIPOLYGON (((-58.4239387151369 -34.5902341970515,-58.4232043705907 -34.589745984383,-58.422446263435 -34.5903427323263,-58.4231731143052 -34.5908320034623,-58.4241561387635 -34.5914936821927,-58.4249014837765 -34.5919954140713,-58.4251316870231 -34.5921502095886,-58.4258898864306 -34.5915311203377,-58.4257426887307 -34.5914333254925,-58.4249080358846 -34.590878540804,-58.4239387151369 -34.5902341970515)))";;"1355";14_21_9;COMUNA 14;"21";"9";"568";"283";"285";"99,30%";"340";"340";"100,00%";"0";"0,00%";"266";"64";"24.06";"202";"75,94%";"24.06";24.060
"MULTIPOLYGON (((-58.4260828170193 -34.5927894675941,-58.4251986959053 -34.5935040864213,-58.426073039702 -34.5941108546826,-58.4262467178801 -34.5942318269241,-58.4273711259914 -34.5950150051864,-58.4280889294477 -34.5955150191404,-58.4291690702415 -34.5948552949287,-58.4288531134383 -34.5946501996774,-58.4281891130083 -34.5942043624305,-58.427222114923 -34.5935551159737,-58.426993095762 -34.5934013107336,-58.4260828170193 -34.5927894675941)))";;"1356";14_22_1;COMUNA 14;"22";"1";"857";"371";"486";"76,34%";"486";"485";"99,79%";"1";"0,21%";"368";"2";"0.54";"366";"99,46%";"0.54";0.540
"MULTIPOLYGON (((-58.4212998386639 -34.595365786286,-58.4215147763943 -34.5964316047293,-58.4229620116974 -34.5963629269828,-58.4231496364765 -34.5963476352286,-58.4231200890432 -34.5961582520892,-58.423010123947 -34.5953006477488,-58.4228681735662 -34.594194220185,-58.4210578927185 -34.5941637555446,-58.4210929767576 -34.5943402533023,-58.4212998386639 -34.595365786286)))";;"1357";14_22_10;COMUNA 14;"22";"10";"672";"291";"381";"76,38%";"430";"430";"100,00%";"0";"0,00%";"336";"10";"2.98";"326";"97,02%";"2.98";2.980
"MULTIPOLYGON (((-58.4260828170193 -34.5927894675941,-58.4251316870231 -34.5921502095886,-58.4249014837765 -34.5919954140713,-58.4241561387635 -34.5914936821927,-58.4231731143052 -34.5908320034623,-58.4225063999038 -34.5913733565029,-58.4225433057114 -34.5916613378172,-58.4226810900941 -34.5927355100559,-58.4233181761116 -34.5921991468253,-58.4242863099749 -34.5928709608036,-58.4251986959053 -34.5935040864213,-58.4260828170193 -34.5927894675941)))";;"1358";14_22_2;COMUNA 14;"22";"2";"875";"421";"454";"92,73%";"494";"493";"99,80%";"1";"0,20%";"407";"55";"13.51";"352";"86,49%";"13.51";13.510
"MULTIPOLYGON (((-58.4214304921368 -34.5896572248702,-58.4202422480787 -34.5900675378778,-58.422454939469 -34.5915999682484,-58.4225433057114 -34.5916613378172,-58.4225063999038 -34.5913733565029,-58.4231731143052 -34.5908320034623,-58.422446263435 -34.5903427323263,-58.4223674323778 -34.5902896760166,-58.4214304921368 -34.5896572248702)))";;"1359";14_22_3;COMUNA 14;"22";"3";"494";"212";"282";"75,18%";"312";"309";"99,04%";"3";"0,97%";"233";"0";"0";"233";"100,00%";"0";0.000
"MULTIPOLYGON (((-58.4202422480787 -34.5900675378778,-58.4190732453074 -34.5907900416813,-58.4190221334813 -34.5908215739487,-58.4191438649817 -34.5915619285285,-58.4205433707206 -34.5915780544285,-58.422454939469 -34.5915999682484,-58.4202422480787 -34.5900675378778)))";;"1360";14_22_4;COMUNA 14;"22";"4";"576";"257";"319";"80,56%";"323";"321";"99,38%";"2";"0,62%";"240";"1";"0.42";"239";"99,58%";"0.42";0.420
"MULTIPOLYGON (((-58.4207821517992 -34.5927781841237,-58.4210578927185 -34.5941637555446,-58.4228681735662 -34.594194220185,-58.4228560406781 -34.5940992829233,-58.4226875383453 -34.5927855141427,-58.4226810900941 -34.5927355100559,-58.4225433057114 -34.5916613378172,-58.422454939469 -34.5915999682484,-58.4205433707206 -34.5915780544285,-58.4207821517992 -34.5927781841237)))";;"1361";14_22_5;COMUNA 14;"22";"5";"926";"449";"477";"94,13%";"510";"510";"100,00%";"0";"0,00%";"423";"72";"17.02";"351";"82,98%";"17.02";17.020
"MULTIPOLYGON (((-58.4228560406781 -34.5940992829233,-58.4228681735662 -34.594194220185,-58.423010123947 -34.5953006477488,-58.4236357964656 -34.5948051964729,-58.4244186621073 -34.5941445031873,-58.4246948644662 -34.5939113409284,-58.4251986959053 -34.5935040864213,-58.4242863099749 -34.5928709608036,-58.4233181761116 -34.5921991468253,-58.4226810900941 -34.5927355100559,-58.4226875383453 -34.5927855141427,-58.4228560406781 -34.5940992829233)))";;"1362";14_22_6;COMUNA 14;"22";"6";"1058";"482";"576";"83,68%";"457";"457";"100,00%";"0";"0,00%";"415";"2";"0.48";"413";"99,52%";"0.48";0.480
"MULTIPOLYGON (((-58.4244186621073 -34.5941445031873,-58.4236357964656 -34.5948051964729,-58.423010123947 -34.5953006477488,-58.4231200890432 -34.5961582520892,-58.4231496364765 -34.5963476352286,-58.4233110295182 -34.5963344474797,-58.4240466850515 -34.5962580542642,-58.4242055674334 -34.5961596927569,-58.4247496535994 -34.5955309284027,-58.4253407346434 -34.5948600282439,-58.4262467178801 -34.5942318269241,-58.426073039702 -34.5941108546826,-58.4251986959053 -34.5935040864213,-58.4246948644662 -34.5939113409284,-58.4244186621073 -34.5941445031873)))";;"1363";14_22_7;COMUNA 14;"22";"7";"760";"343";"417";"82,25%";"369";"367";"99,46%";"2";"0,54%";"322";"13";"4.04";"309";"95,96%";"4.04";4.040
"MULTIPOLYGON (((-58.4262467178801 -34.5942318269241,-58.4253407346434 -34.5948600282439,-58.4247496535994 -34.5955309284027,-58.4242055674334 -34.5961596927569,-58.4246433925177 -34.5967871413586,-58.4248429797965 -34.5970618619775,-58.4260240783581 -34.5966140362798,-58.4262401861582 -34.596511843548,-58.4269502483354 -34.596210492618,-58.4270238495849 -34.5961655828329,-58.4280889294477 -34.5955150191404,-58.4273711259914 -34.5950150051864,-58.4262467178801 -34.5942318269241)))";;"1364";14_22_8;COMUNA 14;"22";"8";"767";"339";"428";"79,21%";"411";"411";"100,00%";"0";"0,00%";"340";"2";"0.59";"338";"99,41%";"0.59";0.590
"MULTIPOLYGON (((-58.4217775514282 -34.597734912628,-58.4228373554465 -34.5977115356876,-58.422933791295 -34.5977177710671,-58.4233671610307 -34.5977486809503,-58.4235379430115 -34.5976319930617,-58.4248429797965 -34.5970618619775,-58.4246433925177 -34.5967871413586,-58.4242055674334 -34.5961596927569,-58.4240466850515 -34.5962580542642,-58.4233110295182 -34.5963344474797,-58.4231496364765 -34.5963476352286,-58.4229620116974 -34.5963629269828,-58.4215147763943 -34.5964316047293,-58.4217775514282 -34.597734912628)))";;"1365";14_22_9;COMUNA 14;"22";"9";"1375";"613";"762";"80,45%";"747";"744";"99,60%";"3";"0,40%";"500";"1";"0.2";"499";"99,80%";"0.2";0.200
"MULTIPOLYGON (((-58.4193429354324 -34.592772610652,-58.4195675651035 -34.5941387298803,-58.4210578927185 -34.5941637555446,-58.4207821517992 -34.5927781841237,-58.4205433707206 -34.5915780544285,-58.4191438649817 -34.5915619285285,-58.4190221334813 -34.5908215739487,-58.4178642691732 -34.591537238803,-58.4180564945698 -34.5927732736196,-58.4191395716156 -34.5927718339767,-58.4193429354324 -34.592772610652)))";;"1366";14_23_1;COMUNA 14;"23";"1";"599";"283";"316";"89,56%";"362";"362";"100,00%";"0";"0,00%";"281";"8";"2.85";"273";"97,15%";"2.85";2.850
"MULTIPOLYGON (((-58.4187247132472 -34.5965640870518,-58.4169964197561 -34.5966460608228,-58.4172629395686 -34.5978256426042,-58.4174656374451 -34.5978207177188,-58.4189408150578 -34.5977892825791,-58.4201627052187 -34.5977631643184,-58.4201387260307 -34.5975224424317,-58.4199633797187 -34.5965052994944,-58.4187247132472 -34.5965640870518)))";;"1367";14_23_10;COMUNA 14;"23";"10";"750";"350";"400";"87,50%";"540";"540";"100,00%";"0";"0,00%";"378";"1";"0.26";"377";"99,74%";"0.26";0.260
"MULTIPOLYGON (((-58.4169964197561 -34.5966460608228,-58.4168640701263 -34.5966523494554,-58.4155178349856 -34.5967129654871,-58.4160005068785 -34.5978547446042,-58.4161590873864 -34.597852481157,-58.4172629395686 -34.5978256426042,-58.4169964197561 -34.5966460608228)))";;"1368";14_23_11;COMUNA 14;"23";"11";"890";"386";"504";"76,59%";"656";"655";"99,85%";"1";"0,15%";"462";"2";"0.43";"460";"99,57%";"0.43";0.430
"MULTIPOLYGON (((-58.4178642691732 -34.591537238803,-58.4170221813865 -34.5920575809254,-58.4169243778265 -34.5921299415062,-58.4163584261062 -34.5925481951315,-58.4161006206252 -34.5927439497532,-58.4180564945698 -34.5927732736196,-58.4178642691732 -34.591537238803)))";;"1369";14_23_2;COMUNA 14;"23";"2";"468";"198";"270";"73,33%";"289";"289";"100,00%";"0";"0,00%";"218";"7";"3.21";"211";"96,79%";"3.21";3.210
"MULTIPOLYGON (((-58.4180564945698 -34.5927732736196,-58.4161006206252 -34.5927439497532,-58.4164180374167 -34.5940858838587,-58.416591255929 -34.594088555167,-58.418293293191 -34.594117215668,-58.4195675651035 -34.5941387298803,-58.4193429354324 -34.592772610652,-58.4191395716156 -34.5927718339767,-58.4180564945698 -34.5927732736196)))";;"1370";14_23_3;COMUNA 14;"23";"3";"547";"254";"293";"86,69%";"284";"284";"100,00%";"0";"0,00%";"243";"2";"0.82";"241";"99,18%";"0.82";0.820
"MULTIPOLYGON (((-58.4161006206252 -34.5927439497532,-58.4158670099874 -34.5929213321055,-58.4152663653947 -34.5933773856764,-58.4143936643459 -34.5940540417439,-58.4164180374167 -34.5940858838587,-58.4161006206252 -34.5927439497532)))";;"1371";14_23_4;COMUNA 14;"23";"4";"726";"325";"401";"81,05%";"463";"463";"100,00%";"0";"0,00%";"368";"2";"0.54";"366";"99,46%";"0.54";0.540
"MULTIPOLYGON (((-58.4164180374167 -34.5940858838587,-58.4143936643459 -34.5940540417439,-58.4146260109031 -34.5946035916291,-58.4150464026154 -34.5955979502481,-58.4167462192796 -34.5955383885913,-58.4164180374167 -34.5940858838587)))";;"1372";14_23_5;COMUNA 14;"23";"5";"1023";"469";"554";"84,66%";"745";"745";"100,00%";"0";"0,00%";"516";"5";"0.97";"511";"99,03%";"0.97";0.970
"MULTIPOLYGON (((-58.418293293191 -34.594117215668,-58.416591255929 -34.594088555167,-58.4164180374167 -34.5940858838587,-58.4167462192796 -34.5955383885913,-58.4169769322219 -34.5955303059227,-58.4185319677594 -34.5954710876072,-58.4184086811515 -34.5947720719718,-58.418293293191 -34.594117215668)))";;"1373";14_23_6;COMUNA 14;"23";"6";"443";"210";"233";"90,13%";"274";"274";"100,00%";"0";"0,00%";"212";"3";"1.42";"209";"98,58%";"1.42";1.420
"MULTIPOLYGON (((-58.4195675651035 -34.5941387298803,-58.418293293191 -34.594117215668,-58.4184086811515 -34.5947720719718,-58.4185319677594 -34.5954710876072,-58.4197788731743 -34.595423643358,-58.4212998386639 -34.595365786286,-58.4210929767576 -34.5943402533023,-58.4210578927185 -34.5941637555446,-58.4195675651035 -34.5941387298803)))";;"1374";14_23_7;COMUNA 14;"23";"7";"694";"329";"365";"90,14%";"382";"382";"100,00%";"0";"0,00%";"341";"26";"7.62";"315";"92,38%";"7.62";7.620
"MULTIPOLYGON (((-58.4212998386639 -34.595365786286,-58.4197788731743 -34.595423643358,-58.4185319677594 -34.5954710876072,-58.4187247132472 -34.5965640870518,-58.4199633797187 -34.5965052994944,-58.4201387260307 -34.5975224424317,-58.4201627052187 -34.5977631643184,-58.4204326843225 -34.5977574128364,-58.4217775514282 -34.597734912628,-58.4215147763943 -34.5964316047293,-58.4212998386639 -34.595365786286)))";;"1375";14_23_8;COMUNA 14;"23";"8";"1095";"514";"581";"88,47%";"552";"551";"99,82%";"1";"0,18%";"482";"80";"16.6";"402";"83,40%";"16.6";16.600
"MULTIPOLYGON (((-58.4185319677594 -34.5954710876072,-58.4169769322219 -34.5955303059227,-58.4167462192796 -34.5955383885913,-58.4150464026154 -34.5955979502481,-58.4155178349856 -34.5967129654871,-58.4168640701263 -34.5966523494554,-58.4169964197561 -34.5966460608228,-58.4187247132472 -34.5965640870518,-58.4185319677594 -34.5954710876072)))";;"1376";14_23_9;COMUNA 14;"23";"9";"954";"448";"506";"88,54%";"620";"620";"100,00%";"0";"0,00%";"492";"2";"0.41";"490";"99,59%";"0.41";0.410
"MULTIPOLYGON (((-58.4172704602167 -34.5907381142472,-58.4169673480298 -34.5903301679067,-58.4159449064975 -34.5911433339347,-58.4169243778265 -34.5921299415062,-58.4170221813865 -34.5920575809254,-58.4178642691732 -34.591537238803,-58.4172704602167 -34.5907381142472)))";;"1377";14_24_1;COMUNA 14;"24";"1";"673";"296";"377";"78,51%";"434";"433";"99,77%";"1";"0,23%";"301";"3";"1";"298";"99,00%";"1";1.000
"MULTIPOLYGON (((-58.4166540878006 -34.5897990430307,-58.4164474407002 -34.5897430471619,-58.4153447066423 -34.5905387122996,-58.4159449064975 -34.5911433339347,-58.4169673480298 -34.5903301679067,-58.4166115651815 -34.5898512825853,-58.4166540878006 -34.5897990430307)))";;"1378";14_24_2;COMUNA 14;"24";"2";"462";"204";"258";"79,07%";"315";"315";"100,00%";"0";"0,00%";"232";"3";"1.29";"229";"98,71%";"1.29";1.290
"MULTIPOLYGON (((-58.4147213659108 -34.5899107677722,-58.413912443851 -34.5905045552346,-58.4140576377937 -34.590653140226,-58.4145242023262 -34.5911306682017,-58.4153447066423 -34.5905387122996,-58.4164474407002 -34.5897430471619,-58.4157328229673 -34.5896003605254,-58.4157500732239 -34.5891556447308,-58.4147213659108 -34.5899107677722)))";;"1379";14_24_3;COMUNA 14;"24";"3";"514";"217";"297";"73,06%";"355";"355";"100,00%";"0";"0,00%";"269";"0";"0";"269";"100,00%";"0";0.000
"MULTIPOLYGON (((-58.4153447066423 -34.5905387122996,-58.4145242023262 -34.5911306682017,-58.4151526516372 -34.5917737570486,-58.4152959554788 -34.5916594420742,-58.4159449064975 -34.5911433339347,-58.4153447066423 -34.5905387122996)))";;"1380";14_24_4;COMUNA 14;"24";"4";"394";"169";"225";"75,11%";"271";"271";"100,00%";"0";"0,00%";"210";"9";"4.29";"201";"95,71%";"4.29";4.290
"MULTIPOLYGON (((-58.4159449064975 -34.5911433339347,-58.4152959554788 -34.5916594420742,-58.4151526516372 -34.5917737570486,-58.4161006206252 -34.5927439497532,-58.4163584261062 -34.5925481951315,-58.4169243778265 -34.5921299415062,-58.4159449064975 -34.5911433339347)))";;"1381";14_24_5;COMUNA 14;"24";"5";"807";"356";"451";"78,94%";"589";"589";"100,00%";"0";"0,00%";"436";"5";"1.15";"431";"98,85%";"1.15";1.150
"MULTIPOLYGON (((-58.4151526516372 -34.5917737570486,-58.4143777648087 -34.5923916461213,-58.4152663653947 -34.5933773856764,-58.4158670099874 -34.5929213321055,-58.4161006206252 -34.5927439497532,-58.4151526516372 -34.5917737570486)))";;"1382";14_24_6;COMUNA 14;"24";"6";"714";"304";"410";"74,15%";"442";"442";"100,00%";"0";"0,00%";"343";"22";"6.41";"321";"93,59%";"6.41";6.410
"MULTIPOLYGON (((-58.4145242023262 -34.5911306682017,-58.4137467102901 -34.591691578219,-58.4143777648087 -34.5923916461213,-58.4151526516372 -34.5917737570486,-58.4145242023262 -34.5911306682017)))";;"1383";14_24_7;COMUNA 14;"24";"7";"690";"286";"404";"70,79%";"443";"443";"100,00%";"0";"0,00%";"331";"4";"1.21";"327";"98,79%";"1.21";1.210
"MULTIPOLYGON (((-58.4137467102901 -34.591691578219,-58.4136460087224 -34.5917642167144,-58.4128778757669 -34.5923197021452,-58.4135230330255 -34.5930731625337,-58.4143777648087 -34.5923916461213,-58.4137467102901 -34.591691578219)))";;"1384";14_24_8;COMUNA 14;"24";"8";"527";"232";"295";"78,64%";"372";"372";"100,00%";"0";"0,00%";"267";"0";"0";"267";"100,00%";"0";0.000
"MULTIPOLYGON (((-58.4143777648087 -34.5923916461213,-58.4135230330255 -34.5930731625337,-58.4143936643459 -34.5940540417439,-58.4152663653947 -34.5933773856764,-58.4143777648087 -34.5923916461213)))";;"1385";14_24_9;COMUNA 14;"24";"9";"720";"329";"391";"84,14%";"457";"457";"100,00%";"0";"0,00%";"348";"3";"0.86";"345";"99,14%";"0.86";0.860
"MULTIPOLYGON (((-58.4165355462886 -34.5867228183805,-58.4158792487128 -34.587196319881,-58.4156616740229 -34.5873530030993,-58.4170667935896 -34.5881851193388,-58.4172778116439 -34.5880268818384,-58.417922951773 -34.5875546364444,-58.4165355462886 -34.5867228183805)))";;"1386";14_25_1;COMUNA 14;"25";"1";"849";"377";"472";"79,87%";"519";"516";"99,42%";"3";"0,58%";"383";"2";"0.52";"381";"99,48%";"0.52";0.520
"MULTIPOLYGON (((-58.418659399739 -34.5879960489392,-58.417922951773 -34.5875546364444,-58.4172778116439 -34.5880268818384,-58.4170667935896 -34.5881851193388,-58.4179139990737 -34.5886867913326,-58.4187756861558 -34.5880658119607,-58.418659399739 -34.5879960489392)))";;"1387";14_25_2;COMUNA 14;"25";"2";"443";"192";"251";"76,49%";"309";"308";"99,68%";"1";"0,32%";"216";"0";"0";"216";"100,00%";"0";0.000
"MULTIPOLYGON (((-58.4158552857481 -34.5890783581241,-58.4157500732239 -34.5891556447308,-58.4157328229673 -34.5896003605254,-58.4164474407002 -34.5897430471619,-58.4166540878006 -34.5897990430307,-58.4168119918016 -34.589605362378,-58.4170258811265 -34.5893429673383,-58.4170580922204 -34.5893034707673,-58.4179139990737 -34.5886867913326,-58.4170667935896 -34.5881851193388,-58.4168088342992 -34.5883784106578,-58.4158552857481 -34.5890783581241)))";;"1388";14_25_3;COMUNA 14;"25";"3";"781";"336";"445";"75,51%";"517";"515";"99,61%";"2";"0,39%";"353";"1";"0.28";"352";"99,72%";"0.28";0.280
"MULTIPOLYGON (((-58.4168119918016 -34.589605362378,-58.4166540878006 -34.5897990430307,-58.4166115651815 -34.5898512825853,-58.4169673480298 -34.5903301679067,-58.4178620638305 -34.5896186405386,-58.4180914033127 -34.5896002027176,-58.4182967271948 -34.5895837276396,-58.4190439339238 -34.5893567346152,-58.4185557093089 -34.5890671812147,-58.4193691245945 -34.5884216017694,-58.4187756861558 -34.5880658119607,-58.4179139990737 -34.5886867913326,-58.4170580922204 -34.5893034707673,-58.4170258811265 -34.5893429673383,-58.4168119918016 -34.589605362378)))";;"1389";14_25_4;COMUNA 14;"25";"4";"524";"229";"295";"77,63%";"403";"402";"99,75%";"1";"0,25%";"285";"1";"0.35";"284";"99,65%";"0.35";0.350
"MULTIPOLYGON (((-58.4202950893953 -34.5889766675795,-58.4193691245945 -34.5884216017694,-58.4185557093089 -34.5890671812147,-58.4190439339238 -34.5893567346152,-58.4202950893953 -34.5889766675795)))";;"1390";14_25_5;COMUNA 14;"25";"5";"466";"200";"266";"75,19%";"298";"298";"100,00%";"0";"0,00%";"239";"6";"2.51";"233";"97,49%";"2.51";2.510
"MULTIPOLYGON (((-58.4202950893953 -34.5889766675795,-58.4190439339238 -34.5893567346152,-58.4202422480787 -34.5900675378778,-58.4214304921368 -34.5896572248702,-58.4202950893953 -34.5889766675795)))";;"1391";14_25_6;COMUNA 14;"25";"6";"460";"212";"248";"85,48%";"400";"400";"100,00%";"0";"0,00%";"277";"15";"5.42";"262";"94,58%";"5.42";5.420
"MULTIPOLYGON (((-58.4190439339238 -34.5893567346152,-58.4182967271948 -34.5895837276396,-58.4180914033127 -34.5896002027176,-58.4183730087431 -34.5899415161309,-58.4190732453074 -34.5907900416813,-58.4202422480787 -34.5900675378778,-58.4190439339238 -34.5893567346152)))";;"1392";14_25_7;COMUNA 14;"25";"7";"721";"332";"389";"85,35%";"498";"498";"100,00%";"0";"0,00%";"373";"71";"19.03";"302";"80,97%";"19.03";19.030
"MULTIPOLYGON (((-58.4183730087431 -34.5899415161309,-58.4172704602167 -34.5907381142472,-58.4178642691732 -34.591537238803,-58.4190221334813 -34.5908215739487,-58.4190732453074 -34.5907900416813,-58.4183730087431 -34.5899415161309)))";;"1393";14_25_8;COMUNA 14;"25";"8";"715";"314";"401";"78,30%";"453";"453";"100,00%";"0";"0,00%";"355";"3";"0.85";"352";"99,15%";"0.85";0.850
"MULTIPOLYGON (((-58.4180914033127 -34.5896002027176,-58.4178620638305 -34.5896186405386,-58.4169673480298 -34.5903301679067,-58.4172704602167 -34.5907381142472,-58.4183730087431 -34.5899415161309,-58.4180914033127 -34.5896002027176)))";;"1394";14_25_9;COMUNA 14;"25";"9";"675";"279";"396";"70,45%";"543";"543";"100,00%";"0";"0,00%";"405";"5";"1.23";"400";"98,77%";"1.23";1.230
"MULTIPOLYGON (((-58.4149890737893 -34.5857896506503,-58.4140607950509 -34.5864042387107,-58.4151635127755 -34.5870580798841,-58.4156616740229 -34.5873530030993,-58.4158792487128 -34.587196319881,-58.4165355462886 -34.5867228183805,-58.4149890737893 -34.5857896506503)))";;"1395";14_26_1;COMUNA 14;"26";"1";"1046";"432";"614";"70,36%";"731";"731";"100,00%";"0";"0,00%";"526";"1";"0.19";"525";"99,81%";"0.19";0.190
"MULTIPOLYGON (((-58.4140607950509 -34.5864042387107,-58.4131550775842 -34.5870038986239,-58.4133776498113 -34.5871868834773,-58.4141163549303 -34.5877999509372,-58.4151635127755 -34.5870580798841,-58.4140607950509 -34.5864042387107)))";;"1396";14_26_2;COMUNA 14;"26";"2";"728";"322";"406";"79,31%";"467";"467";"100,00%";"0";"0,00%";"357";"1";"0.28";"356";"99,72%";"0.28";0.280
"MULTIPOLYGON (((-58.4156616740229 -34.5873530030993,-58.4151635127755 -34.5870580798841,-58.4141163549303 -34.5877999509372,-58.4145416749483 -34.5881528801693,-58.4148071274594 -34.5879683997488,-58.4156616740229 -34.5873530030993)))";;"1397";14_26_3;COMUNA 14;"26";"3";"411";"183";"228";"80,26%";"255";"255";"100,00%";"0";"0,00%";"184";"2";"1.09";"182";"98,91%";"1.09";1.090
"MULTIPOLYGON (((-58.4156616740229 -34.5873530030993,-58.4148071274594 -34.5879683997488,-58.4145416749483 -34.5881528801693,-58.4157500732239 -34.5891556447308,-58.4158552857481 -34.5890783581241,-58.4168088342992 -34.5883784106578,-58.4170667935896 -34.5881851193388,-58.4156616740229 -34.5873530030993)))";;"1398";14_26_4;COMUNA 14;"26";"4";"1732";"732";"1000";"73,20%";"1032";"1032";"100,00%";"0";"0,00%";"850";"5";"0.59";"845";"99,41%";"0.59";0.590
"MULTIPOLYGON (((-58.4145416749483 -34.5881528801693,-58.4143958289115 -34.5882542350531,-58.4135954783472 -34.5887765422383,-58.4147213659108 -34.5899107677722,-58.4157500732239 -34.5891556447308,-58.4145416749483 -34.5881528801693)))";;"1399";14_26_5;COMUNA 14;"26";"5";"944";"435";"509";"85,46%";"609";"609";"100,00%";"0";"0,00%";"458";"2";"0.44";"456";"99,56%";"0.44";0.440
"MULTIPOLYGON (((-58.4131550775842 -34.5870038986239,-58.4123590713506 -34.587530918073,-58.4135954783472 -34.5887765422383,-58.4143958289115 -34.5882542350531,-58.4145416749483 -34.5881528801693,-58.4141163549303 -34.5877999509372,-58.4133776498113 -34.5871868834773,-58.4131550775842 -34.5870038986239)))";;"1400";14_26_6;COMUNA 14;"26";"6";"939";"406";"533";"76,17%";"521";"521";"100,00%";"0";"0,00%";"387";"4";"1.03";"383";"98,97%";"1.03";1.030
"MULTIPOLYGON (((-58.4123590713506 -34.587530918073,-58.4121848584492 -34.5876462732683,-58.4117336916756 -34.5879449709458,-58.4115422675794 -34.5880732762932,-58.4127578895624 -34.5893229847871,-58.4135954783472 -34.5887765422383,-58.4123590713506 -34.587530918073)))";;"1401";14_26_7;COMUNA 14;"26";"7";"1170";"508";"662";"76,74%";"781";"781";"100,00%";"0";"0,00%";"532";"3";"0.56";"529";"99,44%";"0.56";0.560
"MULTIPOLYGON (((-58.4135954783472 -34.5887765422383,-58.4127578895624 -34.5893229847871,-58.413912443851 -34.5905045552346,-58.4147213659108 -34.5899107677722,-58.4135954783472 -34.5887765422383)))";;"1402";14_27_1;COMUNA 14;"27";"1";"1230";"537";"693";"77,49%";"855";"855";"100,00%";"0";"0,00%";"616";"4";"0.65";"612";"99,35%";"0.65";0.650
"MULTIPOLYGON (((-58.4127578895624 -34.5893229847871,-58.4122648042403 -34.5896447666944,-58.4120361503976 -34.5897939737148,-58.4131709833401 -34.5910528699076,-58.4134822920198 -34.5908202401369,-58.413912443851 -34.5905045552346,-58.4127578895624 -34.5893229847871)))";;"1403";14_27_2;COMUNA 14;"27";"2";"1125";"471";"654";"72,02%";"865";"865";"100,00%";"0";"0,00%";"570";"29";"5.09";"541";"94,91%";"5.09";5.090
"MULTIPOLYGON (((-58.4115422675794 -34.5880732762932,-58.4113925013796 -34.5881737808399,-58.4110459453182 -34.5884010381418,-58.4122648042403 -34.5896447666944,-58.4127578895624 -34.5893229847871,-58.4115422675794 -34.5880732762932)))";;"1404";14_27_3;COMUNA 14;"27";"3";"587";"248";"339";"73,16%";"447";"447";"100,00%";"0";"0,00%";"284";"1";"0.35";"283";"99,65%";"0.35";0.350
"MULTIPOLYGON (((-58.4110459453182 -34.5884010381418,-58.4100810499574 -34.5890571310955,-58.4111888291875 -34.5903468100589,-58.4120361503976 -34.5897939737148,-58.4122648042403 -34.5896447666944,-58.4110459453182 -34.5884010381418)))";;"1405";14_27_4;COMUNA 14;"27";"4";"791";"321";"470";"68,30%";"676";"675";"99,85%";"1";"0,15%";"396";"2";"0.51";"394";"99,49%";"0.51";0.510
"MULTIPOLYGON (((-58.4120361503976 -34.5897939737148,-58.4111888291875 -34.5903468100589,-58.4123270205992 -34.5916763519995,-58.4129850834171 -34.5911916730663,-58.4131709833401 -34.5910528699076,-58.4120361503976 -34.5897939737148)))";;"1406";14_27_5;COMUNA 14;"27";"5";"923";"389";"534";"72,85%";"701";"700";"99,86%";"1";"0,14%";"487";"3";"0.62";"484";"99,38%";"0.62";0.620
"MULTIPOLYGON (((-58.4133098718358 -34.5912070168168,-58.4131709833401 -34.5910528699076,-58.4129850834171 -34.5911916730663,-58.4123270205992 -34.5916763519995,-58.4123908455004 -34.5917508883185,-58.4124629252187 -34.5918350762706,-58.4128778757669 -34.5923197021452,-58.4136460087224 -34.5917642167144,-58.4137467102901 -34.591691578219,-58.4133098718358 -34.5912070168168)))";;"1407";14_27_6;COMUNA 14;"27";"6";"419";"175";"244";"71,72%";"317";"317";"100,00%";"0";"0,00%";"212";"2";"0.94";"210";"99,06%";"0.94";0.940
"MULTIPOLYGON (((-58.4140576377937 -34.590653140226,-58.413912443851 -34.5905045552346,-58.4134822920198 -34.5908202401369,-58.4131709833401 -34.5910528699076,-58.4133098718358 -34.5912070168168,-58.4137467102901 -34.591691578219,-58.4145242023262 -34.5911306682017,-58.4140576377937 -34.590653140226)))";;"1408";14_27_7;COMUNA 14;"27";"7";"433";"200";"233";"85,84%";"311";"311";"100,00%";"0";"0,00%";"217";"2";"0.92";"215";"99,08%";"0.92";0.920
"MULTIPOLYGON (((-58.4140703910159 -34.5851341206059,-58.4132963959534 -34.5856308721906,-58.4131582205359 -34.5857256791821,-58.4140607950509 -34.5864042387107,-58.4149890737893 -34.5857896506503,-58.4140703910159 -34.5851341206059)))";;"1409";14_28_1;COMUNA 14;"28";"1";"630";"269";"361";"74,52%";"361";"361";"100,00%";"0";"0,00%";"299";"2";"0.67";"297";"99,33%";"0.67";0.670
"MULTIPOLYGON (((-58.4109637072698 -34.5852037615714,-58.4099321108707 -34.585553686244,-58.410564864364 -34.5865439278416,-58.4107218689938 -34.5864398356713,-58.4116875711991 -34.5857990904251,-58.4109637072698 -34.5852037615714)))";;"1410";14_28_10;COMUNA 14;"28";"10";"843";"379";"464";"81,68%";"583";"583";"100,00%";"0";"0,00%";"381";"0";"0";"381";"100,00%";"0";0.000
"MULTIPOLYGON (((-58.4099321108707 -34.585553686244,-58.408038247127 -34.5861491444708,-58.4081360830691 -34.5862888417864,-58.4083166981262 -34.5865459046194,-58.4090287048918 -34.5875592888259,-58.410564864364 -34.5865439278416,-58.4099321108707 -34.585553686244)))";;"1411";14_28_11;COMUNA 14;"28";"11";"980";"446";"534";"83,52%";"493";"493";"100,00%";"0";"0,00%";"392";"2";"0.51";"390";"99,49%";"0.51";0.510
"MULTIPOLYGON (((-58.4115422675794 -34.5880732762932,-58.4109920964326 -34.5872123055788,-58.410564864364 -34.5865439278416,-58.4090287048918 -34.5875592888259,-58.409497827064 -34.5882271266918,-58.4100810499574 -34.5890571310955,-58.4110459453182 -34.5884010381418,-58.4113925013796 -34.5881737808399,-58.4115422675794 -34.5880732762932)))";;"1412";14_28_12;COMUNA 14;"28";"12";"578";"233";"345";"67,54%";"429";"429";"100,00%";"0";"0,00%";"270";"1";"0.37";"269";"99,63%";"0.37";0.370
"MULTIPOLYGON (((-58.4140703910159 -34.5851341206059,-58.4134032421709 -34.5846579885205,-58.4130242469069 -34.5849122114017,-58.4125207074365 -34.585246314777,-58.4131582205359 -34.5857256791821,-58.4132963959534 -34.5856308721906,-58.4140703910159 -34.5851341206059)))";;"1413";14_28_2;COMUNA 14;"28";"2";"617";"270";"347";"77,81%";"355";"355";"100,00%";"0";"0,00%";"266";"3";"1.13";"263";"98,87%";"1.13";1.130
"MULTIPOLYGON (((-58.4125692742314 -34.5840628358311,-58.4117350186893 -34.5846556835107,-58.4125207074365 -34.585246314777,-58.4130242469069 -34.5849122114017,-58.4134032421709 -34.5846579885205,-58.4125692742314 -34.5840628358311)))";;"1414";14_28_3;COMUNA 14;"28";"3";"676";"283";"393";"72,01%";"369";"369";"100,00%";"0";"0,00%";"288";"1";"0.35";"287";"99,65%";"0.35";0.350
"MULTIPOLYGON (((-58.4117350186893 -34.5846556835107,-58.4109637072698 -34.5852037615714,-58.4116875711991 -34.5857990904251,-58.4125207074365 -34.585246314777,-58.4117350186893 -34.5846556835107)))";;"1415";14_28_4;COMUNA 14;"28";"4";"693";"287";"406";"70,69%";"395";"395";"100,00%";"0";"0,00%";"314";"2";"0.64";"312";"99,36%";"0.64";0.640
"MULTIPOLYGON (((-58.4131582205359 -34.5857256791821,-58.4125207074365 -34.585246314777,-58.4116875711991 -34.5857990904251,-58.412139003086 -34.5861685185889,-58.4123092269683 -34.5863083833805,-58.4131582205359 -34.5857256791821)))";;"1416";14_28_5;COMUNA 14;"28";"5";"555";"259";"296";"87,50%";"300";"300";"100,00%";"0";"0,00%";"228";"0";"0";"228";"100,00%";"0";0.000
"MULTIPOLYGON (((-58.4131582205359 -34.5857256791821,-58.4123092269683 -34.5863083833805,-58.4131550775842 -34.5870038986239,-58.4140607950509 -34.5864042387107,-58.4131582205359 -34.5857256791821)))";;"1417";14_28_6;COMUNA 14;"28";"6";"936";"390";"546";"71,43%";"552";"552";"100,00%";"0";"0,00%";"413";"2";"0.48";"411";"99,52%";"0.48";0.480
"MULTIPOLYGON (((-58.4123092269683 -34.5863083833805,-58.4116216579033 -34.586780229309,-58.4121848584492 -34.5876462732683,-58.4123590713506 -34.587530918073,-58.4131550775842 -34.5870038986239,-58.4123092269683 -34.5863083833805)))";;"1418";14_28_7;COMUNA 14;"28";"7";"740";"312";"428";"72,90%";"585";"585";"100,00%";"0";"0,00%";"374";"1";"0.27";"373";"99,73%";"0.27";0.270
"MULTIPOLYGON (((-58.4116216579033 -34.586780229309,-58.4109920964326 -34.5872123055788,-58.4115422675794 -34.5880732762932,-58.4117336916756 -34.5879449709458,-58.4121848584492 -34.5876462732683,-58.4116216579033 -34.586780229309)))";;"1419";14_28_8;COMUNA 14;"28";"8";"525";"200";"325";"61,54%";"475";"475";"100,00%";"0";"0,00%";"302";"0";"0";"302";"100,00%";"0";0.000
"MULTIPOLYGON (((-58.4123092269683 -34.5863083833805,-58.412139003086 -34.5861685185889,-58.4116875711991 -34.5857990904251,-58.4107218689938 -34.5864398356713,-58.410564864364 -34.5865439278416,-58.4109920964326 -34.5872123055788,-58.4116216579033 -34.586780229309,-58.4123092269683 -34.5863083833805)))";;"1420";14_28_9;COMUNA 14;"28";"9";"579";"253";"326";"77,61%";"383";"383";"100,00%";"0";"0,00%";"263";"1";"0.38";"262";"99,62%";"0.38";0.380
"MULTIPOLYGON (((-58.4098319885127 -34.5798773536802,-58.4084290187643 -34.580386688631,-58.4082443736236 -34.5804537218435,-58.4086659444854 -34.5813723978591,-58.4088850779606 -34.5813034777442,-58.4094650630179 -34.5811167525435,-58.4097363180009 -34.5810294021529,-58.4098171408016 -34.5810033797841,-58.4100596940508 -34.5809253123924,-58.4103973709645 -34.5808265098106,-58.4098319885127 -34.5798773536802)))";;"1421";14_29_1;COMUNA 14;"29";"1";"545";"239";"306";"78,10%";"407";"407";"100,00%";"0";"0,00%";"277";"1";"0.36";"276";"99,64%";"0.36";0.360
"MULTIPOLYGON (((-58.4114353760607 -34.5832536697837,-58.4107145166706 -34.5838883908388,-58.4117350186893 -34.5846556835107,-58.4125692742314 -34.5840628358311,-58.4114353760607 -34.5832536697837)))";;"1422";14_29_10;COMUNA 14;"29";"10";"787";"331";"456";"72,59%";"502";"502";"100,00%";"0";"0,00%";"366";"2";"0.55";"364";"99,45%";"0.55";0.550
"MULTIPOLYGON (((-58.4121050216728 -34.5826640658785,-58.4114353760607 -34.5832536697837,-58.4125692742314 -34.5840628358311,-58.413376598772 -34.5834891272187,-58.4121050216728 -34.5826640658785)))";;"1423";14_29_11;COMUNA 14;"29";"11";"640";"270";"370";"72,97%";"432";"432";"100,00%";"0";"0,00%";"281";"2";"0.71";"279";"99,29%";"0.71";0.710
"MULTIPOLYGON (((-58.4082443736236 -34.5804537218435,-58.4076646302071 -34.5806642451752,-58.4072782185119 -34.5808040056876,-58.4062336143914 -34.5811818523639,-58.4066360683826 -34.5820106635758,-58.4076855030275 -34.5816807049847,-58.4086659444854 -34.5813723978591,-58.4082443736236 -34.5804537218435)))";;"1424";14_29_2;COMUNA 14;"29";"2";"924";"381";"543";"70,17%";"395";"394";"99,75%";"1";"0,25%";"280";"8";"2.86";"272";"97,14%";"2.86";2.860
"MULTIPOLYGON (((-58.4062336143914 -34.5811818523639,-58.4051841460479 -34.5815615188407,-58.4055841552783 -34.5823418091938,-58.4057782546007 -34.5822803480483,-58.4066360683826 -34.5820106635758,-58.4062336143914 -34.5811818523639)))";;"1425";14_29_3;COMUNA 14;"29";"3";"517";"239";"278";"85,97%";"453";"453";"100,00%";"0";"0,00%";"270";"0";"0";"270";"100,00%";"0";0.000
"MULTIPOLYGON (((-58.4066360683826 -34.5820106635758,-58.4057782546007 -34.5822803480483,-58.4055841552783 -34.5823418091938,-58.406019292873 -34.5831905679654,-58.4061723829633 -34.5834592415031,-58.4069089134284 -34.5832478816087,-58.4071941431533 -34.5831599798874,-58.4066360683826 -34.5820106635758)))";;"1426";14_29_4;COMUNA 14;"29";"4";"750";"323";"427";"75,64%";"527";"527";"100,00%";"0";"0,00%";"358";"1";"0.28";"357";"99,72%";"0.28";0.280
"MULTIPOLYGON (((-58.4076855030275 -34.5816807049847,-58.4066360683826 -34.5820106635758,-58.4071941431533 -34.5831599798874,-58.4082214422247 -34.582843246667,-58.4076855030275 -34.5816807049847)))";;"1427";14_29_5;COMUNA 14;"29";"5";"474";"185";"289";"64,01%";"494";"494";"100,00%";"0";"0,00%";"280";"2";"0.71";"278";"99,29%";"0.71";0.710
"MULTIPOLYGON (((-58.4086659444854 -34.5813723978591,-58.4076855030275 -34.5816807049847,-58.4082214422247 -34.582843246667,-58.4092023173288 -34.5825408512266,-58.4086659444854 -34.5813723978591)))";;"1428";14_29_6;COMUNA 14;"29";"6";"826";"357";"469";"76,12%";"679";"678";"99,85%";"1";"0,15%";"448";"3";"0.67";"445";"99,33%";"0.67";0.670
"MULTIPOLYGON (((-58.4103973709645 -34.5808265098106,-58.4100596940508 -34.5809253123924,-58.4098171408016 -34.5810033797841,-58.4097363180009 -34.5810294021529,-58.4094650630179 -34.5811167525435,-58.4088850779606 -34.5813034777442,-58.4086659444854 -34.5813723978591,-58.4092023173288 -34.5825408512266,-58.4099298142657 -34.5823165812488,-58.4101888915021 -34.582236689701,-58.4110960707509 -34.5819779814696,-58.4103973709645 -34.5808265098106)))";;"1429";14_29_7;COMUNA 14;"29";"7";"838";"371";"467";"79,44%";"617";"617";"100,00%";"0";"0,00%";"379";"6";"1.58";"373";"98,42%";"1.58";1.580
"MULTIPOLYGON (((-58.4101888915021 -34.582236689701,-58.4102461451403 -34.5824050365253,-58.4104655965306 -34.5825615400886,-58.4114353760607 -34.5832536697837,-58.4121050216728 -34.5826640658785,-58.4110960707509 -34.5819779814696,-58.4101888915021 -34.582236689701)))";;"1430";14_29_8;COMUNA 14;"29";"8";"609";"261";"348";"75,00%";"376";"375";"99,73%";"1";"0,27%";"267";"2";"0.75";"265";"99,25%";"0.75";0.750
"MULTIPOLYGON (((-58.4109637072698 -34.5852037615714,-58.4117350186893 -34.5846556835107,-58.4107145166706 -34.5838883908388,-58.4114353760607 -34.5832536697837,-58.4104655965306 -34.5825615400886,-58.4102461451403 -34.5824050365253,-58.4101888915021 -34.582236689701,-58.4099298142657 -34.5823165812488,-58.4092023173288 -34.5825408512266,-58.4082214422247 -34.582843246667,-58.4071941431533 -34.5831599798874,-58.4069089134284 -34.5832478816087,-58.4061723829633 -34.5834592415031,-58.4063982243536 -34.5838085150901,-58.4070918071397 -34.5847984508694,-58.4076257231004 -34.585560484472,-58.408038247127 -34.5861491444708,-58.4099321108707 -34.585553686244,-58.4109637072698 -34.5852037615714)))";;"1431";14_29_9;COMUNA 14;"29";"9";"724";"317";"407";"77,89%";"457";"456";"99,78%";"1";"0,22%";"336";"7";"2.08";"329";"97,92%";"2.08";2.080
"MULTIPOLYGON (((-58.4384896600813 -34.5651703497709,-58.4384575594141 -34.5651897104503,-58.4383007172266 -34.5652842608315,-58.4377922974557 -34.5655907913613,-58.4371736898053 -34.5659673702654,-58.4370194002087 -34.5660570601532,-58.4377423560795 -34.5669091488288,-58.4380982651649 -34.5673285351753,-58.4383107357343 -34.5671269492823,-58.4392614206878 -34.5662694219111,-58.4393387402833 -34.5662049268606,-58.4394138457914 -34.5661421919788,-58.4394712392693 -34.5660942430624,-58.4395009578125 -34.5660694588935,-58.4384896600813 -34.5651703497709)))";;"1432";14_3_1;COMUNA 14;"3";"1";"1619";"719";"900";"79,89%";"1018";"1018";"100,00%";"0";"0,00%";"758";"4";"0.53";"754";"99,47%";"0.53";0.530
"MULTIPOLYGON (((-58.4348399835689 -34.5673183275919,-58.4345323311965 -34.5674957295267,-58.4337615336985 -34.5679412728949,-58.4344989426268 -34.5688028209663,-58.4355750160653 -34.5681745163645,-58.4348399835689 -34.5673183275919)))";;"1433";14_3_10;COMUNA 14;"3";"10";"631";"260";"371";"70,08%";"441";"441";"100,00%";"0";"0,00%";"308";"2";"0.65";"306";"99,35%";"0.65";0.650
"MULTIPOLYGON (((-58.4340983283319 -34.5664543859076,-58.4330236293447 -34.5670792271517,-58.4337615336985 -34.5679412728949,-58.4345323311965 -34.5674957295267,-58.4348399835689 -34.5673183275919,-58.4340983283319 -34.5664543859076)))";;"1434";14_3_11;COMUNA 14;"3";"11";"708";"308";"400";"77,00%";"464";"464";"100,00%";"0";"0,00%";"347";"2";"0.58";"345";"99,42%";"0.58";0.580
"MULTIPOLYGON (((-58.4333101396621 -34.5655362006698,-58.4322453189086 -34.5661698407384,-58.4330236293447 -34.5670792271517,-58.4340983283319 -34.5664543859076,-58.4333101396621 -34.5655362006698)))";;"1435";14_3_12;COMUNA 14;"3";"12";"677";"302";"375";"80,53%";"454";"454";"100,00%";"0";"0,00%";"305";"1";"0.33";"304";"99,67%";"0.33";0.330
"MULTIPOLYGON (((-58.4377423560795 -34.5669091488288,-58.4370194002087 -34.5660570601532,-58.43611800847 -34.5665813268125,-58.4359384272813 -34.5666848836614,-58.4366647825403 -34.5675383174613,-58.4361577085489 -34.5678343479374,-58.4370189722431 -34.5688338009872,-58.4370697305506 -34.568778527564,-58.4373530252652 -34.5683470186606,-58.4375065959908 -34.5681131670323,-58.4378793214566 -34.5675363168292,-58.4380982651649 -34.5673285351753,-58.4377423560795 -34.5669091488288)))";;"1436";14_3_2;COMUNA 14;"3";"2";"498";"235";"263";"89,35%";"366";"366";"100,00%";"0";"0,00%";"226";"2";"0.88";"224";"99,12%";"0.88";0.880
"MULTIPOLYGON (((-58.4362754391262 -34.5651801727121,-58.4357737401645 -34.5654802171352,-58.4351980452707 -34.5658149626678,-58.4359384272813 -34.5666848836614,-58.43611800847 -34.5665813268125,-58.4370194002087 -34.5660570601532,-58.4362754391262 -34.5651801727121)))";;"1437";14_3_3;COMUNA 14;"3";"3";"426";"188";"238";"78,99%";"354";"354";"100,00%";"0";"0,00%";"226";"1";"0.44";"225";"99,56%";"0.44";0.440
"MULTIPOLYGON (((-58.4354897950313 -34.5642541846563,-58.4344095128686 -34.5648883332762,-58.4351980452707 -34.5658149626678,-58.4357737401645 -34.5654802171352,-58.4362754391262 -34.5651801727121,-58.4354897950313 -34.5642541846563)))";;"1438";14_3_4;COMUNA 14;"3";"4";"781";"347";"434";"79,95%";"415";"415";"100,00%";"0";"0,00%";"297";"1";"0.34";"296";"99,66%";"0.34";0.340
"MULTIPOLYGON (((-58.4344095128686 -34.5648883332762,-58.4337983083943 -34.5652456706344,-58.4333101396621 -34.5655362006698,-58.4340983283319 -34.5664543859076,-58.4351980452707 -34.5658149626678,-58.4344095128686 -34.5648883332762)))";;"1439";14_3_5;COMUNA 14;"3";"5";"862";"368";"494";"74,49%";"564";"564";"100,00%";"0";"0,00%";"407";"23";"5.65";"384";"94,35%";"5.65";5.650
"MULTIPOLYGON (((-58.4351980452707 -34.5658149626678,-58.4340983283319 -34.5664543859076,-58.4348399835689 -34.5673183275919,-58.4359384272813 -34.5666848836614,-58.4351980452707 -34.5658149626678)))";;"1440";14_3_6;COMUNA 14;"3";"6";"410";"190";"220";"86,36%";"229";"229";"100,00%";"0";"0,00%";"164";"0";"0";"164";"100,00%";"0";0.000
"MULTIPOLYGON (((-58.4359384272813 -34.5666848836614,-58.4348399835689 -34.5673183275919,-58.4355750160653 -34.5681745163645,-58.4361577085489 -34.5678343479374,-58.4366647825403 -34.5675383174613,-58.4359384272813 -34.5666848836614)))";;"1441";14_3_7;COMUNA 14;"3";"7";"638";"279";"359";"77,72%";"384";"384";"100,00%";"0";"0,00%";"297";"0";"0";"297";"100,00%";"0";0.000
"MULTIPOLYGON (((-58.4361577085489 -34.5678343479374,-58.4355750160653 -34.5681745163645,-58.4363159358778 -34.5690376035752,-58.435238153976 -34.5696664072127,-58.4357290409747 -34.5702398513064,-58.436565465764 -34.5693281628077,-58.4367246407563 -34.569154668132,-58.4370189722431 -34.5688338009872,-58.4361577085489 -34.5678343479374)))";;"1442";14_3_8;COMUNA 14;"3";"8";"839";"359";"480";"74,79%";"585";"585";"100,00%";"0";"0,00%";"430";"0";"0";"430";"100,00%";"0";0.000
"MULTIPOLYGON (((-58.4355750160653 -34.5681745163645,-58.4344989426268 -34.5688028209663,-58.435238153976 -34.5696664072127,-58.4363159358778 -34.5690376035752,-58.4355750160653 -34.5681745163645)))";;"1443";14_3_9;COMUNA 14;"3";"9";"893";"352";"541";"65,06%";"618";"618";"100,00%";"0";"0,00%";"456";"0";"0";"456";"100,00%";"0";0.000
"MULTIPOLYGON (((-58.4086165490829 -34.577836736179,-58.4079071633465 -34.5781530527416,-58.4076840153371 -34.5782525339869,-58.4070357478743 -34.5785835214911,-58.4069258493814 -34.5786727708189,-58.4077033342267 -34.5795593576746,-58.409268149878 -34.5789308012074,-58.4086165490829 -34.577836736179)))";;"1444";14_30_1;COMUNA 14;"30";"1";"811";"366";"445";"82,25%";"515";"515";"100,00%";"0";"0,00%";"327";"18";"5.5";"309";"94,50%";"5.5";5.500
"MULTIPOLYGON (((-58.409268149878 -34.5789308012074,-58.4077033342267 -34.5795593576746,-58.4084290187643 -34.580386688631,-58.4098319885127 -34.5798773536802,-58.409268149878 -34.5789308012074)))";;"1445";14_30_2;COMUNA 14;"30";"2";"976";"423";"553";"76,49%";"626";"626";"100,00%";"0";"0,00%";"429";"1";"0.23";"428";"99,77%";"0.23";0.230
"MULTIPOLYGON (((-58.4069258493814 -34.5786727708189,-58.4068647662003 -34.5787223224222,-58.4063238742073 -34.5791614582776,-58.4068276396515 -34.5798715081374,-58.4070643744835 -34.5803464246858,-58.4072782185119 -34.5808040056876,-58.4076646302071 -34.5806642451752,-58.4082443736236 -34.5804537218435,-58.4084290187643 -34.580386688631,-58.4077033342267 -34.5795593576746,-58.4069258493814 -34.5786727708189)))";;"1446";14_30_3;COMUNA 14;"30";"3";"840";"378";"462";"81,82%";"626";"626";"100,00%";"0";"0,00%";"407";"4";"0.98";"403";"99,02%";"0.98";0.980
"MULTIPOLYGON (((-58.4063238742073 -34.5791614582776,-58.4058316226626 -34.5795610352659,-58.4055660706543 -34.579776624428,-58.4058092309052 -34.5803078867829,-58.4062336143914 -34.5811818523639,-58.4072782185119 -34.5808040056876,-58.4070643744835 -34.5803464246858,-58.4068276396515 -34.5798715081374,-58.4063238742073 -34.5791614582776)))";;"1447";14_30_4;COMUNA 14;"30";"4";"574";"272";"302";"90,07%";"539";"539";"100,00%";"0";"0,00%";"305";"1";"0.33";"304";"99,67%";"0.33";0.330
"MULTIPOLYGON (((-58.4046446853413 -34.5805153751944,-58.4036737105645 -34.581289892963,-58.4036702085426 -34.5812926863818,-58.4041678850891 -34.5819290790205,-58.4051841460479 -34.5815615188407,-58.4062336143914 -34.5811818523639,-58.4058092309052 -34.5803078867829,-58.4055660706543 -34.579776624428,-58.4052975354547 -34.5799946060664,-58.4046888166563 -34.5804801834537,-58.4046446853413 -34.5805153751944)))";;"1448";14_30_5;COMUNA 14;"30";"5";"952";"410";"542";"75,65%";"534";"534";"100,00%";"0";"0,00%";"378";"2";"0.53";"376";"99,47%";"0.53";0.530
"MULTIPOLYGON (((-58.4051841460479 -34.5815615188407,-58.4041678850891 -34.5819290790205,-58.4047077665161 -34.582619224227,-58.4055841552783 -34.5823418091938,-58.4051841460479 -34.5815615188407)))";;"1449";14_30_6;COMUNA 14;"30";"6";"476";"201";"275";"73,09%";"317";"317";"100,00%";"0";"0,00%";"233";"0";"0";"233";"100,00%";"0";0.000
"MULTIPOLYGON (((-58.4055841552783 -34.5823418091938,-58.4047077665161 -34.582619224227,-58.4053598727299 -34.5834529467442,-58.4061723829633 -34.5834592415031,-58.406019292873 -34.5831905679654,-58.4055841552783 -34.5823418091938)))";;"1450";14_30_7;COMUNA 14;"30";"7";"383";"166";"217";"76,50%";"314";"314";"100,00%";"0";"0,00%";"204";"1";"0.49";"203";"99,51%";"0.49";0.490
"MULTIPOLYGON (((-58.4036702085426 -34.5812926863818,-58.4035376415111 -34.5813984012022,-58.4033123214105 -34.5814719601606,-58.4024872509809 -34.5817372676956,-58.403803825548 -34.5831985334272,-58.4040266648124 -34.5834425943959,-58.4053598727299 -34.5834529467442,-58.4047077665161 -34.582619224227,-58.4041678850891 -34.5819290790205,-58.4036702085426 -34.5812926863818)))";;"1451";14_30_8;COMUNA 14;"30";"8";"1632";"717";"915";"78,36%";"889";"889";"100,00%";"0";"0,00%";"675";"3";"0.44";"672";"99,56%";"0.44";0.440
"MULTIPOLYGON (((-58.4024872509809 -34.5817372676956,-58.4017599771636 -34.5819727981632,-58.4016537800827 -34.5820061605135,-58.401531475918 -34.582045607945,-58.4020439263355 -34.5834271879044,-58.4040266648124 -34.5834425943959,-58.403803825548 -34.5831985334272,-58.4024872509809 -34.5817372676956)))";;"1452";14_30_9;COMUNA 14;"30";"9";"1280";"540";"740";"72,97%";"807";"807";"100,00%";"0";"0,00%";"579";"2";"0.35";"577";"99,65%";"0.35";0.350
"MULTIPOLYGON (((-58.4079955527841 -34.5750216227645,-58.407812027601 -34.574827165958,-58.4076063652079 -34.5745052286927,-58.4074183106393 -34.5742106945684,-58.4073290000458 -34.5740772681477,-58.4066907357686 -34.5733098719325,-58.4063512653429 -34.5728589766084,-58.4061847458687 -34.5726202730364,-58.4060852915344 -34.5723807099568,-58.4060791889683 -34.5722941010998,-58.4051276495181 -34.5716281528957,-58.4049602758934 -34.5715821956893,-58.4048066877973 -34.5717230398989,-58.4043065468848 -34.5723776183934,-58.4036449994688 -34.5732331112532,-58.403576575612 -34.5733117434489,-58.4034418573903 -34.5734671072664,-58.4027839867299 -34.574276397942,-58.4037921463504 -34.5753727800557,-58.4042953842779 -34.5759214957099,-58.4048722231769 -34.5765502474968,-58.4058010673547 -34.5757938211842,-58.4066314452929 -34.5752004479945,-58.4069965201181 -34.5756107028769,-58.40751559433 -34.5761942026676,-58.4066316142112 -34.5767242446456,-58.4070505530891 -34.5771935405568,-58.4079071633465 -34.5781530527416,-58.4086165490829 -34.577836736179,-58.4098636887645 -34.5772807098098,-58.4099556713709 -34.5772396915329,-58.4097810317224 -34.5768479093655,-58.4097688865747 -34.5767997330623,-58.4097467057301 -34.5767336643287,-58.4097244340126 -34.5766766804398,-58.4096980746348 -34.5766208920048,-58.4096677127927 -34.5765662286326,-58.4096282449831 -34.5765045891693,-58.4095985562769 -34.5764626730865,-58.409567419522 -34.5764217423228,-58.4095347496648 -34.5763816559892,-58.4095005467066 -34.5763424140844,-58.4094648957478 -34.5763040870697,-58.409427796789 -34.5762666749439,-58.4093893349302 -34.5762302481683,-58.4093495101267 -34.5761948771673,-58.4092969189927 -34.5761513312102,-58.4092252635787 -34.5760954524169,-58.4091526708207 -34.5760409112545,-58.4090789706105 -34.5759874259444,-58.4090040777585 -34.5759350668729,-58.4089417792322 -34.5758936292554,-58.408852846621 -34.5758276717839,-58.4087729357704 -34.5757672818479,-58.4085433412669 -34.5755779468628,-58.4084493089004 -34.5754993806655,-58.4083244027567 -34.575370094279,-58.4082150693899 -34.5752542659869,-58.4079955527841 -34.5750216227645)))";;"1453";14_31_1;COMUNA 14;"31";"1";"721";"371";"350";"106,00%";"407";"406";"99,75%";"1";"0,25%";"217";"2";"0.92";"215";"99,08%";"0.92";0.920
"MULTIPOLYGON (((-58.4032074516611 -34.5811771215243,-58.4032076180944 -34.5811729113958,-58.4031094047835 -34.5807617933079,-58.4030130404841 -34.5799638611658,-58.4029985684346 -34.5798404686919,-58.4029115993883 -34.5791734266009,-58.4028944934181 -34.5790425677094,-58.4027612602382 -34.5786565003735,-58.4026323202941 -34.5782221935321,-58.4020486475017 -34.578569243319,-58.4014141149878 -34.5789466181407,-58.4006701070551 -34.579398796313,-58.4002645948574 -34.5796220720152,-58.4002164263313 -34.5796480118737,-58.4001555208349 -34.5796814327705,-58.3998658994531 -34.5798405863941,-58.398588284624 -34.5804716382657,-58.3981093172348 -34.5807020994905,-58.3993616029316 -34.5827150216373,-58.3995722938293 -34.582677664471,-58.4002008569797 -34.5824748810462,-58.401531475918 -34.582045607945,-58.4016537800827 -34.5820061605135,-58.4017599771636 -34.5819727981632,-58.4024872509809 -34.5817372676956,-58.4033123214105 -34.5814719601606,-58.4035376415111 -34.5813984012022,-58.4036702085426 -34.5812926863818,-58.4036737105645 -34.581289892963,-58.4032074516611 -34.5811771215243)))";;"1454";14_31_10;COMUNA 14;"31";"10";"545";"237";"308";"76,95%";"280";"280";"100,00%";"0";"0,00%";"195";"2";"1.03";"193";"98,97%";"1.03";1.030
"MULTIPOLYGON (((-58.401531475918 -34.582045607945,-58.4002008569797 -34.5824748810462,-58.4006066047018 -34.5830390549108,-58.4012154097162 -34.5838814397814,-58.4013459274664 -34.5837927694489,-58.401943107732 -34.5834263630781,-58.4020439263355 -34.5834271879044,-58.401531475918 -34.582045607945)))";;"1455";14_31_11;COMUNA 14;"31";"11";"391";"160";"231";"69,26%";"326";"326";"100,00%";"0";"0,00%";"214";"1";"0.47";"213";"99,53%";"0.47";0.470
"MULTIPOLYGON (((-58.399938993802 -34.5836418366712,-58.4005437183744 -34.584471827839,-58.401126636989 -34.583941820027,-58.4012154097162 -34.5838814397814,-58.4006066047018 -34.5830390549108,-58.4002008569797 -34.5824748810462,-58.3995722938293 -34.582677664471,-58.3993616029316 -34.5827150216373,-58.3992749930615 -34.5827303998269,-58.399938993802 -34.5836418366712)))";;"1456";14_31_12;COMUNA 14;"31";"12";"575";"217";"358";"60,61%";"383";"383";"100,00%";"0";"0,00%";"260";"1";"0.38";"259";"99,62%";"0.38";0.380
"MULTIPOLYGON (((-58.4069965201181 -34.5756107028769,-58.4066314452929 -34.5752004479945,-58.4058010673547 -34.5757938211842,-58.4048722231769 -34.5765502474968,-58.40505854903 -34.5767534427505,-58.4061062456798 -34.5761356675937,-58.4066316142112 -34.5767242446456,-58.40751559433 -34.5761942026676,-58.4069965201181 -34.5756107028769)))";;"1457";14_31_2;COMUNA 14;"31";"2";"837";"393";"444";"88,51%";"439";"439";"100,00%";"0";"0,00%";"327";"2";"0.61";"325";"99,39%";"0.61";0.610
"MULTIPOLYGON (((-58.4066316142112 -34.5767242446456,-58.4061062456798 -34.5761356675937,-58.40505854903 -34.5767534427505,-58.4052989022708 -34.5770154684164,-58.4060255014413 -34.5778075312496,-58.4070505530891 -34.5771935405568,-58.4066316142112 -34.5767242446456)))";;"1458";14_31_3;COMUNA 14;"31";"3";"616";"278";"338";"82,25%";"413";"413";"100,00%";"0";"0,00%";"279";"1";"0.36";"278";"99,64%";"0.36";0.360
"MULTIPOLYGON (((-58.4070505530891 -34.5771935405568,-58.4060255014413 -34.5778075312496,-58.4068647662003 -34.5787223224222,-58.4069258493814 -34.5786727708189,-58.4070357478743 -34.5785835214911,-58.4076840153371 -34.5782525339869,-58.4079071633465 -34.5781530527416,-58.4070505530891 -34.5771935405568)))";;"1459";14_31_4;COMUNA 14;"31";"4";"646";"274";"372";"73,66%";"346";"346";"100,00%";"0";"0,00%";"250";"0";"0";"250";"100,00%";"0";0.000
"MULTIPOLYGON (((-58.4060255014413 -34.5778075312496,-58.4046687371134 -34.5786202375338,-58.4058316226626 -34.5795610352659,-58.4063238742073 -34.5791614582776,-58.4068647662003 -34.5787223224222,-58.4060255014413 -34.5778075312496)))";;"1460";14_31_5;COMUNA 14;"31";"5";"607";"275";"332";"82,83%";"319";"319";"100,00%";"0";"0,00%";"251";"1";"0.4";"250";"99,60%";"0.4";0.400
"MULTIPOLYGON (((-58.4042309172258 -34.5770348919122,-58.4034375451466 -34.577624181869,-58.4046687371134 -34.5786202375338,-58.4060255014413 -34.5778075312496,-58.4052989022708 -34.5770154684164,-58.40505854903 -34.5767534427505,-58.4048722231769 -34.5765502474968,-58.4047566169576 -34.5766444219816,-58.4042309172258 -34.5770348919122)))";;"1461";14_31_6;COMUNA 14;"31";"6";"1220";"551";"669";"82,36%";"610";"609";"99,84%";"1";"0,16%";"406";"0";"0";"406";"100,00%";"0";0.000
"MULTIPOLYGON (((-58.4029115993883 -34.5791734266009,-58.4029985684346 -34.5798404686919,-58.4030130404841 -34.5799638611658,-58.4031094047835 -34.5807617933079,-58.4032076180944 -34.5811729113958,-58.4032074516611 -34.5811771215243,-58.4036737105645 -34.581289892963,-58.4046446853413 -34.5805153751944,-58.4046888166563 -34.5804801834537,-58.4052975354547 -34.5799946060664,-58.4055660706543 -34.579776624428,-58.4058316226626 -34.5795610352659,-58.4046687371134 -34.5786202375338,-58.4034375451466 -34.577624181869,-58.4026323202941 -34.5782221935321,-58.4027612602382 -34.5786565003735,-58.4028944934181 -34.5790425677094,-58.4029115993883 -34.5791734266009)))";;"1462";14_31_7;COMUNA 14;"31";"7";"897";"391";"506";"77,27%";"420";"418";"99,52%";"2";"0,48%";"315";"2";"0.63";"313";"99,37%";"0.63";0.630
"MULTIPOLYGON (((-58.398771721976 -34.5776165170942,-58.3987714106982 -34.5776166860839,-58.3992635358071 -34.5783095069653,-58.3999016265491 -34.5792077616232,-58.3999713737732 -34.5793054071766,-58.4000366213056 -34.5792723407261,-58.4001359553714 -34.5794295108836,-58.4002645948574 -34.5796220720152,-58.4006701070551 -34.579398796313,-58.4014141149878 -34.5789466181407,-58.4020486475017 -34.578569243319,-58.4026323202941 -34.5782221935321,-58.4034375451466 -34.577624181869,-58.4042309172258 -34.5770348919122,-58.4047566169576 -34.5766444219816,-58.4048722231769 -34.5765502474968,-58.4042953842779 -34.5759214957099,-58.4037921463504 -34.5753727800557,-58.4027839867299 -34.574276397942,-58.4026470909426 -34.5741409682823,-58.4026178898503 -34.5741611447826,-58.4025498452015 -34.5742413792427,-58.4023212812154 -34.5745147542698,-58.4020962057508 -34.5747833241231,-58.401845280752 -34.5750894006327,-58.4016550275219 -34.5753152051997,-58.401236692484 -34.5756610757226,-58.401167837016 -34.575717500959,-58.4011449928957 -34.5757376940303,-58.4008497005854 -34.5759322484948,-58.4006019634212 -34.576093502149,-58.4003587605257 -34.5762435247043,-58.4001237134985 -34.5763823180457,-58.3999294270762 -34.5764949217838,-58.3997808915875 -34.5765674847696,-58.3995286536361 -34.5766890443044,-58.3992655464822 -34.5768158396895,-58.3989825094162 -34.5769568524494,-58.3987619607559 -34.5770739337668,-58.3985830738152 -34.5771715662059,-58.3984827667413 -34.5772373653406,-58.398771721976 -34.5776165170942)))";;"1463";14_31_8;COMUNA 14;"31";"8";"738";"340";"398";"85,43%";"525";"525";"100,00%";"0";"0,00%";"269";"2";"0.74";"267";"99,26%";"0.74";0.740
"MULTIPOLYGON (((-58.4001555208349 -34.5796814327705,-58.4002164263313 -34.5796480118737,-58.4002645948574 -34.5796220720152,-58.4001359553714 -34.5794295108836,-58.4000366213056 -34.5792723407261,-58.3999713737732 -34.5793054071766,-58.3999016265491 -34.5792077616232,-58.3992635358071 -34.5783095069653,-58.3987714106982 -34.5776166860839,-58.398771721976 -34.5776165170942,-58.3984827667413 -34.5772373653406,-58.3984290817809 -34.5772725813637,-58.3981287960981 -34.5774697475716,-58.3980608386164 -34.5775155356541,-58.3972055200689 -34.5780799258979,-58.3971470783445 -34.5781200586535,-58.3965594749615 -34.5785064084939,-58.3965823208086 -34.578542213279,-58.3966626680306 -34.5786696553921,-58.3967557534629 -34.5788173907358,-58.396771433382 -34.5788393085216,-58.3969133464146 -34.5790413108743,-58.3979600442247 -34.5804922230065,-58.3981093172348 -34.5807020994905,-58.398588284624 -34.5804716382657,-58.3998658994531 -34.5798405863941,-58.4001555208349 -34.5796814327705)))";;"1464";14_31_9;COMUNA 14;"31";"9";"649";"292";"357";"81,79%";"338";"338";"100,00%";"0";"0,00%";"225";"0";"0";"225";"100,00%";"0";0.000
"MULTIPOLYGON (((-58.4429651325782 -34.5693107023928,-58.4428223348464 -34.5694074439819,-58.4417576702105 -34.5698487639647,-58.4429562396002 -34.5709152773591,-58.4436397274429 -34.5705638215375,-58.4438275632544 -34.5704716636445,-58.4441105934294 -34.5703326869862,-58.4429651325782 -34.5693107023928)))";;"1465";14_4_1;COMUNA 14;"4";"1";"880";"374";"506";"73,91%";"526";"526";"100,00%";"0";"0,00%";"413";"3";"0.73";"410";"99,27%";"0.73";0.730
"MULTIPOLYGON (((-58.4290147046708 -34.5772536227781,-58.4292978990603 -34.5772489116709,-58.4293071730561 -34.5772659571781,-58.430105413946 -34.5770331349857,-58.4314077609481 -34.5766549387561,-58.4314686690477 -34.5765752326874,-58.4317092354041 -34.5764850085087,-58.432202078688 -34.5763389503534,-58.4323432429946 -34.5762741288037,-58.4328412438616 -34.5760277960261,-58.4324173625101 -34.5753604908455,-58.432352685335 -34.5752734992684,-58.4323132776611 -34.5752362343653,-58.4322645012158 -34.5752074181758,-58.4322099313296 -34.5751888826455,-58.4318997979477 -34.5750737999095,-58.4318327987054 -34.5750516693717,-58.4317671627747 -34.5750268629727,-58.4317030603938 -34.5749995216091,-58.4316406618526 -34.5749696453265,-58.4315800522976 -34.5749372341492,-58.4315214019387 -34.5749024993999,-58.431464795921 -34.5748654411031,-58.4313108150741 -34.5747532137449,-58.4310554706626 -34.5749831575701,-58.4291610362894 -34.5766992031331,-58.4284994069358 -34.5772530569274,-58.4290147046708 -34.5772536227781)))";;"1466";14_4_10;COMUNA 14;"4";"10";"1482";"645";"837";"77,06%";"870";"869";"99,89%";"1";"0,12%";"697";"5";"0.72";"692";"99,28%";"0.72";0.720
"MULTIPOLYGON (((-58.4396261802824 -34.5679519593103,-58.4402459893992 -34.5685035073454,-58.4412256823931 -34.5693753411809,-58.4417576702105 -34.5698487639647,-58.4428223348464 -34.5694074439819,-58.4429651325782 -34.5693107023928,-58.4421907260109 -34.5686197701021,-58.4406010110909 -34.5672014026902,-58.4394138457914 -34.5661421919788,-58.4393387402833 -34.5662049268606,-58.4392614206878 -34.5662694219111,-58.4383107357343 -34.5671269492823,-58.4380982651649 -34.5673285351753,-58.4381228537912 -34.5673807959312,-58.4381658371226 -34.5674143271678,-58.4382137597883 -34.5674428591617,-58.4382658557338 -34.5674658283489,-58.4383211885483 -34.5674829528348,-58.438378736703 -34.5674938802832,-58.4384375637817 -34.5674983288027,-58.4385037989283 -34.5674982715235,-58.4385654348452 -34.5675049037319,-58.4386255365128 -34.5675178739115,-58.4386832526531 -34.5675369706201,-58.4387375617155 -34.5675619823838,-58.4387876124975 -34.5675924160609,-58.4388683918171 -34.5676415185061,-58.4389507044484 -34.5676878745971,-58.4390348908074 -34.5677319069506,-58.4391208658144 -34.5677734042693,-58.4392086294445 -34.5678124369753,-58.4392979263252 -34.5678488641645,-58.4393886713149 -34.5678826858173,-58.4394808644068 -34.5679139019306,-58.4396261802824 -34.5679519593103)))";;"1467";14_4_2;COMUNA 14;"4";"2";"610";"282";"328";"85,98%";"274";"273";"99,64%";"1";"0,37%";"220";"1";"0.45";"219";"99,55%";"0.45";0.450
"MULTIPOLYGON (((-58.4402459893992 -34.5685035073454,-58.4396261802824 -34.5679519593103,-58.4394808644068 -34.5679139019306,-58.4393886713149 -34.5678826858173,-58.4392979263252 -34.5678488641645,-58.4392086294445 -34.5678124369753,-58.4391208658144 -34.5677734042693,-58.4390348908074 -34.5677319069506,-58.4389507044484 -34.5676878745971,-58.4388683918171 -34.5676415185061,-58.4387876124975 -34.5675924160609,-58.4387375617155 -34.5675619823838,-58.4386832526531 -34.5675369706201,-58.4386255365128 -34.5675178739115,-58.4385654348452 -34.5675049037319,-58.4385037989283 -34.5674982715235,-58.4384375637817 -34.5674983288027,-58.438378736703 -34.5674938802832,-58.4383211885483 -34.5674829528348,-58.4382658557338 -34.5674658283489,-58.4382137597883 -34.5674428591617,-58.4381658371226 -34.5674143271678,-58.4381228537912 -34.5673807959312,-58.4380982651649 -34.5673285351753,-58.4378793214566 -34.5675363168292,-58.4375065959908 -34.5681131670323,-58.4373530252652 -34.5683470186606,-58.4383177778784 -34.5689593544447,-58.4392227790893 -34.5695688540454,-58.4401611614676 -34.5702008892317,-58.4408670005427 -34.5706762492994,-58.4409910736805 -34.5705741543464,-58.4416625616663 -34.569888185937,-58.4417576702105 -34.5698487639647,-58.4412256823931 -34.5693753411809,-58.4402459893992 -34.5685035073454)))";;"1468";14_4_3;COMUNA 14;"4";"3";"585";"262";"323";"81,11%";"314";"312";"99,36%";"2";"0,64%";"218";"2";"0.92";"216";"99,08%";"0.92";0.920
"MULTIPOLYGON (((-58.4417576702105 -34.5698487639647,-58.4416625616663 -34.569888185937,-58.4409910736805 -34.5705741543464,-58.4408670005427 -34.5706762492994,-58.4418346055778 -34.5713279254677,-58.4419438949339 -34.5714452730906,-58.44220343416 -34.5713022826238,-58.4425441175957 -34.5711271205427,-58.4429562396002 -34.5709152773591,-58.4417576702105 -34.5698487639647)))";;"1469";14_4_4;COMUNA 14;"4";"4";"651";"289";"362";"79,83%";"386";"386";"100,00%";"0";"0,00%";"293";"2";"0.68";"291";"99,32%";"0.68";0.680
"MULTIPOLYGON (((-58.4408670005427 -34.5706762492994,-58.4401611614676 -34.5702008892317,-58.4392227790893 -34.5695688540454,-58.4383177778784 -34.5689593544447,-58.4373530252652 -34.5683470186606,-58.4370697305506 -34.568778527564,-58.4370189722431 -34.5688338009872,-58.4367246407563 -34.569154668132,-58.4395061410178 -34.5707045206705,-58.4402143868211 -34.5710969940372,-58.4414106786584 -34.571739137556,-58.4419438949339 -34.5714452730906,-58.4418346055778 -34.5713279254677,-58.4408670005427 -34.5706762492994)))";;"1470";14_4_5;COMUNA 14;"4";"5";"862";"377";"485";"77,73%";"477";"476";"99,79%";"1";"0,21%";"384";"16";"4.17";"368";"95,83%";"4.17";4.170
"MULTIPOLYGON (((-58.4320914038701 -34.5740504243628,-58.4319880926574 -34.5741434305398,-58.4317541297996 -34.5743540846338,-58.4323249397778 -34.5743066907808,-58.4328393834115 -34.5742639989924,-58.4339120316451 -34.5741798164725,-58.4344282411967 -34.5744491034995,-58.4363081660455 -34.5734195510054,-58.4377116119174 -34.5726362917653,-58.4380826295378 -34.5724291751829,-58.4390034099831 -34.5730657226616,-58.4396599453862 -34.5727039314635,-58.4407445362326 -34.57210621842,-58.4414106786584 -34.571739137556,-58.4402143868211 -34.5710969940372,-58.4395061410178 -34.5707045206705,-58.4367246407563 -34.569154668132,-58.436565465764 -34.5693281628077,-58.4357290409747 -34.5702398513064,-58.4352636807508 -34.5707470934328,-58.4349177277972 -34.5711097068646,-58.4340786388977 -34.5719891282682,-58.4334306580354 -34.5726682290653,-58.433325556055 -34.5727783493748,-58.4331005312602 -34.5730141501684,-58.4325281687061 -34.5736140356408,-58.4322371293697 -34.5739191876248,-58.4320914038701 -34.5740504243628)))";;"1471";14_4_6;COMUNA 14;"4";"6";"1303";"619";"684";"90,50%";"656";"649";"98,93%";"7";"1,08%";"454";"5";"1.1";"449";"98,90%";"1.1";1.100
"MULTIPOLYGON (((-58.4380826295378 -34.5724291751829,-58.4377116119174 -34.5726362917653,-58.4363081660455 -34.5734195510054,-58.4365807296003 -34.5736064485878,-58.436761099059 -34.5737515636567,-58.4369339678366 -34.5739253400653,-58.4371152448589 -34.5741057639751,-58.4384507577622 -34.5733702045971,-58.4390034099831 -34.5730657226616,-58.4380826295378 -34.5724291751829)))";;"1472";14_4_7;COMUNA 14;"4";"7";"929";"397";"532";"74,62%";"604";"603";"99,83%";"1";"0,17%";"432";"1";"0.23";"431";"99,77%";"0.23";0.230
"MULTIPOLYGON (((-58.4339120316451 -34.5741798164725,-58.4328393834115 -34.5742639989924,-58.4323249397778 -34.5743066907808,-58.4317541297996 -34.5743540846338,-58.4315813184697 -34.5745096811154,-58.4314562874942 -34.5746222595919,-58.431575304862 -34.5746536293567,-58.4317261351986 -34.5745373951809,-58.4319606732379 -34.5746161902082,-58.4319709427623 -34.5747050698064,-58.4320846764433 -34.5747505228487,-58.4320744903594 -34.5746659392387,-58.4323000933556 -34.5747331111588,-58.4323077249887 -34.5748188209215,-58.4327416540565 -34.5749378769015,-58.4330088062948 -34.5750098466351,-58.4331424676673 -34.5750460073668,-58.4341530171959 -34.5745789041149,-58.4344282411967 -34.5744491034995,-58.4339120316451 -34.5741798164725)))";;"1473";14_4_8;COMUNA 14;"4";"8";"1123";"490";"633";"77,41%";"600";"599";"99,83%";"1";"0,17%";"482";"7";"1.45";"475";"98,55%";"1.45";1.450
"MULTIPOLYGON (((-58.4313559558578 -34.5747125898175,-58.4313108150741 -34.5747532137449,-58.431464795921 -34.5748654411031,-58.4315214019387 -34.5749024993999,-58.4315800522976 -34.5749372341492,-58.4316406618526 -34.5749696453265,-58.4317030603938 -34.5749995216091,-58.4317671627747 -34.5750268629727,-58.4318327987054 -34.5750516693717,-58.4318997979477 -34.5750737999095,-58.4322099313296 -34.5751888826455,-58.4322645012158 -34.5752074181758,-58.4323132776611 -34.5752362343653,-58.432352685335 -34.5752734992684,-58.4324173625101 -34.5753604908455,-58.4328412438616 -34.5760277960261,-58.4339221993868 -34.5755582576304,-58.4341398825772 -34.5754625056847,-58.4341399132594 -34.575462429621,-58.4341419015386 -34.5754614128824,-58.4343316088415 -34.5753776533707,-58.4343353777452 -34.575375996292,-58.4343352916434 -34.5753760226629,-58.435347705436 -34.5749278544436,-58.4371152448589 -34.5741057639751,-58.4369339678366 -34.5739253400653,-58.436761099059 -34.5737515636567,-58.4365807296003 -34.5736064485878,-58.4363081660455 -34.5734195510054,-58.4344282411967 -34.5744491034995,-58.4341530171959 -34.5745789041149,-58.4331424676673 -34.5750460073668,-58.4330088062948 -34.5750098466351,-58.4327416540565 -34.5749378769015,-58.4323077249887 -34.5748188209215,-58.4323000933556 -34.5747331111588,-58.4320744903594 -34.5746659392387,-58.4320846764433 -34.5747505228487,-58.4319709427623 -34.5747050698064,-58.4319606732379 -34.5746161902082,-58.4317261351986 -34.5745373951809,-58.431575304862 -34.5746536293567,-58.4314562874942 -34.5746222595919,-58.431456229005 -34.5746221719218,-58.4314542567801 -34.574624169034,-58.4313567302302 -34.5747119455597,-58.431355937035 -34.5747125626729,-58.4313559558578 -34.5747125898175)))";;"1474";14_4_9;COMUNA 14;"4";"9";"802";"373";"429";"86,95%";"588";"587";"99,83%";"1";"0,17%";"433";"1";"0.23";"432";"99,77%";"0.23";0.230
"MULTIPOLYGON (((-58.4384507577622 -34.5733702045971,-58.4371152448589 -34.5741057639751,-58.4383823209703 -34.5753597826208,-58.4392084577083 -34.5747799198153,-58.4395978043789 -34.574509067125,-58.4384507577622 -34.5733702045971)))";;"1475";14_5_10;COMUNA 14;"5";"10";"1268";"550";"718";"76,60%";"660";"660";"100,00%";"0";"0,00%";"546";"2";"0.37";"544";"99,63%";"0.37";0.370
"MULTIPOLYGON (((-58.4407445362326 -34.57210621842,-58.4396599453862 -34.5727039314635,-58.4406845894137 -34.5737529681803,-58.4408701465042 -34.5736238410697,-58.4417030525011 -34.5730740341266,-58.4407445362326 -34.57210621842)))";;"1476";14_5_4;COMUNA 14;"5";"4";"554";"240";"314";"76,43%";"369";"368";"99,73%";"1";"0,27%";"284";"4";"1.41";"280";"98,59%";"1.41";1.410
"MULTIPOLYGON (((-58.4396599453862 -34.5727039314635,-58.4390034099831 -34.5730657226616,-58.4384507577622 -34.5733702045971,-58.4395978043789 -34.574509067125,-58.4406845894137 -34.5737529681803,-58.4396599453862 -34.5727039314635)))";;"1477";14_5_5;COMUNA 14;"5";"5";"1046";"441";"605";"72,89%";"644";"642";"99,69%";"2";"0,31%";"507";"2";"0.39";"505";"99,61%";"0.39";0.390
"MULTIPOLYGON (((-58.4413836739283 -34.5744686156813,-58.4406845894137 -34.5737529681803,-58.4395978043789 -34.574509067125,-58.4402741645792 -34.5751805597868,-58.4408493159964 -34.5748141696808,-58.4413836739283 -34.5744686156813)))";;"1478";14_5_6;COMUNA 14;"5";"6";"631";"280";"351";"79,77%";"387";"387";"100,00%";"0";"0,00%";"277";"2";"0.72";"275";"99,28%";"0.72";0.720
"MULTIPOLYGON (((-58.4383823209703 -34.5753597826208,-58.43736556476 -34.5760515187871,-58.437171551997 -34.5760263945938,-58.4366748488737 -34.5759431875973,-58.4369049395167 -34.5761143704289,-58.4373781540552 -34.5761648941805,-58.4376879002636 -34.5761900295265,-58.4378639757382 -34.5761977418606,-58.4379544817975 -34.5762045210914,-58.4380950536257 -34.5762076482313,-58.4384988053999 -34.5762114615038,-58.4386508717018 -34.576214590282,-58.4386510107221 -34.5762145755911,-58.438656264639 -34.5762111280481,-58.4388820035137 -34.5760673102669,-58.4388907922467 -34.5760617172513,-58.4388908511112 -34.5760617435478,-58.4390602894527 -34.5760544522279,-58.4391522631359 -34.5759894672596,-58.439215252005 -34.576051805972,-58.4394827804812 -34.576028405457,-58.4395661387779 -34.5760194068188,-58.4396593742622 -34.5760085084997,-58.4397223828054 -34.576000773571,-58.4398118724048 -34.5759881137924,-58.4398671328546 -34.5759803069102,-58.4399363574855 -34.5759702489918,-58.4399631789589 -34.5759658876092,-58.440034447475 -34.5759541398035,-58.4400850251096 -34.5759458389744,-58.4401396046606 -34.5759369050345,-58.4401607212552 -34.5759333876601,-58.4401842221191 -34.5759289551901,-58.440305132281 -34.5759063004189,-58.440425276028 -34.5758838566645,-58.4405152773803 -34.5758669709325,-58.44053630891 -34.5758630309245,-58.4405617681127 -34.5758583170353,-58.4406791018523 -34.5758363654998,-58.4407237198545 -34.5758259505652,-58.4407709805151 -34.5758032820497,-58.4408818425488 -34.5757838644747,-58.4402741645792 -34.5751805597868,-58.4395978043789 -34.574509067125,-58.4392084577083 -34.5747799198153,-58.4383823209703 -34.5753597826208)))";;"1479";14_5_7;COMUNA 14;"5";"7";"553";"258";"295";"87,46%";"283";"281";"99,29%";"2";"0,71%";"236";"18";"7.63";"218";"92,37%";"7.63";7.630
"MULTIPOLYGON (((-58.4392210921998 -34.5761753334394,-58.439105123129 -34.5761858749034,-58.4388364908941 -34.5761962456551,-58.4388017458578 -34.576218211616,-58.4386510107221 -34.5762145755911,-58.4386508717018 -34.576214590282,-58.4384988053999 -34.5762114615038,-58.4380950536257 -34.5762076482313,-58.4379544817975 -34.5762045210914,-58.4378639757382 -34.5761977418606,-58.4376879002636 -34.5761900295265,-58.4373781540552 -34.5761648941805,-58.4369049395167 -34.5761143704289,-58.4370821644502 -34.5762600477045,-58.4372251720655 -34.5763728288715,-58.4377531978089 -34.5767864764916,-58.438430624285 -34.5773171283471,-58.4387460158305 -34.5775652996663,-58.4391461103298 -34.5778802498997,-58.4398069474023 -34.5784240603882,-58.4399388906297 -34.5785469071055,-58.4408885540874 -34.5777964152476,-58.4418141615156 -34.5768178740203,-58.4418782017236 -34.5767719675341,-58.4416673374516 -34.5765628974718,-58.441051490034 -34.575952282082,-58.4410513579856 -34.575952151041,-58.4412658780761 -34.5758048374368,-58.4412554464087 -34.575807804933,-58.4409839884623 -34.5758852954292,-58.4408806163498 -34.5759147148586,-58.4408090912627 -34.5759313928983,-58.4407579167774 -34.5759432151957,-58.4407018888799 -34.5759558112777,-58.4406567600918 -34.5759656627077,-58.44059664517 -34.5759786101307,-58.4405486214313 -34.5759886018475,-58.4404451662024 -34.5760093585546,-58.4402362128771 -34.5760481247345,-58.4401922766056 -34.5760557225958,-58.4401273089371 -34.5760664857017,-58.4400488028226 -34.5760792886011,-58.4399833243689 -34.5760896289825,-58.4399452635183 -34.5760952559338,-58.4398951969313 -34.5761025004176,-58.4398426610852 -34.5761100261204,-58.439789103754 -34.5761166360773,-58.4397396334578 -34.576122753801,-58.4396989332693 -34.5761278167749,-58.4396618092374 -34.5761324578573,-58.4395343451858 -34.5761453920263,-58.4394413653761 -34.5761548113627,-58.4393555378546 -34.5761634573156,-58.4393319522887 -34.5761659176954,-58.4392210921998 -34.5761753334394)))";;"1480";14_5_8;COMUNA 14;"5";"8";"456";"222";"234";"94,87%";"231";"230";"99,57%";"1";"0,43%";"190";"13";"6.84";"177";"93,16%";"6.84";6.840
"MULTIPOLYGON (((-58.43736556476 -34.5760515187871,-58.4383823209703 -34.5753597826208,-58.4371152448589 -34.5741057639751,-58.435347705436 -34.5749278544436,-58.4360506482721 -34.5754467643164,-58.4366748488737 -34.5759431875973,-58.437171551997 -34.5760263945938,-58.43736556476 -34.5760515187871)))";;"1481";14_5_9;COMUNA 14;"5";"9";"1213";"582";"631";"92,23%";"601";"601";"100,00%";"0";"0,00%";"502";"3";"0.6";"499";"99,40%";"0.6";0.600
"MULTIPOLYGON (((-58.435347705436 -34.5749278544436,-58.4343352916434 -34.5753760226629,-58.4343353777452 -34.575375996292,-58.4343316088415 -34.5753776533707,-58.4341419015386 -34.5754614128824,-58.4341399132594 -34.575462429621,-58.4341398825772 -34.5754625056847,-58.4342998874442 -34.575604771131,-58.435027898099 -34.5762468522543,-58.4358308369018 -34.5769460751931,-58.4360181031748 -34.5771094330037,-58.4366474082728 -34.5776586061015,-58.4377531978089 -34.5767864764916,-58.4372251720655 -34.5763728288715,-58.4370821644502 -34.5762600477045,-58.4369049395167 -34.5761143704289,-58.4366748488737 -34.5759431875973,-58.4360506482721 -34.5754467643164,-58.435347705436 -34.5749278544436)))";;"1482";14_6_1;COMUNA 14;"6";"1";"991";"468";"523";"89,48%";"700";"699";"99,86%";"1";"0,14%";"512";"2";"0.39";"510";"99,61%";"0.39";0.390
"MULTIPOLYGON (((-58.4316376427189 -34.5766771815072,-58.431575137749 -34.576701110255,-58.4314077609481 -34.5766549387561,-58.430105413946 -34.5770331349857,-58.4309744545978 -34.577791776093,-58.4320159885215 -34.5770076432233,-58.4316376427189 -34.5766771815072)))";;"1483";14_6_10;COMUNA 14;"6";"10";"395";"172";"223";"77,13%";"284";"284";"100,00%";"0";"0,00%";"213";"4";"1.88";"209";"98,12%";"1.88";1.880
"MULTIPOLYGON (((-58.4387460158305 -34.5775652996663,-58.438430624285 -34.5773171283471,-58.4377531978089 -34.5767864764916,-58.4366474082728 -34.5776586061015,-58.4375789107878 -34.578471441063,-58.4378318999079 -34.5786921359013,-58.4382256870441 -34.5790358918284,-58.4387413776502 -34.579486365045,-58.4388364233422 -34.5794120143675,-58.4398090142392 -34.5786495631684,-58.4399388906297 -34.5785469071055,-58.4398069474023 -34.5784240603882,-58.4391461103298 -34.5778802498997,-58.4387460158305 -34.5775652996663)))";;"1484";14_6_2;COMUNA 14;"6";"2";"821";"397";"424";"93,63%";"588";"588";"100,00%";"0";"0,00%";"401";"19";"4.74";"382";"95,26%";"4.74";4.740
"MULTIPOLYGON (((-58.4382256870441 -34.5790358918284,-58.4378318999079 -34.5786921359013,-58.4375789107878 -34.578471441063,-58.4366474082728 -34.5776586061015,-58.4356285507674 -34.5784669393892,-58.4347042971654 -34.5792002122419,-58.4346108659512 -34.5792742079477,-58.4355298532169 -34.5800768437583,-58.4361429189499 -34.5806107332543,-58.4366905297423 -34.5810905893738,-58.436944334901 -34.5808922546954,-58.4377162190019 -34.5802884464135,-58.4387413776502 -34.579486365045,-58.4382256870441 -34.5790358918284)))";;"1485";14_6_3;COMUNA 14;"6";"3";"943";"453";"490";"92,45%";"440";"438";"99,55%";"2";"0,46%";"380";"53";"13.95";"327";"86,05%";"13.95";13.950
"MULTIPOLYGON (((-58.4350021403764 -34.5779203675113,-58.4339877760902 -34.5787299557414,-58.4346108659512 -34.5792742079477,-58.4347042971654 -34.5792002122419,-58.4356285507674 -34.5784669393892,-58.4366474082728 -34.5776586061015,-58.4360181031748 -34.5771094330037,-58.4358308369018 -34.5769460751931,-58.435027898099 -34.5762468522543,-58.4340030842711 -34.5770486212394,-58.4350021403764 -34.5779203675113)))";;"1486";14_6_4;COMUNA 14;"6";"4";"722";"354";"368";"96,20%";"499";"498";"99,80%";"1";"0,20%";"361";"9";"2.49";"352";"97,51%";"2.49";2.490
"MULTIPOLYGON (((-58.4339221993868 -34.5755582576304,-58.4328412438616 -34.5760277960261,-58.4340030842711 -34.5770486212394,-58.435027898099 -34.5762468522543,-58.4342998874442 -34.575604771131,-58.4341398825772 -34.5754625056847,-58.4339221993868 -34.5755582576304)))";;"1487";14_6_5;COMUNA 14;"6";"5";"794";"333";"461";"72,23%";"461";"461";"100,00%";"0";"0,00%";"387";"20";"5.17";"367";"94,83%";"5.17";5.170
"MULTIPOLYGON (((-58.4323432429946 -34.5762741288037,-58.432202078688 -34.5763389503534,-58.4317092354041 -34.5764850085087,-58.4314686690477 -34.5765752326874,-58.4314077609481 -34.5766549387561,-58.431575137749 -34.576701110255,-58.4316376427189 -34.5766771815072,-58.4320159885215 -34.5770076432233,-58.4329795283255 -34.5778493254336,-58.4340030842711 -34.5770486212394,-58.4328412438616 -34.5760277960261,-58.4323432429946 -34.5762741288037)))";;"1488";14_6_6;COMUNA 14;"6";"6";"1127";"522";"605";"86,28%";"604";"604";"100,00%";"0";"0,00%";"511";"70";"13.7";"441";"86,30%";"13.7";13.700
"MULTIPOLYGON (((-58.4340030842711 -34.5770486212394,-58.4329795283255 -34.5778493254336,-58.4339877760902 -34.5787299557414,-58.4350021403764 -34.5779203675113,-58.4340030842711 -34.5770486212394)))";;"1489";14_6_7;COMUNA 14;"6";"7";"788";"334";"454";"73,57%";"454";"454";"100,00%";"0";"0,00%";"359";"3";"0.84";"356";"99,16%";"0.84";0.840
"MULTIPOLYGON (((-58.4329795283255 -34.5778493254336,-58.4319568896213 -34.5786493169101,-58.4329751807061 -34.5795381977757,-58.4339877760902 -34.5787299557414,-58.4329795283255 -34.5778493254336)))";;"1490";14_6_8;COMUNA 14;"6";"8";"530";"249";"281";"88,61%";"324";"324";"100,00%";"0";"0,00%";"253";"2";"0.79";"251";"99,21%";"0.79";0.790
"MULTIPOLYGON (((-58.4320159885215 -34.5770076432233,-58.4309744545978 -34.577791776093,-58.4319568896213 -34.5786493169101,-58.4329795283255 -34.5778493254336,-58.4320159885215 -34.5770076432233)))";;"1491";14_6_9;COMUNA 14;"6";"9";"784";"357";"427";"83,61%";"524";"524";"100,00%";"0";"0,00%";"402";"21";"5.22";"381";"94,78%";"5.22";5.220
"MULTIPOLYGON (((-58.4414499813029 -34.5852471040792,-58.4403783835914 -34.585994407989,-58.4392783194378 -34.5867615568936,-58.4385103236918 -34.5872970625551,-58.4383255841881 -34.5874259042432,-58.4379180584624 -34.5877037772497,-58.4379175218298 -34.5877041431526,-58.4378658218065 -34.5877394157562,-58.438081932004 -34.5883682172576,-58.4382715487486 -34.5884590336584,-58.4386143422687 -34.5886203758809,-58.4393890703121 -34.5881083226183,-58.4401565493114 -34.5876011224047,-58.4410892481873 -34.5869846464933,-58.4413975614414 -34.586780255804,-58.4424252046729 -34.586098713067,-58.4434772738804 -34.5854009676046,-58.4445857898517 -34.5846657550622,-58.4447856757497 -34.5845135248236,-58.4443997989956 -34.5831917936965,-58.4436072566103 -34.5837426103913,-58.4425223263383 -34.5844992273853,-58.4414499813029 -34.5852471040792)))";;"1492";14_7_1;COMUNA 14;"7";"1";"879";"422";"457";"92,34%";"478";"478";"100,00%";"0";"0,00%";"375";"50";"13.33";"325";"86,67%";"13.33";13.330
"MULTIPOLYGON (((-58.4437796861044 -34.5822515195962,-58.4434316971011 -34.5817970097772,-58.442323699919 -34.5826143987582,-58.4412672074024 -34.5833936864672,-58.4402157201251 -34.584169303728,-58.4414499813029 -34.5852471040792,-58.4425223263383 -34.5844992273853,-58.4436072566103 -34.5837426103913,-58.4443997989956 -34.5831917936965,-58.4444485951796 -34.5831708142256,-58.4437796861044 -34.5822515195962)))";;"1493";14_7_2;COMUNA 14;"7";"2";"918";"442";"476";"92,86%";"579";"579";"100,00%";"0";"0,00%";"411";"21";"5.11";"390";"94,89%";"5.11";5.110
"MULTIPOLYGON (((-58.4412672074024 -34.5833936864672,-58.442323699919 -34.5826143987582,-58.4434316971011 -34.5817970097772,-58.4425093927139 -34.5809387970112,-58.441375930327 -34.5817868083568,-58.4404048541555 -34.5809389237011,-58.4396649198757 -34.5815233175356,-58.4393836096934 -34.5817439774666,-58.4383589399085 -34.5825476838102,-58.4392816598321 -34.5833535312717,-58.4402157201251 -34.584169303728,-58.4412672074024 -34.5833936864672)))";;"1494";14_7_3;COMUNA 14;"7";"3";"815";"397";"418";"94,98%";"403";"400";"99,26%";"3";"0,75%";"289";"8";"2.77";"281";"97,23%";"2.77";2.770
"MULTIPOLYGON (((-58.4404048541555 -34.5809389237011,-58.441375930327 -34.5817868083568,-58.4425093927139 -34.5809387970112,-58.4422825227001 -34.5807276941797,-58.4415432664226 -34.5800397932262,-58.4405331508016 -34.5790998564832,-58.4403049056493 -34.579291160831,-58.4395118307527 -34.5799559700181,-58.4393925110101 -34.5800549654945,-58.4404048541555 -34.5809389237011)))";;"1495";14_7_4;COMUNA 14;"7";"4";"1021";"487";"534";"91,20%";"577";"577";"100,00%";"0";"0,00%";"402";"3";"0.75";"399";"99,25%";"0.75";0.750
"MULTIPOLYGON (((-58.4373992926257 -34.5817095667674,-58.4383589399085 -34.5825476838102,-58.4393836096934 -34.5817439774666,-58.4396649198757 -34.5815233175356,-58.4404048541555 -34.5809389237011,-58.4393925110101 -34.5800549654945,-58.4395118307527 -34.5799559700181,-58.4403049056493 -34.579291160831,-58.4405331508016 -34.5790998564832,-58.4399388906297 -34.5785469071055,-58.4398090142392 -34.5786495631684,-58.4388364233422 -34.5794120143675,-58.4387413776502 -34.579486365045,-58.4377162190019 -34.5802884464135,-58.436944334901 -34.5808922546954,-58.4366905297423 -34.5810905893738,-58.4373992926257 -34.5817095667674)))";;"1496";14_7_5;COMUNA 14;"7";"5";"745";"359";"386";"93,01%";"424";"423";"99,76%";"1";"0,24%";"260";"13";"5";"247";"95,00%";"5";5.000
"MULTIPOLYGON (((-58.4354058250963 -34.5833636419881,-58.4363090307762 -34.5841533800252,-58.4371885873842 -34.5849223308436,-58.4382398607643 -34.5841332180438,-58.4373394458436 -34.5833473682672,-58.4364066144349 -34.5825332641718,-58.4373992926257 -34.5817095667674,-58.4366905297423 -34.5810905893738,-58.4356685685515 -34.5818890623071,-58.43463917777 -34.5826932997515,-58.4354058250963 -34.5833636419881)))";;"1497";14_7_6;COMUNA 14;"7";"6";"727";"316";"411";"76,89%";"378";"377";"99,74%";"1";"0,27%";"301";"11";"3.65";"290";"96,35%";"3.65";3.650
"MULTIPOLYGON (((-58.4382398607643 -34.5841332180438,-58.4391685564663 -34.5849436450034,-58.4403286639321 -34.5859560874699,-58.4403783835914 -34.585994407989,-58.4414499813029 -34.5852471040792,-58.4402157201251 -34.584169303728,-58.4392816598321 -34.5833535312717,-58.4383589399085 -34.5825476838102,-58.4373992926257 -34.5817095667674,-58.4364066144349 -34.5825332641718,-58.4373394458436 -34.5833473682672,-58.4382398607643 -34.5841332180438)))";;"1498";14_7_7;COMUNA 14;"7";"7";"661";"309";"352";"87,78%";"344";"341";"99,13%";"3";"0,88%";"240";"3";"1.25";"237";"98,75%";"1.25";1.250
"MULTIPOLYGON (((-58.4391685564663 -34.5849436450034,-58.4382398607643 -34.5841332180438,-58.4371885873842 -34.5849223308436,-58.4363807209809 -34.5855288037296,-58.436257302319 -34.5856273726114,-58.4371694806945 -34.5864205567831,-58.4383255841881 -34.5874259042432,-58.4385103236918 -34.5872970625551,-58.4392783194378 -34.5867615568936,-58.4403783835914 -34.585994407989,-58.4403286639321 -34.5859560874699,-58.4391685564663 -34.5849436450034)))";;"1499";14_7_8;COMUNA 14;"7";"8";"586";"254";"332";"76,51%";"369";"367";"99,46%";"2";"0,54%";"239";"7";"2.93";"232";"97,07%";"2.93";2.930
"MULTIPOLYGON (((-58.4338168713973 -34.5846820626639,-58.4347532343449 -34.5853721679433,-58.4357013612324 -34.586070930891,-58.4366666161718 -34.5867822961958,-58.4367007880317 -34.586807451171,-58.4379180584624 -34.5877037772497,-58.4383255841881 -34.5874259042432,-58.4371694806945 -34.5864205567831,-58.436257302319 -34.5856273726114,-58.4363807209809 -34.5855288037296,-58.4371885873842 -34.5849223308436,-58.4363090307762 -34.5841533800252,-58.4354058250963 -34.5833636419881,-58.43463917777 -34.5826932997515,-58.4337149577346 -34.5834152965298,-58.4329300693498 -34.5840284425916,-58.4338168713973 -34.5846820626639)))";;"1500";14_7_9;COMUNA 14;"7";"9";"616";"280";"336";"83,33%";"405";"404";"99,75%";"1";"0,25%";"275";"17";"6.18";"258";"93,82%";"6.18";6.180
"MULTIPOLYGON (((-58.4325575194008 -34.5824053267782,-58.4316521543451 -34.5816152785155,-58.4306894172961 -34.5823769626484,-58.4316705908299 -34.5831001330949,-58.4329300693498 -34.5840284425916,-58.4337149577346 -34.5834152965298,-58.43463917777 -34.5826932997515,-58.4356685685515 -34.5818890623071,-58.4366905297423 -34.5810905893738,-58.4361429189499 -34.5806107332543,-58.4355298532169 -34.5800768437583,-58.4345087443362 -34.5808767862376,-58.4334818241166 -34.581681296327,-58.4325575194008 -34.5824053267782)))";;"1501";14_8_1;COMUNA 14;"8";"1";"843";"427";"416";"102,64%";"490";"489";"99,80%";"1";"0,20%";"366";"6";"1.64";"360";"98,36%";"1.64";1.640
"MULTIPOLYGON (((-58.4346108659512 -34.5792742079477,-58.4339877760902 -34.5787299557414,-58.4329751807061 -34.5795381977757,-58.4319586477857 -34.5803494586,-58.4325730538816 -34.5808866059063,-58.4334818241166 -34.581681296327,-58.4345087443362 -34.5808767862376,-58.4355298532169 -34.5800768437583,-58.4346108659512 -34.5792742079477)))";;"1502";14_8_2;COMUNA 14;"8";"2";"592";"287";"305";"94,10%";"412";"412";"100,00%";"0";"0,00%";"290";"5";"1.72";"285";"98,28%";"1.72";1.720
"MULTIPOLYGON (((-58.4319568896213 -34.5786493169101,-58.4309315909792 -34.5794513413543,-58.4319586477857 -34.5803494586,-58.4329751807061 -34.5795381977757,-58.4319568896213 -34.5786493169101)))";;"1503";14_8_3;COMUNA 14;"8";"3";"356";"166";"190";"87,37%";"227";"226";"99,56%";"1";"0,44%";"169";"10";"5.92";"159";"94,08%";"5.92";5.920
"MULTIPOLYGON (((-58.4309744545978 -34.577791776093,-58.4299317086775 -34.5785768856,-58.4309315909792 -34.5794513413543,-58.4319568896213 -34.5786493169101,-58.4309744545978 -34.577791776093)))";;"1504";14_8_4;COMUNA 14;"8";"4";"455";"203";"252";"80,56%";"316";"316";"100,00%";"0";"0,00%";"245";"30";"12.24";"215";"87,76%";"12.24";12.240
"MULTIPOLYGON (((-58.430105413946 -34.5770331349857,-58.4293071730561 -34.5772659571781,-58.428683736464 -34.5774855125632,-58.4299317086775 -34.5785768856,-58.4309744545978 -34.577791776093,-58.430105413946 -34.5770331349857)))";;"1505";14_8_5;COMUNA 14;"8";"5";"987";"429";"558";"76,88%";"645";"644";"99,84%";"1";"0,16%";"482";"4";"0.83";"478";"99,17%";"0.83";0.830
"MULTIPOLYGON (((-58.4274039091632 -34.5779077725374,-58.428986210866 -34.5792887000775,-58.4299317086775 -34.5785768856,-58.428683736464 -34.5774855125632,-58.4293071730561 -34.5772659571781,-58.4292978990603 -34.5772489116709,-58.4290147046708 -34.5772536227781,-58.4284994069358 -34.5772530569274,-58.4278468505435 -34.577468022218,-58.4266562649694 -34.5778602281201,-58.4267174328779 -34.5779805328977,-58.4267814935005 -34.5781064725322,-58.4274039091632 -34.5779077725374)))";;"1506";14_8_6;COMUNA 14;"8";"6";"927";"398";"529";"75,24%";"629";"629";"100,00%";"0";"0,00%";"469";"33";"7.04";"436";"92,96%";"7.04";7.040
"MULTIPOLYGON (((-58.4274039091632 -34.5779077725374,-58.4267814935005 -34.5781064725322,-58.4265312229552 -34.5781679504994,-58.4278430084109 -34.5797370596068,-58.4280649716708 -34.5799822034086,-58.428986210866 -34.5792887000775,-58.4274039091632 -34.5779077725374)))";;"1507";14_8_7;COMUNA 14;"8";"7";"632";"297";"335";"88,66%";"391";"391";"100,00%";"0";"0,00%";"301";"5";"1.66";"296";"98,34%";"1.66";1.660
"MULTIPOLYGON (((-58.4299317086775 -34.5785768856,-58.428986210866 -34.5792887000775,-58.4280649716708 -34.5799822034086,-58.4284778369545 -34.5804383247211,-58.4289217098766 -34.5808722691722,-58.429010061146 -34.5809544096685,-58.4300039674578 -34.5801769716547,-58.4309315909792 -34.5794513413543,-58.4299317086775 -34.5785768856)))";;"1508";14_8_8;COMUNA 14;"8";"8";"696";"319";"377";"84,62%";"388";"388";"100,00%";"0";"0,00%";"306";"23";"7.52";"283";"92,48%";"7.52";7.520
"MULTIPOLYGON (((-58.4319586477857 -34.5803494586,-58.4309315909792 -34.5794513413543,-58.4300039674578 -34.5801769716547,-58.429010061146 -34.5809544096685,-58.4291100736561 -34.5810473284036,-58.4300412774777 -34.5818796577695,-58.430166404102 -34.5819914563609,-58.4306894172961 -34.5823769626484,-58.4316521543451 -34.5816152785155,-58.4325575194008 -34.5824053267782,-58.4334818241166 -34.581681296327,-58.4325730538816 -34.5808866059063,-58.4319586477857 -34.5803494586)))";;"1509";14_8_9;COMUNA 14;"8";"9";"1177";"570";"607";"93,90%";"780";"779";"99,87%";"1";"0,13%";"476";"7";"1.47";"469";"98,53%";"1.47";1.470
"MULTIPOLYGON (((-58.4342007192986 -34.5702716181239,-58.4331438539856 -34.5708881539678,-58.4340786388977 -34.5719891282682,-58.4349177277972 -34.5711097068646,-58.4352636807508 -34.5707470934328,-58.4357290409747 -34.5702398513064,-58.435238153976 -34.5696664072127,-58.4342007192986 -34.5702716181239)))";;"1510";14_9_1;COMUNA 14;"9";"1";"1190";"582";"608";"95,72%";"731";"731";"100,00%";"0";"0,00%";"491";"5";"1.02";"486";"98,98%";"1.02";1.020
"MULTIPOLYGON (((-58.4331438539856 -34.5708881539678,-58.4329812055291 -34.5709830481437,-58.4323104254646 -34.5713752238165,-58.4330556830345 -34.5722355144191,-58.4334306580354 -34.5726682290653,-58.4340786388977 -34.5719891282682,-58.4331438539856 -34.5708881539678)))";;"1511";14_9_10;COMUNA 14;"9";"10";"912";"408";"504";"80,95%";"633";"633";"100,00%";"0";"0,00%";"462";"2";"0.43";"460";"99,57%";"0.43";0.430
"MULTIPOLYGON (((-58.4321775801271 -34.5714528700669,-58.431167095797 -34.572043765355,-58.4319113264803 -34.57290237237,-58.4325281687061 -34.5736140356408,-58.4331005312602 -34.5730141501684,-58.433325556055 -34.5727783493748,-58.4334306580354 -34.5726682290653,-58.4330556830345 -34.5722355144191,-58.4323104254646 -34.5713752238165,-58.4321775801271 -34.5714528700669)))";;"1512";14_9_11;COMUNA 14;"9";"11";"767";"334";"433";"77,14%";"591";"591";"100,00%";"0";"0,00%";"395";"1";"0.25";"394";"99,75%";"0.25";0.250
"MULTIPOLYGON (((-58.4239082950403 -34.5710307859321,-58.4239400619767 -34.5710088232468,-58.4239020165956 -34.5709838100849,-58.4238661677825 -34.5709954893294,-58.4237698253135 -34.5709495638382,-58.4236062752038 -34.5710240630335,-58.4236025499748 -34.5710189662867,-58.4236024822923 -34.5710189272967,-58.4235232860583 -34.5710556640498,-58.4234090933122 -34.5711017560917,-58.4232447440543 -34.5711681848127,-58.4248534796167 -34.5742812215945,-58.4249874541523 -34.5745562043135,-58.4252486006922 -34.5750922229346,-58.4257146925106 -34.5760088122526,-58.4266562649694 -34.5778602281201,-58.4278468505435 -34.577468022218,-58.4284994069358 -34.5772530569274,-58.4291610362894 -34.5766992031331,-58.4310554706626 -34.5749831575701,-58.4313108150741 -34.5747532137449,-58.4313559558578 -34.5747125898175,-58.431355937035 -34.5747125626729,-58.4313567302302 -34.5747119455597,-58.4314542567801 -34.574624169034,-58.431456229005 -34.5746221719218,-58.4314562874942 -34.5746222595919,-58.4315813184697 -34.5745096811154,-58.4317541297996 -34.5743540846338,-58.4319880926574 -34.5741434305398,-58.4320914038701 -34.5740504243628,-58.4322371293697 -34.5739191876248,-58.4325281687061 -34.5736140356408,-58.4319113264803 -34.57290237237,-58.431167095797 -34.572043765355,-58.4301266209287 -34.5726521801789,-58.4295259011678 -34.5730034418702,-58.4286929412971 -34.5734904869662,-58.4279591184667 -34.5731366023334,-58.4275069937959 -34.5729205490294,-58.4273286782953 -34.5728318786462,-58.4270341371385 -34.5726871623779,-58.4262019578826 -34.5722604887443,-58.4244206652606 -34.5712048283979,-58.4241890658558 -34.5710670031488,-58.424138166995 -34.5710364223854,-58.424031798186 -34.5711023774905,-58.4239082950403 -34.5710307859321)))";;"1513";14_9_12;COMUNA 14;"9";"12";"1035";"533";"502";"106,18%";"511";"510";"99,80%";"1";"0,20%";"418";"4";"0.96";"414";"99,04%";"0.96";0.960
"MULTIPOLYGON (((-58.4314307203757 -34.5705941229494,-58.4315655236127 -34.5705154216165,-58.4309146725572 -34.5697640946756,-58.4311736718307 -34.5695088691029,-58.4313114751358 -34.569372208554,-58.431521577245 -34.5691572965225,-58.4315263974778 -34.5691096265117,-58.4312050413024 -34.5687280686984,-58.4311246935185 -34.5686726229999,-58.4308300352949 -34.5684531706993,-58.4307858551794 -34.5684387219098,-58.4307644063808 -34.5684243494788,-58.4307411711607 -34.5684062440196,-58.430716060639 -34.568394194666,-58.4306978467626 -34.5683805273267,-58.430677081134 -34.5683608027138,-58.4303791017576 -34.5681494473869,-58.4303162895706 -34.5681029498442,-58.4303031004148 -34.5680851990934,-58.4300992602385 -34.5679317578668,-58.4297198361905 -34.5676523480048,-58.4261969913097 -34.5696738275931,-58.4258892271244 -34.5698504329539,-58.4244024515225 -34.5706347277275,-58.4243741787531 -34.5706496490747,-58.424199347248 -34.5707418515529,-58.424103460822 -34.5707863302314,-58.4238870772873 -34.5708867589061,-58.4237607042084 -34.5709455944323,-58.4237698253135 -34.5709495638382,-58.4238661677825 -34.5709954893294,-58.4239020165956 -34.5709838100849,-58.4239400619766 -34.5710088232468,-58.4239082950403 -34.5710307859321,-58.424031798186 -34.5711023774905,-58.424138166995 -34.5710364223854,-58.4241890658558 -34.5710670031488,-58.4244206652606 -34.5712048283979,-58.4262019578826 -34.5722604887443,-58.4270341371385 -34.5726871623779,-58.4273286782953 -34.5728318786462,-58.4275069937959 -34.5729205490294,-58.4279591184667 -34.5731366023334,-58.4286929412971 -34.5734904869662,-58.4295259011678 -34.5730034418702,-58.4301266209287 -34.5726521801789,-58.4293781543317 -34.5717923638628,-58.4304213486196 -34.5711833222203,-58.4314307203757 -34.5705941229494)))";;"1514";14_9_13;COMUNA 14;"9";"13";"683";"305";"378";"80,69%";"529";"526";"99,43%";"3";"0,57%";"349";"2";"0.57";"347";"99,43%";"0.57";0.570
"MULTIPOLYGON (((-58.4334620240767 -34.5694082370827,-58.4342007192986 -34.5702716181239,-58.435238153976 -34.5696664072127,-58.4344989426268 -34.5688028209663,-58.4337615336985 -34.5679412728949,-58.4334583045411 -34.5681165603841,-58.4330197653451 -34.5683699867051,-58.4327207060379 -34.5685416816573,-58.4334620240767 -34.5694082370827)))";;"1515";14_9_2;COMUNA 14;"9";"2";"876";"392";"484";"80,99%";"423";"423";"100,00%";"0";"0,00%";"303";"2";"0.66";"301";"99,34%";"0.66";0.660
"MULTIPOLYGON (((-58.4327207060379 -34.5685416816573,-58.4325489507684 -34.568640235189,-58.4316744940715 -34.5691575033175,-58.4324092515441 -34.5700228661448,-58.4331438539856 -34.5708881539678,-58.4342007192986 -34.5702716181239,-58.4334620240767 -34.5694082370827,-58.4327207060379 -34.5685416816573)))";;"1516";14_9_3;COMUNA 14;"9";"3";"1102";"522";"580";"90,00%";"734";"734";"100,00%";"0";"0,00%";"525";"6";"1.14";"519";"98,86%";"1.14";1.140
"MULTIPOLYGON (((-58.4334583045411 -34.5681165603841,-58.4323671873477 -34.5674609134652,-58.4309390710801 -34.5682912202433,-58.431380050735 -34.5688106525206,-58.4316744940715 -34.5691575033175,-58.4325489507684 -34.568640235189,-58.4327207060379 -34.5685416816573,-58.4330197653451 -34.5683699867051,-58.4334583045411 -34.5681165603841)))";;"1517";14_9_4;COMUNA 14;"9";"4";"1217";"551";"666";"82,73%";"766";"766";"100,00%";"0";"0,00%";"537";"4";"0.74";"533";"99,26%";"0.74";0.740
"MULTIPOLYGON (((-58.4330236293447 -34.5670792271517,-58.4323671873477 -34.5674609134652,-58.4334583045411 -34.5681165603841,-58.4337615336985 -34.5679412728949,-58.4330236293447 -34.5670792271517)))";;"1518";14_9_5;COMUNA 14;"9";"5";"398";"173";"225";"76,89%";"255";"255";"100,00%";"0";"0,00%";"198";"2";"1.01";"196";"98,99%";"1.01";1.010
"MULTIPOLYGON (((-58.4322453189086 -34.5661698407384,-58.4312269757943 -34.5667758765989,-58.4323671873477 -34.5674609134652,-58.4330236293447 -34.5670792271517,-58.4322453189086 -34.5661698407384)))";;"1519";14_9_6;COMUNA 14;"9";"6";"694";"320";"374";"85,56%";"427";"427";"100,00%";"0";"0,00%";"296";"1";"0.34";"295";"99,66%";"0.34";0.340
"MULTIPOLYGON (((-58.4312269757943 -34.5667758765989,-58.4306788406815 -34.5671020863444,-58.4301749859636 -34.5673911911203,-58.4309390710801 -34.5682912202433,-58.4323671873477 -34.5674609134652,-58.4312269757943 -34.5667758765989)))";;"1520";14_9_7;COMUNA 14;"9";"7";"654";"284";"370";"76,76%";"378";"378";"100,00%";"0";"0,00%";"264";"0";"0";"264";"100,00%";"0";0.000
"MULTIPOLYGON (((-58.4316744940716 -34.5691575033175,-58.431380050735 -34.5688106525206,-58.4309390710801 -34.5682912202433,-58.4301749859636 -34.5673911911203,-58.4297198361905 -34.5676523480048,-58.4300992602385 -34.5679317578668,-58.4303031004148 -34.5680851990934,-58.4303162895706 -34.5681029498442,-58.4303791017576 -34.5681494473869,-58.430677081134 -34.5683608027138,-58.4306978467626 -34.5683805273267,-58.430716060639 -34.568394194666,-58.4307411711607 -34.5684062440196,-58.4307644063808 -34.5684243494788,-58.4307858551794 -34.5684387219098,-58.4308300352949 -34.5684531706993,-58.4311246935185 -34.5686726229999,-58.4312050413024 -34.5687280686984,-58.4315263974778 -34.5691096265117,-58.431521577245 -34.5691572965225,-58.4313114751358 -34.569372208554,-58.4311736718307 -34.5695088691029,-58.4309146725572 -34.5697640946756,-58.4315655236127 -34.5705154216165,-58.4324092515441 -34.5700228661448,-58.4316744940716 -34.5691575033175)))";;"1521";14_9_8;COMUNA 14;"9";"8";"784";"364";"420";"86,67%";"555";"555";"100,00%";"0";"0,00%";"391";"3";"0.77";"388";"99,23%";"0.77";0.770
"MULTIPOLYGON (((-58.4304213486196 -34.5711833222204,-58.4293781543317 -34.5717923638628,-58.4301266209287 -34.5726521801789,-58.431167095797 -34.572043765355,-58.4321775801271 -34.5714528700669,-58.4323104254646 -34.5713752238165,-58.4329812055291 -34.5709830481437,-58.4331438539856 -34.5708881539678,-58.4324092515441 -34.5700228661448,-58.4315655236127 -34.5705154216165,-58.4314307203758 -34.5705941229494,-58.4304213486196 -34.5711833222204)))";;"1522";14_9_9;COMUNA 14;"9";"9";"793";"361";"432";"83,56%";"579";"579";"100,00%";"0";"0,00%";"363";"8";"2.2";"355";"97,80%";"2.2";2.200
"MULTIPOLYGON (((-58.5001701143996 -34.5930266124165,-58.5014975608172 -34.5938441875342,-58.5021419147886 -34.5942433628426,-58.5030835374687 -34.5943822152499,-58.5034718395455 -34.593953548201,-58.5033113467367 -34.5938561331024,-58.5021419863206 -34.5931333896228,-58.5019281694047 -34.5930011998104,-58.5008170994647 -34.5923152572159,-58.4994872980186 -34.5914941539241,-58.4982024984139 -34.590700911373,-58.4975548237769 -34.5914158447924,-58.4988404792372 -34.5922076853078,-58.5001701143996 -34.5930266124165)))";;"1523";15_1_1;COMUNA 15;"1";"1";"1023";"485";"538";"90,15%";"527";"527";"100,00%";"0";"0,00%";"417";"5";"1.2";"412";"98,80%";"1.2";1.200
"MULTIPOLYGON (((-58.4896166270085 -34.5865001213447,-58.4895137968881 -34.5866138105572,-58.4889943626629 -34.5871828902565,-58.4888955314519 -34.5872911553199,-58.4883689400134 -34.5878742484814,-58.4876994108807 -34.5886156849029,-58.4875902760635 -34.5887364867095,-58.4870285080755 -34.5893596531504,-58.4866953081818 -34.5897292409535,-58.4863291594536 -34.5901353145392,-58.4874588195984 -34.5908323719094,-58.4881627627379 -34.5900588159386,-58.4888360467302 -34.5893189257027,-58.4894129553721 -34.5886849021212,-58.4895085524235 -34.588579172687,-58.490132949199 -34.5878883019111,-58.4907512067374 -34.5872041901127,-58.4914133771589 -34.5864714712664,-58.4908503012128 -34.5861164471956,-58.4902856969623 -34.5857604348949,-58.4896166270085 -34.5865001213447)))";;"1524";15_1_10;COMUNA 15;"1";"10";"939";"441";"498";"88,55%";"396";"396";"100,00%";"0";"0,00%";"340";"29";"8.53";"311";"91,47%";"8.53";8.530
"MULTIPOLYGON (((-58.4874435721607 -34.5862226826704,-58.4868939830429 -34.5867972527595,-58.4868027259303 -34.586897134013,-58.486941298646 -34.5869855608499,-58.4882414374963 -34.5877953988136,-58.4883689400134 -34.5878742484814,-58.4888955314519 -34.5872911553199,-58.4889943626629 -34.5871828902565,-58.4895137968881 -34.5866138105572,-58.4896166270085 -34.5865001213447,-58.4902856969623 -34.5857604348949,-58.4895595287783 -34.5853025500667,-58.4889688735587 -34.5849300578091,-58.4887935939207 -34.5848181894367,-58.4881939670312 -34.58543820058,-58.4880863672964 -34.5855506219488,-58.4874435721607 -34.5862226826704)))";;"1525";15_1_11;COMUNA 15;"1";"11";"587";"295";"292";"101,03%";"272";"272";"100,00%";"0";"0,00%";"220";"3";"1.36";"217";"98,64%";"1.36";1.360
"MULTIPOLYGON (((-58.4861114745179 -34.5876332138026,-58.4855612730704 -34.5882158767963,-58.4854343417769 -34.5883505538135,-58.4850782339436 -34.5887285925722,-58.4847104596042 -34.5891189568117,-58.4836505164796 -34.5894910596889,-58.4825014958378 -34.58989323945,-58.4820121326218 -34.590064451472,-58.481861585128 -34.5901171533638,-58.481457793884 -34.5902458127816,-58.4812884259938 -34.5902997845124,-58.4811822398902 -34.5903286750322,-58.4808709191807 -34.5904133730494,-58.4795448992558 -34.5907512528068,-58.4780829609035 -34.5911237141883,-58.4778249403606 -34.5911893828537,-58.4767283911487 -34.5914687502856,-58.4767269262178 -34.5914662592032,-58.4759623483366 -34.5916592134591,-58.4758796908482 -34.5916787534283,-58.4758758077803 -34.5916859666144,-58.4759500114005 -34.5918713884745,-58.4760162953983 -34.5920564590216,-58.4761235903793 -34.5923549614464,-58.4761489494594 -34.592426740832,-58.4763066673616 -34.5924301741894,-58.4765419671286 -34.5924371198339,-58.4771071805796 -34.592453322664,-58.4777286851226 -34.5924679665998,-58.4783388643927 -34.5924872568934,-58.4789640316109 -34.5925034434252,-58.4795892845586 -34.5925212465248,-58.4802838578841 -34.5925358673127,-58.4808959117706 -34.5925551445504,-58.4815342802448 -34.5925728653027,-58.4821069897167 -34.5925890438179,-58.48271342343 -34.5926067634763,-58.4834482804041 -34.5926268528148,-58.4841344249544 -34.5926437771544,-58.4848796723953 -34.5926645603009,-58.4856210879683 -34.5926853396159,-58.4863250322651 -34.5927030229722,-58.4874721579506 -34.5927342756208,-58.4886642504461 -34.5927687474917,-58.4893963006673 -34.5927910552188,-58.4904592033461 -34.5928187769179,-58.4907014875753 -34.5928227358076,-58.4906296026683 -34.592778375722,-58.4905616244756 -34.5927364263823,-58.4897373595491 -34.5922325777731,-58.4887978612548 -34.5916581820703,-58.4885939497655 -34.5915324458674,-58.4874588195984 -34.5908323719094,-58.4863291594536 -34.5901353145392,-58.4866953081818 -34.5897292409535,-58.4870285080755 -34.5893596531504,-58.4875902760635 -34.5887364867095,-58.4876994108807 -34.5886156849029,-58.4883689400134 -34.5878742484814,-58.4882414374963 -34.5877953988136,-58.486941298646 -34.5869855608499,-58.4868027259303 -34.586897134013,-58.4866959752876 -34.5870140611868,-58.4864405020165 -34.5872846854684,-58.4861114745179 -34.5876332138026)))";;"1526";15_1_12;COMUNA 15;"1";"12";"737";"357";"380";"93,95%";"334";"334";"100,00%";"0";"0,00%";"283";"2";"0.71";"281";"99,29%";"0.71";0.710
"MULTIPOLYGON (((-58.4969361645703 -34.592098793461,-58.4963131539634 -34.5927865290401,-58.4958385898875 -34.5933104118767,-58.4958125418875 -34.5933391524733,-58.4957200512314 -34.5934291877322,-58.4956518677147 -34.5934952613671,-58.4959300948443 -34.5935040922413,-58.4974687544747 -34.5937291297311,-58.4979581249055 -34.5938008231302,-58.4992880993211 -34.5939956505546,-58.5002318432188 -34.5941338200856,-58.5011174204136 -34.5942635496039,-58.502403973569 -34.5944519480101,-58.5025063463871 -34.594469107136,-58.5028768752027 -34.5946979180691,-58.5031812070856 -34.5945822209649,-58.5035437824006 -34.5944501177618,-58.5035437890607 -34.5944500929057,-58.5030835374687 -34.5943822152499,-58.5021419147886 -34.5942433628426,-58.5014975608172 -34.5938441875342,-58.5001701143996 -34.5930266124165,-58.4988404792372 -34.5922076853078,-58.4975548237769 -34.5914158447924,-58.4969361645703 -34.592098793461)))";;"1527";15_1_2;COMUNA 15;"1";"2";"946";"425";"521";"81,57%";"412";"411";"99,76%";"1";"0,24%";"344";"4";"1.16";"340";"98,84%";"1.16";1.160
"MULTIPOLYGON (((-58.4958009568662 -34.5913990084821,-58.4951790492288 -34.5920868084777,-58.495362443525 -34.5922002147247,-58.4963131539634 -34.5927865290401,-58.4969361645703 -34.592098793461,-58.4975548237769 -34.5914158447924,-58.4982024984139 -34.590700911373,-58.4970663616913 -34.589999448064,-58.4959279442245 -34.5892964957797,-58.4952830707034 -34.5900101488909,-58.4946638931914 -34.5906952695242,-58.4955843436441 -34.5912654701895,-58.4958009568662 -34.5913990084821)))";;"1528";15_1_3;COMUNA 15;"1";"3";"691";"309";"382";"80,89%";"339";"338";"99,71%";"1";"0,30%";"268";"0";"0";"268";"100,00%";"0";0.000
"MULTIPOLYGON (((-58.4940418964172 -34.5913834863807,-58.4933725595844 -34.5921241083406,-58.4927083184823 -34.5928590208393,-58.4942766436785 -34.5930851833394,-58.4951321360789 -34.593208555399,-58.4952251375013 -34.5932219818812,-58.4958385898875 -34.5933104118767,-58.4963131539634 -34.5927865290401,-58.495362443525 -34.5922002147247,-58.4951790492288 -34.5920868084777,-58.4958009568662 -34.5913990084821,-58.4955843436441 -34.5912654701895,-58.4946638931914 -34.5906952695242,-58.4940418964172 -34.5913834863807)))";;"1529";15_1_4;COMUNA 15;"1";"4";"644";"297";"347";"85,59%";"276";"275";"99,64%";"1";"0,36%";"237";"1";"0.42";"236";"99,58%";"0.42";0.420
"MULTIPOLYGON (((-58.4892985696857 -34.5907593058433,-58.4885939497655 -34.5915324458674,-58.4887978612548 -34.5916581820703,-58.4897373595491 -34.5922325777731,-58.4905616244756 -34.5927364263823,-58.4906296026683 -34.592778375722,-58.4909597665339 -34.5927975723793,-58.4909929488682 -34.5928005138587,-58.4926454558294 -34.5928204432085,-58.4927083184823 -34.5928590208393,-58.4933725595844 -34.5921241083406,-58.4932314173392 -34.5920373797353,-58.4922401902831 -34.5914204161261,-58.4920908729168 -34.5913274907402,-58.4911025605635 -34.590717700497,-58.4899721901371 -34.5900201840308,-58.4892985696857 -34.5907593058433)))";;"1530";15_1_5;COMUNA 15;"1";"5";"782";"364";"418";"87,08%";"308";"306";"99,35%";"2";"0,65%";"268";"3";"1.12";"265";"98,88%";"1.12";1.120
"MULTIPOLYGON (((-58.4917715663342 -34.5899790628028,-58.4906369410245 -34.5892772574749,-58.4900694908444 -34.5899134678445,-58.4899721901371 -34.5900201840308,-58.4911025605635 -34.590717700497,-58.4920908729168 -34.5913274907402,-58.4922401902831 -34.5914204161261,-58.4932314173392 -34.5920373797353,-58.4933725595844 -34.5921241083406,-58.4940418964172 -34.5913834863807,-58.492907658777 -34.5906818430875,-58.4935302555564 -34.589992997952,-58.4929617829332 -34.5896408022143,-58.492395614881 -34.5892900821787,-58.4917715663342 -34.5899790628028)))";;"1531";15_1_6;COMUNA 15;"1";"6";"740";"366";"374";"97,86%";"279";"279";"100,00%";"0";"0,00%";"257";"1";"0.39";"256";"99,61%";"0.39";0.390
"MULTIPOLYGON (((-58.4946638931914 -34.5906952695242,-58.4952830707034 -34.5900101488909,-58.4959279442245 -34.5892964957797,-58.4955923425811 -34.5890892544438,-58.4953611699577 -34.5889457896502,-58.4947944001007 -34.5885941653359,-58.49422533524 -34.588241060028,-58.4935799448283 -34.588955972055,-58.4929617829332 -34.5896408022143,-58.4935302555564 -34.589992997952,-58.492907658777 -34.5906818430875,-58.4940418964172 -34.5913834863807,-58.4946638931914 -34.5906952695242)))";;"1532";15_1_7;COMUNA 15;"1";"7";"699";"327";"372";"87,90%";"343";"343";"100,00%";"0";"0,00%";"290";"0";"0";"290";"100,00%";"0";0.000
"MULTIPOLYGON (((-58.4912618450719 -34.5885877189692,-58.4907467526137 -34.589154128763,-58.4906369410245 -34.5892772574749,-58.4917715663342 -34.5899790628028,-58.492395614881 -34.5892900821787,-58.4929617829332 -34.5896408022143,-58.4935799448283 -34.588955972055,-58.49422533524 -34.588241060028,-58.4938905082861 -34.5880333207961,-58.4936635142814 -34.587890203819,-58.4925401396548 -34.5871819339516,-58.4923849623767 -34.5873524716385,-58.491882398282 -34.5879051503407,-58.4912618450719 -34.5885877189692)))";;"1533";15_1_8;COMUNA 15;"1";"8";"716";"330";"386";"85,49%";"316";"315";"99,68%";"1";"0,32%";"276";"1";"0.36";"275";"99,64%";"0.36";0.360
"MULTIPOLYGON (((-58.4919701550289 -34.5868224799812,-58.4914133771589 -34.5864714712664,-58.4907512067374 -34.5872041901127,-58.490132949199 -34.5878883019111,-58.4895085524235 -34.588579172687,-58.4894129553721 -34.5886849021212,-58.4888360467302 -34.5893189257027,-58.4881627627379 -34.5900588159386,-58.4874588195984 -34.5908323719094,-58.4885939497655 -34.5915324458674,-58.4892985696857 -34.5907593058433,-58.4899721901371 -34.5900201840308,-58.4900694908444 -34.5899134678445,-58.4906369410245 -34.5892772574749,-58.4907467526137 -34.589154128763,-58.4912618450719 -34.5885877189692,-58.491882398282 -34.5879051503407,-58.4923849623767 -34.5873524716385,-58.4925401396548 -34.5871819339516,-58.4919701550289 -34.5868224799812)))";;"1534";15_1_9;COMUNA 15;"1";"9";"988";"472";"516";"91,47%";"395";"394";"99,75%";"1";"0,25%";"342";"2";"0.58";"340";"99,42%";"0.58";0.580
"MULTIPOLYGON (((-58.4605277209304 -34.5782946331705,-58.4602248561012 -34.5782952612339,-58.4601021605077 -34.5782955403861,-58.4596950759365 -34.5783201095376,-58.4585384469706 -34.5783900080897,-58.4589018745857 -34.579745569532,-58.4591695356574 -34.5807633663714,-58.4605306366777 -34.5807721309098,-58.4605293030354 -34.5796668032238,-58.4605277209304 -34.5782946331705)))";;"1535";15_10_1;COMUNA 15;"10";"1";"719";"336";"383";"87,73%";"404";"404";"100,00%";"0";"0,00%";"348";"16";"4.6";"332";"95,40%";"4.6";4.600
"MULTIPOLYGON (((-58.4499990078592 -34.5808797332743,-58.4495954627069 -34.5810397676731,-58.4494416747398 -34.5810963731292,-58.4491920030256 -34.5811882509685,-58.4498103377166 -34.5824078048491,-58.4502863587663 -34.5833466956408,-58.4512115003107 -34.582925642159,-58.4507054860252 -34.5820735161115,-58.4510636455296 -34.581939742442,-58.4514348324489 -34.5818011095659,-58.4517121779428 -34.5817032434792,-58.4515221632983 -34.5814097633815,-58.4514768732551 -34.5813398971785,-58.4509524718763 -34.5805015736322,-58.4499990078592 -34.5808797332743)))";;"1536";15_10_10;COMUNA 15;"10";"10";"582";"270";"312";"86,54%";"342";"342";"100,00%";"0";"0,00%";"257";"65";"25.29";"192";"74,71%";"25.29";25.290
"MULTIPOLYGON (((-58.4512829571048 -34.5853049012137,-58.4523461539865 -34.5848364558034,-58.4517463849746 -34.583826432552,-58.4512115003107 -34.582925642159,-58.4502863587663 -34.5833466956408,-58.4504730416066 -34.5837149690356,-58.4507713293927 -34.5843003746451,-58.4497445711242 -34.5847994453047,-58.4495536447305 -34.5848875975019,-58.4498821766958 -34.5859171110009,-58.4500898801555 -34.5858305798238,-58.4512829571048 -34.5853049012137)))";;"1537";15_10_11;COMUNA 15;"10";"11";"656";"285";"371";"76,82%";"317";"316";"99,68%";"1";"0,32%";"253";"2";"0.79";"251";"99,21%";"0.79";0.790
"MULTIPOLYGON (((-58.4534314796383 -34.5843581432182,-58.4523461539865 -34.5848364558034,-58.4512829571048 -34.5853049012137,-58.4518097507173 -34.5863391463434,-58.452972755708 -34.5858916207635,-58.4535154650768 -34.5856765836413,-58.4539648727513 -34.5851817373213,-58.4534314796383 -34.5843581432182)))";;"1538";15_10_12;COMUNA 15;"10";"12";"782";"363";"419";"86,63%";"396";"396";"100,00%";"0";"0,00%";"338";"21";"6.21";"317";"93,79%";"6.21";6.210
"MULTIPOLYGON (((-58.4502126742819 -34.5869535957571,-58.4503031515899 -34.5872392503398,-58.450526071589 -34.5879360614762,-58.4507670816588 -34.5886894915362,-58.4507671343743 -34.5886896563305,-58.4507674660423 -34.5886906931597,-58.450768122278 -34.5886899753325,-58.4507682472379 -34.5886898386445,-58.4512368353492 -34.5881772667851,-58.4522059612047 -34.5871172407495,-58.4523756983482 -34.5869316139109,-58.4531101675082 -34.5861229086423,-58.4535154650768 -34.5856765836413,-58.452972755708 -34.5858916207635,-58.4518097507173 -34.5863391463434,-58.4512829571048 -34.5853049012137,-58.4500898801555 -34.5858305798238,-58.4498821766958 -34.5859171110009,-58.4501913955975 -34.5868864781848,-58.4502126742819 -34.5869535957571)))";;"1539";15_10_13;COMUNA 15;"10";"13";"1059";"457";"602";"75,91%";"446";"445";"99,78%";"1";"0,22%";"364";"32";"8.79";"332";"91,21%";"8.79";8.790
"MULTIPOLYGON (((-58.4589018745857 -34.579745569532,-58.4585384469706 -34.5783900080897,-58.4577436891683 -34.5784380085855,-58.4573407699771 -34.5785467285068,-58.4571617890572 -34.5785949619729,-58.4576266998303 -34.5798121456834,-58.4579827341385 -34.5807557203229,-58.458404247766 -34.5818698665309,-58.4584541387735 -34.5820029019412,-58.4587823510731 -34.5828689345368,-58.4588315618735 -34.5830062657006,-58.4605332197592 -34.5829502491291,-58.4605319709835 -34.5818532320421,-58.4605306366777 -34.5807721309098,-58.4591695356574 -34.5807633663714,-58.4589018745857 -34.579745569532)))";;"1540";15_10_2;COMUNA 15;"10";"2";"1107";"579";"528";"109,66%";"408";"407";"99,75%";"1";"0,25%";"341";"3";"0.88";"338";"99,12%";"0.88";0.880
"MULTIPOLYGON (((-58.455580635857 -34.5804015750584,-58.4561536985972 -34.5812991091621,-58.4567063400207 -34.5821633282087,-58.458404247766 -34.5818698665309,-58.4579827341385 -34.5807557203229,-58.4576266998303 -34.5798121456834,-58.4571617890572 -34.5785949619729,-58.4559709050067 -34.5789162535979,-58.4553993012505 -34.5790704525436,-58.4548623485548 -34.5792426799602,-58.4549820449224 -34.5794640348527,-58.455580635857 -34.5804015750584)))";;"1541";15_10_3;COMUNA 15;"10";"3";"1097";"503";"594";"84,68%";"471";"470";"99,79%";"1";"0,21%";"409";"19";"4.65";"390";"95,35%";"4.65";4.650
"MULTIPOLYGON (((-58.4561536985972 -34.5812991091621,-58.4548188623355 -34.5816951734208,-58.4534668977074 -34.5820962219661,-58.4540177284736 -34.5829599599571,-58.4545846618708 -34.5838489087137,-58.4548280748776 -34.5842306304324,-58.4549139808727 -34.5843653597656,-58.4562080783266 -34.5838828804907,-58.4574956040083 -34.5834029929158,-58.4588315618735 -34.5830062657006,-58.4587823510731 -34.5828689345368,-58.4584541387735 -34.5820029019412,-58.458404247766 -34.5818698665309,-58.4567063400207 -34.5821633282087,-58.4561536985972 -34.5812991091621)))";;"1542";15_10_4;COMUNA 15;"10";"4";"799";"383";"416";"92,07%";"432";"432";"100,00%";"0";"0,00%";"337";"20";"5.93";"317";"94,07%";"5.93";5.930
"MULTIPOLYGON (((-58.4548623485548 -34.5792426799602,-58.453533496065 -34.5796688727825,-58.4542734807424 -34.5808353830681,-58.4548188623355 -34.5816951734208,-58.4561536985972 -34.5812991091621,-58.455580635857 -34.5804015750584,-58.4549820449224 -34.5794640348527,-58.4548623485548 -34.5792426799602)))";;"1543";15_10_5;COMUNA 15;"10";"5";"725";"319";"406";"78,57%";"339";"338";"99,71%";"1";"0,30%";"277";"6";"2.17";"271";"97,83%";"2.17";2.170
"MULTIPOLYGON (((-58.4529479182636 -34.5812825564132,-58.4534668977074 -34.5820962219661,-58.4548188623355 -34.5816951734208,-58.4542734807424 -34.5808353830681,-58.453533496065 -34.5796688727825,-58.453020633375 -34.5798333470846,-58.4521930494186 -34.5800987826584,-58.4529479182636 -34.5812825564132)))";;"1544";15_10_6;COMUNA 15;"10";"6";"485";"216";"269";"80,30%";"281";"281";"100,00%";"0";"0,00%";"216";"14";"6.48";"202";"93,52%";"6.48";6.480
"MULTIPOLYGON (((-58.4521930494186 -34.5800987826584,-58.4520223207295 -34.5801534884282,-58.451017614008 -34.5804757337406,-58.4509524718763 -34.5805015736322,-58.4514768732551 -34.5813398971785,-58.4515221632983 -34.5814097633815,-58.4517121779428 -34.5817032434792,-58.4522095254691 -34.5824713471142,-58.4534668977074 -34.5820962219661,-58.4529479182636 -34.5812825564132,-58.4521930494186 -34.5800987826584)))";;"1545";15_10_7;COMUNA 15;"10";"7";"846";"386";"460";"83,91%";"508";"508";"100,00%";"0";"0,00%";"402";"20";"4.98";"382";"95,02%";"4.98";4.980
"MULTIPOLYGON (((-58.4534668977074 -34.5820962219661,-58.4522095254691 -34.5824713471142,-58.4527661364974 -34.5833307952453,-58.4534314796383 -34.5843581432182,-58.4539648727513 -34.5851817373213,-58.4541840816137 -34.5849403345148,-58.4548280748776 -34.5842306304324,-58.4545846618708 -34.5838489087137,-58.4540177284736 -34.5829599599571,-58.4534668977074 -34.5820962219661)))";;"1546";15_10_8;COMUNA 15;"10";"8";"720";"316";"404";"78,22%";"358";"358";"100,00%";"0";"0,00%";"324";"20";"6.17";"304";"93,83%";"6.17";6.170
"MULTIPOLYGON (((-58.4512115003107 -34.582925642159,-58.4517463849746 -34.583826432552,-58.4523461539865 -34.5848364558034,-58.4534314796383 -34.5843581432182,-58.4527661364974 -34.5833307952453,-58.4522095254691 -34.5824713471142,-58.4517121779428 -34.5817032434792,-58.4514348324489 -34.5818011095659,-58.4510636455296 -34.581939742442,-58.4507054860252 -34.5820735161115,-58.4512115003107 -34.582925642159)))";;"1547";15_10_9;COMUNA 15;"10";"9";"766";"345";"421";"81,95%";"352";"352";"100,00%";"0";"0,00%";"297";"26";"8.75";"271";"91,25%";"8.75";8.750
"MULTIPOLYGON (((-58.4498103377166 -34.5824078048491,-58.4491920030256 -34.5811882509685,-58.4484595897346 -34.5814578971885,-58.448393424506 -34.5814822566561,-58.4482796576898 -34.5815241464096,-58.4470924940961 -34.5820344440013,-58.4471840806259 -34.5822217873527,-58.4476359503034 -34.5832882258851,-58.4480739574309 -34.5843219130807,-58.4492162696374 -34.5838298413748,-58.4493761105211 -34.5837609828661,-58.4502863587663 -34.5833466956408,-58.4498103377166 -34.5824078048491)))";;"1548";15_11_1;COMUNA 15;"11";"1";"789";"380";"409";"92,91%";"424";"423";"99,76%";"1";"0,24%";"308";"56";"18.18";"252";"81,82%";"18.18";18.180
"MULTIPOLYGON (((-58.447057780369 -34.5882501859363,-58.4460068649717 -34.5886840782565,-58.4463356913188 -34.5898024774934,-58.4473884989759 -34.5893335812576,-58.4484372921308 -34.5888664360667,-58.4497551013361 -34.5882794466768,-58.4496686869349 -34.5881560522297,-58.4491474003597 -34.5873873728967,-58.4481120061674 -34.5878148764223,-58.447057780369 -34.5882501859363)))";;"1549";15_11_10;COMUNA 15;"11";"10";"670";"311";"359";"86,63%";"333";"333";"100,00%";"0";"0,00%";"268";"22";"8.21";"246";"91,79%";"8.21";8.210
"MULTIPOLYGON (((-58.4497551013361 -34.5882794466768,-58.4484372921308 -34.5888664360667,-58.4473884989759 -34.5893335812576,-58.4487487592147 -34.5906157674278,-58.4491731701343 -34.5902141090356,-58.4495161538629 -34.5898894857066,-58.4503379582443 -34.5891117236567,-58.4507674660423 -34.5886906931597,-58.4507671343743 -34.5886896563305,-58.4507670816588 -34.5886894915362,-58.450526071589 -34.5879360614762,-58.4503031515899 -34.5872392503398,-58.4502126742819 -34.5869535957571,-58.4499969641154 -34.5870366050246,-58.4491474003597 -34.5873873728967,-58.4496686869349 -34.5881560522297,-58.4497551013361 -34.5882794466768)))";;"1550";15_11_11;COMUNA 15;"11";"11";"1164";"540";"624";"86,54%";"681";"680";"99,85%";"1";"0,15%";"531";"23";"4.33";"508";"95,67%";"4.33";4.330
"MULTIPOLYGON (((-58.4473884989759 -34.5893335812576,-58.4463356913188 -34.5898024774934,-58.4463495628361 -34.5898495234881,-58.4466412081877 -34.5908414327917,-58.4466783310605 -34.5908748897078,-58.4468029834782 -34.5909815299734,-58.4475985794161 -34.5917026455972,-58.44788885252 -34.5914295717332,-58.4487487592147 -34.5906157674278,-58.4473884989759 -34.5893335812576)))";;"1551";15_11_12;COMUNA 15;"11";"12";"865";"399";"466";"85,62%";"458";"457";"99,78%";"1";"0,22%";"376";"1";"0.27";"375";"99,73%";"0.27";0.270
"MULTIPOLYGON (((-58.4446653284772 -34.5916052083119,-58.4447541839586 -34.591647819152,-58.4448939442513 -34.5917148627781,-58.4450290069696 -34.5917794771882,-58.4451534998078 -34.5918387475037,-58.4452774055328 -34.5918980176078,-58.4454001369538 -34.5919568017441,-58.4455269791835 -34.592017529035,-58.4456479492809 -34.5920753413231,-58.4456831420991 -34.5920920725332,-58.4457777281324 -34.5921370401125,-58.4458998730632 -34.5921953379877,-58.4460167330178 -34.5922512066428,-58.4461576697289 -34.5923192203261,-58.4462991940586 -34.5923867482499,-58.4464465908941 -34.5924576765159,-58.4466004477502 -34.5925310338303,-58.4466714502749 -34.5925652593803,-58.4467034752902 -34.5925355927286,-58.4473495290462 -34.5919368491697,-58.4475985794161 -34.5917026455972,-58.4468029834782 -34.5909815299734,-58.4466783310605 -34.5908748897078,-58.4466412081877 -34.5908414327917,-58.4463495628361 -34.5898495234881,-58.4463356913188 -34.5898024774934,-58.4460068649717 -34.5886840782565,-58.4459323362799 -34.5887664657165,-58.4450679866722 -34.5896101805563,-58.4441823253299 -34.5904747318249,-58.4436406813238 -34.5910034018983,-58.4436003085545 -34.5910441543006,-58.4435661186157 -34.5910773710692,-58.4436161443639 -34.5911012620602,-58.4436492273706 -34.5911169812068,-58.4437623624088 -34.5911707363729,-58.4439109292919 -34.5912426392467,-58.4440583220762 -34.5913135704093,-58.4442045408613 -34.5913830441901,-58.4443484107426 -34.5914525174417,-58.4444864087322 -34.5915185899214,-58.4446214706069 -34.5915841761345,-58.4446653284772 -34.5916052083119)))";;"1552";15_11_13;COMUNA 15;"11";"13";"923";"442";"481";"91,89%";"450";"450";"100,00%";"0";"0,00%";"364";"35";"9.62";"329";"90,38%";"9.62";9.620
"MULTIPOLYGON (((-58.4457860098013 -34.582595983241,-58.4444485951796 -34.5831708142256,-58.4443997989956 -34.5831917936965,-58.4447856757497 -34.5845135248236,-58.4464273827881 -34.5838078103677,-58.4469546248854 -34.5848040470374,-58.4480739574309 -34.5843219130807,-58.4476359503034 -34.5832882258851,-58.4471840806259 -34.5822217873527,-58.4470924940961 -34.5820344440013,-58.4457860098013 -34.582595983241)))";;"1553";15_11_2;COMUNA 15;"11";"2";"764";"383";"381";"100,52%";"589";"589";"100,00%";"0";"0,00%";"358";"9";"2.51";"349";"97,49%";"2.51";2.510
"MULTIPOLYGON (((-58.4480739574309 -34.5843219130807,-58.4469546248854 -34.5848040470374,-58.4474634075406 -34.5857654888182,-58.4484892424577 -34.5853379895358,-58.4494035091911 -34.5849569502657,-58.4495536447305 -34.5848875975019,-58.4497445711242 -34.5847994453047,-58.4507713293927 -34.5843003746451,-58.4504730416066 -34.5837149690356,-58.4502863587663 -34.5833466956408,-58.4493761105211 -34.5837609828661,-58.4492162696374 -34.5838298413748,-58.4480739574309 -34.5843219130807)))";;"1554";15_11_3;COMUNA 15;"11";"3";"736";"347";"389";"89,20%";"376";"375";"99,73%";"1";"0,27%";"305";"16";"5.25";"289";"94,75%";"5.25";5.250
"MULTIPOLYGON (((-58.4484892424577 -34.5853379895358,-58.4474634075406 -34.5857654888182,-58.4469546248854 -34.5848040470374,-58.4464273827881 -34.5838078103677,-58.4447856757497 -34.5845135248236,-58.44510323548 -34.5856014322883,-58.44540199772 -34.5866245447134,-58.4454943253016 -34.5869408381793,-58.4457036615102 -34.5876528681186,-58.4477939623881 -34.5867866274188,-58.4479634328394 -34.5867163634626,-58.4488176790707 -34.5863605336979,-58.4484892424577 -34.5853379895358)))";;"1555";15_11_4;COMUNA 15;"11";"4";"821";"392";"429";"91,38%";"337";"337";"100,00%";"0";"0,00%";"308";"5";"1.62";"303";"98,38%";"1.62";1.620
"MULTIPOLYGON (((-58.4424252046729 -34.586098713067,-58.4413975614414 -34.586780255804,-58.4423701871224 -34.5875301703218,-58.442519489799 -34.5874268106451,-58.4433854044041 -34.5868254475609,-58.4442985743604 -34.5861912671721,-58.44510323548 -34.5856014322883,-58.4447856757497 -34.5845135248236,-58.4445857898517 -34.5846657550622,-58.4434772738804 -34.5854009676046,-58.4424252046729 -34.586098713067)))";;"1556";15_11_5;COMUNA 15;"11";"5";"701";"320";"381";"83,99%";"320";"320";"100,00%";"0";"0,00%";"245";"17";"6.94";"228";"93,06%";"6.94";6.940
"MULTIPOLYGON (((-58.4399761490941 -34.5893507236871,-58.4400341775636 -34.5893784453132,-58.4401891975189 -34.5894522966368,-58.4403406943693 -34.5895251757668,-58.4404927788874 -34.5895975691397,-58.4406477996557 -34.5896714198785,-58.4407940123412 -34.5897423547876,-58.4409472719458 -34.589815719153,-58.4410641251258 -34.5898720782453,-58.4410897600016 -34.5898843886085,-58.4411734994133 -34.5899246018308,-58.4412107454676 -34.5898847664523,-58.4412107841368 -34.5898847845936,-58.4413745020778 -34.5897112148197,-58.4422741904841 -34.589029721688,-58.4433037505184 -34.5882499991641,-58.4423701871224 -34.5875301703218,-58.4413975614414 -34.586780255804,-58.4410892481873 -34.5869846464933,-58.4401565493114 -34.5876011224047,-58.4393890703121 -34.5881083226183,-58.4386143422687 -34.5886203758809,-58.4386090314684 -34.5886237168274,-58.4385951845511 -34.5886323965985,-58.4385827799916 -34.5886402656497,-58.4385685869034 -34.5886491361737,-58.4385543938121 -34.5886580066959,-58.4385410661182 -34.5886664480331,-58.4385333892091 -34.5886712576826,-58.4386736522478 -34.5887375794169,-58.4388139904656 -34.588803173124,-58.4389660724813 -34.5888750827318,-58.4391199164294 -34.5889474781649,-58.4392673016323 -34.5890164724367,-58.439418210158 -34.5890874099029,-58.4395726421605 -34.5891598048751,-58.439727074431 -34.5892321996512,-58.4398785707438 -34.5893041080069,-58.4399761490941 -34.5893507236871)))";;"1557";15_11_6;COMUNA 15;"11";"6";"798";"384";"414";"92,75%";"288";"288";"100,00%";"0";"0,00%";"266";"22";"8.27";"244";"91,73%";"8.27";8.270
"MULTIPOLYGON (((-58.4413745020778 -34.5897112148197,-58.4412107841368 -34.5898847845936,-58.4412107454676 -34.5898847664523,-58.4411734994133 -34.5899246018308,-58.4412138619239 -34.5899439846243,-58.4413618372742 -34.5900154048356,-58.4415092256005 -34.5900868247649,-58.4416548527134 -34.5901567871862,-58.4417904974363 -34.5902223766467,-58.4419208574694 -34.5902855366805,-58.4420612003628 -34.5903530693392,-58.4422038921246 -34.5904225449309,-58.4423348400633 -34.5904857046192,-58.4423750450922 -34.5905051311302,-58.4424816428903 -34.590556637596,-58.4426284459669 -34.5906275703954,-58.4427699643393 -34.5906960737791,-58.442907959828 -34.5907621480511,-58.4430453683672 -34.5908277363967,-58.4431833641782 -34.5908942960311,-58.4433295813874 -34.5909642565396,-58.4434716883022 -34.5910322735242,-58.4435661186157 -34.5910773710692,-58.4436003085545 -34.5910441543006,-58.4436406813238 -34.5910034018983,-58.4441823253299 -34.5904747318249,-58.4450679866722 -34.5896101805563,-58.4459323362799 -34.5887664657165,-58.4451148769244 -34.5881435087095,-58.4442821894927 -34.5875089236806,-58.4433037505184 -34.5882499991641,-58.4422741904841 -34.589029721688,-58.4413745020778 -34.5897112148197)))";;"1558";15_11_7;COMUNA 15;"11";"7";"679";"317";"362";"87,57%";"305";"305";"100,00%";"0";"0,00%";"258";"22";"8.53";"236";"91,47%";"8.53";8.530
"MULTIPOLYGON (((-58.442519489799 -34.5874268106451,-58.4423701871224 -34.5875301703218,-58.4433037505184 -34.5882499991641,-58.4442821894927 -34.5875089236806,-58.4451148769244 -34.5881435087095,-58.4459323362799 -34.5887664657165,-58.4460068649717 -34.5886840782565,-58.4457036615102 -34.5876528681186,-58.4454943253016 -34.5869408381793,-58.44540199772 -34.5866245447134,-58.44510323548 -34.5856014322883,-58.4442985743604 -34.5861912671721,-58.4433854044041 -34.5868254475609,-58.442519489799 -34.5874268106451)))";;"1559";15_11_8;COMUNA 15;"11";"8";"726";"341";"385";"88,57%";"332";"331";"99,70%";"1";"0,30%";"276";"11";"3.99";"265";"96,01%";"3.99";3.990
"MULTIPOLYGON (((-58.4477939623881 -34.5867866274188,-58.4457036615102 -34.5876528681186,-58.4460068649717 -34.5886840782565,-58.447057780369 -34.5882501859363,-58.4481120061674 -34.5878148764223,-58.4491474003597 -34.5873873728967,-58.4499969641154 -34.5870366050246,-58.4502126742819 -34.5869535957571,-58.4501913955975 -34.5868864781848,-58.4498821766958 -34.5859171110009,-58.4495536447305 -34.5848875975019,-58.4494035091911 -34.5849569502657,-58.4484892424577 -34.5853379895358,-58.4488176790707 -34.5863605336979,-58.4479634328394 -34.5867163634626,-58.4477939623881 -34.5867866274188)))";;"1560";15_11_9;COMUNA 15;"11";"9";"1092";"494";"598";"82,61%";"456";"453";"99,34%";"3";"0,66%";"382";"6";"1.57";"376";"98,43%";"1.57";1.570
"MULTIPOLYGON (((-58.4434898304113 -34.5911517644316,-58.4434899771064 -34.5911518324753,-58.443563666864 -34.5910800301836,-58.4435661186157 -34.5910773710692,-58.4434716883022 -34.5910322735242,-58.4433295813874 -34.5909642565396,-58.4431833641782 -34.5908942960311,-58.4430453683672 -34.5908277363967,-58.442907959828 -34.5907621480511,-58.4427699643393 -34.5906960737791,-58.4426284459669 -34.5906275703954,-58.4424816428903 -34.590556637596,-58.4423750450922 -34.5905051311302,-58.4423348400633 -34.5904857046192,-58.4422038921246 -34.5904225449309,-58.4420612003628 -34.5903530693392,-58.4419208574694 -34.5902855366805,-58.4417904974363 -34.5902223766467,-58.4416548527134 -34.5901567871862,-58.4415092256005 -34.5900868247649,-58.4413618372742 -34.5900154048356,-58.4412138619239 -34.5899439846243,-58.4411734994133 -34.5899246018308,-58.4410897600016 -34.5898843886085,-58.4410641251258 -34.5898720782453,-58.4409472719458 -34.589815719153,-58.4407940123412 -34.5897423547876,-58.4406477996557 -34.5896714198785,-58.4404927788874 -34.5895975691397,-58.4403406943693 -34.5895251757668,-58.4401891975189 -34.5894522966368,-58.4400341775636 -34.5893784453132,-58.4399761490941 -34.5893507236871,-58.4398785707438 -34.5893041080069,-58.439727074431 -34.5892321996512,-58.4395726421605 -34.5891598048751,-58.439418210158 -34.5890874099029,-58.4392673016323 -34.5890164724367,-58.4391199164294 -34.5889474781649,-58.4389660724813 -34.5888750827318,-58.4388139904656 -34.588803173124,-58.4386736522478 -34.5887375794169,-58.4385333892091 -34.5886712576826,-58.4385265268416 -34.5886755570139,-58.4385131991696 -34.5886839029359,-58.438498470381 -34.5886900045414,-58.4384980577219 -34.5886900044596,-58.4384255019724 -34.5887384612705,-58.4384128666407 -34.5887463302584,-58.4383983853129 -34.5887544374079,-58.4383874806415 -34.5887619250892,-58.4383737488122 -34.5887714158611,-58.4383601900631 -34.5887808112538,-58.4383458812786 -34.5887906358499,-58.4383323802223 -34.5887999835449,-58.4383180137182 -34.5888099035384,-58.438303358743 -34.5888199665907,-58.4382889345329 -34.5888299342752,-58.4382753180795 -34.5888393296469,-58.4382614131552 -34.5888488680774,-58.4382513161777 -34.5888559265536,-58.4382498876198 -34.588856862205,-58.4383992963469 -34.5892924024716,-58.4386497892036 -34.5900225517285,-58.4388383424907 -34.5905719064379,-58.4391390633201 -34.5910845204886,-58.4396581526912 -34.591541468745,-58.4407030406826 -34.5922669015821,-58.4416478939777 -34.5912588592222,-58.4418905488343 -34.5914566551785,-58.4426235436029 -34.5920548298651,-58.443176882144 -34.5914646145304,-58.443326201685 -34.5913146323659,-58.4434898304113 -34.5911517644316)))";;"1561";15_12_1;COMUNA 15;"12";"1";"781";"389";"392";"99,23%";"272";"272";"100,00%";"0";"0,00%";"277";"78";"28.16";"199";"71,84%";"28.16";28.160
"MULTIPOLYGON (((-58.4371243928533 -34.5896120139141,-58.4361739156558 -34.5902497238368,-58.436036696171 -34.5903418102852,-58.4353108185579 -34.5908218799388,-58.4363422481463 -34.5914091726669,-58.4374600297344 -34.5920456313919,-58.4380267793051 -34.5914400894662,-58.4381874450515 -34.5915432949549,-58.4383225679401 -34.5916305085809,-58.4391390633201 -34.5910845204886,-58.4388383424907 -34.5905719064379,-58.4386497892036 -34.5900225517285,-58.4383992963469 -34.5892924024716,-58.4382498876198 -34.588856862205,-58.4381233194337 -34.5889418401936,-58.4380514326887 -34.588990067068,-58.4371243928533 -34.5896120139141)))";;"1562";15_12_2;COMUNA 15;"12";"2";"765";"365";"400";"91,25%";"346";"345";"99,71%";"1";"0,29%";"283";"32";"11.31";"251";"88,69%";"11.31";11.310
"MULTIPOLYGON (((-58.4383225679401 -34.5916305085809,-58.4381874450515 -34.5915432949549,-58.4380267793051 -34.5914400894662,-58.4374600297344 -34.5920456313919,-58.4385848955819 -34.5926860250341,-58.4397098638185 -34.593326549114,-58.4401777053147 -34.5928273913055,-58.4407030406826 -34.5922669015821,-58.4396581526912 -34.591541468745,-58.4391390633201 -34.5910845204886,-58.4383225679401 -34.5916305085809)))";;"1563";15_12_3;COMUNA 15;"12";"3";"752";"347";"405";"85,68%";"370";"369";"99,73%";"1";"0,27%";"309";"19";"6.15";"290";"93,85%";"6.15";6.150
"MULTIPOLYGON (((-58.4435287226949 -34.5942285118776,-58.4427203253282 -34.5936673038012,-58.4417459884882 -34.5929909165505,-58.4407030406826 -34.5922669015821,-58.4401777053147 -34.5928273913055,-58.4397098638185 -34.593326549114,-58.4408324651567 -34.5939656538295,-58.4418798104691 -34.5945619871827,-58.4427136954006 -34.5950366522396,-58.4435287226949 -34.5942285118776)))";;"1564";15_12_4;COMUNA 15;"12";"4";"693";"310";"383";"80,94%";"415";"415";"100,00%";"0";"0,00%";"324";"2";"0.62";"322";"99,38%";"0.62";0.620
"MULTIPOLYGON (((-58.4417459884882 -34.5929909165505,-58.4427203253282 -34.5936673038012,-58.4435358639228 -34.592799160921,-58.4437017124581 -34.592622560154,-58.4442361358412 -34.5920583240699,-58.4445950830329 -34.5916793487328,-58.4446653284772 -34.5916052083119,-58.4446214706069 -34.5915841761345,-58.4444864087322 -34.5915185899214,-58.4443484107426 -34.5914525174417,-58.4442045408613 -34.5913830441901,-58.4440583220762 -34.5913135704093,-58.4439109292919 -34.5912426392467,-58.4437623624088 -34.5911707363729,-58.4436492273706 -34.5911169812068,-58.4436161443639 -34.5911012620602,-58.4435661186157 -34.5910773710692,-58.443563666864 -34.5910800301836,-58.4434899771064 -34.5911518324753,-58.4434898304113 -34.5911517644316,-58.443326201685 -34.5913146323659,-58.443176882144 -34.5914646145304,-58.4426235436029 -34.5920548298651,-58.4418905488343 -34.5914566551785,-58.4416478939777 -34.5912588592222,-58.4407030406826 -34.5922669015821,-58.4417459884882 -34.5929909165505)))";;"1565";15_12_5;COMUNA 15;"12";"5";"927";"409";"518";"78,96%";"405";"403";"99,51%";"2";"0,50%";"333";"20";"6.01";"313";"93,99%";"6.01";6.010
"MULTIPOLYGON (((-58.4446653284772 -34.5916052083119,-58.4445950830329 -34.5916793487328,-58.4442361358412 -34.5920583240699,-58.4437017124581 -34.592622560154,-58.4435358639228 -34.592799160921,-58.4443226947064 -34.5934412086853,-58.4450479977576 -34.5927219211677,-58.4458207899249 -34.5933534638797,-58.4459636322899 -34.5932211543919,-58.4465840586791 -34.5926462151951,-58.4466714502749 -34.5925652593803,-58.4466004477502 -34.5925310338303,-58.4464465908941 -34.5924576765159,-58.4462991940586 -34.5923867482499,-58.4461576697289 -34.5923192203261,-58.4460167330178 -34.5922512066428,-58.4458998730632 -34.5921953379877,-58.4457777281324 -34.5921370401125,-58.4456831420991 -34.5920920725332,-58.4456479492809 -34.5920753413231,-58.4455269791835 -34.592017529035,-58.4454001369538 -34.5919568017441,-58.4452774055328 -34.5918980176078,-58.4451534998078 -34.5918387475037,-58.4450290069696 -34.5917794771882,-58.4448939442513 -34.5917148627781,-58.4447541839586 -34.591647819152,-58.4446653284772 -34.5916052083119)))";;"1566";15_12_6;COMUNA 15;"12";"6";"726";"338";"388";"87,11%";"396";"396";"100,00%";"0";"0,00%";"308";"5";"1.62";"303";"98,38%";"1.62";1.620
"MULTIPOLYGON (((-58.4458207899249 -34.5933534638797,-58.4450479977576 -34.5927219211677,-58.4443226947064 -34.5934412086853,-58.4449548259766 -34.5939507589169,-58.4450778659586 -34.5940419775153,-58.4458207899249 -34.5933534638797)))";;"1567";15_12_7;COMUNA 15;"12";"7";"497";"217";"280";"77,50%";"275";"275";"100,00%";"0";"0,00%";"235";"3";"1.28";"232";"98,72%";"1.28";1.280
"MULTIPOLYGON (((-58.4443226947064 -34.5934412086853,-58.4435358639228 -34.592799160921,-58.4427203253282 -34.5936673038012,-58.4435287226949 -34.5942285118776,-58.4443001758785 -34.5947640037516,-58.444345236287 -34.5947221074869,-58.4444408927509 -34.5946374002061,-58.4449864698947 -34.594122178703,-58.4450778659586 -34.5940419775153,-58.4449548259766 -34.5939507589169,-58.4443226947064 -34.5934412086853)))";;"1568";15_12_8;COMUNA 15;"12";"8";"741";"344";"397";"86,65%";"458";"458";"100,00%";"0";"0,00%";"373";"3";"0.8";"370";"99,20%";"0.8";0.800
"MULTIPOLYGON (((-58.4443001758785 -34.5947640037516,-58.4435287226949 -34.5942285118776,-58.4427136954006 -34.5950366522396,-58.442832651053 -34.5951095618408,-58.4433651079579 -34.5954079688919,-58.4435381457545 -34.5954716606456,-58.4443001758785 -34.5947640037516)))";;"1569";15_12_9;COMUNA 15;"12";"9";"520";"235";"285";"82,46%";"309";"309";"100,00%";"0";"0,00%";"245";"4";"1.63";"241";"98,37%";"1.63";1.630
"MULTIPOLYGON (((-58.4343632128599 -34.5914486603437,-58.4341326337843 -34.591601077426,-58.4334455752895 -34.5920583975817,-58.4336530642147 -34.5921917622825,-58.433794569684 -34.5922811656158,-58.4348805619519 -34.5929670789115,-58.4359595902511 -34.5936484737247,-58.4370415311135 -34.5943317610206,-58.437810537515 -34.5935117472038,-58.4385848955819 -34.5926860250341,-58.4374600297344 -34.5920456313919,-58.4363422481463 -34.5914091726669,-58.4353108185579 -34.5908218799388,-58.4343632128599 -34.5914486603437)))";;"1570";15_13_1;COMUNA 15;"13";"1";"849";"423";"426";"99,30%";"390";"390";"100,00%";"0";"0,00%";"304";"10";"3.29";"294";"96,71%";"3.29";3.290
"MULTIPOLYGON (((-58.4427136954006 -34.5950366522396,-58.4418798104691 -34.5945619871827,-58.4412245592473 -34.5952595065791,-58.4410471998686 -34.5954487079856,-58.4411514231488 -34.595514574077,-58.4424283529777 -34.5962763014537,-58.4425904027988 -34.5963517537378,-58.4435381457545 -34.5954716606456,-58.4433651079579 -34.5954079688919,-58.442832651053 -34.5951095618408,-58.4427136954006 -34.5950366522396)))";;"1571";15_13_10;COMUNA 15;"13";"10";"652";"291";"361";"80,61%";"370";"370";"100,00%";"0";"0,00%";"297";"0";"0";"297";"100,00%";"0";0.000
"MULTIPOLYGON (((-58.4359595902511 -34.5936484737247,-58.4348805619519 -34.5929670789115,-58.433794569684 -34.5922811656158,-58.4336530642147 -34.5921917622825,-58.4334455752895 -34.5920583975817,-58.432358668529 -34.5927816819221,-58.4325730527101 -34.5929229377927,-58.4329633421955 -34.5931721278523,-58.4340419291533 -34.5938608637195,-58.4351177241297 -34.5945478287169,-58.4361943031572 -34.5952352068795,-58.4370415311135 -34.5943317610206,-58.4359595902511 -34.5936484737247)))";;"1572";15_13_2;COMUNA 15;"13";"2";"742";"330";"412";"80,10%";"348";"347";"99,71%";"1";"0,29%";"257";"19";"7.39";"238";"92,61%";"7.39";7.390
"MULTIPOLYGON (((-58.4381257035034 -34.595016518032,-58.4370415311135 -34.5943317610206,-58.4361943031572 -34.5952352068795,-58.4364801393905 -34.5954177405494,-58.4372737094806 -34.5959253930712,-58.438351345427 -34.5966147946099,-58.4387335969249 -34.596207671343,-58.439208616488 -34.595700349567,-58.4381257035034 -34.595016518032)))";;"1573";15_13_3;COMUNA 15;"13";"3";"634";"292";"342";"85,38%";"364";"364";"100,00%";"0";"0,00%";"298";"14";"4.7";"284";"95,30%";"4.7";4.700
"MULTIPOLYGON (((-58.4397098638185 -34.593326549114,-58.4385848955819 -34.5926860250341,-58.437810537515 -34.5935117472038,-58.4370415311135 -34.5943317610206,-58.4381257035034 -34.595016518032,-58.4389160879037 -34.5941734021439,-58.4400197825656 -34.5948338494254,-58.4408324651567 -34.5939656538295,-58.4397098638185 -34.593326549114)))";;"1574";15_13_4;COMUNA 15;"13";"4";"686";"293";"393";"74,55%";"344";"343";"99,71%";"1";"0,29%";"262";"3";"1.15";"259";"98,85%";"1.15";1.150
"MULTIPOLYGON (((-58.4418798104691 -34.5945619871827,-58.4408324651567 -34.5939656538295,-58.4400197825656 -34.5948338494254,-58.4410471998686 -34.5954487079856,-58.4412245592473 -34.5952595065791,-58.4418798104691 -34.5945619871827)))";;"1575";15_13_5;COMUNA 15;"13";"5";"426";"188";"238";"78,99%";"243";"243";"100,00%";"0";"0,00%";"212";"2";"0.94";"210";"99,06%";"0.94";0.940
"MULTIPOLYGON (((-58.4410471998686 -34.5954487079856,-58.4400197825656 -34.5948338494254,-58.4389160879037 -34.5941734021439,-58.4381257035034 -34.595016518032,-58.439208616488 -34.595700349567,-58.4402155081912 -34.5963361273972,-58.4410471998686 -34.5954487079856)))";;"1576";15_13_6;COMUNA 15;"13";"6";"498";"217";"281";"77,22%";"291";"290";"99,66%";"1";"0,34%";"238";"7";"2.94";"231";"97,06%";"2.94";2.940
"MULTIPOLYGON (((-58.4402155081912 -34.5963361273972,-58.439208616488 -34.595700349567,-58.4387335969249 -34.596207671343,-58.438351345427 -34.5966147946099,-58.4393534708803 -34.5972558604024,-58.4402155081912 -34.5963361273972)))";;"1577";15_13_7;COMUNA 15;"13";"7";"686";"317";"369";"85,91%";"340";"340";"100,00%";"0";"0,00%";"292";"2";"0.68";"290";"99,32%";"0.68";0.680
"MULTIPOLYGON (((-58.4416521807612 -34.5972224039954,-58.4414982188936 -34.597154487385,-58.4402155081912 -34.5963361273972,-58.4393534708803 -34.5972558604024,-58.4406928127298 -34.5981126213205,-58.4416521807612 -34.5972224039954)))";;"1578";15_13_8;COMUNA 15;"13";"8";"439";"186";"253";"73,52%";"247";"247";"100,00%";"0";"0,00%";"194";"0";"0";"194";"100,00%";"0";0.000
"MULTIPOLYGON (((-58.4410471998686 -34.5954487079856,-58.4402155081912 -34.5963361273972,-58.4414982188936 -34.597154487385,-58.4416521807612 -34.5972224039954,-58.4425904027988 -34.5963517537378,-58.4424283529777 -34.5962763014537,-58.4411514231488 -34.595514574077,-58.4410471998686 -34.5954487079856)))";;"1579";15_13_9;COMUNA 15;"13";"9";"1052";"487";"565";"86,19%";"568";"568";"100,00%";"0";"0,00%";"462";"42";"9.09";"420";"90,91%";"9.09";9.090
"MULTIPOLYGON (((-58.4466333427065 -34.5963098865784,-58.4455545472778 -34.5955613303035,-58.444345236287 -34.5947221074869,-58.4443001758785 -34.5947640037516,-58.4435381457545 -34.5954716606456,-58.4446475470824 -34.5963775693555,-58.4456502778919 -34.597196477787,-58.4460665552819 -34.5968253236454,-58.4466333427065 -34.5963098865784)))";;"1580";15_14_1;COMUNA 15;"14";"1";"848";"412";"436";"94,50%";"414";"414";"100,00%";"0";"0,00%";"364";"12";"3.3";"352";"96,70%";"3.3";3.300
"MULTIPOLYGON (((-58.4447484219952 -34.5997541231801,-58.4437928962107 -34.6006190119929,-58.4447111953031 -34.6013724894386,-58.4448717514504 -34.6013196236635,-58.4449582898551 -34.601291114063,-58.4453339987003 -34.6011674310003,-58.4461498049604 -34.6008999989579,-58.4463095074992 -34.6008476241473,-58.4475935937353 -34.6004268582911,-58.44671291633 -34.5997094650752,-58.4458000661841 -34.5989657219272,-58.4457067389868 -34.5988867622639,-58.4447484219952 -34.5997541231801)))";;"1581";15_14_10;COMUNA 15;"14";"10";"684";"314";"370";"84,86%";"346";"345";"99,71%";"1";"0,29%";"272";"12";"4.41";"260";"95,59%";"4.41";4.410
"MULTIPOLYGON (((-58.4481892135913 -34.6002255144146,-58.4479709983801 -34.6003018996461,-58.4479150391486 -34.6003214710928,-58.4475935937353 -34.6004268582911,-58.4463095074992 -34.6008476241473,-58.4461498049604 -34.6008999989579,-58.4453339987003 -34.6011674310003,-58.4449582898551 -34.601291114063,-58.4448717514504 -34.6013196236635,-58.4447214776904 -34.6014798894117,-58.445697651992 -34.6021031516311,-58.4466754589412 -34.6027273921468,-58.4476549837557 -34.6033527517798,-58.4485389713465 -34.6024053569112,-58.4486293540782 -34.6023070537771,-58.4487438442524 -34.602182484731,-58.4495965455519 -34.6012624738439,-58.449664266682 -34.6011900135451,-58.450251007699 -34.600563219889,-58.450355100671 -34.6004508317984,-58.4512418386715 -34.5994940506113,-58.4509387558156 -34.5992867602867,-58.4496172233051 -34.5997507280904,-58.4493963709926 -34.5998235943326,-58.4493273811745 -34.5998464045681,-58.449024336601 -34.5999463748162,-58.4483660340648 -34.6001635611091,-58.4481892135913 -34.6002255144146)))";;"1582";15_14_11;COMUNA 15;"14";"11";"1025";"486";"539";"90,17%";"383";"383";"100,00%";"0";"0,00%";"376";"26";"6.91";"350";"93,09%";"6.91";6.910
"MULTIPOLYGON (((-58.4435381457545 -34.5954716606456,-58.4425904027988 -34.5963517537378,-58.4436850750957 -34.5972436540111,-58.4446475470824 -34.5963775693555,-58.4435381457545 -34.5954716606456)))";;"1583";15_14_2;COMUNA 15;"14";"2";"899";"415";"484";"85,74%";"473";"473";"100,00%";"0";"0,00%";"386";"2";"0.52";"384";"99,48%";"0.52";0.520
"MULTIPOLYGON (((-58.4425904027988 -34.5963517537378,-58.4416521807612 -34.5972224039954,-58.4427295682857 -34.5981033938159,-58.4436850750957 -34.5972436540111,-58.4425904027988 -34.5963517537378)))";;"1584";15_14_3;COMUNA 15;"14";"3";"722";"324";"398";"81,41%";"376";"375";"99,73%";"1";"0,27%";"302";"7";"2.32";"295";"97,68%";"2.32";2.320
"MULTIPOLYGON (((-58.4427295682857 -34.5981033938159,-58.4416521807612 -34.5972224039954,-58.4406928127298 -34.5981126213205,-58.4416662393312 -34.5988867665085,-58.4417699523268 -34.5989688297541,-58.4426204465607 -34.59820161914,-58.4427295682857 -34.5981033938159)))";;"1585";15_14_4;COMUNA 15;"14";"4";"714";"326";"388";"84,02%";"379";"379";"100,00%";"0";"0,00%";"308";"33";"10.71";"275";"89,29%";"10.71";10.710
"MULTIPOLYGON (((-58.4427295682857 -34.5981033938159,-58.4426204465607 -34.59820161914,-58.4417699523268 -34.5989688297541,-58.4418837984331 -34.5990589231174,-58.4427822236233 -34.599792833659,-58.443737750463 -34.5989277413678,-58.4446923204912 -34.5980634160047,-58.4445839227806 -34.5979759317902,-58.4436850750957 -34.5972436540111,-58.4427295682857 -34.5981033938159)))";;"1586";15_14_5;COMUNA 15;"14";"5";"952";"422";"530";"79,62%";"506";"506";"100,00%";"0";"0,00%";"421";"2";"0.48";"419";"99,52%";"0.48";0.480
"MULTIPOLYGON (((-58.4447484219952 -34.5997541231801,-58.443737750463 -34.5989277413678,-58.4427822236233 -34.599792833659,-58.4436588654529 -34.6005089869453,-58.4437928962107 -34.6006190119929,-58.4447484219952 -34.5997541231801)))";;"1587";15_14_6;COMUNA 15;"14";"6";"522";"223";"299";"74,58%";"342";"342";"100,00%";"0";"0,00%";"286";"9";"3.15";"277";"96,85%";"3.15";3.150
"MULTIPOLYGON (((-58.4457067389868 -34.5988867622639,-58.4455925496748 -34.5987900524426,-58.4446923204912 -34.5980634160047,-58.443737750463 -34.5989277413678,-58.4447484219952 -34.5997541231801,-58.4457067389868 -34.5988867622639)))";;"1588";15_14_7;COMUNA 15;"14";"7";"883";"406";"477";"85,12%";"486";"486";"100,00%";"0";"0,00%";"392";"2";"0.51";"390";"99,49%";"0.51";0.510
"MULTIPOLYGON (((-58.4466333427065 -34.5963098865784,-58.4460665552819 -34.5968253236454,-58.4456502778919 -34.597196477787,-58.4446475470824 -34.5963775693555,-58.4436850750957 -34.5972436540111,-58.4445839227806 -34.5979759317902,-58.4446923204912 -34.5980634160047,-58.4455925496748 -34.5987900524426,-58.4457067389868 -34.5988867622639,-58.4458000661841 -34.5989657219272,-58.44671291633 -34.5997094650752,-58.4476707858468 -34.5988460324801,-58.4475386260338 -34.5987385472011,-58.4466616288212 -34.5980224215308,-58.4472129175876 -34.5975228959451,-58.4477203323465 -34.5970640682546,-58.4466333427065 -34.5963098865784)))";;"1589";15_14_8;COMUNA 15;"14";"8";"841";"387";"454";"85,24%";"391";"391";"100,00%";"0";"0,00%";"326";"37";"11.35";"289";"88,65%";"11.35";11.350
"MULTIPOLYGON (((-58.4476707858468 -34.5988460324801,-58.44671291633 -34.5997094650752,-58.4475935937353 -34.6004268582911,-58.4479150391486 -34.6003214710928,-58.4479709983801 -34.6003018996461,-58.4481892135913 -34.6002255144146,-58.4483660340648 -34.6001635611091,-58.449024336601 -34.5999463748162,-58.4493273811745 -34.5998464045681,-58.4493963709926 -34.5998235943326,-58.4496172233051 -34.5997507280904,-58.4509387558156 -34.5992867602867,-58.4500413532462 -34.5986730553133,-58.4498942856058 -34.5985711346297,-58.4488097261104 -34.5978192968102,-58.4478585385394 -34.5971600043577,-58.4477203323465 -34.5970640682546,-58.4472129175876 -34.5975228959451,-58.4466616288212 -34.5980224215308,-58.4475386260338 -34.5987385472011,-58.4476707858468 -34.5988460324801)))";;"1590";15_14_9;COMUNA 15;"14";"9";"862";"425";"437";"97,25%";"380";"380";"100,00%";"0";"0,00%";"347";"26";"7.49";"321";"92,51%";"7.49";7.490
"MULTIPOLYGON (((-58.4458207899249 -34.5933534638797,-58.4450778659586 -34.5940419775153,-58.4449864698947 -34.594122178703,-58.4444408927509 -34.5946374002061,-58.444345236287 -34.5947221074869,-58.4455545472778 -34.5955613303035,-58.4462674090251 -34.5949198539908,-58.4470190152862 -34.59424344748,-58.4458207899249 -34.5933534638797)))";;"1591";15_15_1;COMUNA 15;"15";"1";"696";"326";"370";"88,11%";"363";"363";"100,00%";"0";"0,00%";"293";"22";"7.51";"271";"92,49%";"7.51";7.510
"MULTIPOLYGON (((-58.4570699624896 -34.6018928602534,-58.4568242427416 -34.6019451041767,-58.456414710606 -34.6023896076981,-58.4560196544578 -34.6028184762106,-58.4574224485757 -34.6037676653374,-58.4581976569819 -34.6042921527887,-58.4584739469889 -34.6044918180705,-58.4589348227102 -34.6043736597031,-58.4582775693629 -34.6039069299309,-58.4581629317192 -34.6038291058859,-58.4579180218086 -34.6030386441329,-58.4575325280211 -34.6017944262699,-58.457251355569 -34.600886985076,-58.4572132930704 -34.6007633870985,-58.456985090764 -34.6000220806408,-58.4568505145534 -34.6001688404525,-58.4562469599799 -34.6008270042253,-58.4561391266732 -34.6009439043491,-58.4569465754973 -34.6015354465272,-58.4570699624896 -34.6018928602534)))";;"1592";15_15_10;COMUNA 15;"15";"10";"934";"416";"518";"80,31%";"473";"473";"100,00%";"0";"0,00%";"413";"20";"4.84";"393";"95,16%";"4.84";4.840
"MULTIPOLYGON (((-58.4462674090251 -34.5949198539908,-58.4455545472778 -34.5955613303035,-58.4466333427065 -34.5963098865784,-58.4473163053464 -34.5956938942296,-58.4480702952811 -34.59501388994,-58.4491284921462 -34.5957893946384,-58.4500611897348 -34.5964729017206,-58.4501942874166 -34.5965710882673,-58.4509844611178 -34.5958586741403,-58.4515539365646 -34.5953452567235,-58.451704523576 -34.5952094904261,-58.4513308622898 -34.594947614949,-58.4507616890164 -34.5945488125681,-58.4507466451822 -34.5945385595065,-58.450596070073 -34.5944024986775,-58.4505482922678 -34.5943593261524,-58.4504769134479 -34.5943396512944,-58.4504322803884 -34.5943241052214,-58.4503118888596 -34.5942808679999,-58.4501732919037 -34.5942313150191,-58.4500634724469 -34.5941861359373,-58.4499219406058 -34.5941278402193,-58.4497851080059 -34.5940656594353,-58.4496476887609 -34.5940005643854,-58.4495226024306 -34.5939398415861,-58.4493992781168 -34.593879604525,-58.4492753667557 -34.5938188815992,-58.4491361868004 -34.5937513574027,-58.4490028796972 -34.5936862620805,-58.4488701599431 -34.5936221380283,-58.4487409640405 -34.593558985584,-58.4486123556347 -34.5934958330701,-58.4484720023189 -34.5934273366275,-58.4483334108835 -34.5933602972548,-58.4481954071393 -34.593292286444,-58.4480509436688 -34.5932223320016,-58.4479135272517 -34.5931567493157,-58.4477743493292 -34.5930901949091,-58.447639869486 -34.5930265549724,-58.447494232258 -34.5929570853981,-58.4473474206786 -34.5928876155015,-58.447200609434 -34.5928176597526,-58.4470543856403 -34.5927481895766,-58.4469052259806 -34.5926767761448,-58.4467496067958 -34.592602933311,-58.4466714502749 -34.5925652593803,-58.4465840586791 -34.5926462151951,-58.4459636322899 -34.5932211543919,-58.4458207899249 -34.5933534638797,-58.4470190152862 -34.59424344748,-58.4462674090251 -34.5949198539908)))";;"1593";15_15_2;COMUNA 15;"15";"2";"759";"353";"406";"86,95%";"257";"257";"100,00%";"0";"0,00%";"235";"13";"5.53";"222";"94,47%";"5.53";5.530
"MULTIPOLYGON (((-58.4473163053464 -34.5956938942296,-58.4466333427065 -34.5963098865784,-58.4477203323465 -34.5970640682546,-58.4483730553704 -34.5964732081751,-58.448223610405 -34.5963633975317,-58.4473163053464 -34.5956938942296)))";;"1594";15_15_3;COMUNA 15;"15";"3";"1044";"461";"583";"79,07%";"434";"434";"100,00%";"0";"0,00%";"401";"0";"0";"401";"100,00%";"0";0.000
"MULTIPOLYGON (((-58.4491284921462 -34.5957893946384,-58.4480702952811 -34.59501388994,-58.4473163053464 -34.5956938942296,-58.448223610405 -34.5963633975317,-58.4483730553704 -34.5964732081751,-58.4477203323465 -34.5970640682546,-58.4478585385394 -34.5971600043577,-58.4488097261104 -34.5978192968102,-58.4498942856058 -34.5985711346297,-58.4500292932844 -34.5984508623922,-58.4504948756626 -34.5980325134056,-58.4512525230744 -34.5973516449764,-58.4501942874166 -34.5965710882673,-58.4500611897348 -34.5964729017206,-58.4491284921462 -34.5957893946384)))";;"1595";15_15_4;COMUNA 15;"15";"4";"988";"494";"494";"100,00%";"379";"379";"100,00%";"0";"0,00%";"352";"31";"8.81";"321";"91,19%";"8.81";8.810
"MULTIPOLYGON (((-58.4504948756626 -34.5980325134056,-58.4500292932844 -34.5984508623922,-58.4498942856058 -34.5985711346297,-58.4500413532462 -34.5986730553133,-58.4509387558156 -34.5992867602867,-58.4518189991531 -34.5990055635249,-58.4527012806424 -34.5987237267395,-58.4529883891985 -34.5986320562511,-58.453687633459 -34.5984086505723,-58.4542180686299 -34.5982391750072,-58.4554841033996 -34.5978347337578,-58.4547948148826 -34.5973527005479,-58.4538163352199 -34.5966684517378,-58.4537674542423 -34.5966342214862,-58.4536552154872 -34.5965556890371,-58.4528200717656 -34.5959886303604,-58.4526072639422 -34.5958441002652,-58.4520837222899 -34.5954757315978,-58.4518865012249 -34.5953369764624,-58.451704523576 -34.5952094904261,-58.4515539365646 -34.5953452567235,-58.4509844611178 -34.5958586741403,-58.4501942874166 -34.5965710882673,-58.4512525230744 -34.5973516449764,-58.4504948756626 -34.5980325134056)))";;"1596";15_15_5;COMUNA 15;"15";"5";"849";"413";"436";"94,72%";"360";"360";"100,00%";"0";"0,00%";"297";"21";"7.07";"276";"92,93%";"7.07";7.070
"MULTIPOLYGON (((-58.453687633459 -34.5984086505723,-58.4529883891985 -34.5986320562511,-58.4527012806424 -34.5987237267395,-58.4518189991531 -34.5990055635249,-58.4509387558156 -34.5992867602867,-58.4512418386715 -34.5994940506113,-58.4520935274604 -34.6000764034808,-58.4520523003574 -34.6001204156616,-58.4526791737103 -34.6005473160813,-58.4530874410935 -34.600825387725,-58.4540388832897 -34.6014733005879,-58.4544950162843 -34.6009771864275,-58.4548806169225 -34.6005577590968,-58.4551750745216 -34.6002375540856,-58.4558857838299 -34.5994644675887,-58.4565820856018 -34.598707080963,-58.456564970688 -34.598657500727,-58.4562363942665 -34.5975900481394,-58.4560576263124 -34.597651519794,-58.4559205056793 -34.5976953167662,-58.4554841033996 -34.5978347337578,-58.4542180686299 -34.5982391750072,-58.453687633459 -34.5984086505723)))";;"1597";15_15_6;COMUNA 15;"15";"6";"881";"415";"466";"89,06%";"329";"329";"100,00%";"0";"0,00%";"311";"25";"8.04";"286";"91,96%";"8.04";8.040
"MULTIPOLYGON (((-58.4565820856018 -34.598707080963,-58.4558857838299 -34.5994644675887,-58.4551750745216 -34.6002375540856,-58.4548806169225 -34.6005577590968,-58.4544950162843 -34.6009771864275,-58.4540388832897 -34.6014733005879,-58.4549920435627 -34.6021224033014,-58.4551713163357 -34.6022445318092,-58.4559526284239 -34.6027731186916,-58.4560196544578 -34.6028184762106,-58.456414710606 -34.6023896076981,-58.4568242427416 -34.6019451041767,-58.4570699624896 -34.6018928602534,-58.4569465754973 -34.6015354465272,-58.4561391266732 -34.6009439043491,-58.4562469599799 -34.6008270042253,-58.4568505145534 -34.6001688404525,-58.456985090764 -34.6000220806408,-58.4568992613058 -34.5997316429129,-58.4565820856018 -34.598707080963)))";;"1598";15_15_7;COMUNA 15;"15";"7";"858";"405";"453";"89,40%";"434";"434";"100,00%";"0";"0,00%";"361";"61";"16.9";"300";"83,10%";"16.9";16.900
"MULTIPOLYGON (((-58.4549920435627 -34.6021224033014,-58.4540388832897 -34.6014733005879,-58.4530874410935 -34.600825387725,-58.4526791737103 -34.6005473160813,-58.4520523003574 -34.6001204156616,-58.4520935274604 -34.6000764034808,-58.4512418386715 -34.5994940506113,-58.450355100671 -34.6004508317984,-58.451222551405 -34.6010183325276,-58.4518631406027 -34.6014374211671,-58.4522774575724 -34.601708453496,-58.4532485794105 -34.6023436975696,-58.4540418903846 -34.6028626493536,-58.4542121363067 -34.6029738627088,-58.4549920435627 -34.6021224033014)))";;"1599";15_15_8;COMUNA 15;"15";"8";"666";"340";"326";"104,29%";"340";"340";"100,00%";"0";"0,00%";"260";"5";"1.92";"255";"98,08%";"1.92";1.920
"MULTIPOLYGON (((-58.4584739469889 -34.6044918180705,-58.4581976569819 -34.6042921527887,-58.4574224485757 -34.6037676653374,-58.4560196544578 -34.6028184762106,-58.4559526284239 -34.6027731186916,-58.4551713163357 -34.6022445318092,-58.4549920435627 -34.6021224033014,-58.4542121363067 -34.6029738627088,-58.4550558780392 -34.6035251365098,-58.4551827766778 -34.6036079644224,-58.4568042058182 -34.6046654173137,-58.4565633128438 -34.6049862625556,-58.4580801020557 -34.6045927935066,-58.4584739469889 -34.6044918180705)))";;"1600";15_15_9;COMUNA 15;"15";"9";"1037";"482";"555";"86,85%";"531";"531";"100,00%";"0";"0,00%";"430";"4";"0.93";"426";"99,07%";"0.93";0.930
"MULTIPOLYGON (((-58.4551827766778 -34.6036079644224,-58.4550558780392 -34.6035251365098,-58.4542121363067 -34.6029738627088,-58.4536393764481 -34.6035991972758,-58.4535377541692 -34.6037096868155,-58.4545072910672 -34.6043403429093,-58.4558033797138 -34.6051834124635,-58.4565633128438 -34.6049862625556,-58.4568042058182 -34.6046654173137,-58.4551827766778 -34.6036079644224)))";;"1601";15_16_1;COMUNA 15;"16";"1";"863";"404";"459";"88,02%";"382";"382";"100,00%";"0";"0,00%";"355";"28";"7.89";"327";"92,11%";"7.89";7.890
"MULTIPOLYGON (((-58.4482242156855 -34.6061280657177,-58.4475512036706 -34.6068613212039,-58.4467722903977 -34.6063381743556,-58.4465637249142 -34.6061960993981,-58.4460265580201 -34.6069014759931,-58.4458787398462 -34.6070947727508,-58.4456777571815 -34.6073574306904,-58.4458644454421 -34.6074420371976,-58.446247447132 -34.607615617009,-58.4466272653969 -34.6075210162368,-58.4470400474061 -34.6074181787735,-58.4490616083139 -34.6069145999531,-58.4490619887586 -34.6069141819997,-58.4492900781285 -34.606857723594,-58.4492899725587 -34.6068576513151,-58.4502369866001 -34.6066217570223,-58.4506559780317 -34.6065151049849,-58.4507387710852 -34.6064940560066,-58.4510499260992 -34.6064148578077,-58.4515075860897 -34.6062984174304,-58.4520150738248 -34.6061672608486,-58.4516790060493 -34.6059317996273,-58.4515630085885 -34.6058569975669,-58.4514103896487 -34.6057584587305,-58.4505939009326 -34.6052350509992,-58.4496180796368 -34.6046094338433,-58.4489260949675 -34.6053634000644,-58.4482242156855 -34.6061280657177)))";;"1602";15_16_10;COMUNA 15;"16";"10";"805";"385";"420";"91,67%";"435";"435";"100,00%";"0";"0,00%";"337";"28";"8.31";"309";"91,69%";"8.31";8.310
"MULTIPOLYGON (((-58.4465637249142 -34.6061960993981,-58.4455852054602 -34.6055294622837,-58.4448753024582 -34.6062252317124,-58.4447572268139 -34.606334936808,-58.4446457958394 -34.6064384453567,-58.4441672610476 -34.6069228986913,-58.4451314780528 -34.6071750929634,-58.4452634910376 -34.6072191276205,-58.4456777571815 -34.6073574306904,-58.4458787398462 -34.6070947727508,-58.4460265580201 -34.6069014759931,-58.4465637249142 -34.6061960993981)))";;"1603";15_16_11;COMUNA 15;"16";"11";"763";"335";"428";"78,27%";"359";"359";"100,00%";"0";"0,00%";"307";"5";"1.63";"302";"98,37%";"1.63";1.630
"MULTIPOLYGON (((-58.451222551405 -34.6010183325276,-58.450355100671 -34.6004508317984,-58.450251007699 -34.600563219889,-58.449664266682 -34.6011900135451,-58.450540322228 -34.6017599144321,-58.4515993204823 -34.6024488443589,-58.4525682319225 -34.6030790933801,-58.4535377541692 -34.6037096868155,-58.4536393764481 -34.6035991972758,-58.4542121363067 -34.6029738627088,-58.4540418903846 -34.6028626493536,-58.4532485794105 -34.6023436975696,-58.4522774575724 -34.601708453496,-58.4518631406027 -34.6014374211671,-58.451222551405 -34.6010183325276)))";;"1604";15_16_2;COMUNA 15;"16";"2";"848";"406";"442";"91,86%";"353";"353";"100,00%";"0";"0,00%";"327";"19";"5.81";"308";"94,19%";"5.81";5.810
"MULTIPOLYGON (((-58.4486293540782 -34.6023070537771,-58.4485389713465 -34.6024053569112,-58.4476549837557 -34.6033527517798,-58.4481737069449 -34.6036838834759,-58.4483035800017 -34.6037667893195,-58.4485492748708 -34.6039242887873,-58.4495200649748 -34.6028690759518,-58.4497260739222 -34.6029990325267,-58.4505978090282 -34.6035419595252,-58.4507044346929 -34.6036083810121,-58.4515841884512 -34.6041535553047,-58.4525682319225 -34.6030790933801,-58.4515993204823 -34.6024488443589,-58.450540322228 -34.6017599144321,-58.449664266682 -34.6011900135451,-58.4495965455519 -34.6012624738439,-58.4487438442524 -34.602182484731,-58.4486293540782 -34.6023070537771)))";;"1605";15_16_3;COMUNA 15;"16";"3";"1065";"483";"582";"82,99%";"454";"454";"100,00%";"0";"0,00%";"388";"28";"7.22";"360";"92,78%";"7.22";7.220
"MULTIPOLYGON (((-58.4535377541692 -34.6037096868155,-58.4525682319225 -34.6030790933801,-58.4515841884512 -34.6041535553047,-58.452568538371 -34.6047635935279,-58.4535518806809 -34.6053729194229,-58.4544038802372 -34.6044525232413,-58.4545072910672 -34.6043403429093,-58.4535377541692 -34.6037096868155)))";;"1606";15_16_4;COMUNA 15;"16";"4";"745";"336";"409";"82,15%";"362";"362";"100,00%";"0";"0,00%";"293";"5";"1.71";"288";"98,29%";"1.71";1.710
"MULTIPOLYGON (((-58.4558033797138 -34.6051834124635,-58.4545072910672 -34.6043403429093,-58.4544038802372 -34.6044525232413,-58.4535518806809 -34.6053729194229,-58.4540018246167 -34.6056517655838,-58.4549823718974 -34.6053967515738,-58.4555246003864 -34.6052557230425,-58.4558033797138 -34.6051834124635)))";;"1607";15_16_5;COMUNA 15;"16";"5";"642";"279";"363";"76,86%";"336";"336";"100,00%";"0";"0,00%";"276";"4";"1.45";"272";"98,55%";"1.45";1.450
"MULTIPOLYGON (((-58.452568538371 -34.6047635935279,-58.4515841884512 -34.6041535553047,-58.4515015589858 -34.6042438328385,-58.4505939009326 -34.6052350509992,-58.4514103896487 -34.6057584587305,-58.4515630085885 -34.6058569975669,-58.4516790060493 -34.6059317996273,-58.4520150738248 -34.6061672608486,-58.452428268855 -34.6060604613586,-58.452958836664 -34.6059231053721,-58.4530692259189 -34.605894310242,-58.4540018246167 -34.6056517655838,-58.4535518806809 -34.6053729194229,-58.452568538371 -34.6047635935279)))";;"1608";15_16_6;COMUNA 15;"16";"6";"794";"353";"441";"80,05%";"380";"379";"99,74%";"1";"0,26%";"308";"7";"2.27";"301";"97,73%";"2.27";2.270
"MULTIPOLYGON (((-58.4505978090282 -34.6035419595252,-58.4497260739222 -34.6029990325267,-58.4495200649748 -34.6028690759518,-58.4485492748708 -34.6039242887873,-58.4496180796368 -34.6046094338433,-58.4505939009326 -34.6052350509992,-58.4515015589858 -34.6042438328385,-58.4515841884512 -34.6041535553047,-58.4507044346929 -34.6036083810121,-58.4505978090282 -34.6035419595252)))";;"1609";15_16_7;COMUNA 15;"16";"7";"848";"398";"450";"88,44%";"369";"369";"100,00%";"0";"0,00%";"316";"19";"6.01";"297";"93,99%";"6.01";6.010
"MULTIPOLYGON (((-58.4485492748708 -34.6039242887873,-58.4483035800017 -34.6037667893195,-58.4481737069449 -34.6036838834759,-58.4476549837557 -34.6033527517798,-58.4469368408734 -34.6041223380371,-58.4469837654078 -34.6041515705429,-58.4463036162383 -34.6048219992072,-58.4457177625381 -34.6053995463639,-58.4455852054602 -34.6055294622837,-58.4465637249142 -34.6061960993981,-58.4471668234391 -34.6054041058051,-58.4474747153343 -34.6049998336849,-58.4475524118242 -34.6048987128001,-58.4477745891399 -34.6046449982573,-58.4478455303912 -34.6046892339283,-58.4489260949675 -34.6053634000644,-58.4496180796368 -34.6046094338433,-58.4485492748708 -34.6039242887873)))";;"1610";15_16_8;COMUNA 15;"16";"8";"839";"384";"455";"84,40%";"457";"456";"99,78%";"1";"0,22%";"354";"10";"2.82";"344";"97,18%";"2.82";2.820
"MULTIPOLYGON (((-58.4478455303912 -34.6046892339283,-58.4477745891399 -34.6046449982573,-58.4475524118242 -34.6048987128001,-58.4474747153343 -34.6049998336849,-58.4471668234391 -34.6054041058051,-58.4465637249142 -34.6061960993981,-58.4467722903977 -34.6063381743556,-58.4475512036706 -34.6068613212039,-58.4482242156855 -34.6061280657177,-58.4489260949675 -34.6053634000644,-58.4478455303912 -34.6046892339283)))";;"1611";15_16_9;COMUNA 15;"16";"9";"735";"323";"412";"78,40%";"395";"394";"99,75%";"1";"0,25%";"306";"0";"0";"306";"100,00%";"0";0.000
"MULTIPOLYGON (((-58.4437928962107 -34.6006190119929,-58.4436588654529 -34.6005089869453,-58.4427822236233 -34.599792833659,-58.4418232694346 -34.6006610164649,-58.4428330060327 -34.6014877658735,-58.4437928962107 -34.6006190119929)))";;"1612";15_17_1;COMUNA 15;"17";"1";"732";"330";"402";"82,09%";"365";"365";"100,00%";"0";"0,00%";"323";"6";"1.86";"317";"98,14%";"1.86";1.860
"MULTIPOLYGON (((-58.4410485910371 -34.6051844329273,-58.4408894286863 -34.6050809499984,-58.4400332459236 -34.6045242237631,-58.439285379801 -34.6056058132306,-58.4401415705689 -34.6058405607655,-58.4403350722207 -34.6058936265379,-58.4414652562619 -34.6062034879134,-58.4415997379745 -34.6062390759511,-58.4428240443641 -34.6065714770162,-58.4429800752824 -34.606612348926,-58.4438529795964 -34.6057230170743,-58.4437296663209 -34.6056401075405,-58.4433341807196 -34.6053703170062,-58.4428235618363 -34.6050219824062,-58.4420245228686 -34.6058191329911,-58.4410485910371 -34.6051844329273)))";;"1613";15_17_10;COMUNA 15;"17";"10";"912";"382";"530";"72,08%";"424";"423";"99,76%";"1";"0,24%";"342";"7";"2.05";"335";"97,95%";"2.05";2.050
"MULTIPOLYGON (((-58.439430956307 -34.6034456725563,-58.4393902212728 -34.6035026431356,-58.439021407985 -34.6038673871713,-58.4391671112361 -34.6039610808604,-58.4400332459236 -34.6045242237631,-58.4408894286863 -34.6050809499984,-58.4410485910371 -34.6051844329273,-58.4418702940863 -34.6043677143213,-58.4408265198549 -34.6036506032593,-58.4406986148909 -34.603561914946,-58.4401493590306 -34.6031808847914,-58.4400879434907 -34.6032062264963,-58.439430956307 -34.6034456725563)))";;"1614";15_17_11;COMUNA 15;"17";"11";"822";"384";"438";"87,67%";"418";"418";"100,00%";"0";"0,00%";"356";"14";"3.93";"342";"96,07%";"3.93";3.930
"MULTIPOLYGON (((-58.439021407985 -34.6038673871713,-58.4388487104704 -34.6037562930111,-58.4376598786198 -34.6043220620565,-58.4371745791229 -34.6045530265198,-58.4379749989363 -34.6049596854722,-58.4385162809844 -34.605234663414,-58.4392016602282 -34.6055828385307,-58.439285379801 -34.6056058132306,-58.4400332459236 -34.6045242237631,-58.4391671112361 -34.6039610808604,-58.439021407985 -34.6038673871713)))";;"1615";15_17_12;COMUNA 15;"17";"12";"730";"332";"398";"83,42%";"352";"352";"100,00%";"0";"0,00%";"302";"1";"0.33";"301";"99,67%";"0.33";0.330
"MULTIPOLYGON (((-58.4420462751802 -34.6019021580564,-58.4421607246911 -34.6019804197855,-58.4422616334135 -34.6020542423506,-58.4424881464614 -34.6022199905998,-58.4430235814996 -34.6019953512726,-58.4433018616706 -34.6018717291576,-58.4434725607114 -34.6017937250391,-58.4444538791432 -34.6014573136203,-58.4447111953031 -34.6013724894386,-58.4437928962107 -34.6006190119929,-58.4428330060327 -34.6014877658735,-58.4418232694346 -34.6006610164649,-58.4410891182865 -34.6012983777654,-58.4418279360928 -34.6017528194519,-58.4420462751802 -34.6019021580564)))";;"1616";15_17_2;COMUNA 15;"17";"2";"584";"249";"335";"74,33%";"316";"316";"100,00%";"0";"0,00%";"271";"2";"0.74";"269";"99,26%";"0.74";0.740
"MULTIPOLYGON (((-58.4433018616706 -34.6018717291576,-58.4430235814996 -34.6019953512726,-58.4424881464614 -34.6022199905998,-58.4433971962564 -34.6028500912534,-58.4442437562811 -34.6034231312279,-58.4443519081682 -34.6034970939933,-58.4449608457607 -34.6028894850111,-58.445697651992 -34.6021031516311,-58.4447214776904 -34.6014798894117,-58.4448717514504 -34.6013196236635,-58.4447111953031 -34.6013724894386,-58.4444538791432 -34.6014573136203,-58.4434725607114 -34.6017937250391,-58.4433018616706 -34.6018717291576)))";;"1617";15_17_3;COMUNA 15;"17";"3";"854";"381";"473";"80,55%";"439";"439";"100,00%";"0";"0,00%";"368";"6";"1.63";"362";"98,37%";"1.63";1.630
"MULTIPOLYGON (((-58.4449608457607 -34.6028894850111,-58.4443519081682 -34.6034970939933,-58.4453205146786 -34.6041600776941,-58.4459470050612 -34.6035047180735,-58.4469368408734 -34.6041223380371,-58.4476549837557 -34.6033527517798,-58.4466754589412 -34.6027273921468,-58.445697651992 -34.6021031516311,-58.4449608457607 -34.6028894850111)))";;"1618";15_17_4;COMUNA 15;"17";"4";"1006";"455";"551";"82,58%";"443";"443";"100,00%";"0";"0,00%";"409";"46";"11.25";"363";"88,75%";"11.25";11.250
"MULTIPOLYGON (((-58.4446604380287 -34.604899516728,-58.4445549699324 -34.6050078854371,-58.4438529795964 -34.6057230170743,-58.4429800752824 -34.606612348926,-58.4441672610476 -34.6069228986913,-58.4446457958394 -34.6064384453567,-58.4447572268139 -34.606334936808,-58.4448753024582 -34.6062252317124,-58.4455852054602 -34.6055294622837,-58.4457177625381 -34.6053995463639,-58.4463036162383 -34.6048219992072,-58.4469837654078 -34.6041515705429,-58.4469368408734 -34.6041223380371,-58.4459470050612 -34.6035047180735,-58.4453205146786 -34.6041600776941,-58.4446604380287 -34.604899516728)))";;"1619";15_17_5;COMUNA 15;"17";"5";"879";"406";"473";"85,84%";"436";"436";"100,00%";"0";"0,00%";"349";"17";"4.87";"332";"95,13%";"4.87";4.870
"MULTIPOLYGON (((-58.4433341807196 -34.6053703170062,-58.4437296663209 -34.6056401075405,-58.4438529795964 -34.6057230170743,-58.4445549699324 -34.6050078854371,-58.4446604380287 -34.604899516728,-58.4453205146786 -34.6041600776941,-58.4443519081682 -34.6034970939933,-58.4436421796999 -34.6042052513396,-58.4428235618363 -34.6050219824062,-58.4433341807196 -34.6053703170062)))";;"1620";15_17_6;COMUNA 15;"17";"6";"711";"295";"416";"70,91%";"356";"356";"100,00%";"0";"0,00%";"308";"15";"4.87";"293";"95,13%";"4.87";4.870
"MULTIPOLYGON (((-58.4443519081682 -34.6034970939933,-58.4442437562811 -34.6034231312279,-58.4433971962564 -34.6028500912534,-58.4424881464614 -34.6022199905998,-58.4422532223877 -34.6023167156952,-58.4421989634105 -34.6023381862791,-58.4414810704003 -34.6026315958057,-58.4413970829832 -34.6026662303715,-58.4426902771842 -34.6035527504168,-58.4436421796999 -34.6042052513396,-58.4443519081682 -34.6034970939933)))";;"1621";15_17_7;COMUNA 15;"17";"7";"738";"323";"415";"77,83%";"411";"411";"100,00%";"0";"0,00%";"333";"18";"5.41";"315";"94,59%";"5.41";5.410
"MULTIPOLYGON (((-58.4413970829832 -34.6026662303715,-58.4412861785935 -34.6027119873404,-58.4401493590306 -34.6031808847914,-58.4406986148909 -34.603561914946,-58.4408265198549 -34.6036506032593,-58.4418702940863 -34.6043677143213,-58.4426902771842 -34.6035527504168,-58.4413970829832 -34.6026662303715)))";;"1622";15_17_8;COMUNA 15;"17";"8";"594";"260";"334";"77,84%";"333";"333";"100,00%";"0";"0,00%";"270";"1";"0.37";"269";"99,63%";"0.37";0.370
"MULTIPOLYGON (((-58.4436421796999 -34.6042052513396,-58.4426902771842 -34.6035527504168,-58.4418702940863 -34.6043677143213,-58.4410485910371 -34.6051844329273,-58.4420245228686 -34.6058191329911,-58.4428235618363 -34.6050219824062,-58.4436421796999 -34.6042052513396)))";;"1623";15_17_9;COMUNA 15;"17";"9";"678";"306";"372";"82,26%";"310";"310";"100,00%";"0";"0,00%";"266";"13";"4.89";"253";"95,11%";"4.89";4.890
"MULTIPOLYGON (((-58.4427822236233 -34.599792833659,-58.4418837984331 -34.5990589231174,-58.4417699523268 -34.5989688297541,-58.4408120201547 -34.5998329906667,-58.4418232694346 -34.6006610164649,-58.4427822236233 -34.599792833659)))";;"1624";15_18_1;COMUNA 15;"18";"1";"570";"254";"316";"80,38%";"330";"330";"100,00%";"0";"0,00%";"257";"4";"1.56";"253";"98,44%";"1.56";1.560
"MULTIPOLYGON (((-58.439021407985 -34.6038673871713,-58.4393902212728 -34.6035026431356,-58.439430956307 -34.6034456725563,-58.4397732049365 -34.6030042587209,-58.4385107745825 -34.6021942659917,-58.4378481011246 -34.6029232449581,-58.4377397274842 -34.60304287525,-58.4388487104704 -34.6037562930111,-58.439021407985 -34.6038673871713)))";;"1625";15_18_10;COMUNA 15;"18";"10";"582";"263";"319";"82,45%";"278";"278";"100,00%";"0";"0,00%";"240";"7";"2.92";"233";"97,08%";"2.92";2.920
"MULTIPOLYGON (((-58.4369768431651 -34.6038852133936,-58.4366161845485 -34.6042833912541,-58.4370533118273 -34.6044913790571,-58.4371745791229 -34.6045530265198,-58.4376598786198 -34.6043220620565,-58.4388487104704 -34.6037562930111,-58.4377397274842 -34.60304287525,-58.4369768431651 -34.6038852133936)))";;"1626";15_18_11;COMUNA 15;"18";"11";"657";"291";"366";"79,51%";"339";"338";"99,71%";"1";"0,30%";"294";"2";"0.68";"292";"99,32%";"0.68";0.680
"MULTIPOLYGON (((-58.4377397274842 -34.60304287525,-58.4364770614997 -34.602230607834,-58.4356687834269 -34.6030484906026,-58.4369768431651 -34.6038852133936,-58.4377397274842 -34.60304287525)))";;"1627";15_18_12;COMUNA 15;"18";"12";"560";"256";"304";"84,21%";"317";"317";"100,00%";"0";"0,00%";"244";"7";"2.87";"237";"97,13%";"2.87";2.870
"MULTIPOLYGON (((-58.4356687834269 -34.6030484906026,-58.4351483827033 -34.6035749433856,-58.4353380277268 -34.6036751306822,-58.4366161845485 -34.6042833912541,-58.4369768431651 -34.6038852133936,-58.4356687834269 -34.6030484906026)))";;"1628";15_18_13;COMUNA 15;"18";"13";"546";"242";"304";"79,61%";"304";"304";"100,00%";"0";"0,00%";"254";"0";"0";"254";"100,00%";"0";0.000
"MULTIPOLYGON (((-58.4408120201547 -34.5998329906667,-58.4399559553201 -34.6006051876172,-58.4410891182865 -34.6012983777654,-58.4418232694346 -34.6006610164649,-58.4408120201547 -34.5998329906667)))";;"1629";15_18_2;COMUNA 15;"18";"2";"500";"241";"259";"93,05%";"232";"232";"100,00%";"0";"0,00%";"213";"0";"0";"213";"100,00%";"0";0.000
"MULTIPOLYGON (((-58.4397638367001 -34.5989745961619,-58.4389452485172 -34.5997341166262,-58.4387649076092 -34.5998743684549,-58.4399559553201 -34.6006051876172,-58.4408120201547 -34.5998329906667,-58.4417699523268 -34.5989688297541,-58.4416662393312 -34.5988867665085,-58.4406928127298 -34.5981126213205,-58.4397638367001 -34.5989745961619)))";;"1630";15_18_3;COMUNA 15;"18";"3";"714";"300";"414";"72,46%";"421";"420";"99,76%";"1";"0,24%";"310";"50";"16.13";"260";"83,87%";"16.13";16.130
"MULTIPOLYGON (((-58.4387649076092 -34.5998743684549,-58.4381053268485 -34.6005831376669,-58.4393106020606 -34.6013145293131,-58.4399559553201 -34.6006051876172,-58.4387649076092 -34.5998743684549)))";;"1631";15_18_4;COMUNA 15;"18";"4";"467";"210";"257";"81,71%";"235";"235";"100,00%";"0";"0,00%";"209";"10";"4.78";"199";"95,22%";"4.78";4.780
"MULTIPOLYGON (((-58.4410891182865 -34.6012983777654,-58.4399559553201 -34.6006051876172,-58.4393106020606 -34.6013145293131,-58.440513599183 -34.6020445000523,-58.4410891182865 -34.6012983777654)))";;"1632";15_18_5;COMUNA 15;"18";"5";"490";"218";"272";"80,15%";"278";"278";"100,00%";"0";"0,00%";"215";"2";"0.93";"213";"99,07%";"0.93";0.930
"MULTIPOLYGON (((-58.440513599183 -34.6020445000523,-58.4397732049365 -34.6030042587209,-58.439430956307 -34.6034456725563,-58.4400879434907 -34.6032062264963,-58.4401493590306 -34.6031808847914,-58.4412861785935 -34.6027119873404,-58.4413970829832 -34.6026662303715,-58.4414810704003 -34.6026315958057,-58.4421989634105 -34.6023381862791,-58.4422532223877 -34.6023167156952,-58.4424881464614 -34.6022199905998,-58.4422616334135 -34.6020542423506,-58.4421607246911 -34.6019804197855,-58.4420462751802 -34.6019021580564,-58.4418279360928 -34.6017528194519,-58.4410891182865 -34.6012983777654,-58.440513599183 -34.6020445000523)))";;"1633";15_18_6;COMUNA 15;"18";"6";"517";"257";"260";"98,85%";"253";"253";"100,00%";"0";"0,00%";"210";"6";"2.86";"204";"97,14%";"2.86";2.860
"MULTIPOLYGON (((-58.440513599183 -34.6020445000523,-58.4393106020606 -34.6013145293131,-58.4385107745825 -34.6021942659917,-58.4397732049365 -34.6030042587209,-58.440513599183 -34.6020445000523)))";;"1634";15_18_7;COMUNA 15;"18";"7";"771";"354";"417";"84,89%";"326";"326";"100,00%";"0";"0,00%";"316";"1";"0.32";"315";"99,68%";"0.32";0.320
"MULTIPOLYGON (((-58.4393106020606 -34.6013145293131,-58.4381053268485 -34.6005831376669,-58.4372882203725 -34.6014098327638,-58.4385107745825 -34.6021942659917,-58.4393106020606 -34.6013145293131)))";;"1635";15_18_8;COMUNA 15;"18";"8";"569";"236";"333";"70,87%";"260";"259";"99,62%";"1";"0,39%";"218";"2";"0.92";"216";"99,08%";"0.92";0.920
"MULTIPOLYGON (((-58.4385107745825 -34.6021942659917,-58.4372882203725 -34.6014098327638,-58.4364770614997 -34.602230607834,-58.4377397274842 -34.60304287525,-58.4378481011246 -34.6029232449581,-58.4385107745825 -34.6021942659917)))";;"1636";15_18_9;COMUNA 15;"18";"9";"492";"200";"292";"68,49%";"267";"267";"100,00%";"0";"0,00%";"222";"0";"0";"222";"100,00%";"0";0.000
"MULTIPOLYGON (((-58.4381053268485 -34.6005831376669,-58.4376002861755 -34.6002642902411,-58.4362220274724 -34.6007256363166,-58.4372882203725 -34.6014098327638,-58.4381053268485 -34.6005831376669)))";;"1637";15_19_1;COMUNA 15;"19";"1";"465";"212";"253";"83,79%";"290";"290";"100,00%";"0";"0,00%";"230";"2";"0.87";"228";"99,13%";"0.87";0.870
"MULTIPOLYGON (((-58.4334730453551 -34.6016458185708,-58.4325034403556 -34.6010233052552,-58.4318726827822 -34.6016973985528,-58.4321984913017 -34.6020724242515,-58.4334730453551 -34.6016458185708)))";;"1638";15_19_10;COMUNA 15;"19";"10";"964";"423";"541";"78,19%";"451";"450";"99,78%";"1";"0,22%";"412";"1";"0.24";"411";"99,76%";"0.24";0.240
"MULTIPOLYGON (((-58.434363674285 -34.6008738865581,-58.4332877194232 -34.6001852253622,-58.4325034403556 -34.6010233052552,-58.4334730453551 -34.6016458185708,-58.4337201521281 -34.6015631278828,-58.434363674285 -34.6008738865581)))";;"1639";15_19_11;COMUNA 15;"19";"11";"806";"364";"442";"82,35%";"488";"488";"100,00%";"0";"0,00%";"383";"3";"0.78";"380";"99,22%";"0.78";0.780
"MULTIPOLYGON (((-58.4376002861755 -34.6002642902411,-58.4369335481934 -34.5998376560632,-58.4359304737564 -34.59919579578,-58.4351481042803 -34.6000337523851,-58.4361503318365 -34.6006732243705,-58.4360551635164 -34.600781517622,-58.4362220274724 -34.6007256363166,-58.4376002861755 -34.6002642902411)))";;"1640";15_19_2;COMUNA 15;"19";"2";"794";"351";"443";"79,23%";"440";"440";"100,00%";"0";"0,00%";"335";"9";"2.69";"326";"97,31%";"2.69";2.690
"MULTIPOLYGON (((-58.4359304737564 -34.59919579578,-58.4348564859247 -34.5985086275914,-58.4340718975887 -34.5993470698599,-58.4351481042803 -34.6000337523851,-58.4359304737564 -34.59919579578)))";;"1641";15_19_3;COMUNA 15;"19";"3";"685";"305";"380";"80,26%";"375";"375";"100,00%";"0";"0,00%";"310";"5";"1.61";"305";"98,39%";"1.61";1.610
"MULTIPOLYGON (((-58.4351481042803 -34.6000337523851,-58.4340718975887 -34.5993470698599,-58.4332877194232 -34.6001852253622,-58.434363674285 -34.6008738865581,-58.4351481042803 -34.6000337523851)))";;"1642";15_19_4;COMUNA 15;"19";"4";"757";"348";"409";"85,09%";"429";"429";"100,00%";"0";"0,00%";"343";"2";"0.58";"341";"99,42%";"0.58";0.580
"MULTIPOLYGON (((-58.4353359316571 -34.6014965265554,-58.4348510789105 -34.6011845739969,-58.4360551635164 -34.600781517622,-58.4361503318365 -34.6006732243705,-58.4351481042803 -34.6000337523851,-58.434363674285 -34.6008738865581,-58.4337201521281 -34.6015631278828,-58.4334730453551 -34.6016458185708,-58.4338093928411 -34.6018590757894,-58.4345090849388 -34.6023066508011,-58.4352400842694 -34.6015917903391,-58.4353359316571 -34.6014965265554)))";;"1643";15_19_5;COMUNA 15;"19";"5";"841";"376";"465";"80,86%";"492";"492";"100,00%";"0";"0,00%";"383";"7";"1.83";"376";"98,17%";"1.83";1.830
"MULTIPOLYGON (((-58.4362220274724 -34.6007256363166,-58.4360551635164 -34.600781517622,-58.4348510789105 -34.6011845739969,-58.4353359316571 -34.6014965265554,-58.4364770614997 -34.602230607834,-58.4372882203725 -34.6014098327638,-58.4362220274724 -34.6007256363166)))";;"1644";15_19_6;COMUNA 15;"19";"6";"765";"329";"436";"75,46%";"408";"408";"100,00%";"0";"0,00%";"338";"2";"0.59";"336";"99,41%";"0.59";0.590
"MULTIPOLYGON (((-58.4364770614997 -34.602230607834,-58.4353359316571 -34.6014965265554,-58.4352400842694 -34.6015917903391,-58.4345090849388 -34.6023066508011,-58.4356687834269 -34.6030484906026,-58.4364770614997 -34.602230607834)))";;"1645";15_19_7;COMUNA 15;"19";"7";"743";"297";"446";"66,59%";"469";"468";"99,79%";"1";"0,21%";"374";"1";"0.27";"373";"99,73%";"0.27";0.270
"MULTIPOLYGON (((-58.4345090849388 -34.6023066508011,-58.4338657440282 -34.6029358200767,-58.4339139427525 -34.6029596351743,-58.4349717671532 -34.6034815899979,-58.4351483827033 -34.6035749433856,-58.4356687834269 -34.6030484906026,-58.4345090849388 -34.6023066508011)))";;"1646";15_19_8;COMUNA 15;"19";"8";"599";"268";"331";"80,97%";"388";"388";"100,00%";"0";"0,00%";"294";"2";"0.68";"292";"99,32%";"0.68";0.680
"MULTIPOLYGON (((-58.4338093928411 -34.6018590757894,-58.4334730453551 -34.6016458185708,-58.4321984913017 -34.6020724242515,-58.4322406282471 -34.6021337751335,-58.4331418295864 -34.602578591092,-58.4333341121189 -34.602673429842,-58.4338657440282 -34.6029358200767,-58.4345090849388 -34.6023066508011,-58.4338093928411 -34.6018590757894)))";;"1647";15_19_9;COMUNA 15;"19";"9";"661";"294";"367";"80,11%";"370";"370";"100,00%";"0";"0,00%";"286";"5";"1.75";"281";"98,25%";"1.75";1.750
"MULTIPOLYGON (((-58.4863755131695 -34.5866300941457,-58.4866524000018 -34.5868012442337,-58.4868027259303 -34.586897134013,-58.4868939830429 -34.5867972527595,-58.4874435721607 -34.5862226826704,-58.4880863672964 -34.5855506219488,-58.4881939670312 -34.58543820058,-58.4887935939207 -34.5848181894367,-58.4881036496145 -34.5844186707893,-58.4870331034763 -34.5837986522757,-58.4864559852411 -34.5845387962499,-58.4858918806247 -34.5852623849654,-58.4853296389313 -34.58598343533,-58.48548898893 -34.5860820012324,-58.4863755131695 -34.5866300941457)))";;"1648";15_2_1;COMUNA 15;"2";"1";"756";"344";"412";"83,50%";"330";"330";"100,00%";"0";"0,00%";"280";"3";"1.07";"277";"98,93%";"1.07";1.070
"MULTIPOLYGON (((-58.4864405020165 -34.5872846854684,-58.4866959752876 -34.5870140611868,-58.4868027259303 -34.586897134013,-58.4866524000018 -34.5868012442337,-58.4863755131695 -34.5866300941457,-58.48548898893 -34.5860820012324,-58.4853296389313 -34.58598343533,-58.4849847874459 -34.5863852756555,-58.4845816984116 -34.5868315638551,-58.4845090823473 -34.5869120026436,-58.4841689001174 -34.5872885570578,-58.4839316390989 -34.5875512852298,-58.4838517003946 -34.5876396125337,-58.4835058082716 -34.5880221522021,-58.4834103770975 -34.5881380885961,-58.4842305055122 -34.5887568447942,-58.4847104596042 -34.5891189568117,-58.4850782339436 -34.5887285925722,-58.4854343417769 -34.5883505538135,-58.4855612730704 -34.5882158767963,-58.4861114745179 -34.5876332138026,-58.4864405020165 -34.5872846854684)))";;"1649";15_2_10;COMUNA 15;"2";"10";"603";"286";"317";"90,22%";"284";"284";"100,00%";"0";"0,00%";"233";"1";"0.43";"232";"99,57%";"0.43";0.430
"MULTIPOLYGON (((-58.4864559852411 -34.5845387962499,-58.4870331034763 -34.5837986522757,-58.485959677628 -34.5831769346438,-58.4858243507844 -34.5830985064314,-58.4850954294486 -34.5826748925397,-58.484746854546 -34.5824723420261,-58.4845800946883 -34.582662239009,-58.4845260363101 -34.5827090816018,-58.484198103115 -34.5829695026282,-58.484080873305 -34.5830592452193,-58.4844243435825 -34.5832756723331,-58.4845410197923 -34.5833484714007,-58.4839611501499 -34.5840589550277,-58.4834748249631 -34.5846547673627,-58.4833794841065 -34.5847761969625,-58.484274156823 -34.5853300083397,-58.4853296389313 -34.58598343533,-58.4858918806247 -34.5852623849654,-58.4864559852411 -34.5845387962499)))";;"1650";15_2_2;COMUNA 15;"2";"2";"817";"387";"430";"90,00%";"328";"328";"100,00%";"0";"0,00%";"300";"0";"0";"300";"100,00%";"0";0.000
"MULTIPOLYGON (((-58.4831341320974 -34.5815350487786,-58.4828390875762 -34.581880957182,-58.4827702197484 -34.5819573097065,-58.4827036502018 -34.5820309856478,-58.4824723620536 -34.5823023021319,-58.4821596907705 -34.5826690576334,-58.4820692519354 -34.5826306901575,-58.4820032599463 -34.5826293625293,-58.481489712775 -34.5826108503559,-58.4814797173524 -34.5828435375282,-58.4814720663719 -34.5828995269239,-58.481456163134 -34.5829884062635,-58.4814420413301 -34.5830474249437,-58.4814217905739 -34.5831151068899,-58.4813857079189 -34.5832106797266,-58.4813626423172 -34.5832570231875,-58.4813380427884 -34.5832980849709,-58.4812209079198 -34.5834478976846,-58.4817599919368 -34.5837795184337,-58.482148680132 -34.5840186218418,-58.4825528705172 -34.5842672289127,-58.4832450074402 -34.5846929768388,-58.4833794841065 -34.5847761969625,-58.4834748249631 -34.5846547673627,-58.4839611501499 -34.5840589550277,-58.4845410197923 -34.5833484714007,-58.4844243435825 -34.5832756723331,-58.484080873305 -34.5830592452193,-58.484198103115 -34.5829695026282,-58.4845260363101 -34.5827090816018,-58.4845800946883 -34.582662239009,-58.484746854546 -34.5824723420261,-58.4841209058026 -34.5821085652494,-58.4831341320974 -34.5815350487786)))";;"1651";15_2_3;COMUNA 15;"2";"3";"828";"405";"423";"95,74%";"335";"335";"100,00%";"0";"0,00%";"292";"0";"0";"292";"100,00%";"0";0.000
"MULTIPOLYGON (((-58.4804408654807 -34.5811822159176,-58.4802376287437 -34.5816548000545,-58.4803961197046 -34.5817851346782,-58.4805765885614 -34.5819563126331,-58.4806944643621 -34.5820879908882,-58.4807759833631 -34.5822286184473,-58.4808450689365 -34.5823611488724,-58.4808836674601 -34.5824779789289,-58.480900977326 -34.5825896006653,-58.4809036305816 -34.5826519267799,-58.4809051006238 -34.5827550293965,-58.4808836757992 -34.5829072219508,-58.4808527839001 -34.5829893426025,-58.4807708230294 -34.5831716862036,-58.4812209079198 -34.5834478976846,-58.4813380427884 -34.5832980849709,-58.4813626423172 -34.5832570231875,-58.4813857079189 -34.5832106797266,-58.4814217905739 -34.5831151068899,-58.4814420413301 -34.5830474249437,-58.481456163134 -34.5829884062635,-58.4814720663719 -34.5828995269239,-58.4814797173524 -34.5828435375282,-58.481489712775 -34.5826108503559,-58.4820032599463 -34.5826293625293,-58.4820692519354 -34.5826306901575,-58.4821596907705 -34.5826690576334,-58.4824723620536 -34.5823023021319,-58.4827036502018 -34.5820309856478,-58.4827702197484 -34.5819573097065,-58.4828390875762 -34.581880957182,-58.4831341320974 -34.5815350487786,-58.4830135434292 -34.581464925162,-58.4821455833616 -34.5809595526435,-58.4811292011629 -34.5803677139438,-58.4810449262004 -34.5804669561138,-58.4807704782524 -34.5807919401201,-58.4804408654807 -34.5811822159176)))";;"1652";15_2_4;COMUNA 15;"2";"4";"554";"255";"299";"85,28%";"245";"245";"100,00%";"0";"0,00%";"208";"2";"0.96";"206";"99,04%";"0.96";0.960
"MULTIPOLYGON (((-58.4804836125763 -34.5799934983768,-58.4801834299697 -34.5798198021185,-58.4792326470187 -34.5792694187008,-58.478988076277 -34.5791249385084,-58.4790404766076 -34.5797385486454,-58.4790442329589 -34.5797889023524,-58.4790736877728 -34.5801910982406,-58.4791186811222 -34.5808029485935,-58.4791547097353 -34.5812893723505,-58.4792396903686 -34.5812981640455,-58.4793364235467 -34.581316672792,-58.4794737745796 -34.5813432748132,-58.4795579067949 -34.5813668557476,-58.4796174294858 -34.5813833974925,-58.4796835094555 -34.5814036708449,-58.4797489938004 -34.5814258457318,-58.4798020458413 -34.5814454165845,-58.4798602927422 -34.5814685079562,-58.4799228830788 -34.5814954016614,-58.4802376287437 -34.5816548000545,-58.4804408654807 -34.5811822159176,-58.4807704782524 -34.5807919401201,-58.4810449262004 -34.5804669561138,-58.4811292011629 -34.5803677139438,-58.4809937130046 -34.5802887873837,-58.4804836125763 -34.5799934983768)))";;"1653";15_2_5;COMUNA 15;"2";"5";"517";"246";"271";"90,77%";"242";"242";"100,00%";"0";"0,00%";"208";"1";"0.48";"207";"99,52%";"0.48";0.480
"MULTIPOLYGON (((-58.4804810694901 -34.5840449335928,-58.4806121070212 -34.5839918136656,-58.4807559948115 -34.5839039719646,-58.4808893224522 -34.5838114131638,-58.4809929342426 -34.5837297041886,-58.4811472779411 -34.5835654488702,-58.4812209079198 -34.5834478976846,-58.4807708230294 -34.5831716862036,-58.4808527839001 -34.5829893426025,-58.4808836757992 -34.5829072219508,-58.4809051006238 -34.5827550293965,-58.4809036305816 -34.5826519267799,-58.480900977326 -34.5825896006653,-58.4808836674601 -34.5824779789289,-58.4808450689365 -34.5823611488724,-58.4807759833631 -34.5822286184473,-58.4806944643621 -34.5820879908882,-58.4805765885614 -34.5819563126331,-58.4803961197046 -34.5817851346782,-58.4802376287437 -34.5816548000545,-58.4799228830788 -34.5814954016614,-58.4798602927422 -34.5814685079562,-58.4798020458413 -34.5814454165845,-58.4797489938004 -34.5814258457318,-58.4796835094555 -34.5814036708449,-58.4796174294858 -34.5813833974925,-58.4795579067949 -34.5813668557476,-58.4794737745796 -34.5813432748132,-58.4793364235467 -34.581316672792,-58.4792396903686 -34.5812981640455,-58.4791547097353 -34.5812893723505,-58.4791833224461 -34.5817337530688,-58.4791917782882 -34.5818655179341,-58.4792503177408 -34.5825046913087,-58.4793058203749 -34.5832832369246,-58.4793377564897 -34.5837326172139,-58.4793737915046 -34.5842383372355,-58.4795808773289 -34.5842169698669,-58.4796759917339 -34.5842141396575,-58.4797936707935 -34.5842080666465,-58.4799101570815 -34.5841989653974,-58.4800425641765 -34.584177255626,-58.480153342007 -34.5841528726401,-58.4803734467726 -34.584089387664,-58.4804810694901 -34.5840449335928)))";;"1654";15_2_6;COMUNA 15;"2";"6";"709";"338";"371";"91,11%";"307";"307";"100,00%";"0";"0,00%";"268";"2";"0.75";"266";"99,25%";"0.75";0.750
"MULTIPOLYGON (((-58.4825528705172 -34.5842672289127,-58.482148680132 -34.5840186218418,-58.4817599919368 -34.5837795184337,-58.4812209079198 -34.5834478976846,-58.4811472779411 -34.5835654488702,-58.4809929342426 -34.5837297041886,-58.4808893224522 -34.5838114131638,-58.4807559948115 -34.5839039719646,-58.4806121070212 -34.5839918136656,-58.4804810694901 -34.5840449335928,-58.4803734467726 -34.584089387664,-58.480153342007 -34.5841528726401,-58.4800425641765 -34.584177255626,-58.4799101570815 -34.5841989653974,-58.4797936707935 -34.5842080666465,-58.4796759917339 -34.5842141396575,-58.4795808773289 -34.5842169698669,-58.4793737915046 -34.5842383372355,-58.4793806227474 -34.5843337627411,-58.4794210132639 -34.5849003296572,-58.4794299795929 -34.585026460335,-58.4794380920738 -34.5851409005091,-58.4796912060232 -34.5853319296576,-58.480694901061 -34.5860892109692,-58.481171489316 -34.5856177825795,-58.4816358980399 -34.5851584673534,-58.4821601501701 -34.584639913028,-58.4825528705172 -34.5842672289127)))";;"1655";15_2_7;COMUNA 15;"2";"7";"666";"310";"356";"87,08%";"306";"306";"100,00%";"0";"0,00%";"279";"2";"0.72";"277";"99,28%";"0.72";0.720
"MULTIPOLYGON (((-58.4845090823473 -34.5869120026436,-58.4845816984116 -34.5868315638551,-58.4849847874459 -34.5863852756555,-58.4853296389313 -34.58598343533,-58.484274156823 -34.5853300083397,-58.4833794841065 -34.5847761969625,-58.4832450074402 -34.5846929768388,-58.4825528705172 -34.5842672289127,-58.4821601501701 -34.584639913028,-58.4816358980399 -34.5851584673534,-58.4820814210797 -34.5855331309885,-58.4824852143967 -34.5858727278977,-58.483286593302 -34.5865466367928,-58.4841689001174 -34.5872885570578,-58.4845090823473 -34.5869120026436)))";;"1656";15_2_8;COMUNA 15;"2";"8";"668";"315";"353";"89,24%";"272";"272";"100,00%";"0";"0,00%";"236";"1";"0.42";"235";"99,58%";"0.42";0.420
"MULTIPOLYGON (((-58.4825287675161 -34.5874729265015,-58.4834103770975 -34.5881380885961,-58.4835058082716 -34.5880221522021,-58.4838517003946 -34.5876396125337,-58.4839316390989 -34.5875512852298,-58.4841689001174 -34.5872885570578,-58.483286593302 -34.5865466367928,-58.4824852143967 -34.5858727278977,-58.4820814210797 -34.5855331309885,-58.4816358980399 -34.5851584673534,-58.481171489316 -34.5856177825795,-58.480694901061 -34.5860892109692,-58.4816906083906 -34.5868404990147,-58.4825287675161 -34.5874729265015)))";;"1657";15_2_9;COMUNA 15;"2";"9";"581";"268";"313";"85,62%";"268";"268";"100,00%";"0";"0,00%";"212";"0";"0";"212";"100,00%";"0";0.000
"MULTIPOLYGON (((-58.4406928127298 -34.5981126213205,-58.4393534708803 -34.5972558604024,-58.4384865585656 -34.5981807976766,-58.4397638367001 -34.5989745961619,-58.4406928127298 -34.5981126213205)))";;"1658";15_20_1;COMUNA 15;"20";"1";"858";"408";"450";"90,67%";"417";"417";"100,00%";"0";"0,00%";"347";"5";"1.44";"342";"98,56%";"1.44";1.440
"MULTIPOLYGON (((-58.4342490035454 -34.5954758345969,-58.4331712450451 -34.5947887911439,-58.4322886991943 -34.5957293153795,-58.4316226233071 -34.5964391752125,-58.4327009854209 -34.597129260594,-58.4333660358497 -34.5964189017309,-58.4344428794417 -34.5971081262571,-58.4353267798184 -34.596162798037,-58.4342490035454 -34.5954758345969)))";;"1659";15_20_10;COMUNA 15;"20";"10";"804";"380";"424";"89,62%";"387";"387";"100,00%";"0";"0,00%";"319";"7";"2.19";"312";"97,81%";"2.19";2.190
"MULTIPOLYGON (((-58.4340419291533 -34.5938608637195,-58.4329633421955 -34.5931721278523,-58.4320950368531 -34.5941027244427,-58.4312172552006 -34.5950434535045,-58.4305540708767 -34.5957542942837,-58.4306774427178 -34.5958343298396,-58.4316226233071 -34.5964391752125,-58.4322886991943 -34.5957293153795,-58.4331712450451 -34.5947887911439,-58.4340419291533 -34.5938608637195)))";;"1660";15_20_11;COMUNA 15;"20";"11";"728";"319";"409";"78,00%";"422";"421";"99,76%";"1";"0,24%";"344";"26";"7.56";"318";"92,44%";"7.56";7.560
"MULTIPOLYGON (((-58.4312194405607 -34.5935397331063,-58.4302822494525 -34.5941633854991,-58.4300594956334 -34.59430234566,-58.4293488081426 -34.5947454103037,-58.4291690702415 -34.5948552949287,-58.4305540708767 -34.5957542942837,-58.4312172552006 -34.5950434535045,-58.4320950368531 -34.5941027244427,-58.4329633421955 -34.5931721278523,-58.4325730527101 -34.5929229377927,-58.432358668529 -34.5927816819221,-58.4312194405607 -34.5935397331063)))";;"1661";15_20_12;COMUNA 15;"20";"12";"738";"314";"424";"74,06%";"453";"452";"99,78%";"1";"0,22%";"342";"4";"1.17";"338";"98,83%";"1.17";1.170
"MULTIPOLYGON (((-58.4375987543087 -34.5991280491538,-58.4369335481934 -34.5998376560632,-58.4376002861755 -34.6002642902411,-58.4381053268485 -34.6005831376669,-58.4387649076092 -34.5998743684549,-58.4389452485172 -34.5997341166262,-58.4397638367001 -34.5989745961619,-58.4384865585656 -34.5981807976766,-58.4375987543087 -34.5991280491538)))";;"1662";15_20_2;COMUNA 15;"20";"2";"805";"351";"454";"77,31%";"535";"535";"100,00%";"0";"0,00%";"366";"5";"1.37";"361";"98,63%";"1.37";1.370
"MULTIPOLYGON (((-58.436594831809 -34.5984855602562,-58.436376816901 -34.5987177054677,-58.4359304737564 -34.59919579578,-58.4369335481934 -34.5998376560632,-58.4375987543087 -34.5991280491538,-58.4384865585656 -34.5981807976766,-58.4374828956892 -34.5975397245433,-58.436594831809 -34.5984855602562)))";;"1663";15_20_3;COMUNA 15;"20";"3";"791";"336";"455";"73,85%";"460";"460";"100,00%";"0";"0,00%";"346";"5";"1.45";"341";"98,55%";"1.45";1.450
"MULTIPOLYGON (((-58.4393534708803 -34.5972558604024,-58.438351345427 -34.5966147946099,-58.4374828956892 -34.5975397245433,-58.4384865585656 -34.5981807976766,-58.4393534708803 -34.5972558604024)))";;"1664";15_20_4;COMUNA 15;"20";"4";"635";"283";"352";"80,40%";"334";"334";"100,00%";"0";"0,00%";"278";"1";"0.36";"277";"99,64%";"0.36";0.360
"MULTIPOLYGON (((-58.438351345427 -34.5966147946099,-58.4372737094806 -34.5959253930712,-58.4371278608199 -34.5960810024622,-58.4364063615515 -34.5968521467332,-58.4374828956892 -34.5975397245433,-58.438351345427 -34.5966147946099)))";;"1665";15_20_5;COMUNA 15;"20";"5";"595";"275";"320";"85,94%";"350";"350";"100,00%";"0";"0,00%";"274";"3";"1.09";"271";"98,91%";"1.09";1.090
"MULTIPOLYGON (((-58.4374828956892 -34.5975397245433,-58.4364063615515 -34.5968521467332,-58.4355211031837 -34.5977982570429,-58.4348564859247 -34.5985086275914,-58.4359304737564 -34.59919579578,-58.436376816901 -34.5987177054677,-58.436594831809 -34.5984855602562,-58.4374828956892 -34.5975397245433)))";;"1666";15_20_6;COMUNA 15;"20";"6";"713";"317";"396";"80,05%";"388";"388";"100,00%";"0";"0,00%";"321";"0";"0";"321";"100,00%";"0";0.000
"MULTIPOLYGON (((-58.4355211031837 -34.5977982570429,-58.4364063615515 -34.5968521467332,-58.4355347080505 -34.5962953144473,-58.4353267798184 -34.596162798037,-58.4344428794417 -34.5971081262571,-58.4333660358497 -34.5964189017309,-58.4327009854209 -34.597129260594,-58.433778428743 -34.5978187727529,-58.4348564859247 -34.5985086275914,-58.4355211031837 -34.5977982570429)))";;"1667";15_20_7;COMUNA 15;"20";"7";"729";"328";"401";"81,80%";"343";"341";"99,42%";"2";"0,59%";"289";"11";"3.81";"278";"96,19%";"3.81";3.810
"MULTIPOLYGON (((-58.4372737094806 -34.5959253930712,-58.4364801393905 -34.5954177405494,-58.4361943031572 -34.5952352068795,-58.4351177241297 -34.5945478287169,-58.4342490035454 -34.5954758345969,-58.4353267798184 -34.596162798037,-58.4355347080505 -34.5962953144473,-58.4364063615515 -34.5968521467332,-58.4371278608199 -34.5960810024622,-58.4372737094806 -34.5959253930712)))";;"1668";15_20_8;COMUNA 15;"20";"8";"659";"276";"383";"72,06%";"309";"308";"99,68%";"1";"0,32%";"268";"1";"0.37";"267";"99,63%";"0.37";0.370
"MULTIPOLYGON (((-58.4351177241297 -34.5945478287169,-58.4340419291533 -34.5938608637195,-58.4331712450451 -34.5947887911439,-58.4342490035454 -34.5954758345969,-58.4351177241297 -34.5945478287169)))";;"1669";15_20_9;COMUNA 15;"20";"9";"491";"233";"258";"90,31%";"265";"265";"100,00%";"0";"0,00%";"225";"8";"3.56";"217";"96,44%";"3.56";3.560
"MULTIPOLYGON (((-58.4348564859247 -34.5985086275914,-58.433778428743 -34.5978187727529,-58.4329930690424 -34.598658686926,-58.4340718975887 -34.5993470698599,-58.4348564859247 -34.5985086275914)))";;"1670";15_21_1;COMUNA 15;"21";"1";"722";"342";"380";"90,00%";"383";"383";"100,00%";"0";"0,00%";"320";"7";"2.19";"313";"97,81%";"2.19";2.190
"MULTIPOLYGON (((-58.4311289661148 -34.5988035061533,-58.4300512766349 -34.5981136185224,-58.429220123503 -34.5989992725074,-58.4294289030137 -34.5991261654736,-58.4296465989643 -34.599320668726,-58.4301501897177 -34.599770539662,-58.4301879911524 -34.5998043538522,-58.4311289661148 -34.5988035061533)))";;"1671";15_21_10;COMUNA 15;"21";"10";"613";"269";"344";"78,20%";"387";"387";"100,00%";"0";"0,00%";"278";"26";"9.35";"252";"90,65%";"9.35";9.350
"MULTIPOLYGON (((-58.4300512766349 -34.5981136185224,-58.4289877387761 -34.5974328804953,-58.4278525175348 -34.5983640060146,-58.427987566853 -34.5984239059692,-58.4285480320993 -34.5986725243934,-58.4291618000751 -34.5989591141025,-58.429220123503 -34.5989992725074,-58.4300512766349 -34.5981136185224)))";;"1672";15_21_11;COMUNA 15;"21";"11";"697";"339";"358";"94,69%";"438";"438";"100,00%";"0";"0,00%";"335";"6";"1.79";"329";"98,21%";"1.79";1.790
"MULTIPOLYGON (((-58.4289877387761 -34.5974328804953,-58.4278355852761 -34.596695345075,-58.4265648222198 -34.5979157973043,-58.4267852199686 -34.597944243749,-58.4277732421143 -34.598328911575,-58.4278525175348 -34.5983640060146,-58.4289877387761 -34.5974328804953)))";;"1673";15_21_12;COMUNA 15;"21";"12";"510";"235";"275";"85,45%";"276";"276";"100,00%";"0";"0,00%";"217";"37";"17.05";"180";"82,95%";"17.05";17.050
"MULTIPOLYGON (((-58.4270238495849 -34.5961655828329,-58.4269502483354 -34.596210492618,-58.4262401861582 -34.596511843548,-58.4260240783581 -34.5966140362798,-58.4248429797965 -34.5970618619775,-58.4235379430115 -34.5976319930617,-58.4233671610307 -34.5977486809503,-58.4237468970472 -34.5978247502171,-58.424954103811 -34.5978517861145,-58.4263027807292 -34.5978819857279,-58.4264393795074 -34.5978996327093,-58.4265648222198 -34.5979157973043,-58.4278355852761 -34.596695345075,-58.4270238495849 -34.5961655828329)))";;"1674";15_21_13;COMUNA 15;"21";"13";"895";"405";"490";"82,65%";"498";"496";"99,60%";"2";"0,40%";"389";"16";"4.11";"373";"95,89%";"4.11";4.110
"MULTIPOLYGON (((-58.433778428743 -34.5978187727529,-58.4327009854209 -34.597129260594,-58.4316226233071 -34.5964391752125,-58.4308360632682 -34.5972773147534,-58.4319134923241 -34.5979688856872,-58.4321666319991 -34.5981313499282,-58.4329930690424 -34.598658686926,-58.433778428743 -34.5978187727529)))";;"1675";15_21_2;COMUNA 15;"21";"2";"822";"379";"443";"85,55%";"453";"453";"100,00%";"0";"0,00%";"374";"2";"0.53";"372";"99,47%";"0.53";0.530
"MULTIPOLYGON (((-58.4291690702415 -34.5948552949287,-58.4280889294477 -34.5955150191404,-58.4297708274708 -34.5965937660051,-58.4302169796455 -34.5968798826031,-58.4308360632682 -34.5972773147534,-58.4316226233071 -34.5964391752125,-58.4306774427178 -34.5958343298396,-58.4305540708767 -34.5957542942837,-58.4291690702415 -34.5948552949287)))";;"1676";15_21_3;COMUNA 15;"21";"3";"631";"293";"338";"86,69%";"343";"343";"100,00%";"0";"0,00%";"293";"37";"12.63";"256";"87,37%";"12.63";12.630
"MULTIPOLYGON (((-58.4280889294477 -34.5955150191404,-58.4270238495849 -34.5961655828329,-58.4278355852761 -34.596695345075,-58.4289877387761 -34.5974328804953,-58.4300512766349 -34.5981136185224,-58.4308360632682 -34.5972773147534,-58.4302169796455 -34.5968798826031,-58.4297708274708 -34.5965937660051,-58.4280889294477 -34.5955150191404)))";;"1677";15_21_4;COMUNA 15;"21";"4";"726";"302";"424";"71,23%";"402";"402";"100,00%";"0";"0,00%";"343";"18";"5.25";"325";"94,75%";"5.25";5.250
"MULTIPOLYGON (((-58.4319134923241 -34.5979688856872,-58.4308360632682 -34.5972773147534,-58.4300512766349 -34.5981136185224,-58.4311289661148 -34.5988035061533,-58.4319134923241 -34.5979688856872)))";;"1678";15_21_5;COMUNA 15;"21";"5";"472";"213";"259";"82,24%";"232";"232";"100,00%";"0";"0,00%";"201";"20";"9.95";"181";"90,05%";"9.95";9.950
"MULTIPOLYGON (((-58.4340718975887 -34.5993470698599,-58.4329930690424 -34.598658686926,-58.4321666319991 -34.5981313499282,-58.4319134923241 -34.5979688856872,-58.4311289661148 -34.5988035061533,-58.432210419951 -34.5994957091669,-58.4332877194232 -34.6001852253622,-58.4340718975887 -34.5993470698599)))";;"1679";15_21_6;COMUNA 15;"21";"6";"1045";"490";"555";"88,29%";"496";"494";"99,60%";"2";"0,40%";"418";"10";"2.39";"408";"97,61%";"2.39";2.390
"MULTIPOLYGON (((-58.4332877194232 -34.6001852253622,-58.432210419951 -34.5994957091669,-58.4314278403488 -34.6003326558612,-58.4325034403556 -34.6010233052552,-58.4332877194232 -34.6001852253622)))";;"1680";15_21_7;COMUNA 15;"21";"7";"411";"183";"228";"80,26%";"217";"217";"100,00%";"0";"0,00%";"175";"2";"1.14";"173";"98,86%";"1.14";1.140
"MULTIPOLYGON (((-58.4314278403488 -34.6003326558612,-58.4310382061634 -34.6007492614427,-58.4311543268513 -34.6008811979602,-58.4318726827822 -34.6016973985528,-58.4325034403556 -34.6010233052552,-58.4314278403488 -34.6003326558612)))";;"1681";15_21_8;COMUNA 15;"21";"8";"574";"241";"333";"72,37%";"320";"320";"100,00%";"0";"0,00%";"261";"1";"0.38";"260";"99,62%";"0.38";0.380
"MULTIPOLYGON (((-58.432210419951 -34.5994957091669,-58.4311289661148 -34.5988035061533,-58.4301879911524 -34.5998043538522,-58.4302750878436 -34.5998821969106,-58.4310382061634 -34.6007492614427,-58.4314278403488 -34.6003326558612,-58.432210419951 -34.5994957091669)))";;"1682";15_21_9;COMUNA 15;"21";"9";"863";"390";"473";"82,45%";"509";"508";"99,80%";"1";"0,20%";"392";"2";"0.51";"390";"99,49%";"0.51";0.510
"MULTIPOLYGON (((-58.4755132447092 -34.5786921037325,-58.4756197634905 -34.5772046947638,-58.4755943296574 -34.5771902630956,-58.4750068651033 -34.5768569294217,-58.4748508671467 -34.5767681384914,-58.4746189996106 -34.5766361135325,-58.4737493789741 -34.5776176451143,-58.473691907532 -34.5776308198707,-58.473568620574 -34.5776590011084,-58.473267299418 -34.5777279741253,-58.4723983282579 -34.5779381959309,-58.4721817229379 -34.5779868769631,-58.4721685891104 -34.5785492959179,-58.4721554553621 -34.5791139684348,-58.473682227393 -34.579126658046,-58.4736829451667 -34.578757558048,-58.4736840332293 -34.5786143125206,-58.4739103538294 -34.5786240106604,-58.4755014111786 -34.5786916034721,-58.4755132447092 -34.5786921037325)))";;"1683";15_3_13;COMUNA 15;"3";"13";"770";"364";"406";"89,66%";"339";"338";"99,71%";"1";"0,30%";"291";"6";"2.06";"285";"97,94%";"2.06";2.060
"MULTIPOLYGON (((-58.4647170878555 -34.5785709150114,-58.4652050345593 -34.5776567831301,-58.4650192441788 -34.5775513598365,-58.4642026914924 -34.5770791696574,-58.4640728442992 -34.5770047314324,-58.4635120892039 -34.5778996332325,-58.4625664615179 -34.5773727827392,-58.4616052644052 -34.5768372623986,-58.4605469730259 -34.5779429286217,-58.4602248561012 -34.5782952612339,-58.4605277209304 -34.5782946331705,-58.4607938877686 -34.5782940742134,-58.4609567725458 -34.5782836536764,-58.4617631064333 -34.5782771833844,-58.4632088030466 -34.5783836692548,-58.4646438651321 -34.5787082458905,-58.4647170878555 -34.5785709150114)))";;"1684";15_3_10;COMUNA 15;"3";"10";"868";"386";"482";"80,08%";"428";"427";"99,77%";"1";"0,23%";"340";"2";"0.59";"338";"99,41%";"0.59";0.590
"MULTIPOLYGON (((-58.4618627028943 -34.5807203141797,-58.4620286575807 -34.580714892445,-58.4632960943232 -34.5806798913828,-58.4632503623371 -34.5795869588014,-58.4618150312383 -34.5796290712657,-58.4617631064333 -34.5782771833844,-58.4609567725458 -34.5782836536764,-58.4607938877686 -34.5782940742134,-58.4605277209304 -34.5782946331705,-58.4605293030354 -34.5796668032238,-58.4605306366777 -34.5807721309098,-58.4618627028943 -34.5807203141797)))";;"1685";15_3_11;COMUNA 15;"3";"11";"755";"345";"410";"84,15%";"400";"400";"100,00%";"0";"0,00%";"340";"37";"10.88";"303";"89,12%";"10.88";10.880
"MULTIPOLYGON (((-58.4632503623371 -34.5795869588014,-58.4632960943232 -34.5806798913828,-58.4645693200998 -34.5806447362194,-58.46471543487 -34.5806400153883,-58.4659895958292 -34.580598647953,-58.4661362213495 -34.5805944183854,-58.4661294027427 -34.5804306089552,-58.4660876424596 -34.5795036701222,-58.4646727495908 -34.5795452522203,-58.4646438651321 -34.5787082458905,-58.4632088030466 -34.5783836692548,-58.4617631064333 -34.5782771833844,-58.4618150312383 -34.5796290712657,-58.4632503623371 -34.5795869588014)))";;"1686";15_3_12;COMUNA 15;"3";"12";"1210";"563";"647";"87,02%";"457";"457";"100,00%";"0";"0,00%";"411";"17";"4.14";"394";"95,86%";"4.14";4.140
"MULTIPOLYGON (((-58.4765688998753 -34.578730784263,-58.4756526324279 -34.578697996237,-58.4755014111786 -34.5786916034721,-58.4739103538294 -34.5786240106604,-58.4736840332293 -34.5786143125206,-58.4736829451667 -34.578757558048,-58.473682227393 -34.579126658046,-58.473681107328 -34.5796740753508,-58.4736787162601 -34.5809164511584,-58.4743102289428 -34.5812695763701,-58.4744617702768 -34.581097864607,-58.4746823546423 -34.5808422691742,-58.4749209860515 -34.5805656143141,-58.4749964987569 -34.5804707436348,-58.4754241208521 -34.5799582841298,-58.4754993036562 -34.5799404586258,-58.4762712824896 -34.5790695642709,-58.4765688998753 -34.578730784263)))";;"1687";15_3_2;COMUNA 15;"3";"2";"941";"418";"523";"79,92%";"478";"478";"100,00%";"0";"0,00%";"399";"3";"0.75";"396";"99,25%";"0.75";0.750
"MULTIPOLYGON (((-58.4721554553621 -34.5791139684348,-58.4721685891104 -34.5785492959179,-58.4721817229379 -34.5779868769631,-58.4719850409903 -34.5780309784398,-58.4714219845728 -34.5781574337254,-58.4712942683469 -34.5781843453212,-58.4709673995732 -34.5782531735999,-58.4708733151037 -34.5782732512001,-58.4703426097223 -34.5783863889143,-58.4695806494955 -34.5785489058387,-58.4694821368199 -34.5785698981464,-58.4708678854215 -34.5793447752471,-58.4721335934824 -34.5800525303828,-58.4736787162601 -34.5809164511584,-58.473681107328 -34.5796740753508,-58.473682227393 -34.579126658046,-58.4721554553621 -34.5791139684348)))";;"1688";15_3_3;COMUNA 15;"3";"3";"918";"414";"504";"82,14%";"417";"417";"100,00%";"0";"0,00%";"382";"5";"1.31";"377";"98,69%";"1.31";1.310
"MULTIPOLYGON (((-58.4718180049586 -34.5766560740499,-58.4716588601605 -34.5765648143791,-58.4708782981342 -34.5761200616605,-58.4707126841563 -34.5760257024586,-58.4699458409868 -34.5755889713448,-58.4689043740231 -34.5768270387747,-58.4698278975652 -34.5773515174636,-58.4690599566469 -34.5782517385334,-58.4695806494955 -34.5785489058387,-58.4703426097223 -34.5783863889143,-58.4708733151037 -34.5782732512001,-58.4709673995732 -34.5782531735999,-58.4712942683469 -34.5781843453212,-58.4714219845728 -34.5781574337254,-58.4719850409903 -34.5780309784398,-58.4726279758844 -34.5773017422787,-58.4727346482442 -34.577181235528,-58.4718180049586 -34.5766560740499)))";;"1689";15_3_4;COMUNA 15;"3";"4";"800";"377";"423";"89,13%";"304";"302";"99,34%";"2";"0,66%";"269";"9";"3.35";"260";"96,65%";"3.35";3.350
"MULTIPOLYGON (((-58.4736847252384 -34.5761076577481,-58.4735471229532 -34.5760327373094,-58.4728867013296 -34.5756550317527,-58.472742458324 -34.5755718007441,-58.4719584081166 -34.575119519616,-58.471805907701 -34.5750325555664,-58.4708650271922 -34.5744961204651,-58.4699458409868 -34.5755889713448,-58.4707126841563 -34.5760257024586,-58.4708782981342 -34.5761200616605,-58.4716588601605 -34.5765648143791,-58.4718180049586 -34.5766560740499,-58.4727346482442 -34.577181235528,-58.4726279758844 -34.5773017422787,-58.4719850409903 -34.5780309784398,-58.4721817229379 -34.5779868769631,-58.472398328258 -34.5779381959309,-58.473267299418 -34.5777279741253,-58.473568620574 -34.5776590011085,-58.473691907532 -34.5776308198707,-58.4737493789741 -34.5776176451143,-58.4746189996106 -34.5766361135325,-58.4738290546519 -34.5761863803952,-58.4736847252384 -34.5761076577481)))";;"1690";15_3_5;COMUNA 15;"3";"5";"801";"375";"426";"88,03%";"274";"274";"100,00%";"0";"0,00%";"242";"22";"9.09";"220";"90,91%";"9.09";9.090
"MULTIPOLYGON (((-58.4667868533176 -34.5756289788344,-58.4658851303033 -34.5764401667495,-58.4660713450434 -34.5765460112857,-58.4672206590497 -34.5772019876896,-58.4681451129733 -34.5777296481916,-58.4690599566469 -34.5782517385334,-58.4698278975652 -34.5773515174636,-58.4689043740231 -34.5768270387747,-58.4699458409868 -34.5755889713448,-58.4708650271922 -34.5744961204651,-58.4699256062461 -34.5739604526578,-58.4698265963384 -34.574076590187,-58.4690122033533 -34.5750532962606,-58.4681884153461 -34.574580006117,-58.4680422205214 -34.5744954315416,-58.4679358840822 -34.5745950882738,-58.4667868533176 -34.5756289788344)))";;"1691";15_3_6;COMUNA 15;"3";"6";"731";"349";"382";"91,36%";"324";"324";"100,00%";"0";"0,00%";"272";"1";"0.37";"271";"99,63%";"0.37";0.370
"MULTIPOLYGON (((-58.4641215235993 -34.575621996423,-58.4647279231714 -34.5759592556482,-58.4657943706964 -34.5765524273427,-58.4658851303033 -34.5764401667495,-58.4667868533176 -34.5756289788344,-58.4679358840822 -34.5745950882738,-58.4680422205214 -34.5744954315416,-58.4681884153461 -34.574580006117,-58.4690122033533 -34.5750532962606,-58.4698265963384 -34.574076590187,-58.4699256062461 -34.5739604526578,-58.4691338386307 -34.5735089988278,-58.4682875873865 -34.573026484668,-58.4680812837286 -34.5729088128466,-58.4673642913018 -34.5724961486204,-58.4660374144441 -34.5733358759265,-58.4649915594845 -34.5739950126698,-58.4633555686456 -34.5750083853759,-58.4631896259131 -34.5751036718882,-58.4641215235993 -34.575621996423)))";;"1692";15_3_7;COMUNA 15;"3";"7";"812";"387";"425";"91,06%";"311";"309";"99,36%";"2";"0,65%";"251";"1";"0.4";"250";"99,60%";"0.4";0.400
"MULTIPOLYGON (((-58.4641215235993 -34.575621996423,-58.4631896259131 -34.5751036718882,-58.4623760820579 -34.5760318807683,-58.4622470884241 -34.5761666747876,-58.4616052644052 -34.5768372623986,-58.4625664615179 -34.5773727827392,-58.4635120892039 -34.5778996332325,-58.4640728442992 -34.5770047314324,-58.4647279231714 -34.5759592556482,-58.4641215235993 -34.575621996423)))";;"1693";15_3_8;COMUNA 15;"3";"8";"917";"446";"471";"94,69%";"380";"380";"100,00%";"0";"0,00%";"329";"5";"1.52";"324";"98,48%";"1.52";1.520
"MULTIPOLYGON (((-58.4657943706964 -34.5765524273427,-58.4647279231714 -34.5759592556482,-58.4640728442992 -34.5770047314324,-58.4642026914924 -34.5770791696574,-58.4650192441788 -34.5775513598365,-58.4652050345593 -34.5776567831301,-58.4647170878555 -34.5785709150114,-58.4646438651321 -34.5787082458905,-58.4646727495908 -34.5795452522203,-58.4660876424596 -34.5795036701222,-58.4660227409242 -34.5790202010181,-58.4663154441622 -34.5782874859805,-58.467121301117 -34.5773211512724,-58.4672206590497 -34.5772019876896,-58.4660713450434 -34.5765460112857,-58.4658851303033 -34.5764401667495,-58.4657943706964 -34.5765524273427)))";;"1694";15_3_9;COMUNA 15;"3";"9";"877";"409";"468";"87,39%";"439";"439";"100,00%";"0";"0,00%";"349";"4";"1.15";"345";"98,85%";"1.15";1.150
"MULTIPOLYGON (((-58.4708718283536 -34.5804820758594,-58.4708714244626 -34.5815753606455,-58.4710430856637 -34.5815737996721,-58.4720984267219 -34.581559497029,-58.472087410424 -34.582032052618,-58.4720808783134 -34.5822495268845,-58.4735707728948 -34.5817649466528,-58.4738577148283 -34.5816716070418,-58.4739949699101 -34.5816269446834,-58.4743102289428 -34.5812695763701,-58.4736787162601 -34.5809164511584,-58.4721335934824 -34.5800525303828,-58.4708678854215 -34.5793447752471,-58.4708720848884 -34.5796232372845,-58.4708718283536 -34.5804820758594)))";;"1695";15_4_1;COMUNA 15;"4";"1";"852";"394";"458";"86,03%";"423";"423";"100,00%";"0";"0,00%";"337";"2";"0.59";"335";"99,41%";"0.59";0.590
"MULTIPOLYGON (((-58.460405765846 -34.5854315455672,-58.4603787097951 -34.585528042087,-58.4605265912711 -34.5855695509841,-58.4607718494315 -34.5856383290589,-58.4609718456451 -34.5856949182186,-58.4612192097795 -34.5857636954228,-58.4614623638405 -34.5858324720823,-58.4617002545501 -34.585955222706,-58.4618655153305 -34.5860396679109,-58.4619665663694 -34.5861258536344,-58.4621834057638 -34.5863104126779,-58.4623949829962 -34.5864888774238,-58.4626118242798 -34.5866743062514,-58.4628307717933 -34.5868597346859,-58.4629760879836 -34.5869825130223,-58.4630801007463 -34.5869056404945,-58.464356895068 -34.5859712257319,-58.4652932751726 -34.5868431462159,-58.466348310064 -34.5860703414086,-58.466793649837 -34.5857440464119,-58.4674001748765 -34.5852997811186,-58.4665244166188 -34.5843849856162,-58.4662847020073 -34.5841346305328,-58.464883961989 -34.5845901048044,-58.4647923385834 -34.5846198963595,-58.463491551656 -34.5850428867466,-58.463415680761 -34.5850948611664,-58.4620558710364 -34.5851345110695,-58.4609901796478 -34.5851431631173,-58.4607589888774 -34.5851450611455,-58.4606673646237 -34.5851242137332,-58.4606144850853 -34.5851026626663,-58.4605732721282 -34.5850581530972,-58.4605356374482 -34.584943922422,-58.4604706633094 -34.5850361081131,-58.4604255276594 -34.5852032267728,-58.4604463027545 -34.5852877376457,-58.4604139413724 -34.5854023896033,-58.460405765846 -34.5854315455672)))";;"1696";15_4_10;COMUNA 15;"4";"10";"643";"297";"346";"85,84%";"301";"301";"100,00%";"0";"0,00%";"257";"2";"0.78";"255";"99,22%";"0.78";0.780
"MULTIPOLYGON (((-58.4696568667954 -34.5837937667154,-58.4696336433748 -34.5830454978733,-58.4695576907295 -34.5830702214909,-58.4694925519339 -34.5830914231883,-58.4685172541477 -34.5834085992785,-58.4684199283185 -34.5834402248953,-58.4673936174425 -34.5837740147687,-58.4672931402047 -34.5838066959877,-58.4671751219248 -34.5838450822274,-58.4662847020073 -34.5841346305328,-58.4665244166188 -34.5843849856162,-58.4674001748765 -34.5852997811186,-58.466793649837 -34.5857440464119,-58.4677378873792 -34.5866210889611,-58.4683436474341 -34.5861776641792,-58.46876837386 -34.5858666452459,-58.4691955664421 -34.585553934478,-58.4696107499482 -34.5852500260552,-58.4697328562631 -34.5852094540459,-58.4696977651854 -34.5851144521889,-58.4696568667954 -34.5837937667154)))";;"1697";15_4_11;COMUNA 15;"4";"11";"771";"380";"391";"97,19%";"331";"331";"100,00%";"0";"0,00%";"296";"9";"3.04";"287";"96,96%";"3.04";3.040
"MULTIPOLYGON (((-58.4720808783134 -34.5822495268845,-58.4708710180619 -34.5826430808024,-58.4696336433748 -34.5830454978733,-58.4696568667954 -34.5837937667154,-58.470724413855 -34.5837898982225,-58.4708718961255 -34.5837843248283,-58.47102917079 -34.5837783984609,-58.4720461368395 -34.58376895824,-58.4720202994326 -34.5849680233497,-58.4721297197065 -34.5849568877299,-58.4724602099217 -34.584328526214,-58.4729814753408 -34.5833374568741,-58.4735384826855 -34.5822784918553,-58.4736477870881 -34.582061501315,-58.4736304080195 -34.5819967818906,-58.4736564537538 -34.5819195228434,-58.4736303894319 -34.5818548041968,-58.4735707728948 -34.5817649466528,-58.4720808783134 -34.5822495268845)))";;"1698";15_4_12;COMUNA 15;"4";"12";"812";"377";"435";"86,67%";"376";"376";"100,00%";"0";"0,00%";"353";"20";"5.67";"333";"94,33%";"5.67";5.670
"MULTIPOLYGON (((-58.4708892728154 -34.5873148899414,-58.4711667405682 -34.5867875257236,-58.4721297197065 -34.5849568877299,-58.4720202994326 -34.5849680233497,-58.4720461368395 -34.58376895824,-58.47102917079 -34.5837783984609,-58.4708718961255 -34.5837843248283,-58.470724413855 -34.5837898982225,-58.4696568667954 -34.5837937667154,-58.4696977651854 -34.5851144521889,-58.4697328562631 -34.5852094540459,-58.4696107499482 -34.5852500260552,-58.4691955664421 -34.585553934478,-58.46876837386 -34.5858666452459,-58.4683436474341 -34.5861776641792,-58.4692868843489 -34.58705525813,-58.4702308224086 -34.5879335488737,-58.4708194583523 -34.58744764645,-58.4708530885178 -34.587383697962,-58.4708892728154 -34.5873148899414)))";;"1699";15_4_13;COMUNA 15;"4";"13";"768";"331";"437";"75,74%";"414";"414";"100,00%";"0";"0,00%";"328";"3";"0.91";"325";"99,09%";"0.91";0.910
"MULTIPOLYGON (((-58.4630801007463 -34.5869056404945,-58.4629760879836 -34.5869825130223,-58.4630255095802 -34.5870242694407,-58.4631907741811 -34.5871705223233,-58.4633813029524 -34.5873481148608,-58.4635749904958 -34.5875291892975,-58.4637518363789 -34.5876945935584,-58.4639423675401 -34.5878721852047,-58.4641392155366 -34.5880576114782,-58.4643360643734 -34.5882412963166,-58.4645202820134 -34.5884145343493,-58.4647108164949 -34.5885938658867,-58.4648981937772 -34.5887714560664,-58.4650855718569 -34.5889490459532,-58.4652697926413 -34.5891231533902,-58.465451908809 -34.5892955194799,-58.4656445527277 -34.5894774611534,-58.4658056162645 -34.5896280633163,-58.4659835237194 -34.5897943348149,-58.4661635373723 -34.5899640882129,-58.4663488153964 -34.5901399350734,-58.4665109342781 -34.5902931479245,-58.4666509464773 -34.5904245973821,-58.4668151719555 -34.5905804214207,-58.4668275193891 -34.5905935490001,-58.4668758940272 -34.590564308253,-58.4669576438223 -34.5905150781121,-58.4671179907636 -34.5903883772151,-58.4676611911425 -34.5899590434123,-58.4678926393022 -34.5897761391427,-58.4680767411968 -34.5896306323877,-58.4681906762966 -34.5895409054113,-58.4688952291434 -34.5889857789937,-58.4692116532658 -34.5887365271562,-58.4702308224086 -34.5879335488737,-58.4692868843489 -34.58705525813,-58.4683436474341 -34.5861776641792,-58.4677378873792 -34.5866210889611,-58.466793649837 -34.5857440464119,-58.466348310064 -34.5860703414086,-58.4652932751726 -34.5868431462159,-58.464356895068 -34.5859712257319,-58.4630801007463 -34.5869056404945)))";;"1700";15_4_14;COMUNA 15;"4";"14";"897";"446";"451";"98,89%";"324";"324";"100,00%";"0";"0,00%";"318";"54";"16.98";"264";"83,02%";"16.98";16.980
"MULTIPOLYGON (((-58.4708710180619 -34.5826430808024,-58.4720808783134 -34.5822495268845,-58.472087410424 -34.582032052618,-58.4720984267219 -34.581559497029,-58.4710430856637 -34.5815737996721,-58.4708714244626 -34.5815753606455,-58.4708718283536 -34.5804820758594,-58.4708720848884 -34.5796232372845,-58.4708678854215 -34.5793447752471,-58.4694821368199 -34.5785698981464,-58.4695212019218 -34.5794028181023,-58.4695304018214 -34.580492510843,-58.4695396878687 -34.5815914291172,-58.4695410635907 -34.5817541118235,-58.4695528056577 -34.5826868961312,-58.4695576907295 -34.5830702214909,-58.4696336433748 -34.5830454978733,-58.4708710180619 -34.5826430808024)))";;"1701";15_4_2;COMUNA 15;"4";"2";"691";"318";"373";"85,25%";"328";"328";"100,00%";"0";"0,00%";"256";"6";"2.34";"250";"97,66%";"2.34";2.340
"MULTIPOLYGON (((-58.4693321965182 -34.5786018795551,-58.4694821368199 -34.5785698981464,-58.4695806494955 -34.5785489058387,-58.4690599566469 -34.5782517385334,-58.4681451129733 -34.5777296481916,-58.4672206590497 -34.5772019876896,-58.467121301117 -34.5773211512724,-58.4663154441622 -34.5782874859805,-58.4660227409242 -34.5790202010181,-58.4660876424596 -34.5795036701222,-58.4672207818605 -34.5794703925889,-58.4683524728575 -34.5794371750281,-58.4683273976973 -34.5788161643322,-58.4686342616417 -34.5787507245268,-58.4693321965182 -34.5786018795551)))";;"1702";15_4_3;COMUNA 15;"4";"3";"955";"442";"513";"86,16%";"514";"514";"100,00%";"0";"0,00%";"401";"4";"1";"397";"99,00%";"1";1.000
"MULTIPOLYGON (((-58.4683524728575 -34.5794371750281,-58.4683963980845 -34.5805272183632,-58.4684405802964 -34.5816228955114,-58.4684465510253 -34.5817719859019,-58.4684874033012 -34.5827180089178,-58.4685172541477 -34.5834085992785,-58.4694925519339 -34.5830914231883,-58.4695576907295 -34.5830702214909,-58.4695528056577 -34.5826868961312,-58.4695410635907 -34.5817541118235,-58.4695396878687 -34.5815914291172,-58.4695304018214 -34.580492510843,-58.4695212019218 -34.5794028181023,-58.4694821368199 -34.5785698981464,-58.4693321965182 -34.5786018795551,-58.4686342616417 -34.5787507245268,-58.4683273976973 -34.5788161643322,-58.4683524728575 -34.5794371750281)))";;"1703";15_4_4;COMUNA 15;"4";"4";"564";"275";"289";"95,16%";"235";"235";"100,00%";"0";"0,00%";"206";"15";"7.28";"191";"92,72%";"7.28";7.280
"MULTIPOLYGON (((-58.4683524728575 -34.5794371750281,-58.4672207818605 -34.5794703925889,-58.4672646072592 -34.580561844839,-58.46730851913 -34.5816564660198,-58.4673525173084 -34.5827511574104,-58.4673936174425 -34.5837740147687,-58.4684199283185 -34.5834402248953,-58.4685172541477 -34.5834085992785,-58.4684874033012 -34.5827180089178,-58.4684465510253 -34.5817719859019,-58.4684405802964 -34.5816228955114,-58.4683963980845 -34.5805272183632,-58.4683524728575 -34.5794371750281)))";;"1704";15_4_5;COMUNA 15;"4";"5";"636";"298";"338";"88,17%";"264";"264";"100,00%";"0";"0,00%";"230";"12";"5.22";"218";"94,78%";"5.22";5.220
"MULTIPOLYGON (((-58.4662268266817 -34.5827840838083,-58.4662714922853 -34.583874056864,-58.4662847020073 -34.5841346305328,-58.4671751219248 -34.5838450822274,-58.4672931402047 -34.5838066959877,-58.4673936174425 -34.5837740147687,-58.4673525173084 -34.5827511574104,-58.46730851913 -34.5816564660198,-58.4672646072592 -34.580561844839,-58.4672207818605 -34.5794703925889,-58.4660876424596 -34.5795036701222,-58.4661294027427 -34.5804306089552,-58.4661362213495 -34.5805944183854,-58.4661819917731 -34.5816899554447,-58.4661875320364 -34.5818225664023,-58.4662268266817 -34.5827840838083)))";;"1705";15_4_6;COMUNA 15;"4";"6";"801";"357";"444";"80,41%";"327";"324";"99,08%";"3";"0,93%";"270";"4";"1.48";"266";"98,52%";"1.48";1.480
"MULTIPOLYGON (((-58.46471543487 -34.5806400153883,-58.4645693200998 -34.5806447362194,-58.4632960943232 -34.5806798913828,-58.4633021409214 -34.5808254607751,-58.4633447225966 -34.5817728941613,-58.4633938630553 -34.5828667418268,-58.4634428344837 -34.5839589694926,-58.4646903092124 -34.5839248696208,-58.4648542264455 -34.5839196553564,-58.4662714922853 -34.583874056864,-58.4662268266817 -34.5827840838083,-58.4661875320364 -34.5818225664023,-58.4661819917731 -34.5816899554447,-58.4661362213495 -34.5805944183854,-58.4659895958292 -34.580598647953,-58.46471543487 -34.5806400153883)))";;"1706";15_4_7;COMUNA 15;"4";"7";"827";"400";"427";"93,68%";"365";"365";"100,00%";"0";"0,00%";"308";"19";"6.17";"289";"93,83%";"6.17";6.170
"MULTIPOLYGON (((-58.461958475646 -34.5829086446794,-58.4620062361907 -34.584001084183,-58.4632583103193 -34.5839639706811,-58.4634428344837 -34.5839589694926,-58.4633938630553 -34.5828667418268,-58.4633447225966 -34.5817728941613,-58.4633021409214 -34.5808254607751,-58.4632960943232 -34.5806798913828,-58.4620286575807 -34.580714892445,-58.4618627028943 -34.5807203141797,-58.4605306366777 -34.5807721309098,-58.4605319709835 -34.5818532320421,-58.4605332197592 -34.5829502491291,-58.461958475646 -34.5829086446794)))";;"1707";15_4_8;COMUNA 15;"4";"8";"755";"336";"419";"80,19%";"344";"344";"100,00%";"0";"0,00%";"297";"11";"3.7";"286";"96,30%";"3.7";3.700
"MULTIPOLYGON (((-58.4620062361907 -34.584001084183,-58.461958475646 -34.5829086446794,-58.4605332197592 -34.5829502491291,-58.4605345537482 -34.5840461392135,-58.4605356374482 -34.584943922422,-58.4605732721282 -34.5850581530972,-58.4606144850853 -34.5851026626663,-58.4606673646237 -34.5851242137332,-58.4607589888774 -34.5851450611455,-58.4609901796478 -34.5851431631173,-58.4620558710364 -34.5851345110695,-58.463415680761 -34.5850948611664,-58.463491551656 -34.5850428867466,-58.4647923385834 -34.5846198963595,-58.464883961989 -34.5845901048044,-58.4662847020073 -34.5841346305328,-58.4662714922853 -34.583874056864,-58.4648542264455 -34.5839196553564,-58.4646903092124 -34.5839248696208,-58.4634428344837 -34.5839589694926,-58.4632583103193 -34.5839639706811,-58.4620062361907 -34.584001084183)))";;"1708";15_4_9;COMUNA 15;"4";"9";"642";"298";"344";"86,63%";"304";"304";"100,00%";"0";"0,00%";"264";"18";"6.82";"246";"93,18%";"6.82";6.820
"MULTIPOLYGON (((-58.477574292984 -34.5805432062089,-58.4790736877728 -34.5801910982406,-58.4790442329589 -34.5797889023524,-58.4790404766076 -34.5797385486454,-58.478988076277 -34.5791249385084,-58.4772227097052 -34.5795329952448,-58.4754993036562 -34.5799404586258,-58.4754241208521 -34.5799582841298,-58.4749964987569 -34.5804707436348,-58.4751960182788 -34.5805838266598,-58.4752603086578 -34.5806056519531,-58.4753246816844 -34.5806107159447,-58.4754208111939 -34.580590071304,-58.4759832808165 -34.5804566959894,-58.4764266215196 -34.5808121546508,-58.4765871206501 -34.580775022279,-58.477574292984 -34.5805432062089)))";;"1709";15_5_1;COMUNA 15;"5";"1";"779";"367";"412";"89,08%";"397";"396";"99,75%";"1";"0,25%";"303";"3";"0.99";"300";"99,01%";"0.99";0.990
"MULTIPOLYGON (((-58.4750052473198 -34.5889887667163,-58.4740599727122 -34.5900093217848,-58.4750331011668 -34.5907684125537,-58.4757241642846 -34.591307517151,-58.4757584969365 -34.5913932211149,-58.4761304947213 -34.5909951367383,-58.476740294369 -34.5903426477282,-58.4776969504899 -34.5893189014187,-58.4778003115446 -34.5892083208597,-58.4786090548659 -34.588339662091,-58.4778133274138 -34.5877245271664,-58.4769972627595 -34.5886192389935,-58.4768979885597 -34.5887278464975,-58.4767972354973 -34.5886532777151,-58.4759222318403 -34.5879986309875,-58.4750052473198 -34.5889887667163)))";;"1710";15_5_10;COMUNA 15;"5";"10";"661";"318";"343";"92,71%";"250";"248";"99,20%";"2";"0,81%";"224";"11";"4.91";"213";"95,09%";"4.91";4.910
"MULTIPOLYGON (((-58.476740294369 -34.5903426477282,-58.4761304947213 -34.5909951367383,-58.4757584969365 -34.5913932211149,-58.4758796908482 -34.5916787534283,-58.4759623483366 -34.5916592134591,-58.4767269262178 -34.5914662592032,-58.4767283911487 -34.5914687502856,-58.4778249403606 -34.5911893828537,-58.4780829609035 -34.5911237141883,-58.4788567129969 -34.5902201274822,-58.4796259360264 -34.5893216069929,-58.4797264827868 -34.5892034192545,-58.4786090548659 -34.588339662091,-58.4778003115446 -34.5892083208597,-58.4776969504899 -34.5893189014187,-58.476740294369 -34.5903426477282)))";;"1711";15_5_11;COMUNA 15;"5";"11";"749";"366";"383";"95,56%";"305";"305";"100,00%";"0";"0,00%";"274";"12";"4.38";"262";"95,62%";"4.38";4.380
"MULTIPOLYGON (((-58.4809499574729 -34.587738324353,-58.4811775184076 -34.5874653213476,-58.4812601820237 -34.5873647413617,-58.4816906083906 -34.5868404990147,-58.480694901061 -34.5860892109692,-58.4796912060232 -34.5853319296576,-58.4794380920738 -34.5851409005091,-58.4794579033829 -34.5854187964378,-58.479493512884 -34.5859185301835,-58.4789558768538 -34.5864881331415,-58.4788600976981 -34.5865896288489,-58.477913195165 -34.5876150737217,-58.4778133274138 -34.5877245271664,-58.4786090548659 -34.588339662091,-58.4797264827868 -34.5892034192545,-58.4798357131944 -34.5890750185346,-58.4805102404806 -34.5882658049354,-58.4809499574729 -34.587738324353)))";;"1712";15_5_12;COMUNA 15;"5";"12";"718";"335";"383";"87,47%";"312";"312";"100,00%";"0";"0,00%";"272";"4";"1.47";"268";"98,53%";"1.47";1.470
"MULTIPOLYGON (((-58.4788567129969 -34.5902201274822,-58.4780829609035 -34.5911237141883,-58.4795448992558 -34.5907512528068,-58.4808709191807 -34.5904133730494,-58.4811822398902 -34.5903286750322,-58.4812884259938 -34.5902997845124,-58.481457793884 -34.5902458127816,-58.4812850157294 -34.5898996986249,-58.4811699162576 -34.5896690026441,-58.4812194565108 -34.5895718785727,-58.4812180745669 -34.5894843400655,-58.4812291171411 -34.5893586291277,-58.4812500414806 -34.5892489032411,-58.4812614416437 -34.5891998150326,-58.4812874802541 -34.5891122019219,-58.4813088418123 -34.5890543794455,-58.4814696390693 -34.5887674418938,-58.4820994502984 -34.5879976645512,-58.4825287675161 -34.5874729265015,-58.4816906083906 -34.5868404990147,-58.4812601820237 -34.5873647413617,-58.4811775184076 -34.5874653213476,-58.4809499574729 -34.587738324353,-58.4805102404806 -34.5882658049354,-58.4798357131944 -34.5890750185346,-58.4797264827868 -34.5892034192545,-58.4796259360264 -34.5893216069929,-58.4788567129969 -34.5902201274822)))";;"1713";15_5_13;COMUNA 15;"5";"13";"742";"364";"378";"96,30%";"364";"364";"100,00%";"0";"0,00%";"289";"2";"0.69";"287";"99,31%";"0.69";0.690
"MULTIPOLYGON (((-58.4836505164796 -34.5894910596889,-58.4847104596042 -34.5891189568117,-58.4842305055122 -34.5887568447942,-58.4834103770975 -34.5881380885961,-58.4825287675161 -34.5874729265015,-58.4820994502984 -34.5879976645512,-58.4814696390693 -34.5887674418938,-58.4813088418123 -34.5890543794455,-58.4812874802541 -34.5891122019219,-58.4812614416437 -34.5891998150326,-58.4812500414806 -34.5892489032411,-58.4812291171411 -34.5893586291277,-58.4812180745669 -34.5894843400655,-58.4812194565108 -34.5895718785727,-58.4811699162576 -34.5896690026441,-58.4812850157294 -34.5898996986249,-58.481457793884 -34.5902458127816,-58.481861585128 -34.5901171533638,-58.4820121326218 -34.590064451472,-58.4825014958378 -34.58989323945,-58.4836505164796 -34.5894910596889)))";;"1714";15_5_14;COMUNA 15;"5";"14";"722";"347";"375";"92,53%";"290";"290";"100,00%";"0";"0,00%";"261";"0";"0";"261";"100,00%";"0";0.000
"MULTIPOLYGON (((-58.4769131424718 -34.5812022559824,-58.4777046322772 -34.5818369058129,-58.4781736752341 -34.5820427008203,-58.4792503177408 -34.5825046913087,-58.4791917782882 -34.5818655179341,-58.4791833224461 -34.5817337530688,-58.4791547097353 -34.5812893723505,-58.4791186811222 -34.5808029485935,-58.4790736877728 -34.5801910982406,-58.477574292984 -34.5805432062089,-58.4765871206501 -34.580775022279,-58.4764266215196 -34.5808121546508,-58.4759832808165 -34.5804566959894,-58.4754208111939 -34.580590071304,-58.4753246816844 -34.5806107159447,-58.4752603086578 -34.5806056519531,-58.4751960182788 -34.5805838266598,-58.4749964987569 -34.5804707436348,-58.4749209860515 -34.5805656143141,-58.4746823546423 -34.5808422691742,-58.4744617702768 -34.581097864607,-58.4743102289428 -34.5812695763701,-58.4744782463853 -34.5813980867197,-58.4754883189947 -34.5821602700902,-58.4759930138961 -34.5816906897308,-58.4757180335042 -34.581483316426,-58.4762600738207 -34.5813559281953,-58.4769131424718 -34.5812022559824)))";;"1715";15_5_2;COMUNA 15;"5";"2";"995";"458";"537";"85,29%";"398";"397";"99,75%";"1";"0,25%";"358";"4";"1.12";"354";"98,88%";"1.12";1.120
"MULTIPOLYGON (((-58.4792503177408 -34.5825046913087,-58.4781736752341 -34.5820427008203,-58.4777046322772 -34.5818369058129,-58.4769131424718 -34.5812022559824,-58.4762600738207 -34.5813559281953,-58.4757180335042 -34.581483316426,-58.4759930138961 -34.5816906897308,-58.4754883189947 -34.5821602700902,-58.476651360293 -34.5830379957477,-58.4780024673795 -34.584057593979,-58.4782606110116 -34.5834007738462,-58.4784483647474 -34.5829229836512,-58.4786547949128 -34.5830511311255,-58.4787308431941 -34.5830951370545,-58.4788241777949 -34.5831420985212,-58.4788837884503 -34.5831673733605,-58.4789651987363 -34.5831972933457,-58.4790274480303 -34.5832167928778,-58.4790805000317 -34.5832312229819,-58.4793058203749 -34.5832832369246,-58.4792503177408 -34.5825046913087)))";;"1716";15_5_3;COMUNA 15;"5";"3";"762";"361";"401";"90,02%";"320";"320";"100,00%";"0";"0,00%";"278";"1";"0.36";"277";"99,64%";"0.36";0.360
"MULTIPOLYGON (((-58.4729814753408 -34.5833374568741,-58.4724602099217 -34.584328526214,-58.4730447844798 -34.5850486483313,-58.4737359485651 -34.5842303853444,-58.4743146326811 -34.5835452331463,-58.4746527970887 -34.5831449023658,-58.4750403369938 -34.5826860421038,-58.4751136388761 -34.5825999747878,-58.4754883189947 -34.5821602700902,-58.4744782463853 -34.5813980867197,-58.4743102289428 -34.5812695763701,-58.4739949699101 -34.5816269446834,-58.4738577148283 -34.5816716070418,-58.4735707728948 -34.5817649466528,-58.4736303894319 -34.5818548041968,-58.4736564537538 -34.5819195228434,-58.4736304080195 -34.5819967818906,-58.4736477870881 -34.582061501315,-58.4735384826855 -34.5822784918553,-58.4729814753408 -34.5833374568741)))";;"1717";15_5_4;COMUNA 15;"5";"4";"582";"274";"308";"88,96%";"283";"283";"100,00%";"0";"0,00%";"235";"17";"7.23";"218";"92,77%";"7.23";7.230
"MULTIPOLYGON (((-58.4737359485651 -34.5842303853444,-58.4730447844798 -34.5850486483313,-58.4739781318151 -34.5861984011795,-58.4744583213017 -34.5856291073683,-58.4746879415253 -34.5853569612732,-58.4752872287491 -34.5846464494162,-58.4758007737798 -34.5840376380753,-58.4762050830515 -34.5835582785824,-58.4762776183876 -34.583473760024,-58.476651360293 -34.5830379957477,-58.4754883189947 -34.5821602700902,-58.4751136388761 -34.5825999747878,-58.4750403369938 -34.5826860421038,-58.4746527970887 -34.5831449023658,-58.4743146326811 -34.5835452331463,-58.4737359485651 -34.5842303853444)))";;"1718";15_5_5;COMUNA 15;"5";"5";"775";"356";"419";"84,96%";"362";"362";"100,00%";"0";"0,00%";"301";"3";"1";"298";"99,00%";"1";1.000
"MULTIPOLYGON (((-58.4771392034183 -34.5850835861578,-58.4772408551568 -34.5849629353652,-58.4776357113238 -34.5844981503929,-58.4763731700307 -34.5835455128654,-58.4762776183876 -34.583473760024,-58.4762050830515 -34.5835582785824,-58.4758007737798 -34.5840376380753,-58.4752872287491 -34.5846464494162,-58.4746879415253 -34.5853569612732,-58.4760250072115 -34.5863484122276,-58.4761436418282 -34.5864391071225,-58.4767612608338 -34.5869080001919,-58.4768603944094 -34.5869860904828,-58.477923260302 -34.5858392963017,-58.4780038000472 -34.5857532263914,-58.4772925850416 -34.5852035023824,-58.4771392034183 -34.5850835861578)))";;"1719";15_5_6;COMUNA 15;"5";"6";"779";"360";"419";"85,92%";"332";"331";"99,70%";"1";"0,30%";"282";"1";"0.35";"281";"99,65%";"0.35";0.350
"MULTIPOLYGON (((-58.476651360293 -34.5830379957477,-58.4762776183876 -34.583473760024,-58.4763731700307 -34.5835455128654,-58.4776357113238 -34.5844981503929,-58.4772408551568 -34.5849629353652,-58.4771392034183 -34.5850835861578,-58.4772925850416 -34.5852035023824,-58.4780038000472 -34.5857532263914,-58.4788288075894 -34.5863910333858,-58.4789558768538 -34.5864881331415,-58.479493512884 -34.5859185301835,-58.4794579033829 -34.5854187964378,-58.4794380920738 -34.5851409005091,-58.4794299795929 -34.585026460335,-58.4794210132639 -34.5849003296572,-58.4793806227474 -34.5843337627411,-58.4793737915046 -34.5842383372355,-58.4793377564897 -34.5837326172139,-58.4793058203749 -34.5832832369246,-58.4790805000317 -34.5832312229819,-58.4790274480303 -34.5832167928778,-58.4789651987363 -34.5831972933457,-58.4788837884503 -34.5831673733605,-58.4788241777949 -34.5831420985212,-58.4787308431941 -34.5830951370545,-58.4786547949128 -34.5830511311255,-58.4784483647474 -34.5829229836512,-58.4782606110116 -34.5834007738462,-58.4780024673795 -34.584057593979,-58.476651360293 -34.5830379957477)))";;"1720";15_5_7;COMUNA 15;"5";"7";"703";"318";"385";"82,60%";"329";"329";"100,00%";"0";"0,00%";"281";"2";"0.71";"279";"99,29%";"0.71";0.710
"MULTIPOLYGON (((-58.4759222318403 -34.5879986309875,-58.4767972354973 -34.5886532777151,-58.4768979885597 -34.5887278464975,-58.4769972627595 -34.5886192389935,-58.4778133274138 -34.5877245271664,-58.477913195165 -34.5876150737217,-58.4788600976981 -34.5865896288489,-58.4789558768538 -34.5864881331415,-58.4788288075894 -34.5863910333858,-58.4780038000472 -34.5857532263914,-58.477923260302 -34.5858392963017,-58.4768603944094 -34.5869860904828,-58.4767612608338 -34.5869080001919,-58.4761436418282 -34.5864391071225,-58.4760250072115 -34.5863484122276,-58.4746879415253 -34.5853569612732,-58.4744583213017 -34.5856291073683,-58.4739781318151 -34.5861984011795,-58.474693127844 -34.5870791433602,-58.4753082726847 -34.5875398042076,-58.4754348282084 -34.5876338793732,-58.4759222318403 -34.5879986309875)))";;"1721";15_5_8;COMUNA 15;"5";"8";"907";"437";"470";"92,98%";"395";"395";"100,00%";"0";"0,00%";"334";"4";"1.2";"330";"98,80%";"1.2";1.200
"MULTIPOLYGON (((-58.4724602099217 -34.584328526214,-58.4721297197065 -34.5849568877299,-58.4711667405682 -34.5867875257236,-58.4708892728154 -34.5873148899414,-58.4708530885178 -34.587383697962,-58.4708194583523 -34.58744764645,-58.4711162505856 -34.5876996787753,-58.4712347127034 -34.5878023507482,-58.471893449793 -34.5883172532336,-58.4721174307698 -34.5884923136238,-58.472896346833 -34.5891010783111,-58.4730860954371 -34.5892493781193,-58.4732193797626 -34.5893535962347,-58.4740599727122 -34.5900093217848,-58.4750052473198 -34.5889887667163,-58.4759222318403 -34.5879986309875,-58.4754348282084 -34.5876338793732,-58.4753082726847 -34.5875398042076,-58.474693127844 -34.5870791433602,-58.4739781318151 -34.5861984011795,-58.4730447844798 -34.5850486483313,-58.4724602099217 -34.584328526214)))";;"1722";15_5_9;COMUNA 15;"5";"9";"916";"433";"483";"89,65%";"276";"275";"99,64%";"1";"0,36%";"258";"9";"3.49";"249";"96,51%";"3.49";3.490
"MULTIPOLYGON (((-58.5002536216253 -34.5952178699038,-58.5007097164842 -34.5955033736435,-58.501792895151 -34.5951008326492,-58.5027574526382 -34.59474233682,-58.5028766593643 -34.5946980001235,-58.5028768752027 -34.5946979180691,-58.5025063463871 -34.594469107136,-58.502403973569 -34.5944519480101,-58.5011174204136 -34.5942635496039,-58.5002318432188 -34.5941338200856,-58.4992880993211 -34.5939956505546,-58.4979581249055 -34.5938008231302,-58.4987817781518 -34.5943151096143,-58.4989246323784 -34.5943997889231,-58.4990964497161 -34.5945017136255,-58.5001069291136 -34.5951260803858,-58.5002536216253 -34.5952178699038)))";;"1723";15_6_1;COMUNA 15;"6";"1";"678";"310";"368";"84,24%";"354";"354";"100,00%";"0";"0,00%";"291";"1";"0.34";"290";"99,66%";"0.34";0.340
"MULTIPOLYGON (((-58.4975911787431 -34.5958775591471,-58.4968954472304 -34.5966448281815,-58.4971282620495 -34.5967885006927,-58.4971751147229 -34.5968173618249,-58.4983848619464 -34.5963676304009,-58.499550828959 -34.5959341684229,-58.4996339354819 -34.595903297026,-58.5001263573109 -34.5957201821187,-58.5007097164842 -34.5955033736435,-58.5002536216253 -34.5952178699038,-58.5001069291136 -34.5951260803858,-58.4990964497161 -34.5945017136255,-58.4989246323784 -34.5943997889231,-58.4982611896799 -34.5951373368619,-58.4981177571569 -34.5952967509986,-58.4975911787431 -34.5958775591471)))";;"1724";15_6_2;COMUNA 15;"6";"2";"681";"300";"381";"78,74%";"349";"348";"99,71%";"1";"0,29%";"285";"1";"0.35";"284";"99,65%";"0.35";0.350
"MULTIPOLYGON (((-58.4962640780561 -34.5950579698035,-58.4955680007272 -34.5958257948718,-58.4968954472304 -34.5966448281815,-58.4975911787431 -34.5958775591471,-58.4981177571569 -34.5952967509986,-58.4982611896799 -34.5951373368619,-58.4989246323784 -34.5943997889231,-58.4987817781518 -34.5943151096143,-58.4979581249055 -34.5938008231302,-58.4974687544747 -34.5937291297311,-58.496935882262 -34.594316909097,-58.4962640780561 -34.5950579698035)))";;"1725";15_6_3;COMUNA 15;"6";"3";"641";"303";"338";"89,64%";"341";"341";"100,00%";"0";"0,00%";"286";"10";"3.5";"276";"96,50%";"3.5";3.500
"MULTIPOLYGON (((-58.4974687544747 -34.5937291297311,-58.4959300948443 -34.5935040922413,-58.4956518677147 -34.5934952613671,-58.4949760171481 -34.5942625114672,-58.4942798496675 -34.5950309631409,-58.4931292380872 -34.5967439278589,-58.4929088631432 -34.5970674458697,-58.4934177131758 -34.5970333738599,-58.4947157690319 -34.5969476847742,-58.4967848860194 -34.5968111331741,-58.4971282620495 -34.5967885006927,-58.4968954472304 -34.5966448281815,-58.4955680007272 -34.5958257948718,-58.4962640780561 -34.5950579698035,-58.496935882262 -34.594316909097,-58.4974687544747 -34.5937291297311)))";;"1726";15_6_4;COMUNA 15;"6";"4";"722";"340";"382";"89,01%";"301";"300";"99,67%";"1";"0,33%";"250";"3";"1.2";"247";"98,80%";"1.2";1.200
"MULTIPOLYGON (((-58.4920108655443 -34.5936307700538,-58.4931432611468 -34.5943296047814,-58.4942798496675 -34.5950309631409,-58.4949760171481 -34.5942625114672,-58.4956518677147 -34.5934952613671,-58.4957200512314 -34.5934291877322,-58.4958125418875 -34.5933391524733,-58.4958385898875 -34.5933104118767,-58.4952251375013 -34.5932219818812,-58.4951321360789 -34.593208555399,-58.4942766436785 -34.5930851833394,-58.4927083184823 -34.5928590208393,-58.4926454558294 -34.5928204432085,-58.4909929488682 -34.5928005138587,-58.4909597665339 -34.5927975723793,-58.4906296026683 -34.592778375722,-58.4907014875753 -34.5928227358076,-58.4908657121067 -34.5929241104683,-58.4910005351876 -34.5930032782488,-58.4920108655443 -34.5936307700538)))";;"1727";15_6_5;COMUNA 15;"6";"5";"526";"247";"279";"88,53%";"233";"233";"100,00%";"0";"0,00%";"192";"4";"2.08";"188";"97,92%";"2.08";2.080
"MULTIPOLYGON (((-58.4797472749255 -34.5992762767636,-58.4803223590066 -34.5990285094817,-58.48078026076 -34.5988311813768,-58.4821273837689 -34.5982507406932,-58.4829152619249 -34.5979112334022,-58.4830370154053 -34.5977712781813,-58.4832726441382 -34.5976674318495,-58.4832095112133 -34.5975657483989,-58.4842326468866 -34.5963966535329,-58.4847055549498 -34.5966779885634,-58.484751295677 -34.5967051644614,-58.485815657742 -34.5966002451009,-58.4863699800148 -34.5965457001005,-58.4869077800605 -34.5964927052165,-58.4870237704946 -34.5964793717745,-58.4876763688088 -34.5964169840046,-58.4877139986705 -34.5963739464537,-58.4880550494203 -34.5959837904545,-58.48840113482 -34.5961894302927,-58.490186189137 -34.5972500684051,-58.4912175193545 -34.5971808854079,-58.4924899440056 -34.5970954600485,-58.4929088631432 -34.5970674458697,-58.4931292380872 -34.5967439278589,-58.4942798496675 -34.5950309631409,-58.4931432611468 -34.5943296047814,-58.4920108655443 -34.5936307700538,-58.4910005351876 -34.5930032782488,-58.4908657121067 -34.5929241104683,-58.4907014875753 -34.5928227358076,-58.4904592033461 -34.5928187769179,-58.4893963006673 -34.5927910552188,-58.4886642504461 -34.5927687474917,-58.4874721579506 -34.5927342756208,-58.4863250322651 -34.5927030229722,-58.4856210879683 -34.5926853396159,-58.4848796723953 -34.5926645603009,-58.4841344249544 -34.5926437771544,-58.4834482804041 -34.5926268528148,-58.48271342343 -34.5926067634763,-58.4821069897167 -34.5925890438179,-58.4815342802448 -34.5925728653027,-58.4808959117706 -34.5925551445504,-58.4802838578841 -34.5925358673127,-58.4795892845586 -34.5925212465248,-58.4789640316109 -34.5925034434252,-58.4783388643927 -34.5924872568934,-58.4777286851226 -34.5924679665998,-58.4771071805796 -34.592453322664,-58.4765419671286 -34.5924371198339,-58.4763066673616 -34.5924301741894,-58.4761489494594 -34.592426740832,-58.4761921447241 -34.5925434308225,-58.4762056920289 -34.5925851915393,-58.476708887026 -34.5939900493737,-58.4771157306048 -34.5951149757006,-58.4775887710502 -34.5963386075359,-58.4776384363514 -34.5964617562363,-58.4776951974021 -34.5966054298367,-58.4777838911427 -34.5968531945607,-58.4778797487966 -34.5970880585475,-58.4783477119155 -34.5983424846161,-58.4785613338864 -34.5989176200578,-58.4786065137603 -34.5991341013832,-58.4788312891424 -34.599670923493,-58.4797472749255 -34.5992762767636)))";;"1728";15_6_6;COMUNA 15;"6";"6";"516";"243";"273";"89,01%";"188";"188";"100,00%";"0";"0,00%";"183";"0";"0";"183";"100,00%";"0";0.000
"MULTIPOLYGON (((-58.48840113482 -34.5961894302927,-58.4880550494203 -34.5959837904545,-58.4877139986705 -34.5963739464537,-58.4876763688088 -34.5964169840046,-58.4870237704946 -34.5964793717745,-58.4869077800605 -34.5964927052165,-58.4863699800148 -34.5965457001005,-58.485815657742 -34.5966002451009,-58.484751295677 -34.5967051644614,-58.4847055549498 -34.5966779885634,-58.4842326468866 -34.5963966535329,-58.4832095112133 -34.5975657483989,-58.4832726441382 -34.5976674318495,-58.4830370154053 -34.5977712781813,-58.4848534848842 -34.5976347594716,-58.4848551523516 -34.5976346231837,-58.4861305197001 -34.5975374045113,-58.4864869309628 -34.5975112077831,-58.4866811047486 -34.5974969438747,-58.4871433743308 -34.5974629071753,-58.4873536438493 -34.5974474417419,-58.4877982844636 -34.5974162935576,-58.4885444896067 -34.5973639526769,-58.4895267678338 -34.5972965549806,-58.490186189137 -34.5972500684051,-58.48840113482 -34.5961894302927)))";;"1729";15_6_7;COMUNA 15;"6";"7";"656";"297";"359";"82,73%";"299";"299";"100,00%";"0";"0,00%";"255";"0";"0";"255";"100,00%";"0";0.000
"MULTIPOLYGON (((-58.4702308224086 -34.5879335488737,-58.4692116532658 -34.5887365271562,-58.4688952291434 -34.5889857789937,-58.4681906762966 -34.5895409054113,-58.4680767411968 -34.5896306323877,-58.4678926393022 -34.5897761391427,-58.4676611911425 -34.5899590434123,-58.4671179907636 -34.5903883772151,-58.4669576438223 -34.5905150781121,-58.4668758940272 -34.590564308253,-58.4668275193891 -34.5905935490001,-58.4667711641284 -34.5906276136994,-58.4667701300891 -34.5906280467629,-58.4668536745516 -34.5907036103416,-58.4669015354674 -34.5907368494651,-58.467287751546 -34.5911150900614,-58.467350517301 -34.5911763577298,-58.4677161252671 -34.5914956517222,-58.4677751439379 -34.591546073821,-58.4678707832208 -34.591626636387,-58.4680319978317 -34.5917398029578,-58.4683038394269 -34.5919088115701,-58.4683863621437 -34.5919477529596,-58.4684697365677 -34.5919871168049,-58.4688109835462 -34.5921297114818,-58.468839091785 -34.5922025298583,-58.4692786992126 -34.5923273006275,-58.4696435314649 -34.5923859447094,-58.4697803005594 -34.5924014304221,-58.4697584002593 -34.5922353687759,-58.4697506457049 -34.5921766345025,-58.4711224126997 -34.5922254227138,-58.4729434882181 -34.5922796517927,-58.4732366109955 -34.5922849791608,-58.474033969844 -34.5922993449025,-58.474301970365 -34.592304179065,-58.4743324978292 -34.5923027142683,-58.4761235903793 -34.5923549614464,-58.4760162953983 -34.5920564590216,-58.4759500114005 -34.5918713884745,-58.4758758077803 -34.5916859666144,-58.4758796908482 -34.5916787534283,-58.4757584969365 -34.5913932211149,-58.4757241642846 -34.591307517151,-58.4750331011668 -34.5907684125537,-58.4740599727122 -34.5900093217848,-58.4732193797626 -34.5893535962347,-58.4730860954371 -34.5892493781193,-58.472896346833 -34.5891010783111,-58.4721174307698 -34.5884923136238,-58.471893449793 -34.5883172532336,-58.4712347127034 -34.5878023507482,-58.4711162505856 -34.5876996787753,-58.4708194583523 -34.58744764645,-58.4702308224086 -34.5879335488737)))";;"1730";15_7_1;COMUNA 15;"7";"1";"900";"446";"454";"98,24%";"330";"329";"99,70%";"1";"0,30%";"300";"14";"4.67";"286";"95,33%";"4.67";4.670
"MULTIPOLYGON (((-58.4703101513616 -34.6015421760998,-58.4691344872454 -34.6018090144794,-58.4689122822032 -34.6018603659761,-58.4692921652885 -34.602165075938,-58.4701945190696 -34.6028061045093,-58.4704341176867 -34.6029375029852,-58.4715483890813 -34.6027067847294,-58.4725256178219 -34.6025044487605,-58.4733940818136 -34.6023246506066,-58.4731009194378 -34.6009183547965,-58.4722094755277 -34.6011140687975,-58.4720066919426 -34.6011571142435,-58.4712630946781 -34.6013258370979,-58.4703101513616 -34.6015421760998)))";;"1731";15_7_10;COMUNA 15;"7";"10";"984";"480";"504";"95,24%";"447";"447";"100,00%";"0";"0,00%";"379";"54";"14.25";"325";"85,75%";"14.25";14.250
"MULTIPOLYGON (((-58.4718035259388 -34.6039416013666,-58.4726492644898 -34.6044675410562,-58.4729835082192 -34.604674352105,-58.4730386194089 -34.6047084332354,-58.4740166585734 -34.6053111155374,-58.4736425958029 -34.6035167159606,-58.4733940818136 -34.6023246506066,-58.4725256178219 -34.6025044487605,-58.4715483890813 -34.6027067847294,-58.4704341176867 -34.6029375029852,-58.4716096608952 -34.6038210477504,-58.4717100856447 -34.6038835075204,-58.4718035259388 -34.6039416013666)))";;"1732";15_7_11;COMUNA 15;"7";"11";"891";"406";"485";"83,71%";"382";"382";"100,00%";"0";"0,00%";"329";"5";"1.52";"324";"98,48%";"1.52";1.520
"MULTIPOLYGON (((-58.4769714632744 -34.6015839043735,-58.4767867362258 -34.601622166732,-58.4761904814571 -34.6017456190886,-58.4752736543437 -34.6019355129603,-58.4743351903791 -34.6021298387911,-58.4733940818136 -34.6023246506066,-58.4736425958029 -34.6035167159606,-58.4740166585734 -34.6053111155374,-58.4749324498392 -34.6041740126235,-58.4757052403253 -34.6032096709656,-58.4757363218796 -34.6031708633645,-58.4763816195979 -34.6023656917925,-58.4769714632744 -34.6015839043735)))";;"1733";15_7_12;COMUNA 15;"7";"12";"971";"475";"496";"95,77%";"361";"361";"100,00%";"0";"0,00%";"348";"4";"1.15";"344";"98,85%";"1.15";1.150
"MULTIPOLYGON (((-58.4665923236826 -34.5907351695108,-58.4665306703955 -34.5907722856172,-58.4663188861958 -34.5909082834158,-58.466116298254 -34.5910384352836,-58.4659776627481 -34.5911292877729,-58.465952967203 -34.5911454862614,-58.465028074699 -34.5919363839057,-58.4644091423089 -34.5924672602501,-58.4643818074555 -34.5925514893154,-58.4644405724316 -34.5927483976881,-58.4646791270122 -34.5935475805267,-58.4648267248386 -34.5940422454034,-58.4650255761036 -34.5947213971342,-58.4651070821095 -34.5949909747845,-58.465202173873 -34.5953307550103,-58.4652904604312 -34.595207196029,-58.4653957262345 -34.5951032934255,-58.4661057009703 -34.5942919445367,-58.4667080253419 -34.5936739441866,-58.4670828874989 -34.5932893386752,-58.467983666628 -34.5923651819684,-58.4680922390539 -34.5922537643558,-58.4683863621437 -34.5919477529596,-58.4683038394269 -34.5919088115701,-58.4680319978317 -34.5917398029578,-58.4678707832208 -34.591626636387,-58.4677751439379 -34.591546073821,-58.4677161252671 -34.5914956517222,-58.467350517301 -34.5911763577298,-58.467287751546 -34.5911150900614,-58.4669015354674 -34.5907368494651,-58.4668536745516 -34.5907036103416,-58.4667701300891 -34.5906280467629,-58.4665923236826 -34.5907351695108)))";;"1734";15_7_2;COMUNA 15;"7";"2";"705";"326";"379";"86,02%";"246";"246";"100,00%";"0";"0,00%";"244";"19";"7.79";"225";"92,21%";"7.79";7.790
"MULTIPOLYGON (((-58.4694531416323 -34.594849996118,-58.4703224529093 -34.5954222912605,-58.4706163708836 -34.5956158012369,-58.4705402930445 -34.595333119043,-58.4702287455461 -34.5941747129647,-58.4701214907039 -34.5937759714566,-58.4697803005594 -34.5924014304221,-58.4696435314649 -34.5923859447094,-58.4692786992126 -34.5923273006275,-58.468839091785 -34.5922025298583,-58.4688109835462 -34.5921297114818,-58.4684697365677 -34.5919871168049,-58.4683863621437 -34.5919477529596,-58.4680922390539 -34.5922537643558,-58.467983666628 -34.5923651819684,-58.4670828874989 -34.5932893386752,-58.4681705311073 -34.5940055201584,-58.4686812727046 -34.5943417770155,-58.4694531416323 -34.594849996118)))";;"1735";15_7_3;COMUNA 15;"7";"3";"647";"316";"331";"95,47%";"254";"254";"100,00%";"0";"0,00%";"230";"4";"1.74";"226";"98,26%";"1.74";1.740
"MULTIPOLYGON (((-58.4777284926517 -34.5999109326568,-58.4785428374752 -34.5997349778267,-58.4788312891424 -34.599670923493,-58.4786065137603 -34.5991341013832,-58.4785613338864 -34.5989176200578,-58.4783477119155 -34.5983424846161,-58.4778797487966 -34.5970880585475,-58.4777838911427 -34.5968531945607,-58.4776951974021 -34.5966054298367,-58.4776384363514 -34.5964617562363,-58.4775887710502 -34.5963386075359,-58.4771157306048 -34.5951149757006,-58.476708887026 -34.5939900493737,-58.4762056920289 -34.5925851915393,-58.4761921447241 -34.5925434308225,-58.4761489494594 -34.592426740832,-58.4761235903793 -34.5923549614464,-58.4743324978292 -34.5923027142683,-58.474301970365 -34.592304179065,-58.474033969844 -34.5922993449025,-58.4732366109955 -34.5922849791608,-58.4729434882181 -34.5922796517927,-58.4711224126997 -34.5922254227138,-58.4697506457049 -34.5921766345025,-58.4697584002593 -34.5922353687759,-58.4697803005594 -34.5924014304221,-58.4701214907039 -34.5937759714566,-58.4702287455461 -34.5941747129647,-58.4705402930445 -34.595333119043,-58.4706163708836 -34.5956158012369,-58.47060113151 -34.5956680577867,-58.4706525940326 -34.595915176766,-58.4704905419351 -34.5960780808962,-58.4704610778458 -34.5961076613915,-58.4703692777893 -34.5961845716014,-58.4703254257884 -34.5962683804318,-58.4704986535836 -34.5963032299969,-58.4704809465239 -34.5963799946801,-58.470524306564 -34.5965001374297,-58.4711660363665 -34.5983141085838,-58.4716187993713 -34.5984784488742,-58.4722975217354 -34.5987279844704,-58.4730756441042 -34.5990239885323,-58.4736334303514 -34.5992200741378,-58.4744696467058 -34.599517683847,-58.4744977536094 -34.5995285266198,-58.47488962764 -34.5996447601736,-58.4752898493466 -34.5997617662831,-58.4756161398487 -34.5998376505874,-58.4759114286294 -34.5999066357055,-58.4759376515807 -34.5998508560762,-58.4765648452489 -34.5999445224124,-58.4764035422443 -34.5999786968731,-58.4769147405461 -34.6000867411281,-58.4772643435182 -34.6000112040496,-58.4777284926517 -34.5999109326568)))";;"1736";15_7_4;COMUNA 15;"7";"4";"942";"459";"483";"95,03%";"241";"239";"99,17%";"2";"0,84%";"216";"41";"18.98";"175";"81,02%";"18.98";18.980
"MULTIPOLYGON (((-58.4654854429801 -34.5962495016434,-58.4655118469653 -34.5963386594405,-58.4655254748472 -34.5963845764069,-58.465618305171 -34.5964108428506,-58.4658575291977 -34.596321326367,-58.4664447386351 -34.5963218027369,-58.4671643784832 -34.5963141021756,-58.4680940334878 -34.5963002612686,-58.4690006938023 -34.5962868370202,-58.4701932505901 -34.5962690928725,-58.4703254257884 -34.5962683804318,-58.4703692777893 -34.5961845716014,-58.4704610778458 -34.5961076613915,-58.4704905419351 -34.5960780808962,-58.4706525940326 -34.595915176766,-58.47060113151 -34.5956680577867,-58.4706163708836 -34.5956158012369,-58.4703224529093 -34.5954222912605,-58.4694531416323 -34.594849996118,-58.4686812727046 -34.5943417770155,-58.4681705311073 -34.5940055201584,-58.4670828874989 -34.5932893386752,-58.4667080253419 -34.5936739441866,-58.4661057009703 -34.5942919445367,-58.4653957262345 -34.5951032934255,-58.4652904604312 -34.595207196029,-58.465202173873 -34.5953307550103,-58.46545469519 -34.5961458363296,-58.4654854429801 -34.5962495016434)))";;"1737";15_7_5;COMUNA 15;"7";"5";"888";"448";"440";"101,82%";"330";"329";"99,70%";"1";"0,30%";"293";"21";"7.17";"272";"92,83%";"7.17";7.170
"MULTIPOLYGON (((-58.4694538382939 -34.599248547151,-58.4699932790195 -34.599130553816,-58.4699633787778 -34.5990560456891,-58.4700983666413 -34.5990296985371,-58.4703571104233 -34.5990901778617,-58.4704330800609 -34.5990940464594,-58.4704780452411 -34.5990598873571,-58.4705061466885 -34.5990196023215,-58.4705699448799 -34.5991033338415,-58.4715588521416 -34.5993761638762,-58.471665313884 -34.5993965089957,-58.4724532174883 -34.5995464543275,-58.4731378979285 -34.5996771069257,-58.4733555073503 -34.5997186390081,-58.4736337582821 -34.5997727714011,-58.4737406470442 -34.5997943823246,-58.4755911495194 -34.6001554118914,-58.4761046471211 -34.6002616986633,-58.4763923362789 -34.6001995516651,-58.4769147405461 -34.6000867411281,-58.4764035422443 -34.5999786968731,-58.4765648452489 -34.5999445224124,-58.4759376515807 -34.5998508560762,-58.4759114286294 -34.5999066357055,-58.4756161398487 -34.5998376505874,-58.4752898493466 -34.5997617662831,-58.47488962764 -34.5996447601736,-58.4744977536094 -34.5995285266198,-58.4744696467058 -34.599517683847,-58.4736334303514 -34.5992200741378,-58.4730756441042 -34.5990239885323,-58.4722975217354 -34.5987279844704,-58.4716187993713 -34.5984784488742,-58.4711660363665 -34.5983141085838,-58.470524306564 -34.5965001374297,-58.4704809465239 -34.5963799946801,-58.4704986535836 -34.5963032299969,-58.4703254257884 -34.5962683804318,-58.4701932505901 -34.5962690928725,-58.4690006938023 -34.5962868370202,-58.4680940334878 -34.5963002612686,-58.4671643784832 -34.5963141021756,-58.4664447386351 -34.5963218027369,-58.4658575291977 -34.596321326367,-58.465618305171 -34.5964108428506,-58.4655254748472 -34.5963845764069,-58.4656172522911 -34.5967012393789,-58.4656202846161 -34.5967075076409,-58.4659419842421 -34.5977883529477,-58.4659585938089 -34.5978444814383,-58.4662413004634 -34.5987970455628,-58.466302970391 -34.5990050095162,-58.4664698387414 -34.5995732657686,-58.4665051027295 -34.5996719304355,-58.4665759716843 -34.599870456952,-58.4667257809136 -34.5998384086184,-58.4681339308872 -34.5995363001841,-58.4683348388366 -34.5994931908242,-58.4694538382939 -34.599248547151)))";;"1738";15_7_6;COMUNA 15;"7";"6";"1031";"508";"523";"97,13%";"327";"327";"100,00%";"0";"0,00%";"321";"148";"46.11";"173";"53,89%";"46.11";46.110
"MULTIPOLYGON (((-58.4699083976377 -34.6004694834832,-58.4685680324269 -34.6007645665857,-58.4681339308872 -34.5995363001841,-58.4667257809136 -34.5998384086184,-58.4665759716843 -34.599870456952,-58.466623842494 -34.6000046154975,-58.4669660202132 -34.6011137309504,-58.4670069083837 -34.6012464106325,-58.4673340151915 -34.6022495354184,-58.467492941229 -34.6022101615869,-58.4687660474554 -34.6018941070111,-58.4689122822032 -34.6018603659761,-58.4691344872454 -34.6018090144794,-58.4703101513616 -34.6015421760998,-58.4699083976377 -34.6004694834832)))";;"1739";15_7_7;COMUNA 15;"7";"7";"1024";"480";"544";"88,24%";"407";"405";"99,51%";"2";"0,49%";"351";"39";"11.11";"312";"88,89%";"11.11";11.110
"MULTIPOLYGON (((-58.4699083976377 -34.6004694834832,-58.4703101513616 -34.6015421760998,-58.4712630946781 -34.6013258370979,-58.4720066919426 -34.6011571142435,-58.4722094755277 -34.6011140687975,-58.4731009194378 -34.6009183547965,-58.4739513940818 -34.6007316524907,-58.4749031274094 -34.6005226797947,-58.4752996602609 -34.60043559391,-58.4758488946868 -34.6003170102978,-58.4761046471211 -34.6002616986633,-58.4755911495194 -34.6001554118914,-58.4737406470442 -34.5997943823246,-58.4736337582821 -34.5997727714011,-58.4733555073503 -34.5997186390081,-58.4731378979285 -34.5996771069257,-58.4724532174883 -34.5995464543275,-58.471665313884 -34.5993965089957,-58.4715588521416 -34.5993761638762,-58.4705699448799 -34.5991033338415,-58.4705061466885 -34.5990196023215,-58.4704780452411 -34.5990598873571,-58.4704330800609 -34.5990940464594,-58.4703571104233 -34.5990901778617,-58.4700983666413 -34.5990296985371,-58.4699633787778 -34.5990560456891,-58.4699932790195 -34.599130553816,-58.4694538382939 -34.599248547151,-58.4683348388366 -34.5994931908242,-58.4681339308872 -34.5995363001841,-58.4685680324269 -34.6007645665857,-58.4699083976377 -34.6004694834832)))";;"1740";15_7_8;COMUNA 15;"7";"8";"980";"466";"514";"90,66%";"326";"325";"99,69%";"1";"0,31%";"328";"1";"0.3";"327";"99,70%";"0.3";0.300
"MULTIPOLYGON (((-58.4739513940818 -34.6007316524907,-58.4731009194378 -34.6009183547965,-58.4733940818136 -34.6023246506066,-58.4743351903791 -34.6021298387911,-58.4752736543437 -34.6019355129603,-58.4761904814571 -34.6017456190886,-58.4767867362258 -34.601622166732,-58.4769714632744 -34.6015839043735,-58.4774987858523 -34.6008250802265,-58.4767320205023 -34.6003916331075,-58.4764557546868 -34.6002388990073,-58.4764033590396 -34.6002003979251,-58.4761046471211 -34.6002616986633,-58.4758488946868 -34.6003170102978,-58.4752996602609 -34.60043559391,-58.4749031274094 -34.6005226797947,-58.4739513940818 -34.6007316524907)))";;"1741";15_7_9;COMUNA 15;"7";"9";"801";"388";"413";"93,95%";"313";"313";"100,00%";"0";"0,00%";"283";"7";"2.47";"276";"97,53%";"2.47";2.470
"MULTIPOLYGON (((-58.4656202846161 -34.5967075076409,-58.4656172522911 -34.5967012393789,-58.4655323513758 -34.5966435727015,-58.4654504837124 -34.596617247569,-58.4653399083937 -34.5966119133542,-58.4652969851295 -34.596605716851,-58.46527109491 -34.5966019848597,-58.4651614018675 -34.5965761410456,-58.4646140455398 -34.5964785414262,-58.4638637439545 -34.596429394045,-58.4640701086406 -34.5970852624725,-58.4633345370509 -34.5972387955999,-58.4626010918952 -34.5973918313144,-58.4629329852414 -34.5984394068731,-58.4616193706028 -34.5987192018376,-58.4614773116492 -34.5987492016535,-58.4615232998487 -34.5988898413288,-58.4618008499343 -34.5997855823612,-58.4619829395854 -34.5997469905364,-58.4632649720203 -34.5994767696884,-58.4645555128556 -34.5992046337482,-58.464725080395 -34.5991677986486,-58.464900439134 -34.5991296955545,-58.4662413004634 -34.5987970455628,-58.4659585938089 -34.5978444814383,-58.4659419842421 -34.5977883529477,-58.4656202846161 -34.5967075076409)))";;"1742";15_8_1;COMUNA 15;"8";"1";"974";"473";"501";"94,41%";"336";"336";"100,00%";"0";"0,00%";"336";"31";"9.23";"305";"90,77%";"9.23";9.230
"MULTIPOLYGON (((-58.4655111757749 -34.6016947812023,-58.4650965072555 -34.6025396813115,-58.4649457629742 -34.6028430759609,-58.4652785241911 -34.6027589112645,-58.465796955897 -34.602630373209,-58.4660827016225 -34.6025595882901,-58.4673340151915 -34.6022495354184,-58.4670069083837 -34.6012464106325,-58.4669660202132 -34.6011137309504,-58.466623842494 -34.6000046154975,-58.4665759716843 -34.599870456952,-58.4663865595084 -34.5999109573329,-58.4656608938465 -34.6013901885935,-58.46543247026 -34.6014375900952,-58.4654742079711 -34.6015739323762,-58.4655111757749 -34.6016947812023)))";;"1743";15_8_10;COMUNA 15;"8";"10";"888";"393";"495";"79,39%";"467";"467";"100,00%";"0";"0,00%";"382";"3";"0.79";"379";"99,21%";"0.79";0.790
"MULTIPOLYGON (((-58.4626010918952 -34.5973918313144,-58.4633345370509 -34.5972387955999,-58.4640701086406 -34.5970852624725,-58.4638637439545 -34.596429394045,-58.4637678485472 -34.5964274230141,-58.4624802442182 -34.59650419104,-58.4623220933132 -34.5965110219045,-58.4615048521402 -34.5965466518265,-58.4610085113163 -34.5965771401002,-58.4607717528887 -34.5965907990921,-58.459275403754 -34.5966774597858,-58.4592082079774 -34.5966936556945,-58.4582467689335 -34.5969260982203,-58.4579383816939 -34.5970005965129,-58.4578298789342 -34.5970394669799,-58.4582197829777 -34.5983000236945,-58.4585515385264 -34.5993724006937,-58.4586986245764 -34.5993404325452,-58.4600130252965 -34.5990605986441,-58.4613221368256 -34.598781877316,-58.4614773116492 -34.5987492016535,-58.4616193706028 -34.5987192018376,-58.4629329852414 -34.5984394068731,-58.4626010918952 -34.5973918313144)))";;"1744";15_8_2;COMUNA 15;"8";"2";"720";"352";"368";"95,65%";"249";"249";"100,00%";"0";"0,00%";"237";"20";"8.44";"217";"91,56%";"8.44";8.440
"MULTIPOLYGON (((-58.4600130252965 -34.5990605986441,-58.4586986245764 -34.5993404325452,-58.4585515385264 -34.5993724006937,-58.4588721471517 -34.6004087185352,-58.4589101268125 -34.6005315413224,-58.4591538468431 -34.6013113671665,-58.4591942117982 -34.6014409507375,-58.4606571802676 -34.601129774949,-58.4607954109334 -34.6011003394417,-58.4621209043436 -34.600819004159,-58.4622790635657 -34.600785411974,-58.4634124916689 -34.6005434295361,-58.4635849581761 -34.600506877713,-58.4633067904044 -34.5996169861426,-58.4632649720203 -34.5994767696884,-58.4619829395854 -34.5997469905364,-58.4618008499343 -34.5997855823612,-58.4615232998487 -34.5988898413288,-58.4614773116492 -34.5987492016535,-58.4613221368256 -34.598781877316,-58.4600130252965 -34.5990605986441)))";;"1745";15_8_3;COMUNA 15;"8";"3";"1008";"451";"557";"80,97%";"444";"444";"100,00%";"0";"0,00%";"373";"18";"4.83";"355";"95,17%";"4.83";4.830
"MULTIPOLYGON (((-58.456564970688 -34.598657500727,-58.4565820856018 -34.598707080963,-58.4568992613058 -34.5997316429129,-58.456985090764 -34.6000220806408,-58.4572132930704 -34.6007633870985,-58.457251355569 -34.600886985076,-58.4575325280211 -34.6017944262699,-58.4591942117982 -34.6014409507375,-58.4591538468431 -34.6013113671665,-58.4589101268125 -34.6005315413224,-58.4588721471517 -34.6004087185352,-58.4585515385264 -34.5993724006937,-58.4582197829777 -34.5983000236945,-58.4578298789342 -34.5970394669799,-58.4576143209653 -34.5971165034314,-58.4570733381926 -34.5973024728184,-58.4564940274615 -34.5975015369572,-58.4562363942665 -34.5975900481394,-58.456564970688 -34.598657500727)))";;"1746";15_8_4;COMUNA 15;"8";"4";"942";"433";"509";"85,07%";"370";"370";"100,00%";"0";"0,00%";"330";"37";"11.21";"293";"88,79%";"11.21";11.210
"MULTIPOLYGON (((-58.4579180218086 -34.6030386441329,-58.4581629317192 -34.6038291058859,-58.4582775693629 -34.6039069299309,-58.4589348227102 -34.6043736597031,-58.4600209545276 -34.6040951567711,-58.459581261888 -34.6026831915577,-58.4595442169879 -34.6025643832836,-58.4591942117982 -34.6014409507375,-58.4575325280211 -34.6017944262699,-58.4579180218086 -34.6030386441329)))";;"1747";15_8_5;COMUNA 15;"8";"5";"749";"341";"408";"83,58%";"324";"324";"100,00%";"0";"0,00%";"285";"22";"7.72";"263";"92,28%";"7.72";7.720
"MULTIPOLYGON (((-58.4610460392885 -34.6023717295162,-58.4609283328485 -34.6023965879624,-58.459581261888 -34.6026831915577,-58.4600209545276 -34.6040951567711,-58.4601240140233 -34.6040687495447,-58.4605391472324 -34.6039623451416,-58.4614694028875 -34.6037253773009,-58.4615883035222 -34.6036950956092,-58.4621085353709 -34.6035625590252,-58.4629111950198 -34.6033581159325,-58.4627181106169 -34.6027352756397,-58.4625407855313 -34.6021632820017,-58.4625107205779 -34.6020620105047,-58.4610460392885 -34.6023717295162)))";;"1748";15_8_6;COMUNA 15;"8";"6";"720";"324";"396";"81,82%";"324";"324";"100,00%";"0";"0,00%";"260";"5";"1.92";"255";"98,08%";"1.92";1.920
"MULTIPOLYGON (((-58.4635849581761 -34.600506877713,-58.4634124916689 -34.6005434295361,-58.4622790635657 -34.600785411974,-58.4621209043436 -34.600819004159,-58.4607954109334 -34.6011003394417,-58.4606571802676 -34.601129774949,-58.4591942117982 -34.6014409507375,-58.4595442169879 -34.6025643832836,-58.459581261888 -34.6026831915577,-58.4609283328485 -34.6023965879624,-58.4610460392885 -34.6023717295162,-58.4625107205779 -34.6020620105047,-58.4626433308899 -34.6020339109787,-58.4638049662115 -34.6017924179311,-58.4639730913979 -34.6017521330696,-58.463629417875 -34.6006492067705,-58.4635849581761 -34.600506877713)))";;"1749";15_8_7;COMUNA 15;"8";"7";"996";"462";"534";"86,52%";"449";"447";"99,55%";"2";"0,45%";"357";"8";"2.24";"349";"97,76%";"2.24";2.240
"MULTIPOLYGON (((-58.4662413004634 -34.5987970455628,-58.464900439134 -34.5991296955545,-58.464725080395 -34.5991677986486,-58.4645555128556 -34.5992046337482,-58.4632649720203 -34.5994767696884,-58.4633067904044 -34.5996169861426,-58.4635849581761 -34.600506877713,-58.463629417875 -34.6006492067705,-58.4639730913979 -34.6017521330696,-58.4640938620747 -34.6017231869861,-58.4652743110475 -34.6014704116865,-58.46543247026 -34.6014375900952,-58.4656608938465 -34.6013901885935,-58.4663865595084 -34.5999109573329,-58.4665759716843 -34.599870456952,-58.4665051027295 -34.5996719304355,-58.4664698387414 -34.5995732657686,-58.466302970391 -34.5990050095162,-58.4662413004634 -34.5987970455628)))";;"1750";15_8_8;COMUNA 15;"8";"8";"931";"434";"497";"87,32%";"361";"361";"100,00%";"0";"0,00%";"323";"26";"8.05";"297";"91,95%";"8.05";8.050
"MULTIPOLYGON (((-58.4655111757749 -34.6016947812023,-58.4654742079711 -34.6015739323762,-58.46543247026 -34.6014375900952,-58.4652743110475 -34.6014704116865,-58.4640938620747 -34.6017231869861,-58.4639730913979 -34.6017521330696,-58.4638049662115 -34.6017924179311,-58.4626433308899 -34.6020339109787,-58.4625107205779 -34.6020620105047,-58.4625407855313 -34.6021632820017,-58.4627181106169 -34.6027352756397,-58.4629111950198 -34.6033581159325,-58.4630730210854 -34.6033169168047,-58.4643593623198 -34.6029914712455,-58.4649457629742 -34.6028430759609,-58.4650965072555 -34.6025396813115,-58.4655111757749 -34.6016947812023)))";;"1751";15_8_9;COMUNA 15;"8";"9";"1025";"466";"559";"83,36%";"483";"482";"99,79%";"1";"0,21%";"433";"23";"5.31";"410";"94,69%";"5.31";5.310
"MULTIPOLYGON (((-58.4531101675082 -34.5861229086423,-58.4523756983482 -34.5869316139109,-58.4522059612047 -34.5871172407495,-58.4512368353492 -34.5881772667851,-58.4514209631238 -34.5883791424555,-58.4515757694264 -34.5883187427374,-58.4526154602623 -34.5879213218329,-58.4538959159196 -34.5874405564426,-58.4531101675082 -34.5861229086423)))";;"1752";15_9_1;COMUNA 15;"9";"1";"518";"239";"279";"85,66%";"291";"290";"99,66%";"1";"0,34%";"228";"0";"0";"228";"100,00%";"0";0.000
"MULTIPOLYGON (((-58.4507674660423 -34.5886906931597,-58.4503379582443 -34.5891117236567,-58.4495161538629 -34.5898894857066,-58.4491731701343 -34.5902141090356,-58.4502261810324 -34.5911624280252,-58.4513847164929 -34.5922058218039,-58.4514918353294 -34.5923015397056,-58.4523602051775 -34.5930777033957,-58.4532331807299 -34.5924334529949,-58.4523667683733 -34.5916553941164,-58.4532509709699 -34.5910025524954,-58.4524862451865 -34.5902827438774,-58.4523132095619 -34.5901385738773,-58.4522289235144 -34.5900682768826,-58.4524411581703 -34.5899010346993,-58.4528967956601 -34.5895407056133,-58.452926538689 -34.589344080401,-58.4531570785328 -34.589180148409,-58.45364660011 -34.5888320027134,-58.4543429775494 -34.5883366803521,-58.4545017798017 -34.5884832463169,-58.454999212819 -34.5881176301939,-58.455048696802 -34.5880275592538,-58.4554160275633 -34.5879889185448,-58.4555909873907 -34.5877564103897,-58.455634181015 -34.5875037817487,-58.4556342606729 -34.5875033158483,-58.4555660294432 -34.5873654334084,-58.4555181380029 -34.5872672561246,-58.4554410887932 -34.5871863006821,-58.4554405726303 -34.5871862579632,-58.4553640393572 -34.5871035071714,-58.4551160926827 -34.5869811873598,-58.4551152296754 -34.5869798809592,-58.4549308982095 -34.5866893686077,-58.4542457486364 -34.5856200848168,-58.4539648727513 -34.5851817373213,-58.4535154650768 -34.5856765836413,-58.4531101675082 -34.5861229086423,-58.4538959159196 -34.5874405564426,-58.4526154602623 -34.5879213218329,-58.4515757694264 -34.5883187427374,-58.4514209631238 -34.5883791424555,-58.4512368353492 -34.5881772667851,-58.4507682472379 -34.5886898386445,-58.450768122278 -34.5886899753325,-58.4507674660423 -34.5886906931597)))";;"1753";15_9_2;COMUNA 15;"9";"2";"495";"228";"267";"85,39%";"248";"248";"100,00%";"0";"0,00%";"209";"1";"0.48";"208";"99,52%";"0.48";0.480
"MULTIPOLYGON (((-58.4491731701343 -34.5902141090356,-58.4487487592147 -34.5906157674278,-58.44788885252 -34.5914295717332,-58.4475985794161 -34.5917026455972,-58.4473495290462 -34.5919368491697,-58.4467034752902 -34.5925355927286,-58.4466714502749 -34.5925652593803,-58.4467496067958 -34.592602933311,-58.4469052259806 -34.5926767761448,-58.4470543856403 -34.5927481895766,-58.447200609434 -34.5928176597526,-58.4473474206786 -34.5928876155015,-58.447494232258 -34.5929570853981,-58.447639869486 -34.5930265549724,-58.4477743493292 -34.5930901949091,-58.4479135272517 -34.5931567493157,-58.4480509436688 -34.5932223320016,-58.4481954071393 -34.593292286444,-58.4483334108835 -34.5933602972548,-58.4484720023189 -34.5934273366275,-58.4486123556347 -34.5934958330701,-58.4487409640405 -34.593558985584,-58.4488701599431 -34.5936221380283,-58.4490028796972 -34.5936862620805,-58.4491361868004 -34.5937513574027,-58.4492753667557 -34.5938188815992,-58.4493992781168 -34.593879604525,-58.4495226024306 -34.5939398415861,-58.4496476887609 -34.5940005643854,-58.4497851080059 -34.5940656594353,-58.4499219406058 -34.5941278402193,-58.4500634724469 -34.5941861359373,-58.4501732919037 -34.5942313150191,-58.4503118888596 -34.5942808679999,-58.4504322803884 -34.5943241052214,-58.4504769134479 -34.5943396512944,-58.4505482922678 -34.5943593261524,-58.4504364956761 -34.5942556702228,-58.449719358163 -34.5936103594002,-58.4506221693061 -34.5929436652304,-58.4514918353294 -34.5923015397056,-58.4513847164929 -34.5922058218039,-58.4502261810324 -34.5911624280252,-58.4491731701343 -34.5902141090356)))";;"1754";15_9_3;COMUNA 15;"9";"3";"517";"261";"256";"101,95%";"280";"280";"100,00%";"0";"0,00%";"230";"2";"0.87";"228";"99,13%";"0.87";0.870
"MULTIPOLYGON (((-58.4523602051775 -34.5930777033957,-58.4514918353294 -34.5923015397056,-58.4506221693061 -34.5929436652304,-58.449719358163 -34.5936103594002,-58.4504364956761 -34.5942556702228,-58.4505482922678 -34.5943593261524,-58.450596070073 -34.5944024986775,-58.4507466451822 -34.5945385595065,-58.4507616890164 -34.5945488125681,-58.4511209763001 -34.5946513159965,-58.4519257365755 -34.5948712574773,-58.4520278432399 -34.5949011971999,-58.4521187939231 -34.5949286709848,-58.4521811319042 -34.594939873996,-58.4522600752318 -34.5949629098463,-58.4523163651051 -34.5949867183982,-58.4524853240639 -34.5950256074199,-58.452955836464 -34.5951481154808,-58.4531244545296 -34.5951945390955,-58.4532173648521 -34.5952202515819,-58.4534385276742 -34.5952791441103,-58.453494819076 -34.595294078531,-58.4536431007067 -34.5951833810697,-58.4542275360346 -34.5947469270759,-58.4532938187034 -34.5939121780093,-58.45315510388 -34.5937881482735,-58.4523602051775 -34.5930777033957)))";;"1755";15_9_4;COMUNA 15;"9";"4";"734";"374";"360";"103,89%";"279";"279";"100,00%";"0";"0,00%";"253";"30";"11.86";"223";"88,14%";"11.86";11.860
"MULTIPOLYGON (((-58.4550963413474 -34.5941063957749,-58.4559188024075 -34.5935027585166,-58.455775997299 -34.5933704213373,-58.4556725341292 -34.5932745665724,-58.4550049256574 -34.5926559103176,-58.4540954118365 -34.5917971535853,-58.4539446085016 -34.5916554470929,-58.4532509709699 -34.5910025524954,-58.4523667683733 -34.5916553941164,-58.4532331807299 -34.5924334529949,-58.4523602051775 -34.5930777033957,-58.45315510388 -34.5937881482735,-58.4532938187034 -34.5939121780093,-58.4542275360346 -34.5947469270759,-58.4543500094317 -34.5946558051837,-58.454965863879 -34.5942021659875,-58.4550963413474 -34.5941063957749)))";;"1756";15_9_5;COMUNA 15;"9";"5";"760";"375";"385";"97,40%";"296";"296";"100,00%";"0";"0,00%";"249";"13";"5.22";"236";"94,78%";"5.22";5.220
"MULTIPOLYGON (((-58.457363061161 -34.5961297641769,-58.4575258075479 -34.5961725193312,-58.4579129603939 -34.5962492986876,-58.4580498181166 -34.5962771923901,-58.4582728620046 -34.5963128358769,-58.4583994151616 -34.5963384047785,-58.4587274687661 -34.5963430639674,-58.4589364619097 -34.5963577190499,-58.4576926186983 -34.5951842482568,-58.4575642849511 -34.5950632522715,-58.4568077454707 -34.5943441758058,-58.4560266943006 -34.5936017824504,-58.4559188024075 -34.5935027585166,-58.4550963413474 -34.5941063957749,-58.454965863879 -34.5942021659875,-58.4543500094317 -34.5946558051837,-58.4542275360346 -34.5947469270759,-58.4536431007067 -34.5951833810697,-58.453747933855 -34.5952109250941,-58.4541556006198 -34.595312507588,-58.4547058285275 -34.5954529024748,-58.4549448774663 -34.5955110187633,-58.4551348734153 -34.5955580747817,-58.4552160326605 -34.5955782214181,-58.4553209521997 -34.595603369635,-58.4558638617921 -34.595720518507,-58.4557326339094 -34.5956042389382,-58.4559004034923 -34.5956422076311,-58.4559885416994 -34.5957213001061,-58.4560559954671 -34.5956717243965,-58.4561553793875 -34.5957011675364,-58.4560616081473 -34.5957739822158,-58.4562040858927 -34.5957942019401,-58.4565949799252 -34.5959128182999,-58.4566944496087 -34.5959405707972,-58.4568012434568 -34.5959686052686,-58.4571489615828 -34.5960763722626,-58.457363061161 -34.5961297641769)))";;"1757";15_9_6;COMUNA 15;"9";"6";"612";"296";"316";"93,67%";"260";"260";"100,00%";"0";"0,00%";"213";"22";"10.33";"191";"89,67%";"10.33";10.330
"MULTIPOLYGON (((-58.4559205056793 -34.5976953167662,-58.4560576263124 -34.597651519794,-58.4562363942665 -34.5975900481394,-58.4564940274615 -34.5975015369572,-58.4570733381926 -34.5973024728184,-58.4576143209653 -34.5971165034314,-58.4578298789342 -34.5970394669799,-58.4579383816939 -34.5970005965129,-58.4582467689335 -34.5969260982203,-58.4592082079774 -34.5966936556945,-58.459275403754 -34.5966774597858,-58.4590483635306 -34.5964632195151,-58.4589631172924 -34.5963828616932,-58.4589364619097 -34.5963577190499,-58.4587274687661 -34.5963430639674,-58.4583994151616 -34.5963384047785,-58.4582728620046 -34.5963128358769,-58.4580498181166 -34.5962771923901,-58.4579129603939 -34.5962492986876,-58.4575258075479 -34.5961725193312,-58.457363061161 -34.5961297641769,-58.4571489615828 -34.5960763722626,-58.4568012434568 -34.5959686052686,-58.4566944496087 -34.5959405707972,-58.4565949799252 -34.5959128182999,-58.4562040858927 -34.5957942019401,-58.4560616081473 -34.5957739822158,-58.4561553793875 -34.5957011675364,-58.4560559954671 -34.5956717243965,-58.4559885416994 -34.5957213001061,-58.4559004034923 -34.5956422076311,-58.4557326339094 -34.5956042389382,-58.4558638617921 -34.595720518507,-58.4553209521997 -34.595603369635,-58.4552160326605 -34.5955782214181,-58.4551348734153 -34.5955580747817,-58.4549448774663 -34.5955110187633,-58.4547058285275 -34.5954529024748,-58.4541556006198 -34.595312507588,-58.453747933855 -34.5952109250941,-58.4536431007067 -34.5951833810697,-58.453494819076 -34.595294078531,-58.4534385276742 -34.5952791441103,-58.4532173648521 -34.5952202515819,-58.4531244545296 -34.5951945390955,-58.452955836464 -34.5951481154808,-58.4524853240639 -34.5950256074199,-58.4523163651051 -34.5949867183982,-58.4522600752318 -34.5949629098463,-58.4521811319042 -34.594939873996,-58.4521187939231 -34.5949286709848,-58.4520278432399 -34.5949011971999,-58.4519257365755 -34.5948712574773,-58.4511209763001 -34.5946513159965,-58.4507616890164 -34.5945488125681,-58.4513308622898 -34.594947614949,-58.451704523576 -34.5952094904261,-58.4518865012249 -34.5953369764624,-58.4520837222899 -34.5954757315978,-58.4526072639422 -34.5958441002652,-58.4528200717656 -34.5959886303604,-58.4536552154872 -34.5965556890371,-58.4537674542423 -34.5966342214862,-58.4538163352199 -34.5966684517378,-58.4547948148826 -34.5973527005479,-58.4554841033996 -34.5978347337578,-58.4559205056793 -34.5976953167662)))";;"1758";15_9_7;COMUNA 15;"9";"7";"730";"362";"368";"98,37%";"332";"332";"100,00%";"0";"0,00%";"270";"40";"14.81";"230";"85,19%";"14.81";14.810
"MULTIPOLYGON (((-58.45364660011 -34.5888320027134,-58.4531570785328 -34.589180148409,-58.452926538689 -34.589344080401,-58.4528967956601 -34.5895407056133,-58.4524411581703 -34.5899010346993,-58.4522289235144 -34.5900682768826,-58.4523132095619 -34.5901385738773,-58.4524862451865 -34.5902827438774,-58.4532509709699 -34.5910025524954,-58.4539446085016 -34.5916554470929,-58.4540954118365 -34.5917971535853,-58.4550049256574 -34.5926559103176,-58.4556725341292 -34.5932745665724,-58.455775997299 -34.5933704213373,-58.4559188024075 -34.5935027585166,-58.4560266943006 -34.5936017824504,-58.4568077454707 -34.5943441758058,-58.4575642849511 -34.5950632522715,-58.4576926186983 -34.5951842482568,-58.4589364619097 -34.5963577190499,-58.4589631172924 -34.5963828616932,-58.4590483635306 -34.5964632195151,-58.459275403754 -34.5966774597858,-58.4607717528887 -34.5965907990921,-58.4610085113163 -34.5965771401002,-58.4615048521402 -34.5965466518265,-58.4623220933132 -34.5965110219045,-58.4624802442182 -34.59650419104,-58.4637678485472 -34.5964274230141,-58.4638637439545 -34.596429394045,-58.4646140455398 -34.5964785414262,-58.4651614018675 -34.5965761410456,-58.46527109491 -34.5966019848597,-58.4652969851295 -34.596605716851,-58.4653399083937 -34.5966119133542,-58.4654504837124 -34.596617247569,-58.4655323513758 -34.5966435727015,-58.4656172522911 -34.5967012393789,-58.4655254748472 -34.5963845764069,-58.4655118469653 -34.5963386594405,-58.4654854429801 -34.5962495016434,-58.46545469519 -34.5961458363296,-58.465202173873 -34.5953307550103,-58.4651070821095 -34.5949909747845,-58.4650255761036 -34.5947213971342,-58.4648267248386 -34.5940422454034,-58.4646791270122 -34.5935475805267,-58.4644405724316 -34.5927483976881,-58.4643818074555 -34.5925514893154,-58.4644091423089 -34.5924672602501,-58.465028074699 -34.5919363839057,-58.465952967203 -34.5911454862614,-58.4659776627481 -34.5911292877729,-58.466116298254 -34.5910384352836,-58.4663188861958 -34.5909082834158,-58.4665306703955 -34.5907722856172,-58.4665923236826 -34.5907351695108,-58.4667701300891 -34.5906280467629,-58.4667711641284 -34.5906276136994,-58.4668275193891 -34.5905935490001,-58.4668151719555 -34.5905804214207,-58.4666509464773 -34.5904245973821,-58.4665109342781 -34.5902931479245,-58.4663488153964 -34.5901399350734,-58.4661635373723 -34.5899640882129,-58.4659835237194 -34.5897943348149,-58.4658056162645 -34.5896280633163,-58.4656445527277 -34.5894774611534,-58.465451908809 -34.5892955194799,-58.4652697926413 -34.5891231533902,-58.4650855718569 -34.5889490459532,-58.4648981937772 -34.5887714560664,-58.4647108164949 -34.5885938658867,-58.4645202820134 -34.5884145343493,-58.4643360643734 -34.5882412963166,-58.4641392155366 -34.5880576114782,-58.4639423675401 -34.5878721852047,-58.4637518363789 -34.5876945935584,-58.4635749904958 -34.5875291892975,-58.4633813029524 -34.5873481148608,-58.4631907741811 -34.5871705223233,-58.4630255095802 -34.5870242694407,-58.4629760879836 -34.5869825130223,-58.4628307717933 -34.5868597346859,-58.4626118242798 -34.5866743062514,-58.4623949829962 -34.5864888774238,-58.4621834057638 -34.5863104126779,-58.4619665663694 -34.5861258536344,-58.4618655153305 -34.5860396679109,-58.4617002545501 -34.585955222706,-58.4614623638405 -34.5858324720823,-58.4612192097795 -34.5857636954228,-58.4609718456451 -34.5856949182186,-58.4607718494315 -34.5856383290589,-58.4605265912711 -34.5855695509841,-58.4603787097951 -34.585528042087,-58.460405765846 -34.5854315455672,-58.4604139413724 -34.5854023896033,-58.4604463027545 -34.5852877376457,-58.4604255276594 -34.5852032267728,-58.4604706633094 -34.5850361081131,-58.4605356374482 -34.584943922422,-58.4605345537482 -34.5840461392135,-58.4605332197592 -34.5829502491291,-58.4588315618735 -34.5830062657006,-58.4574956040083 -34.5834029929158,-58.4562080783266 -34.5838828804907,-58.4549139808727 -34.5843653597656,-58.4548280748776 -34.5842306304324,-58.4541840816137 -34.5849403345148,-58.4539648727513 -34.5851817373213,-58.4542457486364 -34.5856200848168,-58.4549308982095 -34.5866893686077,-58.4551152296754 -34.5869798809592,-58.4551160926827 -34.5869811873598,-58.4553640393572 -34.5871035071714,-58.4554405726303 -34.5871862579632,-58.4554410887932 -34.5871863006821,-58.4555181380029 -34.5872672561246,-58.4555660294432 -34.5873654334084,-58.4556342606729 -34.5875033158483,-58.455634181015 -34.5875037817487,-58.4555909873907 -34.5877564103897,-58.4554160275633 -34.5879889185448,-58.455048696802 -34.5880275592538,-58.454999212819 -34.5881176301939,-58.4545017798017 -34.5884832463169,-58.4543429775494 -34.5883366803521,-58.45364660011 -34.5888320027134)))";;"1759";15_9_8;COMUNA 15;"9";"8";"2324";"1140";"1184";"96,28%";"668";"668";"100,00%";"0";"0,00%";"727";"168";"23.11";"559";"76,89%";"23.11";23.110
"MULTIPOLYGON (((-58.3876239888844 -34.569201319994,-58.3874214621621 -34.5691859833456,-58.3871759460349 -34.5691655491308,-58.3870531788325 -34.5691654731146,-58.3868752522187 -34.5691552214432,-58.3866972544175 -34.5691296871193,-58.3865314932263 -34.5691295838025,-58.3863105819915 -34.5691091631974,-58.3860834606037 -34.5690835972284,-58.3859853026795 -34.5690784649405,-58.3858686654483 -34.5690783915853,-58.3856968213316 -34.56902750647,-58.3855188147305 -34.5690121821301,-58.3852917554278 -34.5690120383583,-58.3851014845571 -34.5690017762732,-58.3849479927995 -34.5689914668975,-58.384812985105 -34.5689710982671,-58.3845859496269 -34.5689455999922,-58.3844263186393 -34.5689454977396,-58.3842115430725 -34.5689199362035,-58.3840028074839 -34.5688995192501,-58.3838002822365 -34.5688841061695,-58.3835977569978 -34.5688687631785,-58.3834136261163 -34.5688483611589,-58.3831865818176 -34.5688329311325,-58.3830147155938 -34.5688074658582,-58.3827753120858 -34.5688073093473,-58.3826280310054 -34.5688021421876,-58.3825605373177 -34.5687818153326,-58.382431694609 -34.5687258127763,-58.3823150920378 -34.5686902415604,-58.3821616764939 -34.5686901404395,-58.3820756986582 -34.5686799424021,-58.3819468171484 -34.5686645748633,-58.3818118107206 -34.5686442029144,-58.3817688267582 -34.5686340331422,-58.3816214770752 -34.5686999241252,-58.3815109307001 -34.5687404862068,-58.3814188638089 -34.5687759194272,-58.3813390514715 -34.5688165018129,-58.3812652886865 -34.5688520175406,-58.3812223502524 -34.5688824127349,-58.3811915763401 -34.5689230277442,-58.3811547428532 -34.5689788506209,-58.3811362186395 -34.5690296150798,-58.3811116100096 -34.5691210110213,-58.3811054256137 -34.5691768543619,-58.3810623223871 -34.5692885204903,-58.3810744927672 -34.5693799410115,-58.3810806383306 -34.5694510045142,-58.3810805688266 -34.569522134286,-58.3810804695939 -34.5696236878795,-58.3810679858056 -34.5697657983124,-58.3810740461849 -34.5698369321795,-58.381037187428 -34.5699181081958,-58.3810125734671 -34.5700145747401,-58.3810001143023 -34.5701313319735,-58.3809755300716 -34.5701973042619,-58.3809570856528 -34.5702531393763,-58.3809262564294 -34.5703496017357,-58.380873814765 -34.570433091299,-58.3806868672677 -34.5704170496657,-58.3806621646532 -34.570429850517,-58.3806288791427 -34.570426306865,-58.3804015798995 -34.5704065755298,-58.3802326925854 -34.5703796294153,-58.3799182189252 -34.5703531478285,-58.3795253411522 -34.5703188652238,-58.3794911186566 -34.5703158840277,-58.3794603862563 -34.5703134686063,-58.3794238653929 -34.5703101336959,-58.3793928775829 -34.5703077180836,-58.3793602724358 -34.5703050196567,-58.3793332007621 -34.5703028179791,-58.3793005955485 -34.5703001899618,-58.3792516456203 -34.5702957901244,-58.3792248299996 -34.5702929547681,-58.3792000558596 -34.5702919518665,-58.3791469348193 -34.570286915304,-58.3790983231325 -34.5702848396802,-58.379074484244 -34.5702851050536,-58.3790410235756 -34.5702865610629,-58.3790170123644 -34.570288868648,-58.3789728218491 -34.5702927821768,-58.3789491499148 -34.5702963576411,-58.3789263294281 -34.5702998632595,-58.3788985688216 -34.5703054782492,-58.3788754903721 -34.5703115190009,-58.3788451732171 -34.5703195266914,-58.3788062519623 -34.5703326695268,-58.3787745689771 -34.5703442679642,-58.37875233849 -34.570353689702,-58.3787330891716 -34.5703617754011,-58.3786962062329 -34.5703798493918,-58.3786737178339 -34.5703917358321,-58.3786547219998 -34.5704017231831,-58.3786325739284 -34.5704138211267,-58.3785852105985 -34.5704401980804,-58.3785502844204 -34.5704596114605,-58.3784109141284 -34.5705431808572,-58.3783615053481 -34.5705715282263,-58.3781786087212 -34.5706751385565,-58.3777935534079 -34.5709014303144,-58.3776959261229 -34.5709589000388,-58.3775278470507 -34.57105751949,-58.377384131512 -34.5711422114813,-58.377233346204 -34.5712297857995,-58.3771200448719 -34.571294779617,-58.3770551303188 -34.5713324821781,-58.3768304837459 -34.5714638088349,-58.376691113178 -34.5715443479534,-58.3765487630493 -34.5716243214043,-58.3764456024823 -34.571679391747,-58.3764266055074 -34.5716899421521,-58.3762826416013 -34.5717656886179,-58.3761217265782 -34.5718492401251,-58.3760299829183 -34.5718958671475,-58.3759907963682 -34.5719173895306,-58.3759542493437 -34.5719387025002,-58.3758660738141 -34.5719925857638,-58.3758195549116 -34.5720239624495,-58.3757891351414 -34.5720478854747,-58.3757570089676 -34.5720752581278,-58.3757265852006 -34.5721029841129,-58.3756947975633 -34.5721322584797,-58.3756752803796 -34.5721516115873,-58.3756311290062 -34.5721985539299,-58.3756012937871 -34.5722333228557,-58.3755810892683 -34.5722585912016,-58.3755647202214 -34.5722798480269,-58.3755445964842 -34.5723092715305,-58.3755221651326 -34.5723471444456,-58.3755062957912 -34.5723790358741,-58.3754986152492 -34.5723962142158,-58.3754838468267 -34.5724337404696,-58.3754712924013 -34.5724709161759,-58.3754648851204 -34.5724917575523,-58.3754504370679 -34.5725485806239,-58.3754449621241 -34.5725734369202,-58.3754396584877 -34.5725973073813,-58.3754359784733 -34.5726154745354,-58.3754312708135 -34.572639345422,-58.3754271580292 -34.5726642731166,-58.3754229529634 -34.5726960320205,-58.3754192582213 -34.5727282842676,-58.3754168511808 -34.5727503961602,-58.3754134916226 -34.5727877897096,-58.375412195232 -34.5728062402689,-58.3754102074859 -34.5728344794812,-58.3754091611419 -34.5728580712822,-58.3755062905659 -34.5728733526145,-58.3755093300369 -34.5728163101142,-58.3755114000222 -34.5727908175542,-58.3755167351889 -34.5727367345647,-58.3755195721681 -34.5727105382969,-58.3755221479907 -34.5726898350331,-58.3755266935061 -34.5726581467944,-58.3755334558253 -34.5726234318409,-58.3755389305991 -34.5725987163917,-58.3755443200824 -34.5725741417323,-58.3755497940413 -34.5725502009626,-58.3755557781767 -34.5725268943865,-58.3755623584366 -34.5725034473846,-58.3755726088276 -34.5724712702368,-58.3755926698565 -34.5724203668996,-58.3756027390026 -34.5723986830228,-58.3756136581483 -34.5723783378365,-58.3756241496796 -34.5723598234078,-58.3756406082718 -34.572334341107,-58.3756586846595 -34.5723087191064,-58.3756915915212 -34.572267614059,-58.3757288412162 -34.5722258078415,-58.375756881992 -34.5721972350528,-58.3758045225595 -34.5721517036592,-58.3758540333664 -34.5721088497474,-58.3758852202029 -34.572084152571,-58.3759125695149 -34.5720654388281,-58.3759323352384 -34.5720526354332,-58.3759528675054 -34.5720395508777,-58.3760027909284 -34.5720091625167,-58.3760524572889 -34.5719803233143,-58.3760923247503 -34.5719590126714,-58.3761374724497 -34.5719361563982,-58.3761827051911 -34.5719133705939,-58.3764708027664 -34.5717627933833,-58.3766043756547 -34.5716907719204,-58.3767170803552 -34.5716273275279,-58.3767992881095 -34.5715803411488,-58.3768728923753 -34.571537574197,-58.3769452194791 -34.5714948063034,-58.3771824722926 -34.5713578542252,-58.3774771423209 -34.571187207948,-58.3776245210314 -34.5711003352091,-58.3777981379513 -34.5709979164979,-58.3779151033144 -34.5709289807617,-58.3782497253619 -34.5707335001301,-58.3783201755327 -34.5706931950107,-58.3784421638335 -34.5706236284073,-58.3785488208196 -34.5705602485613,-58.3786000194869 -34.5705298600085,-58.3786383545386 -34.5705071389611,-58.378678307618 -34.570483996462,-58.3787009673797 -34.5704710537557,-58.3787284822693 -34.5704558607675,-58.378764086961 -34.5704389831228,-58.3787995188864 -34.5704245702431,-58.378832820723 -34.5704117756773,-58.3788658664992 -34.5703996147565,-58.3788979751827 -34.5703880165877,-58.3789208842233 -34.5703811306089,-58.3789483044429 -34.5703753745298,-58.378969932453 -34.5703724314937,-58.3790613786717 -34.5703644656714,-58.3791356239768 -34.5703595163055,-58.3791300535099 -34.5703959929275,-58.3791662253952 -34.5704077787527,-58.3792187062344 -34.5703719680493,-58.3793990980001 -34.5703877257552,-58.3795887691759 -34.5704041937682,-58.3798437361192 -34.5704259173152,-58.3803120409465 -34.5704662359978,-58.3803059555723 -34.5705073604121,-58.3802990960978 -34.5705564423903,-58.3802881207271 -34.5706351707452,-58.3802840842067 -34.5706706624965,-58.3802809878178 -34.5707024927536,-58.3802784915648 -34.570730097883,-58.3802752268408 -34.5707599561106,-58.3803154087464 -34.570763434088,-58.3803484396569 -34.5707662733981,-58.3803515313704 -34.570739161648,-58.3803524935129 -34.5707131752699,-58.3803538746809 -34.570693950027,-58.3803590160263 -34.5706604309341,-58.380362701409 -34.5706356436269,-58.3803654506857 -34.5706104331347,-58.3803700034122 -34.5705694485357,-58.3803760175038 -34.5705142389603,-58.3803806562602 -34.5704723388863,-58.3803972871222 -34.5704429826457,-58.3806805165707 -34.5704684560512,-58.3806765742849 -34.5704948629839,-58.3811252162297 -34.5705318553323,-58.3811636570746 -34.5705744884729,-58.3811507665685 -34.570697161169,-58.3811046695254 -34.5707352305865,-58.3811890313152 -34.57074585078,-58.381063212925 -34.5708164035249,-58.3807573122525 -34.5709880368949,-58.3783381535837 -34.572281021611,-58.3783125110287 -34.5722962862261,-58.3782979352336 -34.5723129669988,-58.3782865018529 -34.5723373263255,-58.3782464846607 -34.572675482021,-58.3782515647383 -34.5727035148942,-58.3782610810188 -34.5727227476454,-58.3782777497366 -34.572741351513,-58.3782979996253 -34.5727547463658,-58.3783219131907 -34.5727655380034,-58.3783572396322 -34.5727723232679,-58.3784087461003 -34.5727758096967,-58.378454972943 -34.5727802079918,-58.3835241095423 -34.5731844633387,-58.3835468417476 -34.5731849006347,-58.3835755270736 -34.5731924547629,-58.3835958595286 -34.5732095813428,-58.3836020508671 -34.5732348681171,-58.3835886309963 -34.5733804289702,-58.3835723319577 -34.5734195749941,-58.3835523977311 -34.5734313935574,-58.3830463000245 -34.5737188230118,-58.3818908065247 -34.5743750631062,-58.3818679749571 -34.5743889922392,-58.3818443776487 -34.5744023574566,-58.3818222341594 -34.5744091036352,-58.3817937129918 -34.5744076057984,-58.3817668115724 -34.5744039962637,-58.3761132452344 -34.5739529852419,-58.3755142378892 -34.5739055850486,-58.3754385265092 -34.573925179664,-58.3732950451924 -34.5751558634628,-58.3707607969072 -34.5765979145859,-58.3707422165275 -34.5766150844048,-58.3706957975615 -34.5770153478021,-58.3706997750002 -34.5770374643972,-58.3707172945706 -34.5770558586483,-58.3707442783261 -34.5770623581232,-58.3707692231854 -34.5770647009539,-58.3760050309057 -34.5774789013089,-58.3760358501819 -34.5774820923412,-58.3760579758798 -34.577493728251,-58.3760671441647 -34.5775201443087,-58.376046190914 -34.5776914745928,-58.3760399549795 -34.5777110484446,-58.3760158389332 -34.5777301870463,-58.375161577505 -34.578214034114,-58.3743037280201 -34.5786997740452,-58.3738505825076 -34.5789449855822,-58.3739726628069 -34.5791002663181,-58.3739717397656 -34.5791022963032,-58.3751269621437 -34.5805351929169,-58.3760111014909 -34.5800308651478,-58.3761619620597 -34.5799483186483,-58.3798382017374 -34.5801625788978,-58.3828575064245 -34.5784282069578,-58.3830166527453 -34.5783437333807,-58.3832155684211 -34.5782557614333,-58.3833718311957 -34.57821592368,-58.3835536444996 -34.5781901985604,-58.3837354376964 -34.578185617552,-58.3839172463902 -34.5781645906418,-58.3842666447186 -34.5781401472025,-58.3844569525076 -34.5781426187224,-58.3847125730541 -34.5781639267123,-58.3854112820632 -34.5782090093157,-58.385616139385 -34.5782221407021,-58.385729905848 -34.5782098176152,-58.3859494054372 -34.5782172800845,-58.3860655489518 -34.5782125641297,-58.3861810429539 -34.5782106690036,-58.3864082596469 -34.5782319556326,-58.3865198748973 -34.5781337607384,-58.3866285523084 -34.5780995313173,-58.3867344249439 -34.5780596660162,-58.3868351565548 -34.5780403682717,-58.3889252998955 -34.5781869514687,-58.3892001671449 -34.5781850350978,-58.3897286067997 -34.5778335959786,-58.3903811702948 -34.577333611368,-58.390956649001 -34.5767590677762,-58.3912676620108 -34.5762847936769,-58.3914556931588 -34.5759466499332,-58.3916637456032 -34.5755918971159,-58.391945572915 -34.5752871183903,-58.3924084442609 -34.5749435685094,-58.3929583984406 -34.574616757484,-58.3935753576087 -34.5743897748771,-58.3940842556997 -34.5742818179911,-58.3932714389492 -34.5733189936449,-58.3937521042201 -34.5730593254723,-58.3940181170664 -34.5729155960811,-58.3945682021667 -34.5726129337137,-58.3948314034795 -34.5724680741597,-58.3952058187326 -34.5721906642895,-58.394820293938 -34.5723093992478,-58.3944511383445 -34.5722953195757,-58.394323517465 -34.572290459218,-58.3941913026827 -34.5722811593399,-58.393924744883 -34.5722623466783,-58.3931779844981 -34.5722135688309,-58.3927871925167 -34.5722347167662,-58.3926732026801 -34.5724869477803,-58.3906988372335 -34.5735719967655,-58.3874774205439 -34.5753128791517,-58.385237271016 -34.5765360558463,-58.3834148816176 -34.5764047394058,-58.3829060075434 -34.5757467745975,-58.3828871538888 -34.5756963376189,-58.3828583221227 -34.5756630075053,-58.3828857285312 -34.575584148877,-58.3829143976371 -34.5755203621227,-58.3829708319758 -34.5754475790366,-58.3830549245519 -34.575388617371,-58.3831612325659 -34.5753367831,-58.3839632907333 -34.5748743963001,-58.3913016042575 -34.5706434474647,-58.3913242802255 -34.5706093043313,-58.3913387037263 -34.5705681842395,-58.3913307261905 -34.5705383895652,-58.3913144941738 -34.5705040124021,-58.3911932786286 -34.5702803403089,-58.3910328997379 -34.5700574197821,-58.3909079050133 -34.5699729765103,-58.3908119822289 -34.5699412285551,-58.3906840153244 -34.5699471393003,-58.3906678984031 -34.5698784648667,-58.3906250329231 -34.5698276627331,-58.3905882034335 -34.5697870758569,-58.3905698488466 -34.5697464294618,-58.3905637365343 -34.5697260728613,-58.3905330019567 -34.5697260546954,-58.3905269422307 -34.5696448504353,-58.3905208738139 -34.5695737170248,-58.3905209264548 -34.56951279894,-58.3904841191347 -34.5694467884133,-58.3904043765016 -34.5694111763002,-58.3903000380794 -34.5693654786932,-58.3902386543269 -34.5693654422712,-58.390189606631 -34.5693755544288,-58.3900361090743 -34.5693703925136,-58.3898704502757 -34.569349940802,-58.3897230826465 -34.5693447821501,-58.3896003240486 -34.5693345674188,-58.3894285266135 -34.5693243231388,-58.3892260126988 -34.5692937071433,-58.3889927465672 -34.569283425237,-58.388734974608 -34.5692578456903,-58.3886305968258 -34.5692577824015,-58.3885691905917 -34.5692831687571,-58.3885078023982 -34.5692882021032,-58.3884710232644 -34.5692881797442,-58.3883789186911 -34.5692729117796,-58.3882930065575 -34.5692830007252,-58.3881886514238 -34.5692575134418,-58.3880843587802 -34.5692574497379,-58.3879922679174 -34.5692269695668,-58.3878879753124 -34.5692269056953,-58.3877897502221 -34.5692014218275,-58.3876239888844 -34.569201319994)))";;"1760";2_1_1;COMUNA 1;"1";"1";"105";"63";"42";"150,00%";"14";"9";"64,29%";"5";"55,56%";"21";"8";"38.1";"13";"61,90%";"38.1";38.100
"MULTIPOLYGON (((-58.3989782109081 -34.570052318432,-58.398797308645 -34.5701434953981,-58.3983509905206 -34.570397919775,-58.3952058187326 -34.5721906642895,-58.3948314034795 -34.5724680741599,-58.3945682021667 -34.5726129337137,-58.3940181170664 -34.5729155960811,-58.3937521042201 -34.5730593254723,-58.3932714389492 -34.5733189936449,-58.3940842556997 -34.5742818179911,-58.3935753576087 -34.5743897748771,-58.3929583984406 -34.574616757484,-58.3924084442609 -34.5749435685094,-58.391945572915 -34.5752871183903,-58.3916637456032 -34.575591897116,-58.3914556931588 -34.5759466499332,-58.3912676620108 -34.5762847936769,-58.390956649001 -34.5767590677762,-58.3903811702948 -34.577333611368,-58.3897286067997 -34.5778335959786,-58.3892001671449 -34.5781850350978,-58.3894841817129 -34.5782256801809,-58.3899149107137 -34.5782401325995,-58.3901554646791 -34.5786072583635,-58.3909067704927 -34.5797334501142,-58.3910040158461 -34.5798811573486,-58.3912234899015 -34.5801886110557,-58.3916110971341 -34.5807657391842,-58.3922032309498 -34.5805135417479,-58.3922688343769 -34.5804670988303,-58.3926649234916 -34.5802890095284,-58.3931067554886 -34.580086789097,-58.3940349628123 -34.5796609591413,-58.3940864260459 -34.5797230329059,-58.394307979692 -34.579619490986,-58.3945188743644 -34.5795343237516,-58.3945992514662 -34.579641204038,-58.394617284637 -34.579663398116,-58.3946827033108 -34.5796322361136,-58.3964207197784 -34.5787916080459,-58.3966626680306 -34.5786696553921,-58.3965823208085 -34.5785422132789,-58.3965594749615 -34.578506408494,-58.3971470783445 -34.5781200586535,-58.3972055200689 -34.5780799258978,-58.3980608386164 -34.5775155356541,-58.3981287960981 -34.5774697475716,-58.3984290817809 -34.5772725813637,-58.3984827667413 -34.5772373653406,-58.3985830738152 -34.5771715662059,-58.3987619607559 -34.5770739337668,-58.3989825094162 -34.5769568524494,-58.3992655464822 -34.5768158396895,-58.3995286536361 -34.5766890443044,-58.3997808915875 -34.5765674847696,-58.3999294270762 -34.5764949217838,-58.4001237134985 -34.5763823180457,-58.4003587605257 -34.5762435247043,-58.4006019634212 -34.5760935021489,-58.4008497005854 -34.5759322484947,-58.4011449928956 -34.5757376940303,-58.401167837016 -34.575717500959,-58.4012366844111 -34.5756610823382,-58.4016550275219 -34.5753152051997,-58.4018452807519 -34.5750894006327,-58.4020962057507 -34.5747833241231,-58.4023212812154 -34.5745147542698,-58.4025498452015 -34.5742413792427,-58.4026178898503 -34.5741611447826,-58.4026470909426 -34.5741409682823,-58.4026447150819 -34.5741387196367,-58.4025155826195 -34.5740112367831,-58.4021409598515 -34.5736319406858,-58.4020393637354 -34.5735252955798,-58.40189895718 -34.5733265897958,-58.4018275500379 -34.5732264058229,-58.4017766023223 -34.5731549644755,-58.4017574066073 -34.5731277544786,-58.4005552854893 -34.5717908821073,-58.4005334262456 -34.5717618556514,-58.4003778599433 -34.5715557815968,-58.4002861573351 -34.5714520683337,-58.399916627017 -34.5710341848782,-58.3997215237438 -34.5707623825773,-58.3996595777738 -34.5704906487924,-58.3996686946237 -34.5702556433974,-58.399775412328 -34.5699766723634,-58.3999877931814 -34.569611394216,-58.4001256522954 -34.5693507965668,-58.3993397587844 -34.5698700339831,-58.3989782109081 -34.570052318432)))";;"1761";2_1_2;COMUNA 2;"1";"2";"518";"268";"250";"107,20%";"124";"124";"100,00%";"0";"0,00%";"133";"36";"27.07";"97";"72,93%";"27.07";27.070
"MULTIPOLYGON (((-58.4019087053874 -34.5864683004804,-58.4010480929824 -34.5869856361194,-58.4009480758469 -34.5870467147753,-58.4018805912887 -34.5877719305043,-58.4019800839097 -34.5878468422062,-58.4029804960765 -34.5872501991679,-58.4019087053874 -34.5864683004804)))";;"1762";2_10_1;COMUNA 2;"10";"1";"975";"437";"538";"81,23%";"736";"736";"100,00%";"0";"0,00%";"519";"5";"0.96";"514";"99,04%";"0.96";0.960
"MULTIPOLYGON (((-58.4019087053874 -34.5864683004804,-58.4011773664321 -34.585934673019,-58.4002176607097 -34.5865317448064,-58.4008492678065 -34.5869698306599,-58.4009480758469 -34.5870467147753,-58.4010480929824 -34.5869856361194,-58.4019087053874 -34.5864683004804)))";;"1763";2_10_2;COMUNA 2;"10";"2";"637";"266";"371";"71,70%";"553";"552";"99,82%";"1";"0,18%";"366";"2";"0.55";"364";"99,45%";"0.55";0.550
"MULTIPOLYGON (((-58.3999308859935 -34.5850253395169,-58.399297424588 -34.585596936672,-58.3991137925554 -34.585762481644,-58.3993122637663 -34.5859037877824,-58.4002176607097 -34.5865317448064,-58.4011773664321 -34.585934673019,-58.3999308859935 -34.5850253395169)))";;"1764";2_10_3;COMUNA 2;"10";"3";"441";"202";"239";"84,52%";"327";"326";"99,69%";"1";"0,31%";"209";"1";"0.48";"208";"99,52%";"0.48";0.480
"MULTIPOLYGON (((-58.3991137925554 -34.585762481644,-58.3989437938265 -34.5859157090156,-58.3982435116009 -34.5865471272527,-58.3991670377884 -34.5871852428306,-58.4002176607097 -34.5865317448064,-58.3993122637663 -34.5859037877824,-58.3991137925554 -34.585762481644)))";;"1765";2_10_4;COMUNA 2;"10";"4";"785";"351";"434";"80,88%";"492";"491";"99,80%";"1";"0,20%";"344";"1";"0.29";"343";"99,71%";"0.29";0.290
"MULTIPOLYGON (((-58.4009480758469 -34.5870467147753,-58.4008492678065 -34.5869698306599,-58.4002176607097 -34.5865317448064,-58.3991670377884 -34.5871852428306,-58.3997868151046 -34.5876134684254,-58.3998903898418 -34.5876927503084,-58.4009480758469 -34.5870467147753)))";;"1766";2_10_5;COMUNA 2;"10";"5";"812";"371";"441";"84,13%";"672";"672";"100,00%";"0";"0,00%";"426";"6";"1.41";"420";"98,59%";"1.41";1.410
"MULTIPOLYGON (((-58.4009480758469 -34.5870467147753,-58.3998903898418 -34.5876927503084,-58.3999993264669 -34.5877761899538,-58.4008383870384 -34.5884378418399,-58.4009020457271 -34.588489636727,-58.4019800839097 -34.5878468422062,-58.4018805912887 -34.5877719305043,-58.4009480758469 -34.5870467147753)))";;"1767";2_10_6;COMUNA 2;"10";"6";"695";"322";"373";"86,33%";"403";"402";"99,75%";"1";"0,25%";"321";"3";"0.93";"318";"99,07%";"0.93";0.930
"MULTIPOLYGON (((-58.3998903898418 -34.5876927503084,-58.3987497063583 -34.5883894393893,-58.3998273136677 -34.5891303105907,-58.4000011972056 -34.5890268043635,-58.4009020457271 -34.588489636727,-58.4008383870384 -34.5884378418399,-58.3999993264669 -34.5877761899538,-58.3998903898418 -34.5876927503084)))";;"1768";2_10_7;COMUNA 2;"10";"7";"868";"366";"502";"72,91%";"713";"713";"100,00%";"0";"0,00%";"483";"2";"0.41";"481";"99,59%";"0.41";0.410
"MULTIPOLYGON (((-58.3998903898418 -34.5876927503084,-58.3997868151046 -34.5876134684254,-58.3991670377884 -34.5871852428306,-58.3980186775501 -34.5878995274806,-58.3987497063583 -34.5883894393893,-58.3998903898418 -34.5876927503084)))";;"1769";2_10_8;COMUNA 2;"10";"8";"856";"358";"498";"71,89%";"624";"624";"100,00%";"0";"0,00%";"443";"3";"0.68";"440";"99,32%";"0.68";0.680
"MULTIPOLYGON (((-58.3982435116009 -34.5865471272527,-58.3975687834015 -34.5871553850942,-58.3972871466692 -34.5874092587627,-58.3980186775501 -34.5878995274806,-58.3991670377884 -34.5871852428306,-58.3982435116009 -34.5865471272527)))";;"1770";2_10_9;COMUNA 2;"10";"9";"611";"285";"326";"87,42%";"407";"407";"100,00%";"0";"0,00%";"299";"3";"1";"296";"99,00%";"1";1.000
"MULTIPOLYGON (((-58.4063982243536 -34.5838085150901,-58.4050649733778 -34.5845921500845,-58.4058940733555 -34.5855127170253,-58.4070918071397 -34.5847984508694,-58.4063982243536 -34.5838085150901)))";;"1771";2_11_1;COMUNA 2;"11";"1";"1196";"495";"701";"70,61%";"900";"900";"100,00%";"0";"0,00%";"621";"3";"0.48";"618";"99,52%";"0.48";0.480
"MULTIPOLYGON (((-58.4053598727299 -34.5834529467442,-58.4040266648124 -34.5834425943959,-58.4042479739326 -34.5836848231551,-58.4050649733778 -34.5845921500845,-58.4063982243536 -34.5838085150901,-58.4061723829633 -34.5834592415031,-58.4053598727299 -34.5834529467442)))";;"1772";2_11_2;COMUNA 2;"11";"2";"564";"245";"319";"76,80%";"307";"307";"100,00%";"0";"0,00%";"241";"1";"0.41";"240";"99,59%";"0.41";0.410
"MULTIPOLYGON (((-58.4040266648124 -34.5834425943959,-58.4020439263355 -34.5834271879044,-58.4020672121742 -34.5834900189431,-58.4035485382137 -34.5854879398272,-58.4049547412042 -34.5846568893475,-58.4050649733778 -34.5845921500845,-58.4042479739326 -34.5836848231551,-58.4040266648124 -34.5834425943959)))";;"1773";2_11_3;COMUNA 2;"11";"3";"1643";"701";"942";"74,42%";"975";"970";"99,49%";"5";"0,52%";"672";"17";"2.53";"655";"97,47%";"2.53";2.530
"MULTIPOLYGON (((-58.4050649733778 -34.5845921500845,-58.4049547412042 -34.5846568893475,-58.4035485382137 -34.5854879398272,-58.4045173356303 -34.5863337918553,-58.4058940733555 -34.5855127170253,-58.4050649733778 -34.5845921500845)))";;"1774";2_11_4;COMUNA 2;"11";"4";"1393";"600";"793";"75,66%";"882";"882";"100,00%";"0";"0,00%";"668";"38";"5.69";"630";"94,31%";"5.69";5.690
"MULTIPOLYGON (((-58.4035485382137 -34.5854879398272,-58.4028477677525 -34.5859037417878,-58.402765133375 -34.5859526468772,-58.40365981056 -34.5868451612473,-58.4045173356303 -34.5863337918553,-58.4035485382137 -34.5854879398272)))";;"1775";2_11_5;COMUNA 2;"11";"5";"309";"133";"176";"75,57%";"231";"231";"100,00%";"0";"0,00%";"169";"0";"0";"169";"100,00%";"0";0.000
"MULTIPOLYGON (((-58.4019087053874 -34.5864683004804,-58.4029804960765 -34.5872501991679,-58.40365981056 -34.5868451612473,-58.402765133375 -34.5859526468772,-58.4028477677525 -34.5859037417878,-58.4035485382137 -34.5854879398272,-58.4020672121742 -34.5834900189431,-58.4020439263355 -34.5834271879044,-58.401943107732 -34.5834263630781,-58.4013459274664 -34.5837927694489,-58.4012154097162 -34.5838814397814,-58.401126636989 -34.583941820027,-58.4005437183744 -34.584471827839,-58.4004723122209 -34.5845367940964,-58.3999308859935 -34.5850253395169,-58.4011773664321 -34.585934673019,-58.4019087053874 -34.5864683004804)))";;"1776";2_11_6;COMUNA 2;"11";"6";"527";"238";"289";"82,35%";"499";"499";"100,00%";"0";"0,00%";"305";"1";"0.33";"304";"99,67%";"0.33";0.330
"MULTIPOLYGON (((-58.408038247127 -34.5861491444708,-58.4076257231004 -34.585560484472,-58.4066233774629 -34.5863261153863,-58.4073522701428 -34.5871392978252,-58.4074429788797 -34.5872399767856,-58.4083166981262 -34.5865459046194,-58.4081360830691 -34.5862888417864,-58.408038247127 -34.5861491444708)))";;"1777";2_12_1;COMUNA 2;"12";"1";"970";"402";"568";"70,77%";"593";"591";"99,66%";"2";"0,34%";"435";"1";"0.23";"434";"99,77%";"0.23";0.230
"MULTIPOLYGON (((-58.4070918071397 -34.5847984508694,-58.4058940733555 -34.5855127170253,-58.4059683562306 -34.5855952901351,-58.4066233774629 -34.5863261153863,-58.4076257231004 -34.585560484472,-58.4070918071397 -34.5847984508694)))";;"1778";2_12_2;COMUNA 2;"12";"2";"818";"334";"484";"69,01%";"568";"568";"100,00%";"0";"0,00%";"402";"2";"0.5";"400";"99,50%";"0.5";0.500
"MULTIPOLYGON (((-58.4066233774629 -34.5863261153863,-58.4059683562306 -34.5855952901351,-58.4058940733555 -34.5855127170253,-58.4045173356303 -34.5863337918553,-58.404622097455 -34.5864245496437,-58.4054978200456 -34.5871780217808,-58.4055937495577 -34.5871125711101,-58.4066233774629 -34.5863261153863)))";;"1779";2_12_3;COMUNA 2;"12";"3";"943";"391";"552";"70,83%";"595";"595";"100,00%";"0";"0,00%";"457";"1";"0.22";"456";"99,78%";"0.22";0.220
"MULTIPOLYGON (((-58.4066233774629 -34.5863261153863,-58.4055937495577 -34.5871125711101,-58.4054978200456 -34.5871780217808,-58.4055984142792 -34.587264551244,-58.4064511011335 -34.5879825112833,-58.4073328151148 -34.5873274655933,-58.4074429788797 -34.5872399767856,-58.4073522701428 -34.5871392978252,-58.4066233774629 -34.5863261153863)))";;"1780";2_12_4;COMUNA 2;"12";"4";"1250";"529";"721";"73,37%";"1003";"1003";"100,00%";"0";"0,00%";"704";"5";"0.71";"699";"99,29%";"0.71";0.710
"MULTIPOLYGON (((-58.4054978200456 -34.5871780217808,-58.4053756502421 -34.5872614185223,-58.4045567193517 -34.5877399236132,-58.4040544348578 -34.5880333570423,-58.4052307023562 -34.5888890917189,-58.4064511011335 -34.5879825112833,-58.4055984142792 -34.587264551244,-58.4054978200456 -34.5871780217808)))";;"1781";2_12_5;COMUNA 2;"12";"5";"1242";"551";"691";"79,74%";"828";"828";"100,00%";"0";"0,00%";"615";"20";"3.25";"595";"96,75%";"3.25";3.250
"MULTIPOLYGON (((-58.40365981056 -34.5868451612473,-58.4029804960765 -34.5872501991679,-58.4039225105121 -34.5879374446594,-58.4040544348578 -34.5880333570423,-58.4045567193517 -34.5877399236132,-58.4053756502421 -34.5872614185223,-58.4054978200456 -34.5871780217808,-58.404622097455 -34.5864245496437,-58.4045173356303 -34.5863337918553,-58.40365981056 -34.5868451612473)))";;"1782";2_12_6;COMUNA 2;"12";"6";"983";"427";"556";"76,80%";"655";"655";"100,00%";"0";"0,00%";"498";"2";"0.4";"496";"99,60%";"0.4";0.400
"MULTIPOLYGON (((-58.4040544348578 -34.5880333570423,-58.4038916346104 -34.5881284937889,-58.4030375033918 -34.5886260569119,-58.4043187936964 -34.5895668549818,-58.4044348387548 -34.5894803576931,-58.4052307023562 -34.5888890917189,-58.4040544348578 -34.5880333570423)))";;"1783";2_13_1;COMUNA 2;"13";"1";"1196";"526";"670";"78,51%";"887";"886";"99,89%";"1";"0,11%";"595";"0";"0";"595";"100,00%";"0";0.000
"MULTIPOLYGON (((-58.4029804960765 -34.5872501991679,-58.4019800839097 -34.5878468422062,-58.4021294508846 -34.5879592448816,-58.4030375033918 -34.5886260569119,-58.4038916346104 -34.5881284937889,-58.4040544348578 -34.5880333570423,-58.4039225105121 -34.5879374446594,-58.4029804960765 -34.5872501991679)))";;"1784";2_13_2;COMUNA 2;"13";"2";"890";"386";"504";"76,59%";"573";"573";"100,00%";"0";"0,00%";"418";"4";"0.96";"414";"99,04%";"0.96";0.960
"MULTIPOLYGON (((-58.4019800839097 -34.5878468422062,-58.4009020457271 -34.588489636727,-58.4017830625547 -34.5892068688857,-58.4018934490807 -34.5892925611566,-58.4030375033918 -34.5886260569119,-58.4021294508846 -34.5879592448816,-58.4019800839097 -34.5878468422062)))";;"1785";2_13_3;COMUNA 2;"13";"3";"973";"409";"564";"72,52%";"718";"718";"100,00%";"0";"0,00%";"516";"2";"0.39";"514";"99,61%";"0.39";0.390
"MULTIPOLYGON (((-58.4030375033918 -34.5886260569119,-58.4018934490807 -34.5892925611566,-58.403190358613 -34.5902995785657,-58.4032617672375 -34.5903546859773,-58.4043187936964 -34.5895668549818,-58.4030375033918 -34.5886260569119)))";;"1786";2_13_4;COMUNA 2;"13";"4";"1112";"502";"610";"82,30%";"742";"742";"100,00%";"0";"0,00%";"555";"1";"0.18";"554";"99,82%";"0.18";0.180
"MULTIPOLYGON (((-58.4018934490807 -34.5892925611566,-58.4008850065925 -34.589880035705,-58.4023222466273 -34.5908986829952,-58.4024227606481 -34.5909800035101,-58.4032617672375 -34.5903546859773,-58.403190358613 -34.5902995785657,-58.4018934490807 -34.5892925611566)))";;"1787";2_13_5;COMUNA 2;"13";"5";"1371";"597";"774";"77,13%";"889";"888";"99,89%";"1";"0,11%";"647";"4";"0.62";"643";"99,38%";"0.62";0.620
"MULTIPOLYGON (((-58.3998273136677 -34.5891303105907,-58.4003544120163 -34.5901892147204,-58.4005986666891 -34.5900467983803,-58.4008850065925 -34.589880035705,-58.4018934490807 -34.5892925611566,-58.4017830625547 -34.5892068688857,-58.4009020457271 -34.588489636727,-58.4000011972056 -34.5890268043635,-58.3998273136677 -34.5891303105907)))";;"1788";2_13_6;COMUNA 2;"13";"6";"1052";"453";"599";"75,63%";"566";"563";"99,47%";"3";"0,53%";"382";"5";"1.31";"377";"98,69%";"1.31";1.310
"MULTIPOLYGON (((-58.4008850065925 -34.589880035705,-58.4005986666891 -34.5900467983803,-58.4003544120163 -34.5901892147204,-58.4004888461663 -34.5904589419239,-58.4010325337264 -34.5915634165405,-58.4024227606481 -34.5909800035101,-58.4023222466273 -34.5908986829952,-58.4008850065925 -34.589880035705)))";;"1789";2_13_7;COMUNA 2;"13";"7";"1211";"516";"695";"74,24%";"888";"888";"100,00%";"0";"0,00%";"634";"7";"1.1";"627";"98,90%";"1.1";1.100
"MULTIPOLYGON (((-58.4032617672375 -34.5903546859773,-58.4024227606481 -34.5909800035101,-58.4010325337264 -34.5915634165405,-58.4011129741619 -34.5917268438996,-58.4014858045173 -34.592538683209,-58.402786610048 -34.592096776128,-58.4032996963661 -34.5917432805907,-58.4041609934522 -34.5911498000492,-58.4042308578951 -34.5911014513438,-58.4041407232182 -34.5910317574786,-58.4032617672375 -34.5903546859773)))";;"1790";2_14_1;COMUNA 2;"14";"1";"760";"341";"419";"81,38%";"372";"370";"99,46%";"2";"0,54%";"248";"1";"0.4";"247";"99,60%";"0.4";0.400
"MULTIPOLYGON (((-58.4036134755765 -34.5940778204799,-58.403507587851 -34.5941216441201,-58.4023478713047 -34.5944428492193,-58.4028222572832 -34.5958248268708,-58.4040604033508 -34.5952948441164,-58.4041767787824 -34.5952347567967,-58.4038644288335 -34.5945890884712,-58.4036134755765 -34.5940778204799)))";;"1791";2_14_10;COMUNA 2;"14";"10";"1006";"418";"588";"71,09%";"814";"814";"100,00%";"0";"0,00%";"537";"27";"5.03";"510";"94,97%";"5.03";5.030
"MULTIPOLYGON (((-58.4042308578951 -34.5911014513438,-58.4041609934522 -34.5911498000492,-58.4032996963661 -34.5917432805907,-58.4040625932508 -34.592420648088,-58.4041695738179 -34.5925150693602,-58.4042268224148 -34.5924855886,-58.4050990159551 -34.5917761162337,-58.4049971366861 -34.5916935296306,-58.4042308578951 -34.5911014513438)))";;"1792";2_14_2;COMUNA 2;"14";"2";"575";"230";"345";"66,67%";"426";"425";"99,77%";"1";"0,24%";"306";"3";"0.98";"303";"99,02%";"0.98";0.980
"MULTIPOLYGON (((-58.4032996963661 -34.5917432805907,-58.402786610048 -34.592096776128,-58.4029976485957 -34.5927948647969,-58.4030463644324 -34.5929086959128,-58.4041695738179 -34.5925150693602,-58.4040625932508 -34.592420648088,-58.4032996963661 -34.5917432805907)))";;"1793";2_14_3;COMUNA 2;"14";"3";"355";"141";"214";"65,89%";"262";"261";"99,62%";"1";"0,38%";"175";"1";"0.57";"174";"99,43%";"0.57";0.570
"MULTIPOLYGON (((-58.402786610048 -34.592096776128,-58.4014858045173 -34.592538683209,-58.4017145226333 -34.5930368454791,-58.4018462240534 -34.5933292466468,-58.4030463644324 -34.5929086959128,-58.4029976485957 -34.5927948647969,-58.402786610048 -34.592096776128)))";;"1794";2_14_4;COMUNA 2;"14";"4";"743";"320";"423";"75,65%";"539";"539";"100,00%";"0";"0,00%";"369";"0";"0";"369";"100,00%";"0";0.000
"MULTIPOLYGON (((-58.4030463644324 -34.5929086959128,-58.4018462240534 -34.5933292466468,-58.4023478713047 -34.5944428492193,-58.403507587851 -34.5941216441201,-58.4036134755765 -34.5940778204799,-58.4030929550962 -34.5930173144968,-58.4030463644324 -34.5929086959128)))";;"1795";2_14_5;COMUNA 2;"14";"5";"1124";"496";"628";"78,98%";"622";"621";"99,84%";"1";"0,16%";"499";"3";"0.6";"496";"99,40%";"0.6";0.600
"MULTIPOLYGON (((-58.4041695738179 -34.5925150693602,-58.4030463644324 -34.5929086959128,-58.4030929550962 -34.5930173144968,-58.4036134755765 -34.5940778204799,-58.4037538640088 -34.5940196466581,-58.405003442342 -34.5934125439806,-58.405106451411 -34.5933418856387,-58.4041695738179 -34.5925150693602)))";;"1796";2_14_6;COMUNA 2;"14";"6";"1031";"424";"607";"69,85%";"734";"734";"100,00%";"0";"0,00%";"532";"6";"1.13";"526";"98,87%";"1.13";1.130
"MULTIPOLYGON (((-58.4050990159551 -34.5917761162337,-58.4042268224148 -34.5924855886,-58.4041695738179 -34.5925150693602,-58.405106451411 -34.5933418856387,-58.4053042044082 -34.5932063396789,-58.4060817323381 -34.5925713962147,-58.4059557662455 -34.5924659110182,-58.4052007252029 -34.59185856182,-58.4050990159551 -34.5917761162337)))";;"1797";2_14_7;COMUNA 2;"14";"7";"648";"282";"366";"77,05%";"489";"489";"100,00%";"0";"0,00%";"348";"17";"4.89";"331";"95,11%";"4.89";4.890
"MULTIPOLYGON (((-58.4060817323381 -34.5925713962147,-58.4053042044082 -34.5932063396789,-58.405106451411 -34.5933418856387,-58.4060901589261 -34.594209844725,-58.40710635031 -34.5936472616749,-58.4072655736795 -34.5935629646008,-58.4060817323381 -34.5925713962147)))";;"1798";2_14_8;COMUNA 2;"14";"8";"695";"272";"423";"64,30%";"566";"566";"100,00%";"0";"0,00%";"380";"4";"1.05";"376";"98,95%";"1.05";1.050
"MULTIPOLYGON (((-58.405106451411 -34.5933418856387,-58.405003442342 -34.5934125439806,-58.4037538640088 -34.5940196466581,-58.4036134755765 -34.5940778204799,-58.4038644288335 -34.5945890884712,-58.4041767787824 -34.5952347567967,-58.4043735773052 -34.5951330864917,-58.4051052307002 -34.5947404609345,-58.4059621968887 -34.5942807035638,-58.4060901589261 -34.594209844725,-58.405106451411 -34.5933418856387)))";;"1799";2_14_9;COMUNA 2;"14";"9";"1475";"682";"793";"86,00%";"894";"893";"99,89%";"1";"0,11%";"605";"68";"11.24";"537";"88,76%";"11.24";11.240
"MULTIPOLYGON (((-58.4010325337264 -34.5915634165405,-58.3999587665999 -34.5920019710594,-58.3999897281931 -34.5920507917154,-58.4003572169446 -34.5929324231544,-58.401286306577 -34.5926089378563,-58.4014858045173 -34.592538683209,-58.4011129741619 -34.5917268438996,-58.4010325337264 -34.5915634165405)))";;"1800";2_15_1;COMUNA 2;"15";"1";"601";"266";"335";"79,40%";"365";"365";"100,00%";"0";"0,00%";"266";"2";"0.75";"264";"99,25%";"0.75";0.750
"MULTIPOLYGON (((-58.3999587665999 -34.5920019710594,-58.3987423005689 -34.5924975563119,-58.3991069770028 -34.5932553118726,-58.3991501648521 -34.5933526621321,-58.4003572169446 -34.5929324231544,-58.3999897281931 -34.5920507917154,-58.3999587665999 -34.5920019710594)))";;"1801";2_15_2;COMUNA 2;"15";"2";"798";"336";"462";"72,73%";"589";"588";"99,83%";"1";"0,17%";"388";"1";"0.26";"387";"99,74%";"0.26";0.260
"MULTIPOLYGON (((-58.3987423005689 -34.5924975563119,-58.3974670671638 -34.592873656679,-58.3975082938681 -34.5929714290279,-58.3980717075527 -34.5943066401433,-58.3980967845058 -34.594366021937,-58.3981227957756 -34.5944286437826,-58.3994928591538 -34.5941337861838,-58.399438284934 -34.5940019217635,-58.3991501648521 -34.5933526621321,-58.3991069770028 -34.5932553118726,-58.3987423005689 -34.5924975563119)))";;"1802";2_15_3;COMUNA 2;"15";"3";"1393";"618";"775";"79,74%";"931";"931";"100,00%";"0";"0,00%";"630";"4";"0.63";"626";"99,37%";"0.63";0.630
"MULTIPOLYGON (((-58.4003572169446 -34.5929324231544,-58.3991501648521 -34.5933526621321,-58.399438284934 -34.5940019217635,-58.3994928591538 -34.5941337861838,-58.3996414063188 -34.5941018195283,-58.4006913895257 -34.5937338924558,-58.4003572169446 -34.5929324231544)))";;"1803";2_15_4;COMUNA 2;"15";"4";"628";"285";"343";"83,09%";"457";"457";"100,00%";"0";"0,00%";"310";"1";"0.32";"309";"99,68%";"0.32";0.320
"MULTIPOLYGON (((-58.4014858045173 -34.592538683209,-58.401286306577 -34.5926089378563,-58.4003572169446 -34.5929324231544,-58.4006913895257 -34.5937338924558,-58.4018462240534 -34.5933292466468,-58.4017145226333 -34.5930368454791,-58.4014858045173 -34.592538683209)))";;"1804";2_15_5;COMUNA 2;"15";"5";"555";"230";"325";"70,77%";"416";"416";"100,00%";"0";"0,00%";"267";"5";"1.87";"262";"98,13%";"1.87";1.870
"MULTIPOLYGON (((-58.4018462240534 -34.5933292466468,-58.4006913895257 -34.5937338924558,-58.4007412056316 -34.5938534294807,-58.4010619454108 -34.5946338336697,-58.4011127612527 -34.5947849215571,-58.4023478713047 -34.5944428492193,-58.4018462240534 -34.5933292466468)))";;"1805";2_15_6;COMUNA 2;"15";"6";"605";"273";"332";"82,23%";"441";"441";"100,00%";"0";"0,00%";"286";"1";"0.35";"285";"99,65%";"0.35";0.350
"MULTIPOLYGON (((-58.4006913895257 -34.5937338924558,-58.3996414063188 -34.5941018195283,-58.3994928591538 -34.5941337861838,-58.399899790535 -34.595117696628,-58.4003726273531 -34.5949899058924,-58.4011127612527 -34.5947849215571,-58.4010619454108 -34.5946338336697,-58.4007412056316 -34.5938534294807,-58.4006913895257 -34.5937338924558)))";;"1806";2_15_7;COMUNA 2;"15";"7";"756";"334";"422";"79,15%";"523";"523";"100,00%";"0";"0,00%";"367";"2";"0.54";"365";"99,46%";"0.54";0.540
"MULTIPOLYGON (((-58.3994928591538 -34.5941337861838,-58.3981227957756 -34.5944286437826,-58.3985216399272 -34.5953891028704,-58.3996711713676 -34.5951718766479,-58.3997650347117 -34.5951541779229,-58.399899790535 -34.595117696628,-58.3994928591538 -34.5941337861838)))";;"1807";2_15_8;COMUNA 2;"15";"8";"708";"309";"399";"77,44%";"487";"487";"100,00%";"0";"0,00%";"339";"5";"1.47";"334";"98,53%";"1.47";1.470
"MULTIPOLYGON (((-58.3974670671638 -34.592873656679,-58.3971964480766 -34.5929534444365,-58.3969960175331 -34.5930125643648,-58.396854275855 -34.5930550952735,-58.3971333497642 -34.5943548738738,-58.3971537968086 -34.594453057704,-58.397305740235 -34.5944360258786,-58.3980717075527 -34.5943066401433,-58.3975082938681 -34.5929714290279,-58.3974670671638 -34.592873656679)))";;"1808";2_16_1;COMUNA 2;"16";"1";"807";"344";"463";"74,30%";"497";"494";"99,40%";"3";"0,61%";"321";"2";"0.62";"319";"99,38%";"0.62";0.620
"MULTIPOLYGON (((-58.396854275855 -34.5930550952735,-58.3957521952598 -34.5933858466668,-58.3956895013169 -34.5934046158102,-58.395887136135 -34.5946060387365,-58.3960542390005 -34.5945890871943,-58.3970096037807 -34.5944692484092,-58.3971537968086 -34.594453057704,-58.3971333497642 -34.5943548738738,-58.396854275855 -34.5930550952735)))";;"1809";2_16_2;COMUNA 2;"16";"2";"712";"306";"406";"75,37%";"434";"433";"99,77%";"1";"0,23%";"308";"15";"4.87";"293";"95,13%";"4.87";4.870
"MULTIPOLYGON (((-58.3956895013169 -34.5934046158102,-58.3943168609925 -34.5936207642484,-58.3945069768721 -34.5947245052808,-58.3957558896515 -34.5946193476107,-58.395887136135 -34.5946060387365,-58.3956895013169 -34.5934046158102)))";;"1810";2_16_3;COMUNA 2;"16";"3";"698";"329";"369";"89,16%";"506";"506";"100,00%";"0";"0,00%";"305";"1";"0.33";"304";"99,67%";"0.33";0.330
"MULTIPOLYGON (((-58.3931963708589 -34.5948356609603,-58.3932101816354 -34.5949532192679,-58.3933119614992 -34.5958630308263,-58.3946866382589 -34.5958090138962,-58.3946666054114 -34.5956237842755,-58.3945244372208 -34.5948263499892,-58.3945069768721 -34.5947245052808,-58.3945056263186 -34.5947166645816,-58.3931963708589 -34.5948356609603)))";;"1811";2_16_8;COMUNA 2;"16";"8";"425";"187";"238";"78,57%";"394";"394";"100,00%";"0";"0,00%";"196";"2";"1.02";"194";"98,98%";"1.02";1.020
"MULTIPOLYGON (((-58.395887136135 -34.5946060387365,-58.3957558896515 -34.5946193476107,-58.3945069768721 -34.5947245052808,-58.3945244372208 -34.5948263499892,-58.3946666054114 -34.5956237842755,-58.3946866382589 -34.5958090138962,-58.3948102153823 -34.5958038712402,-58.3958989867163 -34.5957601041944,-58.3960940301966 -34.5957374634477,-58.3960875986187 -34.5955795664841,-58.395887136135 -34.5946060387365)))";;"1812";2_16_5;COMUNA 2;"16";"5";"822";"350";"472";"74,15%";"572";"572";"100,00%";"0";"0,00%";"386";"23";"5.96";"363";"94,04%";"5.96";5.960
"MULTIPOLYGON (((-58.3971537968086 -34.594453057704,-58.3970096037807 -34.5944692484092,-58.3960542390005 -34.5945890871943,-58.395887136135 -34.5946060387365,-58.3960875986187 -34.5955795664841,-58.3960940301966 -34.5957374634477,-58.3962636924451 -34.5957176960094,-58.3973704357986 -34.5955596254031,-58.3973553001932 -34.595420809089,-58.3971537968086 -34.594453057704)))";;"1813";2_16_6;COMUNA 2;"16";"6";"675";"267";"408";"65,44%";"466";"466";"100,00%";"0";"0,00%";"318";"1";"0.31";"317";"99,69%";"0.31";0.310
"MULTIPOLYGON (((-58.3981227957756 -34.5944286437826,-58.3980967845058 -34.594366021937,-58.3980717075527 -34.5943066401433,-58.397305740235 -34.5944360258786,-58.3971537968086 -34.594453057704,-58.3973553001932 -34.595420809089,-58.3973704357986 -34.5955596254031,-58.3983907244893 -34.5954138236445,-58.3985216399272 -34.5953891028704,-58.3981227957756 -34.5944286437826)))";;"1814";2_16_7;COMUNA 2;"16";"7";"770";"327";"443";"73,81%";"454";"453";"99,78%";"1";"0,22%";"359";"0";"0";"359";"100,00%";"0";0.000
"MULTIPOLYGON (((-58.3985216399272 -34.5953891028704,-58.3983907244893 -34.5954138236445,-58.3973704357986 -34.5955596254031,-58.3975513884978 -34.5972217583082,-58.3976701200303 -34.5972077365896,-58.3988690300277 -34.597048715569,-58.3985216399272 -34.5953891028704)))";;"1815";2_17_1;COMUNA 2;"17";"1";"1217";"542";"675";"80,30%";"868";"867";"99,88%";"1";"0,12%";"571";"2";"0.35";"569";"99,65%";"0.35";0.350
"MULTIPOLYGON (((-58.3973704357986 -34.5955596254031,-58.3962636924451 -34.5957176960094,-58.3960940301966 -34.5957374634477,-58.3961002954048 -34.5958904305474,-58.3961109413952 -34.5971704858623,-58.3960997678227 -34.5972983720197,-58.3962545172898 -34.5972936674646,-58.397397054424 -34.5972400568039,-58.3975513884978 -34.5972217583082,-58.3973704357986 -34.5955596254031)))";;"1816";2_17_2;COMUNA 2;"17";"2";"838";"371";"467";"79,44%";"565";"564";"99,82%";"1";"0,18%";"382";"1";"0.26";"381";"99,74%";"0.26";0.260
"MULTIPOLYGON (((-58.3960940301966 -34.5957374634477,-58.3958989867163 -34.5957601041944,-58.3948102153823 -34.5958038712402,-58.3946866382589 -34.5958090138962,-58.3947026976905 -34.5959583948342,-58.3947778667533 -34.5971472150507,-58.394765929067 -34.5972696779157,-58.3959679284698 -34.5973023142317,-58.3960997678227 -34.5972983720197,-58.3961109413952 -34.5971704858623,-58.3961002954048 -34.5958904305474,-58.3960940301966 -34.5957374634477)))";;"1817";2_17_3;COMUNA 2;"17";"3";"931";"396";"535";"74,02%";"765";"764";"99,87%";"1";"0,13%";"454";"2";"0.44";"452";"99,56%";"0.44";0.440
"MULTIPOLYGON (((-58.3946866382589 -34.5958090138962,-58.3933119614992 -34.5958630308263,-58.39332388045 -34.5959702952809,-58.393191335992 -34.5972320291752,-58.3946323074292 -34.5972660117655,-58.394765929067 -34.5972696779157,-58.3947778667533 -34.5971472150507,-58.3947026976905 -34.5959583948342,-58.3946866382589 -34.5958090138962)))";;"1818";2_17_4;COMUNA 2;"17";"4";"339";"136";"203";"67,00%";"394";"393";"99,75%";"1";"0,25%";"168";"3";"1.79";"165";"98,21%";"1.79";1.790
"MULTIPOLYGON (((-58.394765929067 -34.5972696779157,-58.3946323074292 -34.5972660117655,-58.393191335992 -34.5972320291752,-58.3930357807776 -34.5987117860495,-58.3944029650579 -34.5987126293486,-58.3945482603775 -34.5987120063317,-58.3947555372856 -34.5973762255317,-58.394765929067 -34.5972696779157)))";;"1819";2_17_5;COMUNA 2;"17";"5";"532";"233";"299";"77,93%";"592";"592";"100,00%";"0";"0,00%";"290";"1";"0.34";"289";"99,66%";"0.34";0.340
"MULTIPOLYGON (((-58.3960997678227 -34.5972983720197,-58.3959679284698 -34.5973023142317,-58.394765929067 -34.5972696779157,-58.3947555372856 -34.5973762255317,-58.3945482603775 -34.5987120063317,-58.3957763719993 -34.59870669992,-58.3958784044882 -34.5987035867012,-58.3960887662897 -34.5974240750846,-58.3960997678227 -34.5972983720197)))";;"1820";2_17_6;COMUNA 2;"17";"6";"986";"442";"544";"81,25%";"692";"690";"99,71%";"2";"0,29%";"452";"4";"0.88";"448";"99,12%";"0.88";0.880
"MULTIPOLYGON (((-58.3975513884978 -34.5972217583082,-58.397397054424 -34.5972400568039,-58.3962545172898 -34.5972936674646,-58.3960997678227 -34.5972983720197,-58.3960887662897 -34.5974240750846,-58.3958784044882 -34.5987035867012,-58.3960325604617 -34.59869881168,-58.3973272780961 -34.5985774652432,-58.3973512494483 -34.5984183170481,-58.3975513884978 -34.5972217583082)))";;"1821";2_17_7;COMUNA 2;"17";"7";"1121";"473";"648";"72,99%";"939";"939";"100,00%";"0";"0,00%";"577";"2";"0.35";"575";"99,65%";"0.35";0.350
"MULTIPOLYGON (((-58.3973272780961 -34.5985774652432,-58.3960325604617 -34.59869881168,-58.3958784044882 -34.5987035867012,-58.3958163680119 -34.5997033796732,-58.3971856773585 -34.5997302503009,-58.397312981125 -34.598672038674,-58.3973272780961 -34.5985774652432)))";;"1822";2_17_8;COMUNA 2;"17";"8";"913";"380";"533";"71,29%";"724";"724";"100,00%";"0";"0,00%";"489";"59";"12.07";"430";"87,93%";"12.07";12.070
"MULTIPOLYGON (((-58.3945482603775 -34.5987120063317,-58.3944029650579 -34.5987126293486,-58.3930357807776 -34.5987117860495,-58.392961005351 -34.5994236719657,-58.3929308478483 -34.5996371135758,-58.3943961311923 -34.5996740003001,-58.3947117571341 -34.5996818529173,-58.3958163680119 -34.5997033796732,-58.3958784044882 -34.5987035867012,-58.3957763719993 -34.59870669992,-58.3945482603775 -34.5987120063317)))";;"1823";2_17_9;COMUNA 2;"17";"9";"741";"315";"426";"73,94%";"560";"560";"100,00%";"0";"0,00%";"366";"8";"2.19";"358";"97,81%";"2.19";2.190
"MULTIPOLYGON (((-58.4023478713047 -34.5944428492193,-58.4011127612527 -34.5947849215571,-58.4011747945026 -34.5949689741065,-58.4016065887819 -34.596341357038,-58.4028222572832 -34.5958248268708,-58.4023478713047 -34.5944428492193)))";;"1824";2_18_1;COMUNA 2;"18";"1";"891";"398";"493";"80,73%";"659";"658";"99,85%";"1";"0,15%";"458";"24";"5.24";"434";"94,76%";"5.24";5.240
"MULTIPOLYGON (((-58.4011127612527 -34.5947849215571,-58.4003726273531 -34.5949899058924,-58.399899790535 -34.595117696628,-58.3997650347117 -34.5951541779229,-58.3996711713676 -34.5951718766479,-58.4002853856879 -34.5967440843176,-58.4004235488714 -34.5967097169557,-58.4016065887819 -34.596341357038,-58.4011747945026 -34.5949689741065,-58.4011127612527 -34.5947849215571)))";;"1825";2_18_2;COMUNA 2;"18";"2";"1188";"493";"695";"70,94%";"868";"868";"100,00%";"0";"0,00%";"548";"14";"2.55";"534";"97,45%";"2.55";2.550
"MULTIPOLYGON (((-58.3996711713676 -34.5951718766479,-58.3985216399272 -34.5953891028704,-58.3988690300277 -34.597048715569,-58.3990010495544 -34.5970311782421,-58.4001579551796 -34.5967757808642,-58.4002853856879 -34.5967440843176,-58.3996711713676 -34.5951718766479)))";;"1826";2_18_3;COMUNA 2;"18";"3";"787";"322";"465";"69,25%";"734";"731";"99,59%";"3";"0,41%";"397";"3";"0.76";"394";"99,24%";"0.76";0.760
"MULTIPOLYGON (((-58.3988690300277 -34.597048715569,-58.3976701200303 -34.5972077365896,-58.3975513884978 -34.5972217583082,-58.3973512494483 -34.5984183170481,-58.3973272780961 -34.5985774652432,-58.397312981125 -34.598672038674,-58.3971856773585 -34.5997302503009,-58.3987230216627 -34.5997602924901,-58.3999209290805 -34.5996215431604,-58.4010694339109 -34.5994845881792,-58.4006875308326 -34.5980096198354,-58.4007908503405 -34.5979922772626,-58.4020881800973 -34.5977677086254,-58.4018266856004 -34.596998393857,-58.4016471180564 -34.5964701147031,-58.4016065887819 -34.596341357038,-58.4004235488714 -34.5967097169557,-58.4002853856879 -34.5967440843176,-58.4001579551796 -34.5967757808642,-58.3990010495544 -34.5970311782421,-58.3988690300277 -34.597048715569)))";;"1827";2_18_4;COMUNA 2;"18";"4";"1185";"501";"684";"73,25%";"451";"445";"98,67%";"6";"1,35%";"267";"6";"2.25";"261";"97,75%";"2.25";2.250
"MULTIPOLYGON (((-58.4028222572832 -34.5958248268708,-58.4016065887819 -34.596341357038,-58.4016471180564 -34.5964701147031,-58.4018266856004 -34.596998393857,-58.4028608497127 -34.5966378350675,-58.4030770486584 -34.5965670226562,-58.4028222572832 -34.5958248268708)))";;"1828";2_18_5;COMUNA 2;"18";"5";"549";"234";"315";"74,29%";"334";"334";"100,00%";"0";"0,00%";"250";"6";"2.4";"244";"97,60%";"2.4";2.400
"MULTIPOLYGON (((-58.4030770486584 -34.5965670226562,-58.4028608497127 -34.5966378350675,-58.4018266856004 -34.596998393857,-58.4020881800973 -34.5977677086254,-58.4034106299335 -34.5975387016003,-58.4030770486584 -34.5965670226562)))";;"1829";2_18_6;COMUNA 2;"18";"6";"744";"314";"430";"73,02%";"516";"516";"100,00%";"0";"0,00%";"367";"19";"5.18";"348";"94,82%";"5.18";5.180
"MULTIPOLYGON (((-58.4034106299335 -34.5975387016003,-58.4020881800973 -34.5977677086254,-58.4025368197199 -34.5990874883694,-58.4030827802325 -34.5987960550108,-58.4037215185266 -34.5984550847024,-58.4036740159329 -34.5983058306476,-58.4034106299335 -34.5975387016003)))";;"1830";2_18_7;COMUNA 2;"18";"7";"595";"228";"367";"62,13%";"362";"361";"99,72%";"1";"0,28%";"277";"24";"8.66";"253";"91,34%";"8.66";8.660
"MULTIPOLYGON (((-58.4020881800973 -34.5977677086254,-58.4007908503405 -34.5979922772626,-58.4006875308326 -34.5980096198354,-58.4010694339109 -34.5994845881792,-58.4012081843027 -34.5994681082511,-58.4020082362967 -34.5993697022085,-58.4024743679909 -34.599120839122,-58.4025368197199 -34.5990874883694,-58.4020881800973 -34.5977677086254)))";;"1831";2_18_8;COMUNA 2;"18";"8";"912";"373";"539";"69,20%";"550";"548";"99,64%";"2";"0,36%";"335";"88";"26.27";"247";"73,73%";"26.27";26.270
"MULTIPOLYGON (((-58.4060901589261 -34.594209844725,-58.4059621968887 -34.5942807035638,-58.4051052307002 -34.5947404609345,-58.405603772133 -34.5957393960842,-58.4062335285566 -34.5955331317881,-58.4064902686294 -34.5954490216893,-58.4066815029791 -34.5953864311305,-58.4066367707406 -34.5952914773135,-58.4060901589261 -34.594209844725)))";;"1832";2_19_1;COMUNA 2;"19";"1";"854";"382";"472";"80,93%";"570";"570";"100,00%";"0";"0,00%";"393";"4";"1.02";"389";"98,98%";"1.02";1.020
"MULTIPOLYGON (((-58.4051052307002 -34.5947404609345,-58.4043735773052 -34.5951330864917,-58.4041767787824 -34.5952347567967,-58.4045826792583 -34.5960739270618,-58.405603772133 -34.5957393960842,-58.4051052307002 -34.5947404609345)))";;"1833";2_19_2;COMUNA 2;"19";"2";"675";"302";"373";"80,97%";"425";"425";"100,00%";"0";"0,00%";"306";"1";"0.33";"305";"99,67%";"0.33";0.330
"MULTIPOLYGON (((-58.4041767787824 -34.5952347567967,-58.4040604033508 -34.5952948441164,-58.4028222572832 -34.5958248268708,-58.4030770486584 -34.5965670226562,-58.404289987771 -34.5961697769529,-58.4045826792583 -34.5960739270618,-58.4041767787824 -34.5952347567967)))";;"1834";2_19_3;COMUNA 2;"19";"3";"717";"307";"410";"74,88%";"400";"400";"100,00%";"0";"0,00%";"305";"12";"3.93";"293";"96,07%";"3.93";3.930
"MULTIPOLYGON (((-58.4045826792583 -34.5960739270618,-58.404289987771 -34.5961697769529,-58.4030770486584 -34.5965670226562,-58.4034106299335 -34.5975387016003,-58.4051776895651 -34.5972327749726,-58.4046385517948 -34.5961894510977,-58.4045826792583 -34.5960739270618)))";;"1835";2_19_4;COMUNA 2;"19";"4";"997";"436";"561";"77,72%";"690";"690";"100,00%";"0";"0,00%";"499";"28";"5.61";"471";"94,39%";"5.61";5.610
"MULTIPOLYGON (((-58.4062335285566 -34.5955331317881,-58.405603772133 -34.5957393960842,-58.4045826792583 -34.5960739270618,-58.4046385517948 -34.5961894510977,-58.4051776895651 -34.5972327749726,-58.4065068513462 -34.5970025402976,-58.4064650865773 -34.5967999780117,-58.4062335285566 -34.5955331317881)))";;"1836";2_19_5;COMUNA 2;"19";"5";"790";"334";"456";"73,25%";"524";"523";"99,81%";"1";"0,19%";"361";"3";"0.83";"358";"99,17%";"0.83";0.830
"MULTIPOLYGON (((-58.4066815029791 -34.5953864311305,-58.4064902686294 -34.5954490216893,-58.4062335285566 -34.5955331317881,-58.4064650865773 -34.5967999780117,-58.4065068513462 -34.5970025402976,-58.4069837367154 -34.5968070471741,-58.4073664113027 -34.5966360879126,-58.4073122271852 -34.5965368341345,-58.4067283613868 -34.5954858931226,-58.4066815029791 -34.5953864311305)))";;"1837";2_19_6;COMUNA 2;"19";"6";"745";"327";"418";"78,23%";"574";"572";"99,65%";"2";"0,35%";"424";"2";"0.47";"422";"99,53%";"0.47";0.470
"MULTIPOLYGON (((-58.4069837367154 -34.5968070471741,-58.4065068513462 -34.5970025402976,-58.4051776895651 -34.5972327749726,-58.4054908533228 -34.5978386497836,-58.4055862711666 -34.5980409557906,-58.4066262332025 -34.5980458044772,-58.4081479690345 -34.59806895992,-58.4075582256242 -34.5969877376432,-58.4073664113027 -34.5966360879126,-58.4069837367154 -34.5968070471741)))";;"1838";2_19_7;COMUNA 2;"19";"7";"682";"310";"372";"83,33%";"452";"451";"99,78%";"1";"0,22%";"324";"5";"1.54";"319";"98,46%";"1.54";1.540
"MULTIPOLYGON (((-58.4051776895651 -34.5972327749726,-58.4034106299335 -34.5975387016003,-58.4036740159329 -34.5983058306476,-58.4037215185266 -34.5984550847024,-58.4045067070641 -34.5980359385108,-58.4047319711159 -34.5980369612585,-58.4055862711666 -34.5980409557906,-58.4054908533228 -34.5978386497836,-58.4051776895651 -34.5972327749726)))";;"1839";2_19_8;COMUNA 2;"19";"8";"831";"357";"474";"75,32%";"516";"514";"99,61%";"2";"0,39%";"377";"21";"5.57";"356";"94,43%";"5.57";5.570
"MULTIPOLYGON (((-58.399938993802 -34.5836418366712,-58.3990938791467 -34.5844048809748,-58.3997799076243 -34.5849151868831,-58.3999308859935 -34.5850253395169,-58.4004723122209 -34.5845367940964,-58.4005437183744 -34.584471827839,-58.399938993802 -34.5836418366712)))";;"1840";2_2_1;COMUNA 2;"2";"1";"587";"267";"320";"83,44%";"335";"333";"99,40%";"2";"0,60%";"252";"11";"4.37";"241";"95,63%";"4.37";4.370
"MULTIPOLYGON (((-58.3981093172348 -34.5807020994905,-58.3979491781786 -34.5807791304987,-58.3978441526259 -34.580827104887,-58.3960787171595 -34.5816335816289,-58.395985870288 -34.5816759974482,-58.397219255344 -34.5830955263857,-58.397311486705 -34.5830791667124,-58.3990938791467 -34.5844048809748,-58.399938993802 -34.5836418366712,-58.3992749930615 -34.5827303998269,-58.3993616029316 -34.5827150216373,-58.3981093172348 -34.5807020994905)))";;"1841";2_2_2;COMUNA 2;"2";"2";"878";"390";"488";"79,92%";"523";"523";"100,00%";"0";"0,00%";"362";"1";"0.28";"361";"99,72%";"0.28";0.280
"MULTIPOLYGON (((-58.3912918879096 -34.584893895391,-58.3917185351221 -34.5847567443332,-58.3922649879371 -34.5850264380449,-58.3923398913605 -34.5850634545796,-58.3933167107167 -34.5855407232568,-58.3935101011722 -34.5856352030613,-58.3943192835783 -34.5847390030691,-58.3944279611051 -34.5849194937682,-58.3948828295341 -34.585570830089,-58.3954308906717 -34.5859774174341,-58.3955065621078 -34.5859094282017,-58.3960292550947 -34.5855664615395,-58.396403188819 -34.5853210919141,-58.3965414765192 -34.5853226458887,-58.3966432902864 -34.585242250721,-58.3983866607437 -34.5856572372391,-58.3986056348515 -34.5857106644509,-58.3987165693263 -34.5857377660078,-58.3989437938265 -34.5859157090156,-58.3991137925554 -34.585762481644,-58.3992974245879 -34.585596936672,-58.3999308859935 -34.5850253395169,-58.3997799076243 -34.5849151868832,-58.3990938791467 -34.5844048809748,-58.397311486705 -34.5830791667124,-58.397219255344 -34.5830955263857,-58.395985870288 -34.5816759974482,-58.3960787171595 -34.5816335816289,-58.3978441526259 -34.580827104887,-58.3979491781786 -34.5807791304987,-58.3981093172348 -34.5807020994905,-58.3979600442246 -34.5804922230065,-58.3969133464146 -34.5790413108743,-58.396771433382 -34.5788393085216,-58.3967557534629 -34.5788173907358,-58.3966626680306 -34.5786696553921,-58.3964207197784 -34.578791608046,-58.3946827033108 -34.5796322361136,-58.394617284637 -34.579663398116,-58.3945992514662 -34.579641204038,-58.3945188743644 -34.5795343237516,-58.394307979692 -34.5796194909859,-58.3940864260459 -34.5797230329059,-58.3940349628123 -34.5796609591413,-58.3931067554886 -34.580086789097,-58.3926649234916 -34.5802890095284,-58.3922688343769 -34.5804670988303,-58.3922032309498 -34.5805135417478,-58.3916110971341 -34.5807657391842,-58.391653517558 -34.5808289005499,-58.3916265026361 -34.5808351923827,-58.3915323076856 -34.5808592229947,-58.3914575287505 -34.5808807295527,-58.3913929670231 -34.5809029462889,-58.3913393902331 -34.5809242538832,-58.3912907517436 -34.5809459164705,-58.391170213857 -34.5810069751663,-58.3910944824159 -34.5810467211307,-58.3910442215503 -34.5810735237241,-58.3909216351228 -34.5811399333032,-58.3907991334676 -34.5812065540845,-58.3907172671708 -34.581250662576,-58.3906703284565 -34.5812756359124,-58.3906102710314 -34.5813072214733,-58.3905501285335 -34.5813386661034,-58.3904294180214 -34.5814011324695,-58.3901874012053 -34.5815251489567,-58.3900262263975 -34.5816080142488,-58.3899343085288 -34.581655707923,-58.3897717689179 -34.5817407552515,-58.3896095692048 -34.5818262251182,-58.3895016344376 -34.5818833458786,-58.3893578343882 -34.5819598824132,-58.3891664124647 -34.5820623066506,-58.3890572835612 -34.5821210460807,-58.3889326496076 -34.5821883679436,-58.3887903806529 -34.5822655385592,-58.3886280058675 -34.5823541057252,-58.3884427136573 -34.58245575786,-58.3883919383108 -34.5824846718034,-58.3883416710089 -34.5825167551787,-58.3880906627529 -34.5826903414949,-58.3878734793099 -34.5828404963691,-58.3878395683027 -34.5828639272364,-58.3878226116866 -34.5828768751105,-58.3874134362518 -34.5831888896634,-58.3869635947458 -34.583551372613,-58.3867336564576 -34.5837707456887,-58.3866428058206 -34.5838573827748,-58.3864214464393 -34.584098381193,-58.3859756507791 -34.5845886146303,-58.3855993091385 -34.5850143806391,-58.3853252002859 -34.5853834474545,-58.3850582940573 -34.5858795655916,-58.3847113977328 -34.5864528295136,-58.3845074767953 -34.586956140005,-58.384317385724 -34.5870811760235,-58.3838373043093 -34.5874163965732,-58.3836826730853 -34.5874961846054,-58.3838433859003 -34.5876791725766,-58.3850250304915 -34.5870352951572,-58.3858242703934 -34.5866002907623,-58.3858455697248 -34.5865886839913,-58.3874401960287 -34.5859033120726,-58.388578846986 -34.5853502674254,-58.3886271704127 -34.5853210044668,-58.3892831905234 -34.5851182056845,-58.3895629025375 -34.5850390746385,-58.3898493883321 -34.5850033994586,-58.3899949882782 -34.5850167262549,-58.3903407670799 -34.585048341475,-58.3906990213654 -34.5850302427516,-58.3910022883034 -34.5849869688218,-58.3912918879096 -34.584893895391)))";;"1842";2_2_3;COMUNA 2;"2";"3";"572";"265";"307";"86,32%";"303";"303";"100,00%";"0";"0,00%";"229";"2";"0.87";"227";"99,13%";"0.87";0.870
"MULTIPOLYGON (((-58.3966432902864 -34.585242250721,-58.3965414765192 -34.5853226458887,-58.3971231095895 -34.5867942164151,-58.3983866607437 -34.5856572372391,-58.3966432902864 -34.585242250721)))";;"1843";2_2_4;COMUNA 2;"2";"4";"540";"232";"308";"75,32%";"240";"240";"100,00%";"0";"0,00%";"205";"0";"0";"205";"100,00%";"0";0.000
"MULTIPOLYGON (((-58.3975670145146 -34.5871524010538,-58.3975687834015 -34.5871553850942,-58.3982435116009 -34.5865471272527,-58.3989437938265 -34.5859157090156,-58.3987165693263 -34.5857377660078,-58.3986056348515 -34.5857106644509,-58.3983866607437 -34.5856572372391,-58.3971231095895 -34.5867942164151,-58.3975670145146 -34.5871524010538)))";;"1844";2_2_5;COMUNA 2;"2";"5";"600";"256";"344";"74,42%";"361";"361";"100,00%";"0";"0,00%";"259";"0";"0";"259";"100,00%";"0";0.000
"MULTIPOLYGON (((-58.3965143483915 -34.5867811408019,-58.3969199791595 -34.5870796709283,-58.397337019702 -34.5870575842504,-58.3975670145146 -34.5871524010538,-58.3971231095895 -34.5867942164151,-58.3965414765192 -34.5853226458887,-58.396403188819 -34.5853210919141,-58.3960292550946 -34.5855664615395,-58.3955065621078 -34.5859094282017,-58.3954308906718 -34.5859774174341,-58.3965143483915 -34.5867811408019)))";;"1845";2_2_6;COMUNA 2;"2";"6";"472";"207";"265";"78,11%";"289";"289";"100,00%";"0";"0,00%";"197";"0";"0";"197";"100,00%";"0";0.000
"MULTIPOLYGON (((-58.3954308906718 -34.5859774174341,-58.3953409879977 -34.5860582866095,-58.394977651566 -34.5863536608447,-58.3962162439483 -34.5869668313245,-58.3972155751019 -34.5874615464262,-58.3972871466692 -34.5874092587627,-58.3975687834015 -34.5871553850942,-58.3975670145146 -34.5871524010538,-58.397337019702 -34.5870575842504,-58.3969199791595 -34.5870796709283,-58.3965143483915 -34.5867811408019,-58.3954308906718 -34.5859774174341)))";;"1846";2_2_7;COMUNA 2;"2";"7";"301";"136";"165";"82,42%";"196";"196";"100,00%";"0";"0,00%";"141";"0";"0";"141";"100,00%";"0";0.000
"MULTIPOLYGON (((-58.3943192835783 -34.5847390030691,-58.3935101011722 -34.5856352030614,-58.3937786524527 -34.5857664166505,-58.3947505513372 -34.5862412061399,-58.394977651566 -34.5863536608447,-58.3953409879977 -34.5860582866095,-58.3954308906718 -34.5859774174341,-58.3948828295341 -34.585570830089,-58.3944279611051 -34.5849194937682,-58.3943192835783 -34.5847390030691)))";;"1847";2_2_8;COMUNA 2;"2";"8";"697";"303";"394";"76,90%";"428";"427";"99,77%";"1";"0,23%";"282";"3";"1.06";"279";"98,94%";"1.06";1.060
"MULTIPOLYGON (((-58.4103298871933 -34.5939298254166,-58.4090554193998 -34.5944867584307,-58.4096236431721 -34.5956625457032,-58.4109718041962 -34.5950849330966,-58.4103298871933 -34.5939298254166)))";;"1848";2_20_1;COMUNA 2;"20";"1";"959";"422";"537";"78,58%";"595";"595";"100,00%";"0";"0,00%";"457";"1";"0.22";"456";"99,78%";"0.22";0.220
"MULTIPOLYGON (((-58.4090554193998 -34.5944867584307,-58.4089408433769 -34.5945368508146,-58.4081053288084 -34.5949019871098,-58.4078697949307 -34.5949902652375,-58.4084546139639 -34.5961637412716,-58.4087245748388 -34.5960477297096,-58.4096236431721 -34.5956625457032,-58.4090554193998 -34.5944867584307)))";;"1849";2_20_2;COMUNA 2;"20";"2";"822";"358";"464";"77,16%";"652";"651";"99,85%";"1";"0,15%";"449";"38";"8.46";"411";"91,54%";"8.46";8.460
"MULTIPOLYGON (((-58.4078697949307 -34.5949902652375,-58.4077162929673 -34.5950478744756,-58.4066815029791 -34.5953864311305,-58.4067283613868 -34.5954858931226,-58.4073122271852 -34.5965368341345,-58.4073664113027 -34.5966360879126,-58.4076471973581 -34.5965106466673,-58.4084546139639 -34.5961637412716,-58.4078697949307 -34.5949902652375)))";;"1850";2_20_3;COMUNA 2;"20";"3";"751";"278";"473";"58,77%";"514";"512";"99,61%";"2";"0,39%";"372";"20";"5.38";"352";"94,62%";"5.38";5.380
"MULTIPOLYGON (((-58.4075582256242 -34.5969877376432,-58.4081479690345 -34.59806895992,-58.4087214727026 -34.5980785110929,-58.4094280912428 -34.5980883994574,-58.4088616913076 -34.5969685301966,-58.4084546139639 -34.5961637412716,-58.4076471973581 -34.5965106466673,-58.4073664113027 -34.5966360879126,-58.4075582256242 -34.5969877376432)))";;"1851";2_20_4;COMUNA 2;"20";"4";"841";"389";"452";"86,06%";"527";"526";"99,81%";"1";"0,19%";"386";"14";"3.63";"372";"96,37%";"3.63";3.630
"MULTIPOLYGON (((-58.4096236431721 -34.5956625457032,-58.4087245748388 -34.5960477297096,-58.4084546139639 -34.5961637412716,-58.4088616913076 -34.5969685301966,-58.4102298824859 -34.5969484211462,-58.4102037904457 -34.5968631249331,-58.4096236431721 -34.5956625457032)))";;"1852";2_20_5;COMUNA 2;"20";"5";"504";"220";"284";"77,46%";"303";"302";"99,67%";"1";"0,33%";"251";"10";"3.98";"241";"96,02%";"3.98";3.980
"MULTIPOLYGON (((-58.4111518927695 -34.5954119938802,-58.4109718041962 -34.5950849330966,-58.4096236431721 -34.5956625457032,-58.4102037904457 -34.5968631249331,-58.4102298824859 -34.5969484211462,-58.4102944572496 -34.596917250505,-58.4114711922259 -34.5963485732015,-58.4116198610917 -34.5962558854453,-58.4111518927695 -34.5954119938802)))";;"1853";2_20_6;COMUNA 2;"20";"6";"637";"287";"350";"82,00%";"426";"426";"100,00%";"0";"0,00%";"356";"36";"10.11";"320";"89,89%";"10.11";10.110
"MULTIPOLYGON (((-58.4102298824859 -34.5969484211462,-58.410250790258 -34.5970166017863,-58.4102941448179 -34.5980927182868,-58.411918832168 -34.5980030496281,-58.4117397302634 -34.5968830725519,-58.4116198610917 -34.5962558854453,-58.4114711922259 -34.5963485732015,-58.4102944572496 -34.596917250505,-58.4102298824859 -34.5969484211462)))";;"1854";2_20_7;COMUNA 2;"20";"7";"569";"250";"319";"78,37%";"380";"378";"99,47%";"2";"0,53%";"247";"5";"2.02";"242";"97,98%";"2.02";2.020
"MULTIPOLYGON (((-58.4102298824859 -34.5969484211462,-58.4088616913076 -34.5969685301966,-58.4094280912428 -34.5980883994574,-58.4102941448179 -34.5980927182868,-58.410250790258 -34.5970166017863,-58.4102298824859 -34.5969484211462)))";;"1855";2_20_8;COMUNA 2;"20";"8";"671";"304";"367";"82,83%";"407";"405";"99,51%";"2";"0,49%";"301";"0";"0";"301";"100,00%";"0";0.000
"MULTIPOLYGON (((-58.4079382451492 -34.5908691479195,-58.4071366193975 -34.591673535758,-58.407349290443 -34.5918894860056,-58.4078725385015 -34.5924994645827,-58.4089771878002 -34.591789857424,-58.4090990175181 -34.5917103303838,-58.4079382451492 -34.5908691479195)))";;"1856";2_21_1;COMUNA 2;"21";"1";"1058";"458";"600";"76,33%";"658";"658";"100,00%";"0";"0,00%";"462";"23";"4.98";"439";"95,02%";"4.98";4.980
"MULTIPOLYGON (((-58.4078725385015 -34.5924994645827,-58.407349290443 -34.5918894860056,-58.4071366193975 -34.591673535758,-58.4062326353008 -34.5924481514156,-58.4060817323381 -34.5925713962147,-58.4072655736795 -34.5935629646008,-58.4074033285413 -34.5934899256394,-58.4081048514435 -34.5931583270587,-58.4083737541395 -34.593083796242,-58.4078725385015 -34.5924994645827)))";;"1857";2_21_2;COMUNA 2;"21";"2";"959";"393";"566";"69,43%";"605";"605";"100,00%";"0";"0,00%";"442";"3";"0.68";"439";"99,32%";"0.68";0.680
"MULTIPOLYGON (((-58.4090990175181 -34.5917103303838,-58.4089771878002 -34.591789857424,-58.4078725385015 -34.5924994645827,-58.4083737541395 -34.593083796242,-58.4084614859509 -34.5930595385365,-58.408593083641 -34.5930230462218,-58.4095665191727 -34.592820789907,-58.409698877488 -34.5927921139384,-58.4090990175181 -34.5917103303838)))";;"1858";2_21_3;COMUNA 2;"21";"3";"775";"352";"423";"83,22%";"473";"473";"100,00%";"0";"0,00%";"369";"2";"0.54";"367";"99,46%";"0.54";0.540
"MULTIPOLYGON (((-58.409698877488 -34.5927921139384,-58.4095665191727 -34.592820789907,-58.408593083641 -34.5930230462218,-58.4084614859509 -34.5930595385365,-58.4089408433769 -34.5945368508146,-58.4090554193998 -34.5944867584307,-58.4103298871933 -34.5939298254166,-58.4102267025302 -34.5937438583085,-58.409698877488 -34.5927921139384)))";;"1859";2_21_4;COMUNA 2;"21";"4";"1046";"436";"610";"71,48%";"774";"773";"99,87%";"1";"0,13%";"530";"5";"0.94";"525";"99,06%";"0.94";0.940
"MULTIPOLYGON (((-58.4084614859509 -34.5930595385365,-58.4083737541395 -34.593083796242,-58.4081048514435 -34.5931583270587,-58.4074033285413 -34.5934899256394,-58.4072655736795 -34.5935629646008,-58.4078697949307 -34.5949902652375,-58.4081053288084 -34.5949019871098,-58.4089408433769 -34.5945368508146,-58.4084614859509 -34.5930595385365)))";;"1860";2_21_5;COMUNA 2;"21";"5";"984";"417";"567";"73,54%";"652";"651";"99,85%";"1";"0,15%";"508";"2";"0.39";"506";"99,61%";"0.39";0.390
"MULTIPOLYGON (((-58.4072655736795 -34.5935629646008,-58.40710635031 -34.5936472616749,-58.4060901589261 -34.594209844725,-58.4066367707406 -34.5952914773135,-58.4066815029791 -34.5953864311305,-58.4077162929673 -34.5950478744756,-58.4078697949307 -34.5949902652375,-58.4072655736795 -34.5935629646008)))";;"1861";2_21_6;COMUNA 2;"21";"6";"926";"373";"553";"67,45%";"671";"668";"99,55%";"3";"0,45%";"481";"17";"3.53";"464";"96,47%";"3.53";3.530
"MULTIPOLYGON (((-58.4079382451492 -34.5908691479195,-58.4071400165957 -34.5902801721865,-58.4070220444766 -34.5901941995096,-58.4062560456946 -34.5908241543621,-58.4061466407117 -34.590914107282,-58.4062599307202 -34.5909978250192,-58.4070345819132 -34.5915699640356,-58.4071366193975 -34.591673535758,-58.4079382451492 -34.5908691479195)))";;"1862";2_22_1;COMUNA 2;"22";"1";"699";"298";"401";"74,31%";"556";"555";"99,82%";"1";"0,18%";"368";"4";"1.09";"364";"98,91%";"1.09";1.090
"MULTIPOLYGON (((-58.4070220444766 -34.5901941995096,-58.4064113339365 -34.5897493946109,-58.4062902140546 -34.5896610957317,-58.4055488099841 -34.5901892225299,-58.4053505524281 -34.5903264589281,-58.4055009513922 -34.5904372381384,-58.4061466407117 -34.590914107282,-58.4062560456946 -34.5908241543621,-58.4070220444766 -34.5901941995096)))";;"1863";2_22_2;COMUNA 2;"22";"2";"534";"233";"301";"77,41%";"378";"378";"100,00%";"0";"0,00%";"281";"1";"0.36";"280";"99,64%";"0.36";0.360
"MULTIPOLYGON (((-58.4052307023562 -34.5888890917189,-58.4044348387548 -34.5894803576931,-58.4043187936964 -34.5895668549818,-58.4044655302044 -34.5896746758641,-58.4053505524281 -34.5903264589281,-58.4055488099841 -34.5901892225299,-58.4062902140546 -34.5896610957317,-58.4053691835092 -34.5889897946785,-58.4052307023562 -34.5888890917189)))";;"1864";2_22_3;COMUNA 2;"22";"3";"439";"192";"247";"77,73%";"305";"305";"100,00%";"0";"0,00%";"205";"0";"0";"205";"100,00%";"0";0.000
"MULTIPOLYGON (((-58.4053505524281 -34.5903264589281,-58.4044655302044 -34.5896746758641,-58.4043187936964 -34.5895668549818,-58.4032617672375 -34.5903546859773,-58.4041407232182 -34.5910317574786,-58.4042308578951 -34.5911014513438,-58.4053505524281 -34.5903264589281)))";;"1865";2_22_4;COMUNA 2;"22";"4";"959";"397";"562";"70,64%";"695";"694";"99,86%";"1";"0,14%";"483";"2";"0.41";"481";"99,59%";"0.41";0.410
"MULTIPOLYGON (((-58.4061466407117 -34.590914107282,-58.4055009513922 -34.5904372381384,-58.4053505524281 -34.5903264589281,-58.4042308578951 -34.5911014513438,-58.4049971366861 -34.5916935296306,-58.4050990159551 -34.5917761162337,-58.4052059523029 -34.5916879941622,-58.4061466407117 -34.590914107282)))";;"1866";2_22_5;COMUNA 2;"22";"5";"1093";"473";"620";"76,29%";"744";"744";"100,00%";"0";"0,00%";"528";"1";"0.19";"527";"99,81%";"0.19";0.190
"MULTIPOLYGON (((-58.4071366193975 -34.591673535758,-58.4070345819132 -34.5915699640356,-58.4062599307202 -34.5909978250192,-58.4061466407117 -34.590914107282,-58.4052059523029 -34.5916879941622,-58.4050990159551 -34.5917761162337,-58.4052007252029 -34.59185856182,-58.4059557662455 -34.5924659110182,-58.4060817323381 -34.5925713962147,-58.4062326353008 -34.5924481514156,-58.4071366193975 -34.591673535758)))";;"1867";2_22_6;COMUNA 2;"22";"6";"1016";"420";"596";"70,47%";"919";"918";"99,89%";"1";"0,11%";"557";"1";"0.18";"556";"99,82%";"0.18";0.180
"MULTIPOLYGON (((-58.4083166981262 -34.5865459046194,-58.4074429788797 -34.5872399767856,-58.4082791946868 -34.5881676433334,-58.4090287048918 -34.5875592888259,-58.4083166981262 -34.5865459046194)))";;"1868";2_23_1;COMUNA 2;"23";"1";"1079";"443";"636";"69,65%";"630";"629";"99,84%";"1";"0,16%";"435";"1";"0.23";"434";"99,77%";"0.23";0.230
"MULTIPOLYGON (((-58.4074429788797 -34.5872399767856,-58.4073328151148 -34.5873274655933,-58.4064511011335 -34.5879825112833,-58.4074546163524 -34.5888274401462,-58.4076044823107 -34.5887137709494,-58.4081801906875 -34.588248024907,-58.4082791946868 -34.5881676433334,-58.4074429788797 -34.5872399767856)))";;"1869";2_23_2;COMUNA 2;"23";"2";"1025";"421";"604";"69,70%";"797";"797";"100,00%";"0";"0,00%";"512";"0";"0";"512";"100,00%";"0";0.000
"MULTIPOLYGON (((-58.4074546163524 -34.5888274401462,-58.4064511011335 -34.5879825112833,-58.4052307023562 -34.5888890917189,-58.4053691835092 -34.5889897946785,-58.4062902140546 -34.5896610957317,-58.4073649010515 -34.5888955008167,-58.4074546163524 -34.5888274401462)))";;"1870";2_23_3;COMUNA 2;"23";"3";"928";"384";"544";"70,59%";"712";"712";"100,00%";"0";"0,00%";"441";"4";"0.91";"437";"99,09%";"0.91";0.910
"MULTIPOLYGON (((-58.4080777064224 -34.5893521077766,-58.4074546163524 -34.5888274401462,-58.4073649010515 -34.5888955008167,-58.4062902140546 -34.5896610957317,-58.4064113339365 -34.5897493946109,-58.4070220444766 -34.5901941995096,-58.4071384343845 -34.5900984740959,-58.4080777064224 -34.5893521077766)))";;"1871";2_23_4;COMUNA 2;"23";"4";"849";"356";"493";"72,21%";"516";"515";"99,81%";"1";"0,19%";"381";"19";"4.99";"362";"95,01%";"4.99";4.990
"MULTIPOLYGON (((-58.4088171668784 -34.5887644552482,-58.4082791946868 -34.5881676433334,-58.4081801906875 -34.588248024907,-58.4076044823107 -34.5887137709494,-58.4074546163524 -34.5888274401462,-58.4080777064224 -34.5893521077766,-58.4088171668784 -34.5887644552482)))";;"1872";2_23_5;COMUNA 2;"23";"5";"650";"283";"367";"77,11%";"441";"441";"100,00%";"0";"0,00%";"295";"1";"0.34";"294";"99,66%";"0.34";0.340
"MULTIPOLYGON (((-58.4090287048918 -34.5875592888259,-58.4082791946868 -34.5881676433334,-58.4088171668784 -34.5887644552482,-58.4089159993851 -34.5886859041483,-58.409497827064 -34.5882271266918,-58.4090287048918 -34.5875592888259)))";;"1873";2_23_6;COMUNA 2;"23";"6";"406";"178";"228";"78,07%";"312";"312";"100,00%";"0";"0,00%";"203";"0";"0";"203";"100,00%";"0";0.000
"MULTIPOLYGON (((-58.409497827064 -34.5882271266918,-58.4089159993851 -34.5886859041483,-58.4088171668784 -34.5887644552482,-58.4094038223405 -34.5894152318234,-58.4095032118594 -34.5895319699869,-58.4099256481933 -34.589176082836,-58.4100810499574 -34.5890571310955,-58.409497827064 -34.5882271266918)))";;"1874";2_23_7;COMUNA 2;"23";"7";"456";"192";"264";"72,73%";"371";"371";"100,00%";"0";"0,00%";"237";"1";"0.42";"236";"99,58%";"0.42";0.420
"MULTIPOLYGON (((-58.4088171668784 -34.5887644552482,-58.4080777064224 -34.5893521077766,-58.408897242242 -34.5900421472237,-58.4095032118594 -34.5895319699869,-58.4094038223405 -34.5894152318234,-58.4088171668784 -34.5887644552482)))";;"1875";2_23_8;COMUNA 2;"23";"8";"445";"195";"250";"78,00%";"251";"251";"100,00%";"0";"0,00%";"187";"4";"2.14";"183";"97,86%";"2.14";2.140
"MULTIPOLYGON (((-58.408897242242 -34.5900421472237,-58.4080777064224 -34.5893521077766,-58.4071384343845 -34.5900984740959,-58.4070220444766 -34.5901941995096,-58.4071400165957 -34.5902801721865,-58.4079382451492 -34.5908691479195,-58.4080345380201 -34.5907725675379,-58.4086675301294 -34.5902365605196,-58.408897242242 -34.5900421472237)))";;"1876";2_23_9;COMUNA 2;"23";"9";"943";"395";"548";"72,08%";"660";"660";"100,00%";"0";"0,00%";"463";"1";"0.22";"462";"99,78%";"0.22";0.220
"MULTIPOLYGON (((-58.4111888291875 -34.5903468100589,-58.4105047279576 -34.5907931568573,-58.4115319644764 -34.5921003337813,-58.4116128861143 -34.5922076958664,-58.4123908455004 -34.5917508883185,-58.4123270205992 -34.5916763519995,-58.4111888291875 -34.5903468100589)))";;"1877";2_24_1;COMUNA 2;"24";"1";"1012";"424";"588";"72,11%";"610";"610";"100,00%";"0";"0,00%";"450";"1";"0.22";"449";"99,78%";"0.22";0.220
"MULTIPOLYGON (((-58.4100810499574 -34.5890571310955,-58.4099256481933 -34.589176082836,-58.4095032118594 -34.5895319699869,-58.4096378306105 -34.5896901334926,-58.4105047279576 -34.5907931568573,-58.4111888291875 -34.5903468100589,-58.4100810499574 -34.5890571310955)))";;"1878";2_24_2;COMUNA 2;"24";"2";"787";"348";"439";"79,27%";"529";"529";"100,00%";"0";"0,00%";"377";"1";"0.27";"376";"99,73%";"0.27";0.270
"MULTIPOLYGON (((-58.4095032118594 -34.5895319699869,-58.408897242242 -34.5900421472237,-58.4086675301294 -34.5902365605196,-58.4098792332166 -34.591201284213,-58.4105047279576 -34.5907931568573,-58.4096378306105 -34.5896901334926,-58.4095032118594 -34.5895319699869)))";;"1879";2_24_3;COMUNA 2;"24";"3";"795";"350";"445";"78,65%";"450";"450";"100,00%";"0";"0,00%";"335";"1";"0.3";"334";"99,70%";"0.3";0.300
"MULTIPOLYGON (((-58.4105047279576 -34.5907931568573,-58.4098792332166 -34.591201284213,-58.4097511858057 -34.5912848235854,-58.4106450589616 -34.5925854708008,-58.4110184566763 -34.5924995697757,-58.411120751871 -34.5924715837806,-58.4112005608351 -34.5924497152145,-58.4116128861143 -34.5922076958664,-58.4115319644764 -34.5921003337813,-58.4105047279576 -34.5907931568573)))";;"1880";2_24_4;COMUNA 2;"24";"4";"1050";"446";"604";"73,84%";"642";"641";"99,84%";"1";"0,16%";"464";"13";"2.8";"451";"97,20%";"2.8";2.800
"MULTIPOLYGON (((-58.4097511858057 -34.5912848235854,-58.4090990175181 -34.5917103303838,-58.409698877488 -34.5927921139384,-58.4104989021796 -34.5926190716671,-58.4106450589616 -34.5925854708008,-58.4097511858057 -34.5912848235854)))";;"1881";2_24_5;COMUNA 2;"24";"5";"922";"371";"551";"67,33%";"730";"730";"100,00%";"0";"0,00%";"506";"1";"0.2";"505";"99,80%";"0.2";0.200
"MULTIPOLYGON (((-58.4086675301294 -34.5902365605196,-58.4080345380201 -34.5907725675379,-58.4079382451492 -34.5908691479195,-58.4090990175181 -34.5917103303838,-58.4097511858057 -34.5912848235854,-58.4098792332166 -34.591201284213,-58.4086675301294 -34.5902365605196)))";;"1882";2_24_6;COMUNA 2;"24";"6";"968";"395";"573";"68,94%";"621";"621";"100,00%";"0";"0,00%";"468";"3";"0.64";"465";"99,36%";"0.64";0.640
"MULTIPOLYGON (((-58.4124629252187 -34.5918350762706,-58.4123908455004 -34.5917508883185,-58.4116128861143 -34.5922076958664,-58.4116850435416 -34.5923034340557,-58.4121208032158 -34.5928756802476,-58.4126834554221 -34.5924602619679,-58.4128778757669 -34.5923197021452,-58.4124629252187 -34.5918350762706)))";;"1883";2_25_1;COMUNA 2;"25";"1";"570";"237";"333";"71,17%";"458";"458";"100,00%";"0";"0,00%";"312";"2";"0.64";"310";"99,36%";"0.64";0.640
"MULTIPOLYGON (((-58.4155178349856 -34.5967129654871,-58.4142348771073 -34.5967707748029,-58.4146278602449 -34.5978979456493,-58.4156625650391 -34.5978597558484,-58.4160005068785 -34.5978547446042,-58.4155178349856 -34.5967129654871)))";;"1884";2_25_10;COMUNA 2;"25";"10";"605";"275";"330";"83,33%";"435";"435";"100,00%";"0";"0,00%";"299";"1";"0.33";"298";"99,67%";"0.33";0.330
"MULTIPOLYGON (((-58.4129896466176 -34.5968268253721,-58.4117397302634 -34.5968830725519,-58.411918832168 -34.5980030496281,-58.4120909588458 -34.5979936137291,-58.4129838623689 -34.5979586273118,-58.4132525675508 -34.5979487361076,-58.4146278602449 -34.5978979456493,-58.4142348771073 -34.5967707748029,-58.4129896466176 -34.5968268253721)))";;"1885";2_25_11;COMUNA 2;"25";"11";"1037";"474";"563";"84,19%";"659";"657";"99,70%";"2";"0,30%";"501";"43";"8.58";"458";"91,42%";"8.58";8.580
"MULTIPOLYGON (((-58.4116128861143 -34.5922076958664,-58.4112005608351 -34.5924497152145,-58.411120751871 -34.5924715837806,-58.4110184566763 -34.5924995697757,-58.4106450589616 -34.5925854708008,-58.4104989021796 -34.5926190716671,-58.409698877488 -34.5927921139384,-58.4102267025302 -34.5937438583085,-58.4115644754221 -34.5931063025539,-58.4116475200863 -34.5932251448129,-58.4121208032158 -34.5928756802476,-58.4116850435416 -34.5923034340557,-58.4116128861143 -34.5922076958664)))";;"1886";2_25_2;COMUNA 2;"25";"2";"647";"272";"375";"72,53%";"492";"492";"100,00%";"0";"0,00%";"349";"1";"0.29";"348";"99,71%";"0.29";0.290
"MULTIPOLYGON (((-58.4121208032158 -34.5928756802476,-58.4116475200863 -34.5932251448129,-58.4115644754221 -34.5931063025539,-58.4102267025302 -34.5937438583085,-58.4103298871933 -34.5939298254166,-58.4109718041962 -34.5950849330966,-58.4111518927695 -34.5954119938802,-58.4126387450976 -34.5947334314734,-58.4126376743564 -34.5946727948617,-58.4125788129207 -34.5945541745143,-58.4123061756118 -34.5941832026475,-58.4122441469164 -34.5940928213647,-58.4127440323612 -34.593694278996,-58.4121208032158 -34.5928756802476)))";;"1887";2_25_3;COMUNA 2;"25";"3";"743";"293";"450";"65,11%";"240";"239";"99,58%";"1";"0,42%";"177";"12";"6.78";"165";"93,22%";"6.78";6.780
"MULTIPOLYGON (((-58.4128778757669 -34.5923197021452,-58.4126834554221 -34.5924602619679,-58.4121208032158 -34.5928756802476,-58.4127440323612 -34.593694278996,-58.4135230330255 -34.5930731625337,-58.4128778757669 -34.5923197021452)))";;"1888";2_25_4;COMUNA 2;"25";"4";"757";"294";"463";"63,50%";"632";"632";"100,00%";"0";"0,00%";"427";"5";"1.17";"422";"98,83%";"1.17";1.170
"MULTIPOLYGON (((-58.4135230330255 -34.5930731625337,-58.4127440323612 -34.593694278996,-58.4135334678806 -34.5947310486543,-58.4137267094833 -34.5945740075407,-58.4143936643459 -34.5940540417439,-58.4135230330255 -34.5930731625337)))";;"1889";2_25_5;COMUNA 2;"25";"5";"930";"411";"519";"79,19%";"620";"619";"99,84%";"1";"0,16%";"469";"4";"0.85";"465";"99,15%";"0.85";0.850
"MULTIPOLYGON (((-58.4126387450976 -34.5947334314734,-58.4111518927695 -34.5954119938802,-58.4116198610917 -34.5962558854453,-58.4117802015672 -34.5961559485745,-58.4126670242619 -34.5954351605909,-58.4135334678806 -34.5947310486543,-58.4127440323612 -34.593694278996,-58.4122441469164 -34.5940928213647,-58.4123061756118 -34.5941832026475,-58.4125788129207 -34.5945541745143,-58.4126376743564 -34.5946727948617,-58.4126387450976 -34.5947334314734)))";;"1890";2_25_6;COMUNA 2;"25";"6";"759";"331";"428";"77,34%";"459";"453";"98,69%";"6";"1,32%";"355";"110";"30.99";"245";"69,01%";"30.99";30.990
"MULTIPOLYGON (((-58.4143936643459 -34.5940540417439,-58.4137267094833 -34.5945740075407,-58.4135334678806 -34.5947310486543,-58.4126670242619 -34.5954351605909,-58.4127051595098 -34.5956074364505,-58.4138288964084 -34.5956062014604,-58.4148443048947 -34.5956050545379,-58.4150464026154 -34.5955979502481,-58.4146260109031 -34.5946035916291,-58.4143936643459 -34.5940540417439)))";;"1891";2_25_7;COMUNA 2;"25";"7";"768";"356";"412";"86,41%";"528";"528";"100,00%";"0";"0,00%";"386";"7";"1.81";"379";"98,19%";"1.81";1.810
"MULTIPOLYGON (((-58.4127051595098 -34.5956074364505,-58.4126670242619 -34.5954351605909,-58.4117802015672 -34.5961559485745,-58.4116198610917 -34.5962558854453,-58.4117397302634 -34.5968830725519,-58.4129896466176 -34.5968268253721,-58.4142348771073 -34.5967707748029,-58.4138288964084 -34.5956062014604,-58.4127051595098 -34.5956074364505)))";;"1892";2_25_8;COMUNA 2;"25";"8";"1222";"586";"636";"92,14%";"746";"743";"99,60%";"3";"0,40%";"523";"12";"2.29";"511";"97,71%";"2.29";2.290
"MULTIPOLYGON (((-58.4150464026154 -34.5955979502481,-58.4148443048947 -34.5956050545379,-58.4138288964084 -34.5956062014604,-58.4142348771073 -34.5967707748029,-58.4155178349856 -34.5967129654871,-58.4150464026154 -34.5955979502481)))";;"1893";2_25_9;COMUNA 2;"25";"9";"775";"340";"435";"78,16%";"677";"677";"100,00%";"0";"0,00%";"411";"1";"0.24";"410";"99,76%";"0.24";0.240
"MULTIPOLYGON (((-58.3972155751019 -34.5874615464262,-58.3962162439483 -34.5869668313245,-58.3951855035613 -34.5877343949184,-58.3952842721868 -34.5878547360319,-58.395857918388 -34.5885538119371,-58.3965170249554 -34.588023586534,-58.3972155751019 -34.5874615464262)))";;"1894";2_3_1;COMUNA 2;"3";"1";"895";"362";"533";"67,92%";"610";"610";"100,00%";"0";"0,00%";"399";"3";"0.75";"396";"99,25%";"0.75";0.750
"MULTIPOLYGON (((-58.394977651566 -34.5863536608447,-58.3944072491295 -34.5868173053509,-58.3950591720333 -34.587580445552,-58.3951855035613 -34.5877343949184,-58.3962162439483 -34.5869668313245,-58.394977651566 -34.5863536608447)))";;"1895";2_3_2;COMUNA 2;"3";"2";"745";"327";"418";"78,23%";"735";"735";"100,00%";"0";"0,00%";"411";"5";"1.22";"406";"98,78%";"1.22";1.220
"MULTIPOLYGON (((-58.3917185351221 -34.5847567443332,-58.3912918879096 -34.584893895391,-58.3910022883034 -34.5849869688218,-58.3907196643609 -34.5851860358863,-58.3906725492981 -34.5852154459013,-58.3906278164233 -34.5852472517679,-58.3905855509494 -34.5852813831136,-58.390545923365 -34.5853176287655,-58.3905091041596 -34.585355777551,-58.3904753487946 -34.5853958296237,-58.3904446574549 -34.58543757371,-58.3904171154796 -34.5854807985866,-58.3903929784545 -34.5855253635563,-58.3903723316592 -34.5855711278209,-58.3903550901894 -34.5856178096302,-58.3903415095719 -34.5856653387118,-58.390331504842 -34.5857135037403,-58.3903252465574 -34.5857620231163,-58.3903575904162 -34.5860736041664,-58.3903735311501 -34.5861523491848,-58.3905189153989 -34.5863190616933,-58.3906105182724 -34.5864444730002,-58.3906774190175 -34.5865786728323,-58.3907618592875 -34.5867158408302,-58.3908323671288 -34.5868150412898,-58.3909169884318 -34.5868412893284,-58.3909486384087 -34.5868734219079,-58.3909027874993 -34.5869171290958,-58.3908745811813 -34.5869404232954,-58.3908533349408 -34.5869899902477,-58.3908603349783 -34.5870688003527,-58.3908497054985 -34.5871504170932,-58.3908284416048 -34.5872204073844,-58.3907841831501 -34.5872934124139,-58.3907931970875 -34.5874068025581,-58.3908168004854 -34.5876856304624,-58.3907769203352 -34.5877172983773,-58.3909150216523 -34.5878410466139,-58.3917498799645 -34.5885536759906,-58.3920063789431 -34.5883438868723,-58.3923244967602 -34.5881731484012,-58.3923749954947 -34.5882728998107,-58.392862413641 -34.5891068045488,-58.3929898007731 -34.5892182902717,-58.3940254360939 -34.588654700001,-58.3941643862549 -34.5885820991516,-58.3945120587054 -34.5884005260722,-58.3952842721868 -34.5878547360319,-58.3951855035613 -34.5877343949184,-58.3950591720333 -34.587580445552,-58.3944072491295 -34.5868173053509,-58.394977651566 -34.5863536608447,-58.3947505513372 -34.5862412061399,-58.3937786524527 -34.5857664166505,-58.3935101011722 -34.5856352030614,-58.3933167107167 -34.5855407232568,-58.3923398913605 -34.5850634545796,-58.3922649879371 -34.5850264380449,-58.3917185351221 -34.5847567443332)))";;"1896";2_3_3;COMUNA 2;"3";"3";"266";"114";"152";"75,00%";"112";"111";"99,11%";"1";"0,90%";"100";"0";"0";"100";"100,00%";"0";0.000
"MULTIPOLYGON (((-58.395857918388 -34.5885538119371,-58.3952842721868 -34.5878547360319,-58.3945120587054 -34.5884005260722,-58.3941643862549 -34.5885820991516,-58.3949082277221 -34.5893178960732,-58.3950258216253 -34.5892232392538,-58.395857918388 -34.5885538119371)))";;"1897";2_3_4;COMUNA 2;"3";"4";"369";"159";"210";"75,71%";"267";"267";"100,00%";"0";"0,00%";"188";"1";"0.53";"187";"99,47%";"0.53";0.530
"MULTIPOLYGON (((-58.3929898007731 -34.5892182902717,-58.3919263174831 -34.5900682753753,-58.3920341313823 -34.590164468429,-58.3929129997463 -34.5909367653226,-58.3938187668711 -34.5901952082611,-58.3939681483337 -34.5900749355927,-58.3949082277221 -34.5893178960732,-58.3941643862549 -34.5885820991516,-58.3940254360939 -34.588654700001,-58.3929898007731 -34.5892182902717)))";;"1898";2_3_5;COMUNA 2;"3";"5";"714";"331";"383";"86,42%";"503";"501";"99,60%";"2";"0,40%";"293";"3";"1.02";"290";"98,98%";"1.02";1.020
"MULTIPOLYGON (((-58.3923244967602 -34.5881731484012,-58.3920063789431 -34.5883438868723,-58.3917498799645 -34.5885536759906,-58.3909549829571 -34.5892010540201,-58.3919263174831 -34.5900682753753,-58.3929898007731 -34.5892182902717,-58.392862413641 -34.5891068045488,-58.3923749954947 -34.5882728998107,-58.3923244967602 -34.5881731484012)))";;"1899";2_3_6;COMUNA 2;"3";"6";"678";"288";"390";"73,85%";"555";"552";"99,46%";"3";"0,54%";"274";"18";"6.57";"256";"93,43%";"6.57";6.570
"MULTIPOLYGON (((-58.3909549829571 -34.5892010540201,-58.3899550381687 -34.5900154240543,-58.3908089397489 -34.5907812420913,-58.3909235595099 -34.5908849756331,-58.3910291486913 -34.5907950341288,-58.3919263174831 -34.5900682753753,-58.3909549829571 -34.5892010540201)))";;"1900";2_3_7;COMUNA 2;"3";"7";"885";"368";"517";"71,18%";"511";"511";"100,00%";"0";"0,00%";"353";"2";"0.57";"351";"99,43%";"0.57";0.570
"MULTIPOLYGON (((-58.3919263174831 -34.5900682753753,-58.3910291486913 -34.5907950341288,-58.3909235595099 -34.5908849756331,-58.3917259907338 -34.591611389122,-58.3918909856472 -34.5917643078973,-58.392135470811 -34.5915732447865,-58.3929129997463 -34.5909367653226,-58.3920341313823 -34.590164468429,-58.3919263174831 -34.5900682753753)))";;"1901";2_3_8;COMUNA 2;"3";"8";"606";"267";"339";"78,76%";"347";"346";"99,71%";"1";"0,29%";"234";"2";"0.85";"232";"99,15%";"0.85";0.850
"MULTIPOLYGON (((-58.3886271704127 -34.5853210044668,-58.388578846986 -34.5853502674254,-58.3874401960287 -34.5859033120726,-58.3883484119578 -34.5868033416056,-58.3889355190518 -34.5864576980333,-58.3894031734845 -34.5861824053071,-58.3894875238008 -34.5861280171218,-58.3886271704127 -34.5853210044668)))";;"1902";2_4_1;COMUNA 2;"4";"1";"823";"356";"467";"76,23%";"473";"472";"99,79%";"1";"0,21%";"313";"1";"0.32";"312";"99,68%";"0.32";0.320
"MULTIPOLYGON (((-58.3850250304915 -34.5870352951572,-58.3838433859003 -34.5876791725766,-58.3849489686869 -34.5887920071339,-58.3850639074587 -34.588725105806,-58.3859699494049 -34.5881974182995,-58.3860936661499 -34.5881212253663,-58.3850250304915 -34.5870352951572)))";;"1903";2_4_10;COMUNA 2;"4";"10";"884";"365";"519";"70,33%";"722";"721";"99,86%";"1";"0,14%";"430";"2";"0.47";"428";"99,53%";"0.47";0.470
"MULTIPOLYGON (((-58.3889355190518 -34.5864576980333,-58.3883484119578 -34.5868033416056,-58.3891995578743 -34.5876467079155,-58.389317481275 -34.5875693814099,-58.3897692333908 -34.5872749220731,-58.3889355190518 -34.5864576980333)))";;"1904";2_4_2;COMUNA 2;"4";"2";"233";"112";"121";"92,56%";"252";"251";"99,60%";"1";"0,40%";"109";"4";"3.67";"105";"96,33%";"3.67";3.670
"MULTIPOLYGON (((-58.3897692333908 -34.5872749220731,-58.389317481275 -34.5875693814099,-58.3891995578743 -34.5876467079155,-58.389966137214 -34.5883214195269,-58.3907769203352 -34.5877172983773,-58.3908168004854 -34.5876856304624,-58.3907931970875 -34.5874068025581,-58.3907841831501 -34.5872934124139,-58.3908284416048 -34.5872204073844,-58.3908497054985 -34.5871504170932,-58.3908603349783 -34.5870688003527,-58.3908533349408 -34.5869899902477,-58.3908745811813 -34.5869404232954,-58.3909027874993 -34.5869171290958,-58.3909486384087 -34.5868734219079,-58.3909169884318 -34.5868412893284,-58.3908323671288 -34.5868150412898,-58.3907618592875 -34.5867158408302,-58.3906774190175 -34.5865786728323,-58.3906105182724 -34.5864444730002,-58.3905189153989 -34.5863190616933,-58.3903735311501 -34.5861523491848,-58.3903575904162 -34.5860736041664,-58.3903252465574 -34.5857620231163,-58.390331504842 -34.5857135037403,-58.3903415095719 -34.5856653387118,-58.3903550901894 -34.5856178096302,-58.3903723316592 -34.5855711278209,-58.3903929784545 -34.5855253635563,-58.3904171154796 -34.5854807985866,-58.3904446574549 -34.58543757371,-58.3904753487946 -34.5853958296237,-58.3905091041596 -34.585355777551,-58.390545923365 -34.5853176287655,-58.3905855509494 -34.5852813831136,-58.3906278164233 -34.5852472517679,-58.3906725492981 -34.5852154459013,-58.3907196643609 -34.5851860358863,-58.3910022883034 -34.5849869688218,-58.3906990213654 -34.5850302427516,-58.3903407670799 -34.585048341475,-58.3899949882782 -34.5850167262549,-58.3898493883321 -34.5850033994586,-58.3895629025375 -34.5850390746385,-58.3892831905234 -34.5851182056845,-58.3886271704127 -34.5853210044668,-58.3894875238008 -34.5861280171218,-58.3894031734845 -34.5861824053071,-58.3889355190518 -34.5864576980333,-58.3897692333908 -34.5872749220731)))";;"1905";2_4_3;COMUNA 2;"4";"3";"365";"144";"221";"65,16%";"259";"259";"100,00%";"0";"0,00%";"149";"78";"52.35";"71";"47,65%";"52.35";52.350
"MULTIPOLYGON (((-58.3907769203352 -34.5877172983773,-58.389966137214 -34.5883214195269,-58.3906028738576 -34.5888866790603,-58.3909549829571 -34.5892010540201,-58.3917498799645 -34.5885536759906,-58.3909150216523 -34.5878410466139,-58.3907769203352 -34.5877172983773)))";;"1906";2_4_4;COMUNA 2;"4";"4";"499";"210";"289";"72,66%";"322";"321";"99,69%";"1";"0,31%";"195";"1";"0.51";"194";"99,49%";"0.51";0.510
"MULTIPOLYGON (((-58.389966137214 -34.5883214195269,-58.3891034034342 -34.5890143806864,-58.3889751389502 -34.5891311389095,-58.3898472272915 -34.5899187361877,-58.3899550381687 -34.5900154240543,-58.3909549829571 -34.5892010540201,-58.3906028738576 -34.5888866790603,-58.389966137214 -34.5883214195269)))";;"1907";2_4_5;COMUNA 2;"4";"5";"702";"317";"385";"82,34%";"459";"459";"100,00%";"0";"0,00%";"284";"1";"0.35";"283";"99,65%";"0.35";0.350
"MULTIPOLYGON (((-58.389966137214 -34.5883214195269,-58.3891995578743 -34.5876467079155,-58.3881151466126 -34.5883576981968,-58.3883499071779 -34.5885663708992,-58.3889751389502 -34.5891311389095,-58.3891034034342 -34.5890143806864,-58.389966137214 -34.5883214195269)))";;"1908";2_4_6;COMUNA 2;"4";"6";"539";"226";"313";"72,20%";"301";"301";"100,00%";"0";"0,00%";"212";"2";"0.94";"210";"99,06%";"0.94";0.940
"MULTIPOLYGON (((-58.3883484119578 -34.5868033416056,-58.3872227477136 -34.5874659871228,-58.3870837866269 -34.5875460451605,-58.3879933847859 -34.5882493799594,-58.3881151466126 -34.5883576981968,-58.3891995578743 -34.5876467079155,-58.3883484119578 -34.5868033416056)))";;"1909";2_4_7;COMUNA 2;"4";"7";"617";"273";"344";"79,36%";"446";"445";"99,78%";"1";"0,22%";"235";"1";"0.43";"234";"99,57%";"0.43";0.430
"MULTIPOLYGON (((-58.3874401960287 -34.5859033120726,-58.3858455697248 -34.5865886839913,-58.3870837866269 -34.5875460451605,-58.3872227477136 -34.5874659871228,-58.3883484119578 -34.5868033416056,-58.3874401960287 -34.5859033120726)))";;"1910";2_4_8;COMUNA 2;"4";"8";"997";"465";"532";"87,41%";"716";"715";"99,86%";"1";"0,14%";"427";"5";"1.17";"422";"98,83%";"1.17";1.170
"MULTIPOLYGON (((-58.3858455697248 -34.5865886839913,-58.3858242703934 -34.5866002907623,-58.3850250304915 -34.5870352951572,-58.3860936661499 -34.5881212253663,-58.3862081805284 -34.5880508014181,-58.3870837866269 -34.5875460451605,-58.3858455697248 -34.5865886839913)))";;"1911";2_4_9;COMUNA 2;"4";"9";"812";"365";"447";"81,66%";"529";"529";"100,00%";"0";"0,00%";"333";"3";"0.9";"330";"99,10%";"0.9";0.900
"MULTIPOLYGON (((-58.3860936661499 -34.5881212253663,-58.3859699494049 -34.5881974182995,-58.3850639074587 -34.588725105806,-58.3849489686869 -34.5887920071339,-58.3859359583781 -34.5897864038775,-58.3870310577033 -34.5890684676707,-58.3881151466126 -34.5883576981968,-58.3879933847859 -34.5882493799594,-58.3870837866269 -34.5875460451605,-58.3862081805284 -34.5880508014181,-58.3860936661499 -34.5881212253663)))";;"1912";2_5_1;COMUNA 2;"5";"1";"710";"350";"360";"97,22%";"406";"405";"99,75%";"1";"0,25%";"256";"1";"0.39";"255";"99,61%";"0.39";0.390
"MULTIPOLYGON (((-58.3870310577033 -34.5890684676707,-58.3859359583781 -34.5897864038775,-58.3869174413735 -34.590775155048,-58.3870018941623 -34.590708585109,-58.3879272917733 -34.5899735630849,-58.3870310577033 -34.5890684676707)))";;"1913";2_5_2;COMUNA 2;"5";"2";"887";"394";"493";"79,92%";"433";"432";"99,77%";"1";"0,23%";"319";"10";"3.13";"309";"96,87%";"3.13";3.130
"MULTIPOLYGON (((-58.3881151466126 -34.5883576981968,-58.3870310577033 -34.5890684676707,-58.3879272917733 -34.5899735630849,-58.3880177087254 -34.5899017141873,-58.3888491752844 -34.5892457152021,-58.3889751389502 -34.5891311389095,-58.3883499071779 -34.5885663708992,-58.3881151466126 -34.5883576981968)))";;"1914";2_5_3;COMUNA 2;"5";"3";"661";"284";"377";"75,33%";"338";"337";"99,70%";"1";"0,30%";"255";"0";"0";"255";"100,00%";"0";0.000
"MULTIPOLYGON (((-58.3889751389502 -34.5891311389095,-58.3888491752844 -34.5892457152021,-58.3880177087254 -34.5899017141873,-58.3879272917733 -34.5899735630849,-58.3880134790392 -34.5900605207182,-58.3889362402546 -34.590845056674,-58.3899550381687 -34.5900154240543,-58.3898472272915 -34.5899187361877,-58.3889751389502 -34.5891311389095)))";;"1915";2_5_4;COMUNA 2;"5";"4";"544";"233";"311";"74,92%";"413";"413";"100,00%";"0";"0,00%";"226";"0";"0";"226";"100,00%";"0";0.000
"MULTIPOLYGON (((-58.3879272917733 -34.5899735630849,-58.3870018941623 -34.590708585109,-58.3869174413735 -34.590775155048,-58.3878782380866 -34.5915914139141,-58.3879499768136 -34.5916482206778,-58.3889362402546 -34.590845056674,-58.3880134790392 -34.5900605207182,-58.3879272917733 -34.5899735630849)))";;"1916";2_5_5;COMUNA 2;"5";"5";"777";"327";"450";"72,67%";"523";"523";"100,00%";"0";"0,00%";"324";"1";"0.31";"323";"99,69%";"0.31";0.310
"MULTIPOLYGON (((-58.3889362402546 -34.590845056674,-58.3879499768136 -34.5916482206778,-58.3890052190938 -34.5924844587429,-58.3899211953671 -34.5917158232514,-58.389826319041 -34.5916278054185,-58.389022186304 -34.5909180692248,-58.3889362402546 -34.590845056674)))";;"1917";2_5_6;COMUNA 2;"5";"6";"811";"339";"472";"71,82%";"525";"524";"99,81%";"1";"0,19%";"328";"1";"0.3";"327";"99,70%";"0.3";0.300
"MULTIPOLYGON (((-58.3899550381687 -34.5900154240543,-58.3889362402546 -34.590845056674,-58.389022186304 -34.5909180692248,-58.389826319041 -34.5916278054185,-58.3899211953671 -34.5917158232514,-58.3900161327057 -34.5916362288052,-58.3906996824029 -34.5910756963707,-58.3909235595099 -34.5908849756331,-58.3908089397489 -34.5907812420913,-58.3899550381687 -34.5900154240543)))";;"1918";2_5_7;COMUNA 2;"5";"7";"828";"358";"470";"76,17%";"473";"471";"99,58%";"2";"0,42%";"329";"17";"5.17";"312";"94,83%";"5.17";5.170
"MULTIPOLYGON (((-58.3909235595099 -34.5908849756331,-58.3906996824029 -34.5910756963707,-58.3900161327057 -34.5916362288052,-58.3899211953671 -34.5917158232514,-58.3907590083425 -34.592493604141,-58.3908551705935 -34.5925740160621,-58.3918909856472 -34.5917643078973,-58.3917259907338 -34.591611389122,-58.3909235595099 -34.5908849756331)))";;"1919";2_5_8;COMUNA 2;"5";"8";"700";"304";"396";"76,77%";"523";"523";"100,00%";"0";"0,00%";"328";"4";"1.22";"324";"98,78%";"1.22";1.220
"MULTIPOLYGON (((-58.3899211953671 -34.5917158232514,-58.3890052190938 -34.5924844587429,-58.3891406150393 -34.5925917277401,-58.3894572094418 -34.5928234765502,-58.3900179774502 -34.5932338279003,-58.3907620271884 -34.5926468513772,-58.3908551705935 -34.5925740160621,-58.3907590083425 -34.592493604141,-58.3899211953671 -34.5917158232514)))";;"1920";2_5_9;COMUNA 2;"5";"9";"616";"246";"370";"66,49%";"393";"393";"100,00%";"0";"0,00%";"271";"1";"0.37";"270";"99,63%";"0.37";0.370
"MULTIPOLYGON (((-58.3894572094418 -34.5928234765502,-58.3891406150393 -34.5925917277401,-58.3890052190938 -34.5924844587429,-58.3879499768136 -34.5916482206778,-58.3879097520326 -34.5916810142272,-58.38756654533 -34.5928304260636,-58.3878537942812 -34.5928291940726,-58.3884603941836 -34.5928308322632,-58.3885935015986 -34.5928298567877,-58.3888046169491 -34.5928282946005,-58.3885929359634 -34.5945217535575,-58.3885651209096 -34.5946761792954,-58.38919786391 -34.5946952247514,-58.3897369817848 -34.5943606056603,-58.3900600782646 -34.5942743161684,-58.3900179774502 -34.5932338279003,-58.3894572094418 -34.5928234765502)))";;"1921";2_6_1;COMUNA 2;"6";"1";"432";"186";"246";"75,61%";"238";"238";"100,00%";"0";"0,00%";"175";"0";"0";"175";"100,00%";"0";0.000
"MULTIPOLYGON (((-58.3882018413264 -34.5983684245858,-58.3870838429195 -34.5982927340334,-58.3869592547376 -34.5982812478773,-58.3869438983015 -34.5984042008012,-58.386863459811 -34.5992928467762,-58.3879515997437 -34.5993438018046,-58.3881472200179 -34.5993546261138,-58.3881536738704 -34.5991851165452,-58.3881914913512 -34.598513987222,-58.3882018413264 -34.5983684245858)))";;"1922";2_6_10;COMUNA 2;"6";"10";"515";"235";"280";"83,93%";"515";"513";"99,61%";"2";"0,39%";"228";"1";"0.44";"227";"99,56%";"0.44";0.440
"MULTIPOLYGON (((-58.3888046169491 -34.5928282946005,-58.3885935015986 -34.5928298567877,-58.3884603941836 -34.5928308322632,-58.3878537942812 -34.5928291940726,-58.38756654533 -34.5928304260636,-58.3873092570493 -34.5945461795004,-58.3872901768753 -34.5946445518222,-58.3874368160658 -34.594656896349,-58.3884590109091 -34.5946729456489,-58.3885651209096 -34.5946761792954,-58.3885929359634 -34.5945217535575,-58.3888046169491 -34.5928282946005)))";;"1923";2_6_2;COMUNA 2;"6";"2";"1346";"580";"766";"75,72%";"843";"842";"99,88%";"1";"0,12%";"572";"5";"0.87";"567";"99,13%";"0.87";0.870
"MULTIPOLYGON (((-58.3885651209096 -34.5946761792954,-58.3884590109091 -34.5946729456489,-58.3874368160658 -34.594656896349,-58.3872901768753 -34.5946445518222,-58.3872704117887 -34.5947468675315,-58.3871783904446 -34.5955498699697,-58.3871562567267 -34.5957282434639,-58.3882529685668 -34.5957605384145,-58.3884201417588 -34.5957645841033,-58.388542697177 -34.5948011705346,-58.3885651209096 -34.5946761792954)))";;"1924";2_6_3;COMUNA 2;"6";"3";"638";"295";"343";"86,01%";"317";"316";"99,68%";"1";"0,32%";"226";"1";"0.44";"225";"99,56%";"0.44";0.440
"MULTIPOLYGON (((-58.38919786391 -34.5946952247514,-58.3885651209096 -34.5946761792954,-58.388542697177 -34.5948011705346,-58.3884201417588 -34.5957645841033,-58.3899489725869 -34.595801422022,-58.3900165470137 -34.595169536363,-58.3900223353271 -34.5950749586705,-58.390060775716 -34.5944514361644,-58.3900600782646 -34.5942743161684,-58.3897369817848 -34.5943606056603,-58.38919786391 -34.5946952247514)))";;"1925";2_6_4;COMUNA 2;"6";"4";"835";"363";"472";"76,91%";"482";"482";"100,00%";"0";"0,00%";"333";"5";"1.5";"328";"98,50%";"1.5";1.500
"MULTIPOLYGON (((-58.3899489725869 -34.595801422022,-58.3884201417588 -34.5957645841033,-58.3883949272969 -34.5959625341651,-58.3882980862522 -34.5971192803891,-58.3884261694898 -34.5971253445627,-58.3896461875747 -34.5971942526913,-58.3897828767291 -34.5971957429516,-58.3898085603258 -34.5970423721045,-58.3899259611438 -34.596016416628,-58.3899489725869 -34.595801422022)))";;"1926";2_6_5;COMUNA 2;"6";"5";"488";"223";"265";"84,15%";"285";"285";"100,00%";"0";"0,00%";"183";"0";"0";"183";"100,00%";"0";0.000
"MULTIPOLYGON (((-58.3884201417588 -34.5957645841033,-58.3882529685668 -34.5957605384145,-58.3871562567267 -34.5957282434639,-58.387130691734 -34.5959337989747,-58.3870614854001 -34.596931893237,-58.3870628229592 -34.5970535184703,-58.3872758906311 -34.5970709749634,-58.3882980862522 -34.5971192803891,-58.3883949272969 -34.5959625341651,-58.3884201417588 -34.5957645841033)))";;"1927";2_6_6;COMUNA 2;"6";"6";"680";"299";"381";"78,48%";"603";"603";"100,00%";"0";"0,00%";"320";"28";"8.75";"292";"91,25%";"8.75";8.750
"MULTIPOLYGON (((-58.3882980862522 -34.5971192803891,-58.3872758906311 -34.5970709749634,-58.3870628229592 -34.5970535184703,-58.3870641650542 -34.5971701435116,-58.3869721230883 -34.5981783645968,-58.3869592547376 -34.5982812478773,-58.3870838429195 -34.5982927340334,-58.3882018413264 -34.5983684245858,-58.3882101206767 -34.5982526505555,-58.388287154263 -34.5972493491545,-58.3882980862522 -34.5971192803891)))";;"1928";2_6_7;COMUNA 2;"6";"7";"392";"179";"213";"84,04%";"334";"333";"99,70%";"1";"0,30%";"175";"0";"0";"175";"100,00%";"0";0.000
"MULTIPOLYGON (((-58.3897828767291 -34.5971957429516,-58.3896461875747 -34.5971942526913,-58.3884261694898 -34.5971253445627,-58.3882980862522 -34.5971192803891,-58.388287154263 -34.5972493491545,-58.3882101206767 -34.5982526505555,-58.3882018413264 -34.5983684245858,-58.3883317125237 -34.5983772365342,-58.3897193285408 -34.5984785007145,-58.3897255550862 -34.5983704017048,-58.3897597617311 -34.5973334104949,-58.3897828767291 -34.5971957429516)))";;"1929";2_6_8;COMUNA 2;"6";"8";"569";"242";"327";"74,01%";"329";"329";"100,00%";"0";"0,00%";"219";"25";"11.42";"194";"88,58%";"11.42";11.420
"MULTIPOLYGON (((-58.3897193285408 -34.5984785007145,-58.3883317125237 -34.5983772365342,-58.3882018413264 -34.5983684245858,-58.3881914913512 -34.598513987222,-58.3881536738704 -34.5991851165452,-58.3881472200179 -34.5993546261138,-58.3894802834475 -34.599428675529,-58.3896641498178 -34.5994408284322,-58.3897193285408 -34.5984785007145)))";;"1930";2_6_9;COMUNA 2;"6";"9";"501";"223";"278";"80,22%";"527";"527";"100,00%";"0";"0,00%";"276";"6";"2.17";"270";"97,83%";"2.17";2.170
"MULTIPOLYGON (((-58.3918909856472 -34.5917643078973,-58.3908551705935 -34.5925740160621,-58.3909566093013 -34.5926587269519,-58.3921811500929 -34.5937506102367,-58.3921584046877 -34.5939606052985,-58.393076657833 -34.5938160565559,-58.3930621130623 -34.5936925222993,-58.3928348461291 -34.5926394637967,-58.3918909856472 -34.5917643078973)))";;"1931";2_7_1;COMUNA 2;"7";"1";"1419";"591";"828";"71,38%";"809";"807";"99,75%";"2";"0,25%";"573";"1";"0.17";"572";"99,83%";"0.17";0.170
"MULTIPOLYGON (((-58.3908551705935 -34.5925740160621,-58.3907620271884 -34.5926468513772,-58.3900179774502 -34.5932338279003,-58.3900600782646 -34.5942743161684,-58.3921584046877 -34.5939606052985,-58.3921811500929 -34.5937506102367,-58.3909566093013 -34.5926587269519,-58.3908551705935 -34.5925740160621)))";;"1932";2_7_2;COMUNA 2;"7";"2";"1073";"470";"603";"77,94%";"773";"773";"100,00%";"0";"0,00%";"493";"4";"0.81";"489";"99,19%";"0.81";0.810
"MULTIPOLYGON (((-58.3921584046877 -34.5939606052985,-58.3900600782646 -34.5942743161684,-58.390060775716 -34.5944514361644,-58.3900223353271 -34.5950749586705,-58.3920546306304 -34.5949210756724,-58.3921584046877 -34.5939606052985)))";;"1933";2_7_3;COMUNA 2;"7";"3";"922";"373";"549";"67,94%";"548";"547";"99,82%";"1";"0,18%";"361";"7";"1.94";"354";"98,06%";"1.94";1.940
"MULTIPOLYGON (((-58.393076657833 -34.5938160565559,-58.3921584046877 -34.5939606052985,-58.3920546306304 -34.5949210756724,-58.3931959749532 -34.5948322909778,-58.393076657833 -34.5938160565559)))";;"1934";2_7_4;COMUNA 2;"7";"4";"672";"304";"368";"82,61%";"390";"390";"100,00%";"0";"0,00%";"267";"2";"0.75";"265";"99,25%";"0.75";0.750
"MULTIPOLYGON (((-58.3931959749532 -34.5948322909778,-58.3920546306304 -34.5949210756724,-58.3919554892029 -34.5958388707808,-58.3933119614992 -34.5958630308263,-58.3932101816354 -34.5949532192679,-58.3931959749532 -34.5948322909778)))";;"1935";2_7_5;COMUNA 2;"7";"5";"524";"232";"292";"79,45%";"445";"445";"100,00%";"0";"0,00%";"244";"1";"0.41";"243";"99,59%";"0.41";0.410
"MULTIPOLYGON (((-58.3920546306304 -34.5949210756724,-58.3900223353271 -34.5950749586705,-58.3900165470137 -34.595169536363,-58.3899489725869 -34.595801422022,-58.3902254090708 -34.595808065639,-58.3919554892029 -34.5958388707808,-58.3920546306304 -34.5949210756724)))";;"1936";2_7_6;COMUNA 2;"7";"6";"590";"257";"333";"77,18%";"560";"560";"100,00%";"0";"0,00%";"271";"1";"0.37";"270";"99,63%";"0.37";0.370
"MULTIPOLYGON (((-58.3919554892029 -34.5958388707808,-58.3902254090708 -34.595808065639,-58.3899489725869 -34.595801422022,-58.3899259611438 -34.596016416628,-58.3898085603258 -34.5970423721045,-58.3897828767291 -34.5971957429516,-58.3913432623475 -34.5972130040435,-58.3916249017118 -34.5972161262716,-58.3918063015675 -34.5972190488042,-58.3919554892029 -34.5958388707808)))";;"1937";2_7_7;COMUNA 2;"7";"7";"933";"412";"521";"79,08%";"695";"692";"99,57%";"3";"0,43%";"409";"3";"0.73";"406";"99,27%";"0.73";0.730
"MULTIPOLYGON (((-58.3916549626963 -34.5986192962683,-58.3911951753527 -34.5985860686956,-58.3910773118547 -34.5985774781189,-58.3909531463441 -34.598568531597,-58.3897193285408 -34.5984785007145,-58.3896641498178 -34.5994408284322,-58.3901402099307 -34.5994721699684,-58.3913754982052 -34.5995534647226,-58.391552893462 -34.5995643433433,-58.3929308478483 -34.5996371135758,-58.392961005351 -34.5994236719657,-58.3930357807776 -34.5987117860495,-58.393191335992 -34.5972320291752,-58.39332388045 -34.5959702952809,-58.3933119614992 -34.5958630308263,-58.3919554892029 -34.5958388707808,-58.3918063015675 -34.5972190488042,-58.3916549626963 -34.5986192962683)))";;"1938";2_7_8;COMUNA 2;"7";"8";"435";"174";"261";"66,67%";"315";"311";"98,73%";"4";"1,29%";"172";"3";"1.74";"169";"98,26%";"1.74";1.740
"MULTIPOLYGON (((-58.3913432623475 -34.5972130040435,-58.3897828767291 -34.5971957429516,-58.3897597617311 -34.5973334104949,-58.3897255550862 -34.5983704017048,-58.3897193285408 -34.5984785007145,-58.3909531463441 -34.598568531597,-58.3910773118547 -34.5985774781189,-58.3911951753527 -34.5985860686956,-58.3916549626963 -34.5986192962683,-58.3918063015675 -34.5972190488042,-58.3916249017118 -34.5972161262716,-58.3913432623475 -34.5972130040435)))";;"1939";2_7_9;COMUNA 2;"7";"9";"530";"220";"310";"70,97%";"429";"429";"100,00%";"0";"0,00%";"278";"0";"0";"278";"100,00%";"0";0.000
"MULTIPOLYGON (((-58.3966040894421 -34.5923883141042,-58.3971964480766 -34.5929534444365,-58.3974670671638 -34.592873656679,-58.3971322427324 -34.5920785163829,-58.3970840468519 -34.5919641197725,-58.3967645702706 -34.5911539155859,-58.3960006708018 -34.5918197239642,-58.3964878482024 -34.5922774016564,-58.3966040894421 -34.5923883141042)))";;"1940";2_8_1;COMUNA 2;"8";"1";"713";"304";"409";"74,33%";"540";"538";"99,63%";"2";"0,37%";"347";"2";"0.58";"345";"99,42%";"0.58";0.580
"MULTIPOLYGON (((-58.3957919714071 -34.5901919396655,-58.394943296801 -34.5909107957163,-58.3959303815374 -34.591753697008,-58.3960006708018 -34.5918197239642,-58.3967645702706 -34.5911539155859,-58.3957919714071 -34.5901919396655)))";;"1941";2_8_2;COMUNA 2;"8";"2";"702";"297";"405";"73,33%";"456";"456";"100,00%";"0";"0,00%";"306";"2";"0.65";"304";"99,35%";"0.65";0.650
"MULTIPOLYGON (((-58.3949082277221 -34.5893178960732,-58.3939681483337 -34.5900749355927,-58.3941132385371 -34.5902019940943,-58.394943296801 -34.5909107957163,-58.3957919714071 -34.5901919396655,-58.3949082277221 -34.5893178960732)))";;"1942";2_8_3;COMUNA 2;"8";"3";"900";"397";"503";"78,93%";"714";"713";"99,86%";"1";"0,14%";"457";"3";"0.66";"454";"99,34%";"0.66";0.660
"MULTIPOLYGON (((-58.394943296801 -34.5909107957163,-58.3941132385371 -34.5902019940943,-58.3939681483337 -34.5900749355927,-58.3938187668711 -34.5901952082611,-58.3929129997463 -34.5909367653226,-58.3938919598467 -34.591796932641,-58.3939931116087 -34.5917155779706,-58.394943296801 -34.5909107957163)))";;"1943";2_8_4;COMUNA 2;"8";"4";"1105";"459";"646";"71,05%";"676";"676";"100,00%";"0";"0,00%";"478";"1";"0.21";"477";"99,79%";"0.21";0.210
"MULTIPOLYGON (((-58.394943296801 -34.5909107957163,-58.3939931116087 -34.5917155779706,-58.3938919598467 -34.591796932641,-58.3939849723 -34.5918786784114,-58.3949164030264 -34.592673033388,-58.3959221837849 -34.5918881344453,-58.3960006708018 -34.5918197239642,-58.3959303815374 -34.591753697008,-58.394943296801 -34.5909107957163)))";;"1944";2_8_5;COMUNA 2;"8";"5";"907";"409";"498";"82,13%";"654";"653";"99,85%";"1";"0,15%";"413";"2";"0.48";"411";"99,52%";"0.48";0.480
"MULTIPOLYGON (((-58.3966040894421 -34.5923883141042,-58.3964878482024 -34.5922774016564,-58.3960006708018 -34.5918197239642,-58.3959221837849 -34.5918881344453,-58.3949164030264 -34.592673033388,-58.3957521952598 -34.5933858466668,-58.396854275855 -34.5930550952735,-58.3969960175331 -34.5930125643648,-58.3971964480766 -34.5929534444365,-58.3966040894421 -34.5923883141042)))";;"1945";2_8_6;COMUNA 2;"8";"6";"1247";"514";"733";"70,12%";"890";"890";"100,00%";"0";"0,00%";"625";"5";"0.8";"620";"99,20%";"0.8";0.800
"MULTIPOLYGON (((-58.3938919598467 -34.591796932641,-58.3934740569012 -34.5921331180029,-58.3928348461291 -34.5926394637967,-58.3930621130623 -34.5936925222993,-58.393076657833 -34.5938160565559,-58.3943168609925 -34.5936207642484,-58.3956895013169 -34.5934046158102,-58.3957521952598 -34.5933858466668,-58.3949164030264 -34.592673033388,-58.3939849723 -34.5918786784114,-58.3938919598467 -34.591796932641)))";;"1946";2_8_7;COMUNA 2;"8";"7";"1495";"613";"882";"69,50%";"991";"990";"99,90%";"1";"0,10%";"707";"23";"3.25";"684";"96,75%";"3.25";3.250
"MULTIPOLYGON (((-58.3929129997463 -34.5909367653226,-58.392135470811 -34.5915732447865,-58.3918909856472 -34.5917643078973,-58.3928348461291 -34.5926394637967,-58.3934740569012 -34.5921331180029,-58.3938919598467 -34.591796932641,-58.3929129997463 -34.5909367653226)))";;"1947";2_8_8;COMUNA 2;"8";"8";"848";"363";"485";"74,85%";"493";"493";"100,00%";"0";"0,00%";"357";"2";"0.56";"355";"99,44%";"0.56";0.560
"MULTIPOLYGON (((-58.395857918388 -34.5885538119371,-58.3950258216253 -34.5892232392538,-58.3949082277221 -34.5893178960732,-58.3957919714071 -34.5901919396655,-58.3966239293769 -34.5894871536375,-58.395857918388 -34.5885538119371)))";;"1948";2_9_1;COMUNA 2;"9";"1";"765";"306";"459";"66,67%";"592";"592";"100,00%";"0";"0,00%";"399";"3";"0.75";"396";"99,25%";"0.75";0.750
"MULTIPOLYGON (((-58.3965170249554 -34.588023586534,-58.395857918388 -34.5885538119371,-58.3966239293769 -34.5894871536375,-58.3957919714071 -34.5901919396655,-58.3967645702706 -34.5911539155859,-58.3974352305245 -34.5905693937725,-58.3986053407445 -34.5898642816688,-58.3990505804709 -34.5895961941559,-58.3983126699401 -34.5887383784914,-58.398634845126 -34.5884811433829,-58.3987497063583 -34.5883894393893,-58.3980186775501 -34.5878995274806,-58.3972871466692 -34.5874092587627,-58.3972155751019 -34.5874615464262,-58.3965170249554 -34.588023586534)))";;"1949";2_9_2;COMUNA 2;"9";"2";"681";"227";"454";"50,00%";"319";"317";"99,37%";"2";"0,63%";"218";"1";"0.46";"217";"99,54%";"0.46";0.460
"MULTIPOLYGON (((-58.3987497063583 -34.5883894393893,-58.398634845126 -34.5884811433829,-58.3983126699401 -34.5887383784914,-58.3990505804709 -34.5895961941559,-58.3998273136677 -34.5891303105907,-58.3987497063583 -34.5883894393893)))";;"1950";2_9_3;COMUNA 2;"9";"3";"865";"386";"479";"80,58%";"682";"682";"100,00%";"0";"0,00%";"451";"0";"0";"451";"100,00%";"0";0.000
"MULTIPOLYGON (((-58.3998273136677 -34.5891303105907,-58.3990505804709 -34.5895961941559,-58.3986053407445 -34.5898642816688,-58.3992273535618 -34.5908466175913,-58.4003544120163 -34.5901892147204,-58.3998273136677 -34.5891303105907)))";;"1951";2_9_4;COMUNA 2;"9";"4";"1021";"451";"570";"79,12%";"617";"617";"100,00%";"0";"0,00%";"461";"0";"0";"461";"100,00%";"0";0.000
"MULTIPOLYGON (((-58.3986053407445 -34.5898642816688,-58.3974352305245 -34.5905693937725,-58.3980369090621 -34.5914064373362,-58.3981025742704 -34.5915071098926,-58.3986495471053 -34.5911836530011,-58.3992273535618 -34.5908466175913,-58.3986053407445 -34.5898642816688)))";;"1952";2_9_5;COMUNA 2;"9";"5";"1028";"431";"597";"72,19%";"713";"713";"100,00%";"0";"0,00%";"488";"3";"0.61";"485";"99,39%";"0.61";0.610
"MULTIPOLYGON (((-58.3974352305245 -34.5905693937725,-58.3967645702706 -34.5911539155859,-58.3970840468519 -34.5919641197725,-58.3971322427324 -34.5920785163829,-58.397645823131 -34.5917772300532,-58.3981025742704 -34.5915071098926,-58.3980369090621 -34.5914064373362,-58.3974352305245 -34.5905693937725)))";;"1953";2_9_6;COMUNA 2;"9";"6";"900";"369";"531";"69,49%";"679";"678";"99,85%";"1";"0,15%";"441";"2";"0.45";"439";"99,55%";"0.45";0.450
"MULTIPOLYGON (((-58.3981025742704 -34.5915071098926,-58.397645823131 -34.5917772300532,-58.3971322427324 -34.5920785163829,-58.3974670671638 -34.592873656679,-58.3987423005689 -34.5924975563119,-58.3983682990254 -34.5919142381593,-58.3981025742704 -34.5915071098926)))";;"1954";2_9_7;COMUNA 2;"9";"7";"949";"393";"556";"70,68%";"714";"713";"99,86%";"1";"0,14%";"472";"0";"0";"472";"100,00%";"0";0.000
"MULTIPOLYGON (((-58.3992273535618 -34.5908466175913,-58.3986495471053 -34.5911836530011,-58.3981025742704 -34.5915071098926,-58.3983682990254 -34.5919142381593,-58.3987423005689 -34.5924975563119,-58.3999587665999 -34.5920019710594,-58.3992273535618 -34.5908466175913)))";;"1955";2_9_8;COMUNA 2;"9";"8";"1377";"604";"773";"78,14%";"898";"898";"100,00%";"0";"0,00%";"649";"4";"0.62";"645";"99,38%";"0.62";0.620
"MULTIPOLYGON (((-58.4003544120163 -34.5901892147204,-58.3992273535618 -34.5908466175913,-58.3999587665999 -34.5920019710594,-58.4010325337264 -34.5915634165405,-58.4004888461663 -34.5904589419239,-58.4003544120163 -34.5901892147204)))";;"1956";2_9_9;COMUNA 2;"9";"9";"1150";"497";"653";"76,11%";"781";"781";"100,00%";"0";"0,00%";"550";"10";"1.82";"540";"98,18%";"1.82";1.820
"MULTIPOLYGON (((-58.4123093634233 -34.6002382071366,-58.4121240654761 -34.5992961422995,-58.411918832168 -34.5980030496281,-58.4102941448179 -34.5980927182868,-58.4105902229219 -34.5993924020356,-58.4099545915514 -34.5994322713167,-58.4086966154945 -34.5995084141382,-58.4091364059186 -34.6007271756238,-58.4091784895713 -34.6008440999481,-58.4108625650451 -34.6005277022522,-58.4109991917505 -34.6005019845875,-58.4123093634233 -34.6002382071366)))";;"1957";3_1_1;COMUNA 3;"1";"1";"1026";"453";"573";"79,06%";"667";"667";"100,00%";"0";"0,00%";"488";"44";"9.02";"444";"90,98%";"9.02";9.020
"MULTIPOLYGON (((-58.411742231099 -34.6040833481152,-58.4115848360541 -34.6040774369904,-58.4104751564697 -34.604026260945,-58.4103444995547 -34.6040302191867,-58.4107707970593 -34.6051091741562,-58.41088365881 -34.6050980949618,-58.4120364759797 -34.6051076639359,-58.411742231099 -34.6040833481152)))";;"1958";3_1_10;COMUNA 3;"1";"10";"438";"211";"227";"92,95%";"195";"195";"100,00%";"0";"0,00%";"192";"84";"43.75";"108";"56,25%";"43.75";43.750
"MULTIPOLYGON (((-58.4103444995547 -34.6040302191867,-58.4100860815485 -34.6040381364992,-58.409183046695 -34.6040960558101,-58.408914738704 -34.604118966866,-58.4089837121162 -34.6042765383698,-58.4093775268675 -34.6052460431466,-58.4107707970593 -34.6051091741562,-58.4103444995547 -34.6040302191867)))";;"1959";3_1_11;COMUNA 3;"1";"11";"462";"226";"236";"95,76%";"288";"287";"99,65%";"1";"0,35%";"230";"19";"8.26";"211";"91,74%";"8.26";8.260
"MULTIPOLYGON (((-58.4094280912428 -34.5980883994574,-58.4087214727026 -34.5980785110929,-58.4081479690345 -34.59806895992,-58.4082342245222 -34.5982269622768,-58.4086966154945 -34.5995084141382,-58.4099545915514 -34.5994322713167,-58.4105902229219 -34.5993924020356,-58.4102941448179 -34.5980927182868,-58.4094280912428 -34.5980883994574)))";;"1960";3_1_2;COMUNA 3;"1";"2";"903";"410";"493";"83,16%";"536";"535";"99,81%";"1";"0,19%";"419";"15";"3.58";"404";"96,42%";"3.58";3.580
"MULTIPOLYGON (((-58.4081479690345 -34.59806895992,-58.4066262332025 -34.5980458044772,-58.4071953027705 -34.5995993636927,-58.4086966154945 -34.5995084141382,-58.4082342245222 -34.5982269622768,-58.4081479690345 -34.59806895992)))";;"1961";3_1_3;COMUNA 3;"1";"3";"960";"395";"565";"69,91%";"621";"621";"100,00%";"0";"0,00%";"467";"49";"10.49";"418";"89,51%";"10.49";10.490
"MULTIPOLYGON (((-58.4086966154945 -34.5995084141382,-58.4071953027705 -34.5995993636927,-58.407234834183 -34.5997071322669,-58.4075782149685 -34.6006344359169,-58.4077598221715 -34.6011106626937,-58.4091784895713 -34.6008440999481,-58.4091364059186 -34.6007271756238,-58.4086966154945 -34.5995084141382)))";;"1962";3_1_4;COMUNA 3;"1";"4";"490";"220";"270";"81,48%";"345";"345";"100,00%";"0";"0,00%";"248";"9";"3.63";"239";"96,37%";"3.63";3.630
"MULTIPOLYGON (((-58.4108625650451 -34.6005277022522,-58.4091784895713 -34.6008440999481,-58.4077598221715 -34.6011106626937,-58.4080722017632 -34.6019243549334,-58.4081095277983 -34.6020216992671,-58.4094798792293 -34.6016826439025,-58.4110460545806 -34.6012950627827,-58.4108625650451 -34.6005277022522)))";;"1963";3_1_5;COMUNA 3;"1";"5";"909";"403";"506";"79,64%";"494";"493";"99,80%";"1";"0,20%";"374";"33";"8.82";"341";"91,18%";"8.82";8.820
"MULTIPOLYGON (((-58.4112302299751 -34.6020605921762,-58.4114377912496 -34.6028904996506,-58.4115848622861 -34.6034786116778,-58.4128332669505 -34.603267078034,-58.4129727122721 -34.6032345280815,-58.4128039938622 -34.6025116854483,-58.4125916132526 -34.6016018456514,-58.4123093634233 -34.6002382071366,-58.4109991917505 -34.6005019845875,-58.4108625650451 -34.6005277022522,-58.4110460545806 -34.6012950627827,-58.4112051665352 -34.6019604369636,-58.4112302299751 -34.6020605921762)))";;"1964";3_1_6;COMUNA 3;"1";"6";"715";"358";"357";"100,28%";"372";"371";"99,73%";"1";"0,27%";"262";"47";"17.94";"215";"82,06%";"17.94";17.940
"MULTIPOLYGON (((-58.4094798792293 -34.6016826439025,-58.4081095277983 -34.6020216992671,-58.4084651930104 -34.6029481604717,-58.4097904590468 -34.6025437974732,-58.4099202008397 -34.602501809821,-58.4112302299751 -34.6020605921762,-58.4112051665352 -34.6019604369636,-58.4110460545806 -34.6012950627827,-58.4094798792293 -34.6016826439025)))";;"1965";3_1_7;COMUNA 3;"1";"7";"847";"430";"417";"103,12%";"372";"371";"99,73%";"1";"0,27%";"347";"177";"51.01";"170";"48,99%";"51.01";51.010
"MULTIPOLYGON (((-58.408684564853 -34.6035196877511,-58.4087182361641 -34.6036073820058,-58.408839131935 -34.6039461805528,-58.408914738704 -34.604118966866,-58.409183046695 -34.6040960558101,-58.4100860815485 -34.6040381364992,-58.4103444995547 -34.6040302191867,-58.4102819121317 -34.6038719469365,-58.4100593108728 -34.603270349608,-58.4097904590468 -34.6025437974732,-58.4084651930104 -34.6029481604717,-58.408684564853 -34.6035196877511)))";;"1966";3_1_8;COMUNA 3;"1";"8";"491";"247";"244";"101,23%";"242";"241";"99,59%";"1";"0,41%";"188";"116";"61.7";"72";"38,30%";"61.7";61.700
"MULTIPOLYGON (((-58.4115848622861 -34.6034786116778,-58.4114377912496 -34.6028904996506,-58.4112302299751 -34.6020605921762,-58.4099202008397 -34.602501809821,-58.4097904590468 -34.6025437974732,-58.4100593108728 -34.603270349608,-58.4102819121317 -34.6038719469365,-58.4103444995547 -34.6040302191867,-58.4104751564697 -34.604026260945,-58.4115848360541 -34.6040774369904,-58.411742231099 -34.6040833481152,-58.4120364759797 -34.6051076639359,-58.413412361718 -34.6051190729599,-58.4132219723806 -34.6043022751838,-58.4131834869508 -34.6041375350811,-58.4129727122721 -34.6032345280815,-58.4128332669505 -34.603267078034,-58.4115848622861 -34.6034786116778)))";;"1967";3_1_9;COMUNA 3;"1";"9";"530";"247";"283";"87,28%";"295";"291";"98,64%";"4";"1,37%";"227";"2";"0.88";"225";"99,12%";"0.88";0.880
"MULTIPOLYGON (((-58.4061198153138 -34.6077438236391,-58.40487078277 -34.6076341494924,-58.4047484767391 -34.6076243727928,-58.4046709395968 -34.6087649413165,-58.404574310173 -34.610042336466,-58.4055449677441 -34.6100961068484,-58.4059659035084 -34.6101207408265,-58.4059854242534 -34.6097231297379,-58.4060062401884 -34.609299461929,-58.4060294648944 -34.6088404417952,-58.406036862241 -34.6087343145721,-58.4061198153138 -34.6077438236391)))";;"1968";3_10_1;COMUNA 3;"10";"1";"786";"341";"445";"76,63%";"521";"518";"99,42%";"3";"0,58%";"377";"6";"1.59";"371";"98,41%";"1.59";1.590
"MULTIPOLYGON (((-58.4047484767391 -34.6076243727928,-58.4036332448479 -34.6075349614693,-58.4034663906529 -34.6075272042389,-58.4033973317985 -34.6086986927064,-58.4046709395968 -34.6087649413165,-58.4047484767391 -34.6076243727928)))";;"1969";3_10_2;COMUNA 3;"10";"2";"820";"379";"441";"85,94%";"436";"435";"99,77%";"1";"0,23%";"323";"27";"8.36";"296";"91,64%";"8.36";8.360
"MULTIPOLYGON (((-58.4034663906529 -34.6075272042389,-58.4033166563465 -34.6075201593654,-58.402106421471 -34.6074787177526,-58.4019681014475 -34.6074709726409,-58.4019082361708 -34.6086212668791,-58.4033973317985 -34.6086986927064,-58.4034663906529 -34.6075272042389)))";;"1970";3_10_3;COMUNA 3;"10";"3";"952";"449";"503";"89,26%";"314";"313";"99,68%";"1";"0,32%";"257";"27";"10.51";"230";"89,49%";"10.51";10.510
"MULTIPOLYGON (((-58.4019681014475 -34.6074709726409,-58.4006337910732 -34.6073968477606,-58.4004958971511 -34.6073891716218,-58.3992563842933 -34.6073225450365,-58.3992183354676 -34.6084091849933,-58.3992132625411 -34.6084715790125,-58.3993052487534 -34.6084779651036,-58.4004148793868 -34.6085506519398,-58.4005523502811 -34.6085570603021,-58.4017424027089 -34.6086126626986,-58.4019082361708 -34.6086212668791,-58.4019681014475 -34.6074709726409)))";;"1971";3_10_4;COMUNA 3;"10";"4";"733";"331";"402";"82,34%";"417";"416";"99,76%";"1";"0,24%";"298";"11";"3.69";"287";"96,31%";"3.69";3.690
"MULTIPOLYGON (((-58.4005523502811 -34.6085570603021,-58.4004148793868 -34.6085506519398,-58.3993052487534 -34.6084779651036,-58.3992132625411 -34.6084715790125,-58.39910270402 -34.6096988903433,-58.4000731675666 -34.609774113389,-58.4004706757303 -34.6097991768487,-58.4005042077812 -34.6092892218898,-58.4005523502811 -34.6085570603021)))";;"1972";3_10_5;COMUNA 3;"10";"5";"469";"192";"277";"69,31%";"302";"300";"99,34%";"2";"0,67%";"202";"17";"8.42";"185";"91,58%";"8.42";8.420
"MULTIPOLYGON (((-58.4019082361708 -34.6086212668791,-58.4017424027089 -34.6086126626986,-58.4005523502811 -34.6085570603021,-58.4005042077812 -34.6092892218898,-58.4004706757303 -34.6097991768487,-58.4007701485034 -34.6098180623059,-58.4009629608908 -34.6098324719455,-58.4014646541672 -34.609869964036,-58.4017813344235 -34.6098875175695,-58.401853323016 -34.6097531119613,-58.4019082361708 -34.6086212668791)))";;"1973";3_10_6;COMUNA 3;"10";"6";"976";"445";"531";"83,80%";"509";"509";"100,00%";"0";"0,00%";"390";"61";"15.64";"329";"84,36%";"15.64";15.640
"MULTIPOLYGON (((-58.4033973317985 -34.6086986927064,-58.4019082361708 -34.6086212668791,-58.401853323016 -34.6097531119613,-58.4017813344235 -34.6098875175695,-58.4033232563832 -34.6099744780517,-58.4033973317985 -34.6086986927064)))";;"1974";3_10_7;COMUNA 3;"10";"7";"742";"324";"418";"77,51%";"415";"415";"100,00%";"0";"0,00%";"340";"43";"12.65";"297";"87,35%";"12.65";12.650
"MULTIPOLYGON (((-58.4046709395968 -34.6087649413165,-58.4033973317985 -34.6086986927064,-58.4033232563832 -34.6099744780517,-58.404574310173 -34.610042336466,-58.4046709395968 -34.6087649413165)))";;"1975";3_10_8;COMUNA 3;"10";"8";"658";"300";"358";"83,80%";"334";"330";"98,80%";"4";"1,21%";"274";"43";"15.69";"231";"84,31%";"15.69";15.690
"MULTIPOLYGON (((-58.3992563842933 -34.6073225450365,-58.3991171277048 -34.6073150074812,-58.3980076863747 -34.6072405483098,-58.3978498570459 -34.6072390560208,-58.3978395579345 -34.6073394063643,-58.3977368916811 -34.6082521318478,-58.3977265799631 -34.6083683278109,-58.3992132625411 -34.6084715790125,-58.3992183354676 -34.6084091849933,-58.3992563842933 -34.6073225450365)))";;"1976";3_11_1;COMUNA 3;"11";"1";"809";"355";"454";"78,19%";"457";"456";"99,78%";"1";"0,22%";"367";"0";"0";"367";"100,00%";"0";0.000
"MULTIPOLYGON (((-58.3978498570459 -34.6072390560208,-58.3977217537938 -34.6072378610628,-58.3964699945392 -34.6071531003886,-58.3964556478484 -34.6073071827964,-58.3963798422663 -34.6082702756783,-58.3976087868089 -34.6083601661363,-58.3977265799631 -34.6083683278109,-58.3977368916811 -34.6082521318478,-58.3978395579345 -34.6073394063643,-58.3978498570459 -34.6072390560208)))";;"1977";3_11_2;COMUNA 3;"11";"2";"934";"420";"514";"81,71%";"569";"567";"99,65%";"2";"0,35%";"454";"109";"24.01";"345";"75,99%";"24.01";24.010
"MULTIPOLYGON (((-58.3964699945392 -34.6071531003886,-58.3950317990403 -34.6070556175162,-58.3950277869239 -34.6071715350649,-58.3949442608297 -34.6080768741818,-58.3949424909359 -34.6081585663432,-58.3962644345553 -34.608261832302,-58.3963798422663 -34.6082702756783,-58.3964556478484 -34.6073071827964,-58.3964699945392 -34.6071531003886)))";;"1978";3_11_3;COMUNA 3;"11";"3";"898";"399";"499";"79,96%";"457";"454";"99,34%";"3";"0,66%";"384";"97";"25.26";"287";"74,74%";"25.26";25.260
"MULTIPOLYGON (((-58.39356450534 -34.6069238745904,-58.3923150804389 -34.6068087193785,-58.3921121248773 -34.606788671816,-58.3920423175351 -34.6078518396288,-58.3920335154173 -34.6079865577954,-58.3919606234097 -34.6091693054037,-58.3933732049625 -34.6092767398535,-58.393461693681 -34.6080586468491,-58.3935796582757 -34.6080644885954,-58.3948151600149 -34.6081486360463,-58.3949424909359 -34.6081585663432,-58.3949442608297 -34.6080768741818,-58.3950277869239 -34.6071715350649,-58.3950317990403 -34.6070556175162,-58.3948905007375 -34.6070460316757,-58.39356450534 -34.6069238745904)))";;"1979";3_11_4;COMUNA 3;"11";"4";"1213";"556";"657";"84,63%";"638";"628";"98,43%";"10";"1,59%";"386";"17";"4.4";"369";"95,60%";"4.4";4.400
"MULTIPOLYGON (((-58.3949424909359 -34.6081585663432,-58.3948151600149 -34.6081486360463,-58.3935796582757 -34.6080644885954,-58.393461693681 -34.6080586468491,-58.3933732049625 -34.6092767398535,-58.3946129751126 -34.6093709625622,-58.3948638952501 -34.6093878635084,-58.3949424909359 -34.6081585663432)))";;"1980";3_11_5;COMUNA 3;"11";"5";"704";"315";"389";"80,98%";"453";"452";"99,78%";"1";"0,22%";"316";"53";"16.77";"263";"83,23%";"16.77";16.770
"MULTIPOLYGON (((-58.3963798422663 -34.6082702756783,-58.3962644345553 -34.608261832302,-58.3949424909359 -34.6081585663432,-58.3948638952501 -34.6093878635084,-58.3962866295023 -34.6094839314297,-58.3963798422663 -34.6082702756783)))";;"1981";3_11_6;COMUNA 3;"11";"6";"916";"424";"492";"86,18%";"536";"533";"99,44%";"3";"0,56%";"415";"142";"34.22";"273";"65,78%";"34.22";34.220
"MULTIPOLYGON (((-58.3977265799631 -34.6083683278109,-58.3976087868089 -34.6083601661363,-58.3963798422663 -34.6082702756783,-58.3962866295023 -34.6094839314297,-58.3966446984664 -34.6095080703532,-58.3973800801859 -34.609565369766,-58.3975896906379 -34.6095816091571,-58.3977265799631 -34.6083683278109)))";;"1982";3_11_7;COMUNA 3;"11";"7";"843";"337";"506";"66,60%";"585";"584";"99,83%";"1";"0,17%";"437";"58";"13.27";"379";"86,73%";"13.27";13.270
"MULTIPOLYGON (((-58.3992132625411 -34.6084715790125,-58.3977265799631 -34.6083683278109,-58.3975896906379 -34.6095816091571,-58.39910270402 -34.6096988903433,-58.3992132625411 -34.6084715790125)))";;"1983";3_11_8;COMUNA 3;"11";"8";"584";"254";"330";"76,97%";"369";"369";"100,00%";"0";"0,00%";"284";"15";"5.28";"269";"94,72%";"5.28";5.280
"MULTIPOLYGON (((-58.4004706757303 -34.6097991768487,-58.4000731675666 -34.609774113389,-58.39910270402 -34.6096988903433,-58.3990740431911 -34.6106458113317,-58.3990659093814 -34.6108122215922,-58.399300393724 -34.6108310063173,-58.4003930119437 -34.6109141778396,-58.4004099681214 -34.6106787554013,-58.4004706757303 -34.6097991768487)))";;"1984";3_12_1;COMUNA 3;"12";"1";"679";"294";"385";"76,36%";"513";"513";"100,00%";"0";"0,00%";"350";"3";"0.86";"347";"99,14%";"0.86";0.860
"MULTIPOLYGON (((-58.4003930119437 -34.6109141778396,-58.399300393724 -34.6108310063173,-58.3990659093814 -34.6108122215922,-58.3977887253508 -34.6107099253527,-58.3974722205131 -34.6106829950129,-58.3974524123953 -34.610960248018,-58.397436195218 -34.6118733006042,-58.397617020242 -34.6118898766693,-58.3989629689059 -34.6119841821812,-58.399208445982 -34.6120014234719,-58.4003168388476 -34.6120832658009,-58.4003301809357 -34.6118972799798,-58.4003759696476 -34.6111507270239,-58.4003930119437 -34.6109141778396)))";;"1985";3_12_10;COMUNA 3;"12";"10";"845";"377";"468";"80,56%";"390";"390";"100,00%";"0";"0,00%";"363";"98";"27";"265";"73,00%";"27";27.000
"MULTIPOLYGON (((-58.39910270402 -34.6096988903433,-58.3975896906379 -34.6095816091571,-58.3974835892788 -34.6105229952702,-58.3974722205131 -34.6106829950129,-58.3977887253508 -34.6107099253527,-58.3990659093814 -34.6108122215922,-58.3990740431911 -34.6106458113317,-58.39910270402 -34.6096988903433)))";;"1986";3_12_2;COMUNA 3;"12";"2";"904";"380";"524";"72,52%";"545";"545";"100,00%";"0";"0,00%";"428";"52";"12.15";"376";"87,85%";"12.15";12.150
"MULTIPOLYGON (((-58.3975896906379 -34.6095816091571,-58.3973800801859 -34.609565369766,-58.3966446984664 -34.6095080703532,-58.3962866295023 -34.6094839314297,-58.3962221116007 -34.6106004862981,-58.3972673783418 -34.610665490327,-58.3974722205131 -34.6106829950129,-58.3974835892788 -34.6105229952702,-58.3975896906379 -34.6095816091571)))";;"1987";3_12_3;COMUNA 3;"12";"3";"578";"221";"357";"61,90%";"368";"368";"100,00%";"0";"0,00%";"310";"57";"18.39";"253";"81,61%";"18.39";18.390
"MULTIPOLYGON (((-58.3962866295023 -34.6094839314297,-58.3948638952501 -34.6093878635084,-58.3948174943871 -34.610513160424,-58.3962221116007 -34.6106004862981,-58.3962866295023 -34.6094839314297)))";;"1988";3_12_4;COMUNA 3;"12";"4";"491";"253";"238";"106,30%";"288";"287";"99,65%";"1";"0,35%";"249";"73";"29.32";"176";"70,68%";"29.32";29.320
"MULTIPOLYGON (((-58.3948638952501 -34.6093878635084,-58.3946129751126 -34.6093709625622,-58.3933732049625 -34.6092767398535,-58.3933386836116 -34.6104326778815,-58.3945919518975 -34.6104990905567,-58.3948174943871 -34.610513160424,-58.3948638952501 -34.6093878635084)))";;"1989";3_12_5;COMUNA 3;"12";"5";"971";"411";"560";"73,39%";"675";"674";"99,85%";"1";"0,15%";"491";"2";"0.41";"489";"99,59%";"0.41";0.410
"MULTIPOLYGON (((-58.3933732049625 -34.6092767398535,-58.3919606234097 -34.6091693054037,-58.3919516607575 -34.6092921215986,-58.3918751326524 -34.6103404957086,-58.391806531758 -34.6112799265883,-58.3917946753218 -34.6114996459632,-58.3920891184707 -34.6115281276143,-58.3931372043198 -34.6115933799304,-58.3933037230689 -34.6116034046977,-58.3933386836116 -34.6104326778815,-58.3933732049625 -34.6092767398535)))";;"1990";3_12_6;COMUNA 3;"12";"6";"269";"149";"120";"124,17%";"93";"85";"91,40%";"8";"9,41%";"66";"22";"33.33";"44";"66,67%";"33.33";33.330
"MULTIPOLYGON (((-58.3948174943871 -34.610513160424,-58.3945919518975 -34.6104990905567,-58.3933386836116 -34.6104326778815,-58.3933037230689 -34.6116034046977,-58.3945122839905 -34.6116763422841,-58.3947688332201 -34.6116928944442,-58.3948174943871 -34.610513160424)))";;"1991";3_12_7;COMUNA 3;"12";"7";"928";"425";"503";"84,49%";"603";"603";"100,00%";"0";"0,00%";"466";"41";"8.8";"425";"91,20%";"8.8";8.800
"MULTIPOLYGON (((-58.3962221116007 -34.6106004862981,-58.3948174943871 -34.610513160424,-58.3947688332201 -34.6116928944442,-58.3959416186203 -34.6117688262258,-58.3961650345948 -34.6117837375386,-58.3961683884676 -34.6115302794898,-58.3962221116007 -34.6106004862981)))";;"1992";3_12_8;COMUNA 3;"12";"8";"546";"226";"320";"70,63%";"380";"379";"99,74%";"1";"0,26%";"291";"54";"18.56";"237";"81,44%";"18.56";18.560
"MULTIPOLYGON (((-58.3974722205131 -34.6106829950129,-58.3972673783418 -34.610665490327,-58.3962221116007 -34.6106004862981,-58.3961683884676 -34.6115302794898,-58.3961650345948 -34.6117837375386,-58.3972419978385 -34.6118555902959,-58.397436195218 -34.6118733006042,-58.3974524123953 -34.610960248018,-58.3974722205131 -34.6106829950129)))";;"1993";3_12_9;COMUNA 3;"12";"9";"478";"231";"247";"93,52%";"283";"280";"98,94%";"3";"1,07%";"214";"3";"1.4";"211";"98,60%";"1.4";1.400
"MULTIPOLYGON (((-58.4014474235694 -34.6132666982191,-58.4011847331936 -34.6132526923096,-58.4002239208763 -34.6132014980162,-58.400125946434 -34.6143572639152,-58.40135320732 -34.6144316222447,-58.4013703025673 -34.61423606046,-58.4014317969264 -34.6134348654328,-58.4014474235694 -34.6132666982191)))";;"1994";3_13_1;COMUNA 3;"13";"1";"744";"352";"392";"89,80%";"367";"366";"99,73%";"1";"0,27%";"305";"68";"22.3";"237";"77,70%";"22.3";22.300
"MULTIPOLYGON (((-58.3961491762954 -34.6129763775474,-58.3947197365313 -34.6128826987581,-58.3946720304045 -34.6140368685164,-58.3949770504926 -34.6140599967851,-58.3959097479168 -34.6141252315945,-58.3961349617884 -34.614136693117,-58.3961366717035 -34.6139154185216,-58.3961491762954 -34.6129763775474)))";;"1995";3_13_10;COMUNA 3;"13";"10";"693";"345";"348";"99,14%";"204";"204";"100,00%";"0";"0,00%";"315";"145";"46.03";"170";"53,97%";"46.03";46.030
"MULTIPOLYGON (((-58.3988675420895 -34.6131292440118,-58.3986426716598 -34.6131172947379,-58.3976713000906 -34.6130659339473,-58.3974260733235 -34.6130517884021,-58.3963808579229 -34.6129915746729,-58.3961491762954 -34.6129763775474,-58.3961366717035 -34.6139154185216,-58.3961349617884 -34.614136693117,-58.3972323267801 -34.6141923593173,-58.3974748312404 -34.6142062220957,-58.3977556663185 -34.6142222879795,-58.3987782408225 -34.6142807878658,-58.3988483753789 -34.6133528335703,-58.3988675420895 -34.6131292440118)))";;"1996";3_13_11;COMUNA 3;"13";"11";"896";"411";"485";"84,74%";"389";"385";"98,97%";"4";"1,04%";"267";"5";"1.87";"262";"98,13%";"1.87";1.870
"MULTIPOLYGON (((-58.3988675420895 -34.6131292440118,-58.3988483753789 -34.6133528335703,-58.3987782408225 -34.6142807878658,-58.3990299451708 -34.6142951453484,-58.3992898271058 -34.6143095769874,-58.3998589101148 -34.6143411401709,-58.400125946434 -34.6143572639152,-58.4002239208763 -34.6132014980162,-58.4011847331936 -34.6132526923096,-58.4014474235694 -34.6132666982191,-58.4015398082513 -34.6122726242241,-58.4015491601388 -34.6121810058825,-58.401376167672 -34.6121680312617,-58.4004860833935 -34.612095747037,-58.4003168388476 -34.6120832658009,-58.399208445982 -34.6120014234719,-58.3989629689059 -34.6119841821812,-58.3988848171366 -34.6129286120256,-58.3988675420895 -34.6131292440118)))";;"1997";3_13_2;COMUNA 3;"13";"2";"771";"348";"423";"82,27%";"410";"410";"100,00%";"0";"0,00%";"356";"86";"24.16";"270";"75,84%";"24.16";24.160
"MULTIPOLYGON (((-58.3989629689059 -34.6119841821812,-58.397617020242 -34.6118898766693,-58.397436195218 -34.6118733006042,-58.3974181935536 -34.6128891727002,-58.3974260733235 -34.6130517884021,-58.3976713000906 -34.6130659339473,-58.3986426716598 -34.6131172947379,-58.3988675420895 -34.6131292440118,-58.3988848171366 -34.6129286120256,-58.3989629689059 -34.6119841821812)))";;"1998";3_13_3;COMUNA 3;"13";"3";"817";"370";"447";"82,77%";"467";"466";"99,79%";"1";"0,21%";"393";"42";"10.69";"351";"89,31%";"10.69";10.690
"MULTIPOLYGON (((-58.397436195218 -34.6118733006042,-58.3972419978385 -34.6118555902959,-58.3961650345948 -34.6117837375386,-58.3961491762954 -34.6129763775474,-58.3963808579229 -34.6129915746729,-58.3974260733235 -34.6130517884021,-58.3974181935536 -34.6128891727002,-58.397436195218 -34.6118733006042)))";;"1999";3_13_4;COMUNA 3;"13";"4";"516";"249";"267";"93,26%";"253";"252";"99,60%";"1";"0,40%";"208";"67";"32.21";"141";"67,79%";"32.21";32.210
"MULTIPOLYGON (((-58.3961650345948 -34.6117837375386,-58.3959416186203 -34.6117688262258,-58.3947688332201 -34.6116928944442,-58.3947197365313 -34.6128826987581,-58.3961491762954 -34.6129763775474,-58.3961650345948 -34.6117837375386)))";;"2000";3_13_5;COMUNA 3;"13";"5";"633";"275";"358";"76,82%";"433";"433";"100,00%";"0";"0,00%";"329";"27";"8.21";"302";"91,79%";"8.21";8.210
"MULTIPOLYGON (((-58.3947688332201 -34.6116928944442,-58.3945122839905 -34.6116763422841,-58.3933037230689 -34.6116034046977,-58.3932685885735 -34.6127772298824,-58.3945008320274 -34.6128683507222,-58.3947197365313 -34.6128826987581,-58.3947688332201 -34.6116928944442)))";;"2001";3_13_6;COMUNA 3;"13";"6";"735";"326";"409";"79,71%";"438";"438";"100,00%";"0";"0,00%";"323";"9";"2.79";"314";"97,21%";"2.79";2.790
"MULTIPOLYGON (((-58.3933037230689 -34.6116034046977,-58.3931372043198 -34.6115933799304,-58.3920891184707 -34.6115281276143,-58.3917946753218 -34.6114996459632,-58.3917855878243 -34.6116685200297,-58.3917664343424 -34.6124555091322,-58.3917568026426 -34.6126631166423,-58.3920348146329 -34.6126860252854,-58.3932685885735 -34.6127772298824,-58.3933037230689 -34.6116034046977)))";;"2002";3_13_7;COMUNA 3;"13";"7";"622";"267";"355";"75,21%";"320";"319";"99,69%";"1";"0,31%";"251";"12";"4.78";"239";"95,22%";"4.78";4.780
"MULTIPOLYGON (((-58.3932685885735 -34.6127772298824,-58.3920348146329 -34.6126860252854,-58.3917568026426 -34.6126631166423,-58.391749254193 -34.6128249490618,-58.3917102415983 -34.6138250326803,-58.3920015430305 -34.6138513295322,-58.3932321918672 -34.6139311942457,-58.393241423582 -34.6136882330528,-58.3932685885735 -34.6127772298824)))";;"2003";3_13_8;COMUNA 3;"13";"8";"498";"230";"268";"85,82%";"334";"334";"100,00%";"0";"0,00%";"241";"47";"19.5";"194";"80,50%";"19.5";19.500
"MULTIPOLYGON (((-58.3947197365313 -34.6128826987581,-58.3945008320274 -34.6128683507222,-58.3932685885735 -34.6127772298824,-58.393241423582 -34.6136882330528,-58.3932321918672 -34.6139311942457,-58.3935528014822 -34.6139520109242,-58.3946720304045 -34.6140368685164,-58.3947197365313 -34.6128826987581)))";;"2004";3_13_9;COMUNA 3;"13";"9";"723";"303";"420";"72,14%";"472";"472";"100,00%";"0";"0,00%";"369";"28";"7.59";"341";"92,41%";"7.59";7.590
"MULTIPOLYGON (((-58.408599089914 -34.6139669352614,-58.4084009930457 -34.6150863943799,-58.4096803475958 -34.6152503432045,-58.4098725510032 -34.6139949591079,-58.4100399436626 -34.6129016822679,-58.4100709962528 -34.6126929557382,-58.4087131752617 -34.6126110919058,-58.4086221739548 -34.6138362365772,-58.408599089914 -34.6139669352614)))";;"2005";3_14_1;COMUNA 3;"14";"1";"880";"424";"456";"92,98%";"420";"411";"97,86%";"9";"2,19%";"346";"114";"32.95";"232";"67,05%";"32.95";32.950
"MULTIPOLYGON (((-58.4075629526256 -34.6138032965123,-58.4067485251653 -34.6136746816754,-58.4065431789449 -34.613632895688,-58.4065067369228 -34.6137356290789,-58.4061949274602 -34.614803692351,-58.4072839042683 -34.6149432813424,-58.4084009930457 -34.6150863943799,-58.408599089914 -34.6139669352614,-58.4075629526256 -34.6138032965123)))";;"2006";3_14_10;COMUNA 3;"14";"10";"898";"404";"494";"81,78%";"393";"392";"99,75%";"1";"0,26%";"313";"41";"13.1";"272";"86,90%";"13.1";13.100
"MULTIPOLYGON (((-58.4087131752617 -34.6126110919058,-58.4069414788323 -34.6125043053076,-58.4068585232157 -34.6127427266803,-58.4065431789449 -34.613632895688,-58.4067485251653 -34.6136746816754,-58.4075629526256 -34.6138032965123,-58.408599089914 -34.6139669352614,-58.4086221739548 -34.6138362365772,-58.4087131752617 -34.6126110919058)))";;"2007";3_14_2;COMUNA 3;"14";"2";"948";"439";"509";"86,25%";"510";"508";"99,61%";"2";"0,39%";"418";"58";"13.88";"360";"86,12%";"13.88";13.880
"MULTIPOLYGON (((-58.4069414788323 -34.6125043053076,-58.4055671395617 -34.6124214833854,-58.4052767486464 -34.6134242705281,-58.4063271014595 -34.6135889212196,-58.4065431789449 -34.613632895688,-58.4068585232157 -34.6127427266803,-58.4069414788323 -34.6125043053076)))";;"2008";3_14_3;COMUNA 3;"14";"3";"1052";"484";"568";"85,21%";"576";"575";"99,83%";"1";"0,17%";"454";"5";"1.1";"449";"98,90%";"1.1";1.100
"MULTIPOLYGON (((-58.4055671395617 -34.6124214833854,-58.4053341793287 -34.6124074299033,-58.4043501242144 -34.612349918914,-58.403240348848 -34.6122850145724,-58.4031328541214 -34.6133534513599,-58.4040076481114 -34.6133877498019,-58.4042182969452 -34.6133964428179,-58.4052767486464 -34.6134242705281,-58.4055671395617 -34.6124214833854)))";;"2009";3_14_4;COMUNA 3;"14";"4";"802";"371";"431";"86,08%";"403";"400";"99,26%";"3";"0,75%";"299";"38";"12.71";"261";"87,29%";"12.71";12.710
"MULTIPOLYGON (((-58.403240348848 -34.6122850145724,-58.4018590305712 -34.6122042602306,-58.4015491601388 -34.6121810058825,-58.4015398082513 -34.6122726242241,-58.4014474235694 -34.6132666982191,-58.4029038916137 -34.6133444657948,-58.4031328541214 -34.6133534513599,-58.403240348848 -34.6122850145724)))";;"2010";3_14_5;COMUNA 3;"14";"5";"844";"387";"457";"84,68%";"428";"428";"100,00%";"0";"0,00%";"365";"99";"27.12";"266";"72,88%";"27.12";27.120
"MULTIPOLYGON (((-58.4031328541214 -34.6133534513599,-58.4029038916137 -34.6133444657948,-58.4014474235694 -34.6132666982191,-58.4014317969264 -34.6134348654328,-58.4013703025673 -34.61423606046,-58.40135320732 -34.6144316222447,-58.4016243327484 -34.6144480968908,-58.4030053438485 -34.6145335722087,-58.4030371104807 -34.6143047767427,-58.4031328541214 -34.6133534513599)))";;"2011";3_14_6;COMUNA 3;"14";"6";"1114";"513";"601";"85,36%";"633";"633";"100,00%";"0";"0,00%";"514";"22";"4.28";"492";"95,72%";"4.28";4.280
"MULTIPOLYGON (((-58.4042182969452 -34.6133964428179,-58.4040076481114 -34.6133877498019,-58.4031328541214 -34.6133534513599,-58.4030371104807 -34.6143047767427,-58.4030053438485 -34.6145335722087,-58.403300916184 -34.6145518861399,-58.404070513973 -34.6145970487509,-58.4042182969452 -34.6133964428179)))";;"2012";3_14_7;COMUNA 3;"14";"7";"633";"288";"345";"83,48%";"322";"322";"100,00%";"0";"0,00%";"259";"14";"5.41";"245";"94,59%";"5.41";5.410
"MULTIPOLYGON (((-58.4052767486464 -34.6134242705281,-58.4042182969452 -34.6133964428179,-58.404070513973 -34.6145970487509,-58.4049118388992 -34.6146392826518,-58.4052423383164 -34.6135432726908,-58.4052767486464 -34.6134242705281)))";;"2013";3_14_8;COMUNA 3;"14";"8";"720";"322";"398";"80,90%";"398";"396";"99,50%";"2";"0,51%";"316";"42";"13.29";"274";"86,71%";"13.29";13.290
"MULTIPOLYGON (((-58.4065431789449 -34.613632895688,-58.4063271014595 -34.6135889212196,-58.4052767486464 -34.6134242705281,-58.4052423383164 -34.6135432726908,-58.4049118388992 -34.6146392826518,-58.4061949274602 -34.614803692351,-58.4065067369228 -34.6137356290789,-58.4065431789449 -34.613632895688)))";;"2014";3_14_9;COMUNA 3;"14";"9";"103";"48";"55";"87,27%";"55";"55";"100,00%";"0";"0,00%";"43";"23";"53.49";"20";"46,51%";"53.49";53.490
"MULTIPOLYGON (((-58.4085818702511 -34.6103113023475,-58.407665054284 -34.6102376501199,-58.4074075401009 -34.6111655252357,-58.4073361938251 -34.6113705003288,-58.4087979862986 -34.6114704542954,-58.4088822802862 -34.6103354501919,-58.4085818702511 -34.6103113023475)))";;"2015";3_15_1;COMUNA 3;"15";"1";"683";"314";"369";"85,09%";"388";"386";"99,48%";"2";"0,52%";"282";"2";"0.71";"280";"99,29%";"0.71";0.710
"MULTIPOLYGON (((-58.4087979862986 -34.6114704542954,-58.4073361938251 -34.6113705003288,-58.4069414788323 -34.6125043053076,-58.4087131752617 -34.6126110919058,-58.4087979862986 -34.6114704542954)))";;"2016";3_15_2;COMUNA 3;"15";"2";"909";"407";"502";"81,08%";"489";"485";"99,18%";"4";"0,82%";"399";"13";"3.26";"386";"96,74%";"3.26";3.260
"MULTIPOLYGON (((-58.4073361938251 -34.6113705003288,-58.4058375266109 -34.6112638212832,-58.4056525220509 -34.6121268647986,-58.4055671395617 -34.6124214833854,-58.4069414788323 -34.6125043053076,-58.4073361938251 -34.6113705003288)))";;"2017";3_15_3;COMUNA 3;"15";"3";"666";"304";"362";"83,98%";"334";"333";"99,70%";"1";"0,30%";"271";"41";"15.13";"230";"84,87%";"15.13";15.130
"MULTIPOLYGON (((-58.406416988423 -34.6101517959489,-58.4059659035084 -34.6101207408265,-58.4055449677441 -34.6100961068484,-58.404574310173 -34.610042336466,-58.4045078129204 -34.6109800149921,-58.4044904676631 -34.6111791688859,-58.4058375266109 -34.6112638212832,-58.4073361938251 -34.6113705003288,-58.4074075401009 -34.6111655252357,-58.407665054284 -34.6102376501199,-58.406416988423 -34.6101517959489)))";;"2018";3_15_4;COMUNA 3;"15";"4";"788";"361";"427";"84,54%";"474";"473";"99,79%";"1";"0,21%";"334";"12";"3.59";"322";"96,41%";"3.59";3.590
"MULTIPOLYGON (((-58.4043501242144 -34.612349918914,-58.4053341793287 -34.6124074299033,-58.4055671395617 -34.6124214833854,-58.4056525220509 -34.6121268647986,-58.4058375266109 -34.6112638212832,-58.4044904676631 -34.6111791688859,-58.4045078129204 -34.6109800149921,-58.404574310173 -34.610042336466,-58.4033232563832 -34.6099744780517,-58.4032827592688 -34.6111029501466,-58.403240348848 -34.6122850145724,-58.4043501242144 -34.612349918914)))";;"2019";3_15_5;COMUNA 3;"15";"5";"755";"364";"391";"93,09%";"508";"506";"99,61%";"2";"0,40%";"382";"47";"12.3";"335";"87,70%";"12.3";12.300
"MULTIPOLYGON (((-58.4033232563832 -34.6099744780517,-58.4017813344235 -34.6098875175695,-58.4016698746597 -34.6109986291072,-58.4032827592688 -34.6111029501466,-58.4033232563832 -34.6099744780517)))";;"2020";3_15_6;COMUNA 3;"15";"6";"805";"371";"434";"85,48%";"488";"486";"99,59%";"2";"0,41%";"362";"78";"21.55";"284";"78,45%";"21.55";21.550
"MULTIPOLYGON (((-58.4032827592688 -34.6111029501466,-58.4016698746597 -34.6109986291072,-58.4016465357109 -34.6112310202373,-58.4015491601388 -34.6121810058825,-58.4018590305712 -34.6122042602306,-58.403240348848 -34.6122850145724,-58.4032827592688 -34.6111029501466)))";;"2021";3_15_7;COMUNA 3;"15";"7";"1248";"565";"683";"82,72%";"761";"760";"99,87%";"1";"0,13%";"600";"95";"15.83";"505";"84,17%";"15.83";15.830
"MULTIPOLYGON (((-58.4016698746597 -34.6109986291072,-58.4005583357722 -34.6109267978244,-58.4003930119437 -34.6109141778396,-58.4003759696476 -34.6111507270239,-58.4003301809357 -34.6118972799798,-58.4003168388476 -34.6120832658009,-58.4004860833935 -34.612095747037,-58.401376167672 -34.6121680312617,-58.4015491601388 -34.6121810058825,-58.4016465357109 -34.6112310202373,-58.4016698746597 -34.6109986291072)))";;"2022";3_15_8;COMUNA 3;"15";"8";"1281";"555";"726";"76,45%";"845";"843";"99,76%";"2";"0,24%";"617";"4";"0.65";"613";"99,35%";"0.65";0.650
"MULTIPOLYGON (((-58.4017813344235 -34.6098875175695,-58.4014646541672 -34.609869964036,-58.4009629608908 -34.6098324719455,-58.4007701485034 -34.6098180623059,-58.4004706757303 -34.6097991768487,-58.4004099681214 -34.6106787554013,-58.4003930119437 -34.6109141778396,-58.4005583357722 -34.6109267978244,-58.4016698746597 -34.6109986291072,-58.4017813344235 -34.6098875175695)))";;"2023";3_15_9;COMUNA 3;"15";"9";"275";"102";"173";"58,96%";"151";"150";"99,34%";"1";"0,67%";"116";"3";"2.59";"113";"97,41%";"2.59";2.590
"MULTIPOLYGON (((-58.4144670534897 -34.6107363919603,-58.4131004963242 -34.6106380940144,-58.413018393446 -34.6124804514612,-58.4134353605483 -34.6126144282007,-58.4135612348391 -34.612365103748,-58.4140142765254 -34.6115504671036,-58.4144670534897 -34.6107363919603)))";;"2024";3_16_1;COMUNA 3;"16";"1";"891";"383";"508";"75,39%";"469";"468";"99,79%";"1";"0,21%";"375";"66";"17.6";"309";"82,40%";"17.6";17.600
"MULTIPOLYGON (((-58.4131004963242 -34.6106380940144,-58.4117332610533 -34.6105396396284,-58.4116810069478 -34.6118571304925,-58.4128103362182 -34.6124136035807,-58.413018393446 -34.6124804514612,-58.4131004963242 -34.6106380940144)))";;"2025";3_16_2;COMUNA 3;"16";"2";"1121";"525";"596";"88,09%";"608";"608";"100,00%";"0";"0,00%";"504";"63";"12.5";"441";"87,50%";"12.5";12.500
"MULTIPOLYGON (((-58.4117332610533 -34.6105396396284,-58.4103464388983 -34.6104395417397,-58.4102338886687 -34.6115686189894,-58.4112342865325 -34.6116370053102,-58.4116810069478 -34.6118571304925,-58.4117332610533 -34.6105396396284)))";;"2026";3_16_3;COMUNA 3;"16";"3";"881";"406";"475";"85,47%";"416";"416";"100,00%";"0";"0,00%";"388";"90";"23.2";"298";"76,80%";"23.2";23.200
"MULTIPOLYGON (((-58.4103464388983 -34.6104395417397,-58.4099942389885 -34.6104158681143,-58.4091641208348 -34.6103606455262,-58.4088822802862 -34.6103354501919,-58.4087979862986 -34.6114704542954,-58.4102338886687 -34.6115686189894,-58.4103464388983 -34.6104395417397)))";;"2027";3_16_4;COMUNA 3;"16";"4";"464";"217";"247";"87,85%";"253";"250";"98,81%";"3";"1,20%";"178";"3";"1.69";"175";"98,31%";"1.69";1.690
"MULTIPOLYGON (((-58.4102338886687 -34.6115686189894,-58.4087979862986 -34.6114704542954,-58.4087131752617 -34.6126110919058,-58.4100709962528 -34.6126929557382,-58.4102248023744 -34.6116595338741,-58.4102338886687 -34.6115686189894)))";;"2028";3_16_5;COMUNA 3;"16";"5";"664";"348";"316";"110,13%";"295";"293";"99,32%";"2";"0,68%";"267";"96";"35.96";"171";"64,04%";"35.96";35.960
"MULTIPOLYGON (((-58.4116810069478 -34.6118571304925,-58.4112342865325 -34.6116370053102,-58.4102338886687 -34.6115686189894,-58.4102248023744 -34.6116595338741,-58.4100709962528 -34.6126929557382,-58.4114615383792 -34.6130377150165,-58.4116810069478 -34.6118571304925)))";;"2029";3_16_6;COMUNA 3;"16";"6";"741";"380";"361";"105,26%";"350";"347";"99,14%";"3";"0,86%";"275";"48";"17.45";"227";"82,55%";"17.45";17.450
"MULTIPOLYGON (((-58.413018393446 -34.6124804514612,-58.4128103362182 -34.6124136035807,-58.4116810069478 -34.6118571304925,-58.4114615383792 -34.6130377150165,-58.4131163061818 -34.6134164405642,-58.413314005456 -34.6128547399326,-58.4134353605483 -34.6126144282007,-58.413018393446 -34.6124804514612)))";;"2030";3_16_7;COMUNA 3;"16";"7";"787";"383";"404";"94,80%";"367";"367";"100,00%";"0";"0,00%";"312";"103";"33.01";"209";"66,99%";"33.01";33.010
"MULTIPOLYGON (((-58.4114615383792 -34.6130377150165,-58.4100709962528 -34.6126929557382,-58.4100399436626 -34.6129016822679,-58.4098725510032 -34.6139949591079,-58.411312355902 -34.6140532521936,-58.4128700528592 -34.614116224551,-58.4131163061818 -34.6134164405642,-58.4114615383792 -34.6130377150165)))";;"2031";3_16_8;COMUNA 3;"16";"8";"774";"368";"406";"90,64%";"397";"396";"99,75%";"1";"0,25%";"339";"86";"25.37";"253";"74,63%";"25.37";25.370
"MULTIPOLYGON (((-58.4128700528592 -34.614116224551,-58.411312355902 -34.6140532521936,-58.4098725510032 -34.6139949591079,-58.4096803475958 -34.6152503432045,-58.4111499672746 -34.6153428073071,-58.412816360458 -34.6154434332046,-58.4128700528592 -34.614116224551)))";;"2032";3_16_9;COMUNA 3;"16";"9";"1153";"555";"598";"92,81%";"596";"596";"100,00%";"0";"0,00%";"507";"47";"9.27";"460";"90,73%";"9.27";9.270
"MULTIPOLYGON (((-58.412816360458 -34.6154434332046,-58.4111499672746 -34.6153428073071,-58.4110016323061 -34.6166272972833,-58.4127540619096 -34.61662957668,-58.412816360458 -34.6154434332046)))";;"2033";3_17_1;COMUNA 3;"17";"1";"738";"349";"389";"89,72%";"327";"326";"99,69%";"1";"0,31%";"267";"50";"18.73";"217";"81,27%";"18.73";18.730
"MULTIPOLYGON (((-58.4111499672746 -34.6153428073071,-58.4096803475958 -34.6152503432045,-58.4084009930457 -34.6150863943799,-58.4083608940925 -34.6153132156083,-58.4082295337214 -34.6164972132366,-58.4092533057165 -34.6166031627508,-58.4094551882111 -34.616613321809,-58.4096992361419 -34.6166255411851,-58.4110016323061 -34.6166272972833,-58.4111499672746 -34.6153428073071)))";;"2034";3_17_2;COMUNA 3;"17";"2";"822";"399";"423";"94,33%";"391";"390";"99,74%";"1";"0,26%";"325";"97";"29.85";"228";"70,15%";"29.85";29.850
"MULTIPOLYGON (((-58.4084009930457 -34.6150863943799,-58.4072839042683 -34.6149432813424,-58.4069388204188 -34.6163525404915,-58.4082295337214 -34.6164972132366,-58.4083608940925 -34.6153132156083,-58.4084009930457 -34.6150863943799)))";;"2035";3_17_3;COMUNA 3;"17";"3";"452";"190";"262";"72,52%";"256";"256";"100,00%";"0";"0,00%";"208";"43";"20.67";"165";"79,33%";"20.67";20.670
"MULTIPOLYGON (((-58.4082295337214 -34.6164972132366,-58.4069388204188 -34.6163525404915,-58.4066112359766 -34.6176906066855,-58.406572309099 -34.6178122832141,-58.4067433272978 -34.6178662369161,-58.4080315856845 -34.6182823286117,-58.4081219914371 -34.617467269935,-58.4082295337214 -34.6164972132366)))";;"2036";3_17_4;COMUNA 3;"17";"4";"905";"440";"465";"94,62%";"362";"361";"99,72%";"1";"0,28%";"332";"154";"46.39";"178";"53,61%";"46.39";46.390
"MULTIPOLYGON (((-58.4110016323061 -34.6166272972833,-58.4096992361419 -34.6166255411851,-58.4094551882111 -34.616613321809,-58.4092533057165 -34.6166031627508,-58.4082295337214 -34.6164972132366,-58.4081219914371 -34.617467269935,-58.4080315856845 -34.6182823286117,-58.4093326324318 -34.6187024969268,-58.4109895670347 -34.6190496311383,-58.4109990031669 -34.6178450153006,-58.4110016323061 -34.6166272972833)))";;"2037";3_17_5;COMUNA 3;"17";"5";"811";"392";"419";"93,56%";"313";"310";"99,04%";"3";"0,97%";"324";"108";"33.33";"216";"66,67%";"33.33";33.330
"MULTIPOLYGON (((-58.4109990031669 -34.6178450153006,-58.4109895670347 -34.6190496311383,-58.4126420869941 -34.6193945578449,-58.4126822844973 -34.618277351997,-58.4126876053489 -34.6180698820806,-58.4127540619096 -34.61662957668,-58.4110016323061 -34.6166272972833,-58.4109990031669 -34.6178450153006)))";;"2038";3_17_6;COMUNA 3;"17";"6";"726";"321";"405";"79,26%";"390";"390";"100,00%";"0";"0,00%";"327";"36";"11.01";"291";"88,99%";"11.01";11.010
"MULTIPOLYGON (((-58.4109895670347 -34.6190496311383,-58.4093326324318 -34.6187024969268,-58.4093212630339 -34.6188972170987,-58.409252050252 -34.6200234233942,-58.4100790399964 -34.6201937888561,-58.4105191542498 -34.6202844740221,-58.4108118314007 -34.6203362203815,-58.4125438811881 -34.6206423075662,-58.4126353291159 -34.6195830827993,-58.4126420869941 -34.6193945578449,-58.4109895670347 -34.6190496311383)))";;"2039";3_17_7;COMUNA 3;"17";"7";"880";"412";"468";"88,03%";"409";"409";"100,00%";"0";"0,00%";"344";"14";"4.07";"330";"95,93%";"4.07";4.070
"MULTIPOLYGON (((-58.4080315856845 -34.6182823286117,-58.4067433272978 -34.6178662369161,-58.406572309099 -34.6178122832141,-58.4064705061434 -34.6187040986944,-58.4063872116358 -34.6194330999076,-58.4077803593484 -34.6197201535171,-58.409252050252 -34.6200234233942,-58.4093212630339 -34.6188972170987,-58.4093326324318 -34.6187024969268,-58.4080315856845 -34.6182823286117)))";;"2040";3_17_8;COMUNA 3;"17";"8";"1182";"548";"634";"86,44%";"444";"436";"98,20%";"8";"1,83%";"383";"169";"44.13";"214";"55,87%";"44.13";44.130
"MULTIPOLYGON (((-58.406572309099 -34.6178122832141,-58.4054670836418 -34.617463799686,-58.4050351282089 -34.6191545007976,-58.4063872116358 -34.6194330999076,-58.4064705061434 -34.6187040986944,-58.406572309099 -34.6178122832141)))";;"2041";3_17_9;COMUNA 3;"17";"9";"707";"326";"381";"85,56%";"323";"323";"100,00%";"0";"0,00%";"281";"84";"29.89";"197";"70,11%";"29.89";29.890
"MULTIPOLYGON (((-58.4069388204188 -34.6163525404915,-58.4058170253649 -34.6160943373834,-58.4054670836418 -34.617463799686,-58.406572309099 -34.6178122832141,-58.4066112359766 -34.6176906066855,-58.4069388204188 -34.6163525404915)))";;"2042";3_18_1;COMUNA 3;"18";"1";"573";"267";"306";"87,25%";"291";"291";"100,00%";"0";"0,00%";"256";"86";"33.59";"170";"66,41%";"33.59";33.590
"MULTIPOLYGON (((-58.4041385598513 -34.6170449149682,-58.4028525364399 -34.6167731545039,-58.402686359613 -34.6167455366828,-58.4025328739828 -34.6167200376461,-58.4011670450173 -34.6165601958182,-58.4010722846157 -34.6176441299492,-58.402460808953 -34.6177787718724,-58.4022466233633 -34.6187558129454,-58.4035128744328 -34.6188402396232,-58.4041385598513 -34.6170449149682)))";;"2043";3_18_10;COMUNA 3;"18";"10";"581";"268";"313";"85,62%";"257";"256";"99,61%";"1";"0,39%";"208";"21";"10.1";"187";"89,90%";"10.1";10.100
"MULTIPOLYGON (((-58.402460808953 -34.6177787718724,-58.4010722846157 -34.6176441299492,-58.4010525250483 -34.6178696208671,-58.4009802074755 -34.6186673588157,-58.4022466233633 -34.6187558129454,-58.402460808953 -34.6177787718724)))";;"2044";3_18_11;COMUNA 3;"18";"11";"597";"262";"335";"78,21%";"353";"353";"100,00%";"0";"0,00%";"249";"11";"4.42";"238";"95,58%";"4.42";4.420
"MULTIPOLYGON (((-58.4072839042683 -34.6149432813424,-58.4061949274602 -34.614803692351,-58.4061372946498 -34.6150012783381,-58.4058170253649 -34.6160943373834,-58.4069388204188 -34.6163525404915,-58.4072839042683 -34.6149432813424)))";;"2045";3_18_2;COMUNA 3;"18";"2";"761";"362";"399";"90,73%";"356";"355";"99,72%";"1";"0,28%";"302";"44";"14.57";"258";"85,43%";"14.57";14.570
"MULTIPOLYGON (((-58.4061949274602 -34.614803692351,-58.4049118388992 -34.6146392826518,-58.4045541793047 -34.6158254226257,-58.4056095481393 -34.6160465627164,-58.4058170253649 -34.6160943373834,-58.4061372946498 -34.6150012783381,-58.4061949274602 -34.614803692351)))";;"2046";3_18_3;COMUNA 3;"18";"3";"486";"222";"264";"84,09%";"247";"246";"99,60%";"1";"0,41%";"189";"4";"2.12";"185";"97,88%";"2.12";2.120
"MULTIPOLYGON (((-58.404070513973 -34.6145970487509,-58.403300916184 -34.6145518861399,-58.4030053438485 -34.6145335722087,-58.4028794730438 -34.6154419232603,-58.4042992597378 -34.6157719891046,-58.4045541793047 -34.6158254226257,-58.4049118388992 -34.6146392826518,-58.404070513973 -34.6145970487509)))";;"2047";3_18_4;COMUNA 3;"18";"4";"830";"385";"445";"86,52%";"476";"473";"99,37%";"3";"0,63%";"377";"10";"2.65";"367";"97,35%";"2.65";2.650
"MULTIPOLYGON (((-58.4030053438485 -34.6145335722087,-58.4016243327484 -34.6144480968908,-58.40135320732 -34.6144316222447,-58.4012588815605 -34.6155103456674,-58.4028794730438 -34.6154419232603,-58.4030053438485 -34.6145335722087)))";;"2048";3_18_5;COMUNA 3;"18";"5";"396";"179";"217";"82,49%";"209";"209";"100,00%";"0";"0,00%";"171";"16";"9.36";"155";"90,64%";"9.36";9.360
"MULTIPOLYGON (((-58.4028794730438 -34.6154419232603,-58.4012588815605 -34.6155103456674,-58.4011670450173 -34.6165601958182,-58.4025328739828 -34.6167200376461,-58.402686359613 -34.6167455366828,-58.4027214031294 -34.6165821678485,-58.4028794730438 -34.6154419232603)))";;"2049";3_18_6;COMUNA 3;"18";"6";"644";"297";"347";"85,59%";"299";"299";"100,00%";"0";"0,00%";"255";"58";"22.75";"197";"77,25%";"22.75";22.750
"MULTIPOLYGON (((-58.4045541793047 -34.6158254226257,-58.4042992597378 -34.6157719891046,-58.4028794730438 -34.6154419232603,-58.4027214031294 -34.6165821678485,-58.402686359613 -34.6167455366828,-58.4028525364399 -34.6167731545039,-58.4041385598513 -34.6170449149682,-58.4044937286921 -34.6160260347344,-58.4045541793047 -34.6158254226257)))";;"2050";3_18_7;COMUNA 3;"18";"7";"709";"341";"368";"92,66%";"337";"336";"99,70%";"1";"0,30%";"275";"18";"6.55";"257";"93,45%";"6.55";6.550
"MULTIPOLYGON (((-58.4058170253649 -34.6160943373834,-58.4056095481393 -34.6160465627164,-58.4045541793047 -34.6158254226257,-58.4044937286921 -34.6160260347344,-58.4041385598513 -34.6170449149682,-58.4054670836418 -34.617463799686,-58.4058170253649 -34.6160943373834)))";;"2051";3_18_8;COMUNA 3;"18";"8";"538";"245";"293";"83,62%";"313";"313";"100,00%";"0";"0,00%";"254";"10";"3.94";"244";"96,06%";"3.94";3.940
"MULTIPOLYGON (((-58.4054670836418 -34.617463799686,-58.4041385598513 -34.6170449149682,-58.4035128744328 -34.6188402396232,-58.4050351282089 -34.6191545007976,-58.4054670836418 -34.617463799686)))";;"2052";3_18_9;COMUNA 3;"18";"9";"895";"410";"485";"84,54%";"499";"499";"100,00%";"0";"0,00%";"395";"60";"15.19";"335";"84,81%";"15.19";15.190
"MULTIPOLYGON (((-58.400125946434 -34.6143572639152,-58.3998589101148 -34.6143411401709,-58.3992898271058 -34.6143095769874,-58.3992290481438 -34.6151502092056,-58.3994117365015 -34.6151907280908,-58.4012588815605 -34.6155103456674,-58.40135320732 -34.6144316222447,-58.400125946434 -34.6143572639152)))";;"2053";3_19_1;COMUNA 3;"19";"1";"1181";"528";"653";"80,86%";"625";"625";"100,00%";"0";"0,00%";"516";"4";"0.78";"512";"99,22%";"0.78";0.780
"MULTIPOLYGON (((-58.4001298524839 -34.6175523089719,-58.399316896847 -34.6174716047811,-58.3990629751718 -34.6174478802083,-58.3990442916168 -34.617707457074,-58.3989628993509 -34.6185389226795,-58.399242898406 -34.61855371705,-58.4000392761863 -34.6186035670592,-58.4001298524839 -34.6175523089719)))";;"2054";3_19_10;COMUNA 3;"19";"10";"520";"245";"275";"89,09%";"279";"279";"100,00%";"0";"0,00%";"236";"51";"21.61";"185";"78,39%";"21.61";21.610
"MULTIPOLYGON (((-58.3987782408225 -34.6142807878658,-58.3977556663185 -34.6142222879795,-58.3974748312404 -34.6142062220957,-58.3974782333126 -34.6144307389868,-58.3974444273019 -34.6147424221845,-58.3978635397605 -34.6148384237095,-58.3990823865804 -34.6151176668689,-58.3992290481438 -34.6151502092056,-58.3992898271058 -34.6143095769874,-58.3990299451708 -34.6142951453484,-58.3987782408225 -34.6142807878658)))";;"2055";3_19_2;COMUNA 3;"19";"2";"301";"140";"161";"86,96%";"167";"166";"99,40%";"1";"0,60%";"152";"15";"9.87";"137";"90,13%";"9.87";9.870
"MULTIPOLYGON (((-58.396119672083 -34.6152561613525,-58.3961173290909 -34.6154167291687,-58.396096421927 -34.6159963862385,-58.3963827940471 -34.6160196416575,-58.3975208514341 -34.6161403296797,-58.3977358390409 -34.6161643184384,-58.3978111546025 -34.6153823589061,-58.3978635397605 -34.6148384237095,-58.3974444273019 -34.6147424221845,-58.3974782333126 -34.6144307389868,-58.3974748312404 -34.6142062220957,-58.3972323267801 -34.6141923593173,-58.3961349617884 -34.614136693117,-58.3961334481455 -34.6143255018619,-58.396119672083 -34.6152561613525)))";;"2056";3_19_3;COMUNA 3;"19";"3";"665";"287";"378";"75,93%";"407";"405";"99,51%";"2";"0,49%";"310";"31";"10";"279";"90,00%";"10";10.000
"MULTIPOLYGON (((-58.3992290481438 -34.6151502092056,-58.3990823865804 -34.6151176668689,-58.3978635397605 -34.6148384237095,-58.3978111546025 -34.6153823589061,-58.3977358390409 -34.6161643184384,-58.3979141152598 -34.6161842731012,-58.3991442473342 -34.6163242208739,-58.3992290481438 -34.6151502092056)))";;"2057";3_19_4;COMUNA 3;"19";"4";"727";"325";"402";"80,85%";"361";"360";"99,72%";"1";"0,28%";"295";"38";"12.88";"257";"87,12%";"12.88";12.880
"MULTIPOLYGON (((-58.4012588815605 -34.6155103456674,-58.3994117365015 -34.6151907280908,-58.3992290481438 -34.6151502092056,-58.3991442473342 -34.6163242208739,-58.3994212447936 -34.6163557744299,-58.4002248092774 -34.6164498538809,-58.4011670450173 -34.6165601958182,-58.4012588815605 -34.6155103456674)))";;"2058";3_19_5;COMUNA 3;"19";"5";"812";"407";"405";"100,49%";"361";"361";"100,00%";"0";"0,00%";"344";"114";"33.14";"230";"66,86%";"33.14";33.140
"MULTIPOLYGON (((-58.4001298524839 -34.6175523089719,-58.4000392761863 -34.6186035670592,-58.400293974198 -34.618619472819,-58.4009802074755 -34.6186673588157,-58.4010525250483 -34.6178696208671,-58.4010722846157 -34.6176441299492,-58.4011670450173 -34.6165601958182,-58.4002248092774 -34.6164498538809,-58.4001298524839 -34.6175523089719)))";;"2059";3_19_6;COMUNA 3;"19";"6";"781";"359";"422";"85,07%";"416";"416";"100,00%";"0";"0,00%";"336";"14";"4.17";"322";"95,83%";"4.17";4.170
"MULTIPOLYGON (((-58.4002248092774 -34.6164498538809,-58.3994212447936 -34.6163557744299,-58.3991442473342 -34.6163242208739,-58.3979141152598 -34.6161842731012,-58.3977358390409 -34.6161643184384,-58.3975208514341 -34.6161403296797,-58.3963827940471 -34.6160196416575,-58.396096421927 -34.6159963862385,-58.3960531251117 -34.6171975318535,-58.3962767233848 -34.6172157530329,-58.3976238508007 -34.6173268350826,-58.3988416775696 -34.6174272004643,-58.3990629751718 -34.6174478802083,-58.399316896847 -34.6174716047811,-58.4001298524839 -34.6175523089719,-58.4002248092774 -34.6164498538809)))";;"2060";3_19_7;COMUNA 3;"19";"7";"949";"456";"493";"92,49%";"398";"398";"100,00%";"0";"0,00%";"413";"107";"25.91";"306";"74,09%";"25.91";25.910
"MULTIPOLYGON (((-58.3976238508007 -34.6173268350826,-58.3962767233848 -34.6172157530329,-58.3960531251117 -34.6171975318535,-58.395999958393 -34.6181693679954,-58.395989736408 -34.6183817642289,-58.3975145212996 -34.6184623800438,-58.3976238508007 -34.6173268350826)))";;"2061";3_19_8;COMUNA 3;"19";"8";"1160";"530";"630";"84,13%";"604";"604";"100,00%";"0";"0,00%";"499";"74";"14.83";"425";"85,17%";"14.83";14.830
"MULTIPOLYGON (((-58.3990629751718 -34.6174478802083,-58.3988416775696 -34.6174272004643,-58.3976238508007 -34.6173268350826,-58.3975145212996 -34.6184623800438,-58.3989628993509 -34.6185389226795,-58.3990442916168 -34.617707457074,-58.3990629751718 -34.6174478802083)))";;"2062";3_19_9;COMUNA 3;"19";"9";"689";"334";"355";"94,08%";"365";"365";"100,00%";"0";"0,00%";"304";"34";"11.18";"270";"88,82%";"11.18";11.180
"MULTIPOLYGON (((-58.4066262332025 -34.5980458044772,-58.4055862711666 -34.5980409557906,-58.405735351995 -34.5983568122714,-58.4063114765267 -34.5996576226789,-58.406429356963 -34.5996457048076,-58.4071953027705 -34.5995993636927,-58.4066262332025 -34.5980458044772)))";;"2063";3_2_1;COMUNA 3;"2";"1";"742";"332";"410";"80,98%";"444";"444";"100,00%";"0";"0,00%";"323";"28";"8.67";"295";"91,33%";"8.67";8.670
"MULTIPOLYGON (((-58.4084651930104 -34.6029481604717,-58.4074076570733 -34.6030226182321,-58.4078120047602 -34.6042574246621,-58.4087407217323 -34.6041338201716,-58.408914738704 -34.604118966866,-58.408839131935 -34.6039461805528,-58.4087182361641 -34.6036073820058,-58.408684564853 -34.6035196877511,-58.4084651930104 -34.6029481604717)))";;"2064";3_2_10;COMUNA 3;"2";"10";"427";"174";"253";"68,77%";"234";"234";"100,00%";"0";"0,00%";"193";"6";"3.11";"187";"96,89%";"3.11";3.110
"MULTIPOLYGON (((-58.408914738704 -34.604118966866,-58.4087407217323 -34.6041338201716,-58.4078120047602 -34.6042574246621,-58.4078662359932 -34.6044230890552,-58.4082263356672 -34.6053527217199,-58.4083443046493 -34.6053475628688,-58.4093775268675 -34.6052460431466,-58.4089837121162 -34.6042765383698,-58.408914738704 -34.604118966866)))";;"2065";3_2_11;COMUNA 3;"2";"11";"602";"297";"305";"97,38%";"306";"306";"100,00%";"0";"0,00%";"257";"27";"10.51";"230";"89,49%";"10.51";10.510
"MULTIPOLYGON (((-58.4078120047602 -34.6042574246621,-58.4066423949823 -34.6044130959477,-58.4069488589398 -34.6054141892623,-58.407100476511 -34.6054018636178,-58.4082263356672 -34.6053527217199,-58.4078662359932 -34.6044230890552,-58.4078120047602 -34.6042574246621)))";;"2066";3_2_12;COMUNA 3;"2";"12";"845";"384";"461";"83,30%";"423";"423";"100,00%";"0";"0,00%";"365";"50";"13.7";"315";"86,30%";"13.7";13.700
"MULTIPOLYGON (((-58.4055862711666 -34.5980409557906,-58.4047319711159 -34.5980369612585,-58.4052973046898 -34.5997701822883,-58.4054482341858 -34.5997530694412,-58.4063114765267 -34.5996576226789,-58.405735351995 -34.5983568122714,-58.4055862711666 -34.5980409557906)))";;"2067";3_2_2;COMUNA 3;"2";"2";"714";"320";"394";"81,22%";"439";"438";"99,77%";"1";"0,23%";"333";"26";"7.81";"307";"92,19%";"7.81";7.810
"MULTIPOLYGON (((-58.4063114765267 -34.5996576226789,-58.4054482341858 -34.5997530694412,-58.4052973046898 -34.5997701822883,-58.4056312296585 -34.600793899067,-58.4057331825417 -34.6007858478079,-58.4066475228934 -34.6007108458472,-58.4066159913423 -34.6006124473317,-58.4063114765267 -34.5996576226789)))";;"2068";3_2_3;COMUNA 3;"2";"3";"676";"296";"380";"77,89%";"426";"426";"100,00%";"0";"0,00%";"336";"4";"1.19";"332";"98,81%";"1.19";1.190
"MULTIPOLYGON (((-58.4071953027705 -34.5995993636927,-58.406429356963 -34.5996457048076,-58.4063114765267 -34.5996576226789,-58.4066159913423 -34.6006124473317,-58.4066475228934 -34.6007108458472,-58.4075782149685 -34.6006344359169,-58.407234834183 -34.5997071322669,-58.4071953027705 -34.5995993636927)))";;"2069";3_2_4;COMUNA 3;"2";"4";"734";"341";"393";"86,77%";"362";"361";"99,72%";"1";"0,28%";"288";"5";"1.74";"283";"98,26%";"1.74";1.740
"MULTIPOLYGON (((-58.4066475228934 -34.6007108458472,-58.4057331825417 -34.6007858478079,-58.4056312296585 -34.600793899067,-58.4058951288026 -34.6016029261637,-58.4059288566117 -34.6017273127713,-58.406943129132 -34.6016258751891,-58.4077598221715 -34.6011106626937,-58.4075782149685 -34.6006344359169,-58.4066475228934 -34.6007108458472)))";;"2070";3_2_5;COMUNA 3;"2";"5";"872";"399";"473";"84,36%";"472";"472";"100,00%";"0";"0,00%";"369";"36";"9.76";"333";"90,24%";"9.76";9.760
"MULTIPOLYGON (((-58.4077598221715 -34.6011106626937,-58.406943129132 -34.6016258751891,-58.4074076570733 -34.6030226182321,-58.4084651930104 -34.6029481604717,-58.4081095277983 -34.6020216992671,-58.4080722017632 -34.6019243549334,-58.4077598221715 -34.6011106626937)))";;"2071";3_2_6;COMUNA 3;"2";"6";"927";"397";"530";"74,91%";"455";"455";"100,00%";"0";"0,00%";"367";"33";"8.99";"334";"91,01%";"8.99";8.990
"MULTIPOLYGON (((-58.406943129132 -34.6016258751891,-58.4059288566117 -34.6017273127713,-58.4049826372775 -34.6018219428843,-58.4048022347412 -34.6018395341427,-58.4051559313607 -34.6033429976314,-58.4063182994947 -34.603172266225,-58.407273250401 -34.6030320646519,-58.4074076570733 -34.6030226182321,-58.406943129132 -34.6016258751891)))";;"2072";3_2_7;COMUNA 3;"2";"7";"1021";"456";"565";"80,71%";"550";"550";"100,00%";"0";"0,00%";"420";"16";"3.81";"404";"96,19%";"3.81";3.810
"MULTIPOLYGON (((-58.4054694625903 -34.6045636838448,-58.4055173737196 -34.6047480794016,-58.4057132200563 -34.605572004594,-58.4068354864274 -34.605423433528,-58.4069488589398 -34.6054141892623,-58.4066423949823 -34.6044130959477,-58.4063182994947 -34.603172266225,-58.4051559313607 -34.6033429976314,-58.4051915138065 -34.6034945694024,-58.4054694625903 -34.6045636838448)))";;"2073";3_2_8;COMUNA 3;"2";"8";"866";"391";"475";"82,32%";"595";"595";"100,00%";"0";"0,00%";"354";"18";"5.08";"336";"94,92%";"5.08";5.080
"MULTIPOLYGON (((-58.4074076570733 -34.6030226182321,-58.407273250401 -34.6030320646519,-58.4063182994947 -34.603172266225,-58.4066423949823 -34.6044130959477,-58.4078120047602 -34.6042574246621,-58.4074076570733 -34.6030226182321)))";;"2074";3_2_9;COMUNA 3;"2";"9";"836";"378";"458";"82,53%";"394";"393";"99,75%";"1";"0,25%";"311";"7";"2.25";"304";"97,75%";"2.25";2.250
"MULTIPOLYGON (((-58.3961349617884 -34.614136693117,-58.3959097479168 -34.6141252315945,-58.3949770504926 -34.6140599967851,-58.3946720304045 -34.6140368685164,-58.3946263199859 -34.6151446994721,-58.396119672083 -34.6152561613525,-58.3961334481455 -34.6143255018619,-58.3961349617884 -34.614136693117)))";;"2075";3_20_1;COMUNA 3;"20";"1";"603";"272";"331";"82,18%";"341";"341";"100,00%";"0";"0,00%";"318";"100";"31.45";"218";"68,55%";"31.45";31.450
"MULTIPOLYGON (((-58.3945465421018 -34.6170768361043,-58.3931899572481 -34.616977757364,-58.3931988766914 -34.6182341446929,-58.3944959612084 -34.6183027664725,-58.3945465421018 -34.6170768361043)))";;"2076";3_20_10;COMUNA 3;"20";"10";"626";"270";"356";"75,84%";"368";"368";"100,00%";"0";"0,00%";"287";"27";"9.41";"260";"90,59%";"9.41";9.410
"MULTIPOLYGON (((-58.3960531251117 -34.6171975318535,-58.3947918622952 -34.6170947904383,-58.3945465421018 -34.6170768361043,-58.3944959612084 -34.6183027664725,-58.395989736408 -34.6183817642289,-58.395999958393 -34.6181693679954,-58.3960531251117 -34.6171975318535)))";;"2077";3_20_11;COMUNA 3;"20";"11";"479";"195";"284";"68,66%";"307";"307";"100,00%";"0";"0,00%";"239";"8";"3.35";"231";"96,65%";"3.35";3.350
"MULTIPOLYGON (((-58.3946720304045 -34.6140368685164,-58.3935528014822 -34.6139520109242,-58.3932321918672 -34.6139311942457,-58.3932247022417 -34.614127957585,-58.3932018000032 -34.6150335402433,-58.3943268323324 -34.6151223481045,-58.3946263199859 -34.6151446994721,-58.3946720304045 -34.6140368685164)))";;"2078";3_20_2;COMUNA 3;"20";"2";"880";"375";"505";"74,26%";"482";"480";"99,59%";"2";"0,42%";"444";"39";"8.78";"405";"91,22%";"8.78";8.780
"MULTIPOLYGON (((-58.3932321918672 -34.6139311942457,-58.3920015430305 -34.6138513295322,-58.3917102415983 -34.6138250326803,-58.391700488375 -34.6140749655259,-58.3916836907107 -34.6146946961913,-58.3916767718696 -34.6149170240318,-58.39190879939 -34.6149315255989,-58.3932018000032 -34.6150335402433,-58.3932247022417 -34.614127957585,-58.3932321918672 -34.6139311942457)))";;"2079";3_20_3;COMUNA 3;"20";"3";"613";"267";"346";"77,17%";"446";"445";"99,78%";"1";"0,22%";"315";"24";"7.62";"291";"92,38%";"7.62";7.620
"MULTIPOLYGON (((-58.3932018000032 -34.6150335402433,-58.39190879939 -34.6149315255989,-58.3916767718696 -34.6149170240318,-58.3916686253246 -34.6151805497982,-58.391660336064 -34.6155115426556,-58.3916586420106 -34.6157002103409,-58.3918625628738 -34.6157123715989,-58.3930219503919 -34.6157794500962,-58.3931825985913 -34.6157908801748,-58.3932018000032 -34.6150335402433)))";;"2080";3_20_4;COMUNA 3;"20";"4";"616";"269";"347";"77,52%";"378";"378";"100,00%";"0";"0,00%";"290";"3";"1.03";"287";"98,97%";"1.03";1.030
"MULTIPOLYGON (((-58.3946263199859 -34.6151446994721,-58.3943268323324 -34.6151223481045,-58.3932018000032 -34.6150335402433,-58.3931825985913 -34.6157908801748,-58.3943663370608 -34.6158750026282,-58.3945955556011 -34.6158907651622,-58.3946263199859 -34.6151446994721)))";;"2081";3_20_5;COMUNA 3;"20";"5";"482";"205";"277";"74,01%";"268";"268";"100,00%";"0";"0,00%";"232";"22";"9.48";"210";"90,52%";"9.48";9.480
"MULTIPOLYGON (((-58.396119672083 -34.6152561613525,-58.3946263199859 -34.6151446994721,-58.3945955556011 -34.6158907651622,-58.3959166089971 -34.6159817099555,-58.396096421927 -34.6159963862385,-58.3961173290909 -34.6154167291687,-58.396119672083 -34.6152561613525)))";;"2082";3_20_6;COMUNA 3;"20";"6";"485";"247";"238";"103,78%";"236";"236";"100,00%";"0";"0,00%";"189";"42";"22.22";"147";"77,78%";"22.22";22.220
"MULTIPOLYGON (((-58.396096421927 -34.6159963862385,-58.3959166089971 -34.6159817099555,-58.3945955556011 -34.6158907651622,-58.3943663370608 -34.6158750026282,-58.3931825985913 -34.6157908801748,-58.3931780183949 -34.6159715177764,-58.393188510863 -34.6167712703745,-58.3931899572481 -34.616977757364,-58.3945465421018 -34.6170768361043,-58.3947918622952 -34.6170947904383,-58.3960531251117 -34.6171975318535,-58.396096421927 -34.6159963862385)))";;"2083";3_20_7;COMUNA 3;"20";"7";"802";"366";"436";"83,94%";"432";"431";"99,77%";"1";"0,23%";"349";"14";"4.01";"335";"95,99%";"4.01";4.010
"MULTIPOLYGON (((-58.3931825985913 -34.6157908801748,-58.3930219503919 -34.6157794500962,-58.3918625628738 -34.6157123715989,-58.3916586420106 -34.6157002103409,-58.3916574195924 -34.6158352144197,-58.3916751861377 -34.6168787123964,-58.391919143587 -34.6168949815131,-58.3930071601088 -34.6169644131692,-58.3931899572481 -34.616977757364,-58.393188510863 -34.6167712703745,-58.3931780183949 -34.6159715177764,-58.3931825985913 -34.6157908801748)))";;"2084";3_20_8;COMUNA 3;"20";"8";"803";"381";"422";"90,28%";"322";"321";"99,69%";"1";"0,31%";"380";"134";"35.26";"246";"64,74%";"35.26";35.260
"MULTIPOLYGON (((-58.3931899572481 -34.616977757364,-58.3930071601088 -34.6169644131692,-58.391919143587 -34.6168949815131,-58.3916751861377 -34.6168787123964,-58.3916970106205 -34.6181591927059,-58.3920279471634 -34.6181759347472,-58.3930026148053 -34.6182237506708,-58.3931988766914 -34.6182341446929,-58.3931899572481 -34.616977757364)))";;"2085";3_20_9;COMUNA 3;"20";"9";"974";"425";"549";"77,41%";"550";"550";"100,00%";"0";"0,00%";"458";"55";"12.01";"403";"87,99%";"12.01";12.010
"MULTIPOLYGON (((-58.3944959612084 -34.6183027664725,-58.3931988766914 -34.6182341446929,-58.3930026148053 -34.6182237506708,-58.3920279471634 -34.6181759347472,-58.3916970106205 -34.6181591927059,-58.3916659597938 -34.619109348745,-58.3919318958105 -34.6191331661049,-58.3932120967077 -34.6192370042354,-58.3932146793298 -34.6194090539668,-58.3932104297475 -34.6194994772366,-58.3944966613811 -34.6195295703534,-58.3944959612084 -34.6183027664725)))";;"2086";3_21_1;COMUNA 3;"21";"1";"959";"444";"515";"86,21%";"479";"477";"99,58%";"2";"0,42%";"376";"3";"0.8";"373";"99,20%";"0.8";0.800
"MULTIPOLYGON (((-58.3933532611503 -34.6261911263105,-58.3929137685912 -34.6261570717043,-58.3930185579926 -34.6256480298791,-58.3924757426027 -34.6255961675468,-58.3925057722661 -34.6254460388973,-58.3925363949188 -34.6252997839487,-58.3913289998849 -34.6252285881317,-58.3912422628717 -34.6263328000708,-58.3912186621831 -34.6266327259355,-58.3911862757667 -34.6270440588288,-58.3911698240387 -34.627252999868,-58.3921594529537 -34.6272635765247,-58.3932061026106 -34.627449394806,-58.3933088998036 -34.6265701279618,-58.3933532611503 -34.6261911263105)))";;"2087";3_21_10;COMUNA 3;"21";"10";"972";"438";"534";"82,02%";"501";"501";"100,00%";"0";"0,00%";"416";"47";"11.3";"369";"88,70%";"11.3";11.300
"MULTIPOLYGON (((-58.3931653288078 -34.6204623723763,-58.3931653037834 -34.6204629068344,-58.3931105987539 -34.6216312548868,-58.3939452614383 -34.6216705323335,-58.3944623486156 -34.621693147394,-58.3944944497443 -34.6206710172854,-58.3944957446036 -34.6205460840951,-58.39449722666 -34.6204005869122,-58.3944966613811 -34.6195295703534,-58.3932104297475 -34.6194994772366,-58.3931718344586 -34.6203227233458,-58.3931653288078 -34.6204623723763)))";;"2088";3_21_2;COMUNA 3;"21";"2";"912";"419";"493";"84,99%";"491";"490";"99,80%";"1";"0,20%";"397";"7";"1.76";"390";"98,24%";"1.76";1.760
"MULTIPOLYGON (((-58.3916226707086 -34.6202245736595,-58.3918530090309 -34.6202392856202,-58.3930896512696 -34.6203184575494,-58.3931316394479 -34.6203432127044,-58.3931653037834 -34.6204629068344,-58.3931653288078 -34.6204623723763,-58.3931718344586 -34.6203227233458,-58.3932104297475 -34.6194994772366,-58.3932146793298 -34.6194090539668,-58.3932120967077 -34.6192370042354,-58.3919318958105 -34.6191331661049,-58.3916659597938 -34.619109348745,-58.3916226707086 -34.6202245736595)))";;"2089";3_21_3;COMUNA 3;"21";"3";"739";"328";"411";"79,81%";"383";"382";"99,74%";"1";"0,26%";"308";"17";"5.52";"291";"94,48%";"5.52";5.520
"MULTIPOLYGON (((-58.3931653037834 -34.6204629068344,-58.3931316394479 -34.6203432127044,-58.3930896512696 -34.6203184575494,-58.3918530090309 -34.6202392856202,-58.3916226707086 -34.6202245736595,-58.3916104757163 -34.6205395070681,-58.3915537207467 -34.621559931842,-58.3931105987539 -34.6216312548868,-58.3931653037834 -34.6204629068344)))";;"2090";3_21_4;COMUNA 3;"21";"4";"768";"353";"415";"85,06%";"410";"409";"99,76%";"1";"0,24%";"347";"47";"13.54";"300";"86,46%";"13.54";13.540
"MULTIPOLYGON (((-58.3931105987539 -34.6216312548868,-58.3915537207467 -34.621559931842,-58.391488484532 -34.622733807443,-58.391803335849 -34.6227530759999,-58.3929269531713 -34.6228230220136,-58.392957953117 -34.6226310613149,-58.3931105987539 -34.6216312548868)))";;"2091";3_21_5;COMUNA 3;"21";"5";"507";"234";"273";"85,71%";"236";"236";"100,00%";"0";"0,00%";"219";"69";"31.51";"150";"68,49%";"31.51";31.510
"MULTIPOLYGON (((-58.3929269531713 -34.6228230220136,-58.3928990360237 -34.6229958288757,-58.3927912455237 -34.6236326903762,-58.3927291733174 -34.6239992870342,-58.392721125412 -34.6240466784018,-58.3934153170946 -34.6242028546312,-58.3935791210459 -34.6242295681859,-58.3936358646823 -34.623812121282,-58.3937398365189 -34.6230466609316,-58.393765536494 -34.6228744160243,-58.3939452614383 -34.6216705323335,-58.3931105987539 -34.6216312548868,-58.392957953117 -34.6226310613149,-58.3929269531713 -34.6228230220136)))";;"2092";3_21_6;COMUNA 3;"21";"6";"797";"349";"448";"77,90%";"429";"429";"100,00%";"0";"0,00%";"387";"59";"15.25";"328";"84,75%";"15.25";15.250
"MULTIPOLYGON (((-58.3914573948442 -34.6234255031454,-58.3914313558814 -34.6239884649247,-58.3927291733174 -34.6239992870342,-58.3927912455237 -34.6236326903762,-58.3928990360237 -34.6229958288757,-58.3929269531713 -34.6228230220136,-58.391803335849 -34.6227530759999,-58.391488484532 -34.622733807443,-58.3914573948442 -34.6234255031454)))";;"2093";3_21_7;COMUNA 3;"21";"7";"405";"173";"232";"74,57%";"240";"239";"99,58%";"1";"0,42%";"199";"30";"15.08";"169";"84,92%";"15.08";15.080
"MULTIPOLYGON (((-58.3935791210459 -34.6242295681859,-58.3934153170946 -34.6242028546312,-58.392721125412 -34.6240466784018,-58.3927291733174 -34.6239992870342,-58.3914313558814 -34.6239884649247,-58.3914031582974 -34.6242858529578,-58.3913289998849 -34.6252285881317,-58.3925363949188 -34.6252997839487,-58.3932421934431 -34.6253413160373,-58.3934495409729 -34.6253593922832,-58.3934711796898 -34.6251549610069,-58.3935576060597 -34.6243881529499,-58.3935791210459 -34.6242295681859)))";;"2094";3_21_8;COMUNA 3;"21";"8";"690";"298";"392";"76,02%";"400";"400";"100,00%";"0";"0,00%";"314";"20";"6.37";"294";"93,63%";"6.37";6.370
"MULTIPOLYGON (((-58.3934495409729 -34.6253593922832,-58.3932421934431 -34.6253413160373,-58.3925363949188 -34.6252997839487,-58.3925057722661 -34.6254460388973,-58.3924757426027 -34.6255961675468,-58.3930185579926 -34.6256480298791,-58.3929137685912 -34.6261570717043,-58.3933532611503 -34.6261911263105,-58.3934396666985 -34.6254519954519,-58.3934495409729 -34.6253593922832)))";;"2095";3_21_9;COMUNA 3;"21";"9";"416";"177";"239";"74,06%";"256";"256";"100,00%";"0";"0,00%";"188";"1";"0.53";"187";"99,47%";"0.53";0.530
"MULTIPOLYGON (((-58.3959252408541 -34.6195629674596,-58.3959147690265 -34.6196614158661,-58.3958052075469 -34.6206285021671,-58.395987333181 -34.6206399403248,-58.3971120303482 -34.6207132992133,-58.3973886758069 -34.6197981341044,-58.3974410510604 -34.6196004791817,-58.3974699302578 -34.6194911246121,-58.3975145212996 -34.6184623800438,-58.395989736408 -34.6183817642289,-58.395940863981 -34.619414520124,-58.3959252408541 -34.6195629674596)))";;"2096";3_22_1;COMUNA 3;"22";"1";"787";"345";"442";"78,05%";"386";"385";"99,74%";"1";"0,26%";"342";"47";"13.74";"295";"86,26%";"13.74";13.740
"MULTIPOLYGON (((-58.395989736408 -34.6183817642289,-58.3944959612084 -34.6183027664725,-58.3944966613811 -34.6195295703534,-58.3959252408541 -34.6195629674596,-58.395940863981 -34.619414520124,-58.395989736408 -34.6183817642289)))";;"2097";3_22_2;COMUNA 3;"22";"2";"658";"305";"353";"86,40%";"351";"351";"100,00%";"0";"0,00%";"294";"57";"19.39";"237";"80,61%";"19.39";19.390
"MULTIPOLYGON (((-58.3959252408541 -34.6195629674596,-58.3944966613811 -34.6195295703534,-58.39449722666 -34.6204005869122,-58.3944957446036 -34.6205460840951,-58.3958052075469 -34.6206285021671,-58.3959147690265 -34.6196614158661,-58.3959252408541 -34.6195629674596)))";;"2098";3_22_3;COMUNA 3;"22";"3";"407";"193";"214";"90,19%";"219";"219";"100,00%";"0";"0,00%";"181";"63";"34.81";"118";"65,19%";"34.81";34.810
"MULTIPOLYGON (((-58.3958052075469 -34.6206285021671,-58.3944957446036 -34.6205460840951,-58.3944944497443 -34.6206710172854,-58.3944623486156 -34.621693147394,-58.3956417664747 -34.6217471835648,-58.3956644533309 -34.6216086701217,-58.3957909651782 -34.6207542733697,-58.3958052075469 -34.6206285021671)))";;"2099";3_22_4;COMUNA 3;"22";"4";"513";"252";"261";"96,55%";"268";"268";"100,00%";"0";"0,00%";"246";"12";"4.88";"234";"95,12%";"4.88";4.880
"MULTIPOLYGON (((-58.3971120303482 -34.6207132992133,-58.395987333181 -34.6206399403248,-58.3958052075469 -34.6206285021671,-58.3957909651782 -34.6207542733697,-58.3956644533309 -34.6216086701217,-58.3956417664747 -34.6217471835648,-58.3956246440722 -34.6218519665015,-58.3953646726725 -34.6229746788308,-58.3963622852479 -34.623059805798,-58.396423081157 -34.6228845511355,-58.3967666658607 -34.6217987844292,-58.3968355866823 -34.6215809972334,-58.3970788052033 -34.6208231443128,-58.3971120303482 -34.6207132992133)))";;"2100";3_22_5;COMUNA 3;"22";"5";"809";"365";"444";"82,21%";"463";"461";"99,57%";"2";"0,43%";"359";"23";"6.41";"336";"93,59%";"6.41";6.410
"MULTIPOLYGON (((-58.3944623486156 -34.621693147394,-58.3939452614383 -34.6216705323335,-58.393765536494 -34.6228744160243,-58.3949437634362 -34.6229462757833,-58.3953646726725 -34.6229746788308,-58.3956246440722 -34.6218519665015,-58.3956417664747 -34.6217471835648,-58.3944623486156 -34.621693147394)))";;"2101";3_22_6;COMUNA 3;"22";"6";"753";"351";"402";"87,31%";"289";"288";"99,65%";"1";"0,35%";"302";"64";"21.19";"238";"78,81%";"21.19";21.190
"MULTIPOLYGON (((-58.3947378135728 -34.6244882998353,-58.3947377906316 -34.6244882562024,-58.3947970823501 -34.6240177974402,-58.3948092636566 -34.6239703205822,-58.3949437634362 -34.6229462757833,-58.393765536494 -34.6228744160243,-58.3937398365189 -34.6230466609316,-58.3936358646823 -34.623812121282,-58.3935791210459 -34.6242295681859,-58.3935576060597 -34.6243881529499,-58.3934711796898 -34.6251549610069,-58.3934495409729 -34.6253593922832,-58.3936352509152 -34.6253754840297,-58.3946012731863 -34.6254730727033,-58.3946244085518 -34.625310333616,-58.3947378135728 -34.6244882998353)))";;"2102";3_22_7;COMUNA 3;"22";"7";"737";"328";"409";"80,20%";"413";"412";"99,76%";"1";"0,24%";"330";"61";"18.48";"269";"81,52%";"18.48";18.480
"MULTIPOLYGON (((-58.3946012731863 -34.6254730727033,-58.394429725706 -34.6266799894584,-58.3955258497895 -34.6267874326082,-58.3957333273046 -34.6255884216452,-58.3959301853444 -34.6244512373717,-58.3959633641227 -34.6242966023664,-58.3959861957735 -34.6241902731981,-58.3962845824159 -34.6232835740118,-58.3963622852479 -34.623059805798,-58.3953646726725 -34.6229746788308,-58.3949437634362 -34.6229462757833,-58.3948092636566 -34.6239703205822,-58.3947970823501 -34.6240177974402,-58.3947377906316 -34.6244882562024,-58.3947378135728 -34.6244882998353,-58.3946244085518 -34.625310333616,-58.3946012731863 -34.6254730727033)))";;"2103";3_22_8;COMUNA 3;"22";"8";"931";"443";"488";"90,78%";"454";"453";"99,78%";"1";"0,22%";"375";"25";"6.67";"350";"93,33%";"6.67";6.670
"MULTIPOLYGON (((-58.3955258497895 -34.6267874326082,-58.394429725706 -34.6266799894584,-58.3946012731863 -34.6254730727033,-58.3936352509152 -34.6253754840297,-58.3934495409729 -34.6253593922832,-58.3934396666985 -34.6254519954519,-58.3933532611503 -34.6261911263105,-58.3933088998036 -34.6265701279618,-58.3932061026106 -34.627449394806,-58.3942928785819 -34.6276424099532,-58.3953455006943 -34.6278292695942,-58.3955258497895 -34.6267874326082)))";;"2104";3_22_9;COMUNA 3;"22";"9";"939";"441";"498";"88,55%";"464";"464";"100,00%";"0";"0,00%";"373";"58";"15.55";"315";"84,45%";"15.55";15.550
"MULTIPOLYGON (((-58.4000392761863 -34.6186035670592,-58.399242898406 -34.61855371705,-58.3989628993509 -34.6185389226795,-58.3988719341994 -34.6195210925984,-58.3988358864491 -34.6196494584959,-58.3987894174186 -34.6198145807664,-58.3985567419067 -34.6206230783399,-58.3984962018493 -34.620805940167,-58.3998276374659 -34.6209073413691,-58.3999390414581 -34.6196944691993,-58.4000392761863 -34.6186035670592)))";;"2105";3_23_1;COMUNA 3;"23";"1";"799";"356";"443";"80,36%";"355";"355";"100,00%";"0";"0,00%";"330";"82";"24.85";"248";"75,15%";"24.85";24.850
"MULTIPOLYGON (((-58.3955258497895 -34.6267874326082,-58.3953455006943 -34.6278292695942,-58.3968070164921 -34.6280870483159,-58.3968657089348 -34.6280975028923,-58.3970711826348 -34.6269344759484,-58.3971050709549 -34.6267428679989,-58.3972659357977 -34.6257463009856,-58.3970893427925 -34.6257268392745,-58.3957333273046 -34.6255884216452,-58.3955258497895 -34.6267874326082)))";;"2106";3_23_10;COMUNA 3;"23";"10";"1044";"497";"547";"90,86%";"428";"428";"100,00%";"0";"0,00%";"397";"55";"13.85";"342";"86,15%";"13.85";13.850
"MULTIPOLYGON (((-58.3989628993509 -34.6185389226795,-58.3975145212996 -34.6184623800438,-58.3974699302578 -34.6194911246121,-58.3974410510604 -34.6196004791817,-58.3988358864491 -34.6196494584959,-58.3988719341994 -34.6195210925984,-58.3989628993509 -34.6185389226795)))";;"2107";3_23_2;COMUNA 3;"23";"2";"803";"347";"456";"76,10%";"408";"408";"100,00%";"0";"0,00%";"347";"12";"3.46";"335";"96,54%";"3.46";3.460
"MULTIPOLYGON (((-58.3988358864491 -34.6196494584959,-58.3974410510604 -34.6196004791817,-58.3973886758069 -34.6197981341044,-58.3971120303482 -34.6207132992133,-58.3970788052033 -34.6208231443128,-58.3968355866823 -34.6215809972334,-58.3967666658607 -34.6217987844292,-58.3970113241248 -34.6218101139901,-58.3981921704108 -34.6218940568837,-58.3984584602946 -34.6209198679133,-58.3984962018493 -34.620805940167,-58.3985567419067 -34.6206230783399,-58.3987894174186 -34.6198145807664,-58.3988358864491 -34.6196494584959)))";;"2108";3_23_3;COMUNA 3;"23";"3";"810";"382";"428";"89,25%";"427";"427";"100,00%";"0";"0,00%";"367";"45";"12.26";"322";"87,74%";"12.26";12.260
"MULTIPOLYGON (((-58.3998276374659 -34.6209073413691,-58.3984962018493 -34.620805940167,-58.3984584602946 -34.6209198679133,-58.3981921704108 -34.6218940568837,-58.3995725420303 -34.6220821798628,-58.3998276374659 -34.6209073413691)))";;"2109";3_23_4;COMUNA 3;"23";"4";"448";"211";"237";"89,03%";"213";"213";"100,00%";"0";"0,00%";"191";"41";"21.47";"150";"78,53%";"21.47";21.470
"MULTIPOLYGON (((-58.3995725420303 -34.6220821798628,-58.3981921704108 -34.6218940568837,-58.3978258301103 -34.6232341904281,-58.398027544562 -34.6232602139195,-58.3990670422211 -34.6233919622824,-58.3992754021114 -34.6234184097262,-58.3993135427176 -34.6232278596339,-58.3995725420303 -34.6220821798628)))";;"2110";3_23_5;COMUNA 3;"23";"5";"614";"268";"346";"77,46%";"363";"363";"100,00%";"0";"0,00%";"291";"21";"7.22";"270";"92,78%";"7.22";7.220
"MULTIPOLYGON (((-58.3981921704108 -34.6218940568837,-58.3970113241248 -34.6218101139901,-58.3967666658607 -34.6217987844292,-58.396423081157 -34.6228845511355,-58.3963622852479 -34.623059805798,-58.3966881200419 -34.6230899835875,-58.3975764982818 -34.6232020142203,-58.3978258301103 -34.6232341904281,-58.3981921704108 -34.6218940568837)))";;"2111";3_23_6;COMUNA 3;"23";"6";"610";"289";"321";"90,03%";"263";"263";"100,00%";"0";"0,00%";"242";"39";"16.12";"203";"83,88%";"16.12";16.120
"MULTIPOLYGON (((-58.3978258301103 -34.6232341904281,-58.3975764982818 -34.6232020142203,-58.3966881200419 -34.6230899835875,-58.3963622852479 -34.623059805798,-58.3962845824159 -34.6232835740118,-58.3959861957735 -34.6241902731981,-58.3959633641227 -34.6242966023664,-58.396114046929 -34.6243263336103,-58.3973575073696 -34.6244582076896,-58.3975034309978 -34.624474060955,-58.3975268499273 -34.6243768870561,-58.3977786534843 -34.6234276226672,-58.3978258301103 -34.6232341904281)))";;"2112";3_23_7;COMUNA 3;"23";"7";"661";"308";"353";"87,25%";"315";"315";"100,00%";"0";"0,00%";"274";"43";"15.69";"231";"84,31%";"15.69";15.690
"MULTIPOLYGON (((-58.3975034309978 -34.624474060955,-58.3973575073696 -34.6244582076896,-58.396114046929 -34.6243263336103,-58.3959633641227 -34.6242966023664,-58.3959301853444 -34.6244512373717,-58.3957333273046 -34.6255884216452,-58.3970893427925 -34.6257268392745,-58.3972659357977 -34.6257463009856,-58.3974597367509 -34.6257676026936,-58.3986618756094 -34.6259330340388,-58.3989140217957 -34.6259726041069,-58.3990943681508 -34.6246473011384,-58.3992323013538 -34.6236336763764,-58.3992754021114 -34.6234184097262,-58.3990670422211 -34.6233919622824,-58.398027544562 -34.6232602139195,-58.3978258301103 -34.6232341904281,-58.3977786534843 -34.6234276226672,-58.3975268499273 -34.6243768870561,-58.3975034309978 -34.624474060955)))";;"2113";3_23_8;COMUNA 3;"23";"8";"880";"400";"480";"83,33%";"403";"400";"99,26%";"3";"0,75%";"336";"41";"12.2";"295";"87,80%";"12.2";12.200
"MULTIPOLYGON (((-58.3989140217957 -34.6259726041069,-58.3986618756094 -34.6259330340388,-58.3974597367509 -34.6257676026936,-58.3972659357977 -34.6257463009856,-58.3971050709549 -34.6267428679989,-58.3970711826348 -34.6269344759484,-58.3968657089348 -34.6280975028923,-58.3985941180819 -34.628405969026,-58.3987564309814 -34.6271686887469,-58.3988971437125 -34.6260963318632,-58.3989140217957 -34.6259726041069)))";;"2114";3_23_9;COMUNA 3;"23";"9";"972";"477";"495";"96,36%";"374";"374";"100,00%";"0";"0,00%";"342";"42";"12.28";"300";"87,72%";"12.28";12.280
"MULTIPOLYGON (((-58.4050351282089 -34.6191545007976,-58.4035128744328 -34.6188402396232,-58.4032060153725 -34.6198144202175,-58.4047826738054 -34.6201972345368,-58.4050351282089 -34.6191545007976)))";;"2115";3_24_1;COMUNA 3;"24";"1";"692";"307";"385";"79,74%";"368";"367";"99,73%";"1";"0,27%";"303";"12";"3.96";"291";"96,04%";"3.96";3.960
"MULTIPOLYGON (((-58.4021429679268 -34.619787065221,-58.4021156879018 -34.6199314229101,-58.4017655082395 -34.6210548791288,-58.4028019554252 -34.6211338458684,-58.404316242129 -34.6214457879797,-58.4044865976268 -34.6214813635809,-58.4045109311422 -34.6212815091093,-58.4047826738054 -34.6201972345368,-58.4032060153725 -34.6198144202175,-58.4035128744328 -34.6188402396232,-58.4022466233633 -34.6187558129454,-58.402166399555 -34.6196631288613,-58.4021429679268 -34.619787065221)))";;"2116";3_24_2;COMUNA 3;"24";"2";"851";"388";"463";"83,80%";"337";"337";"100,00%";"0";"0,00%";"336";"55";"16.37";"281";"83,63%";"16.37";16.370
"MULTIPOLYGON (((-58.4009802074755 -34.6186673588157,-58.400293974198 -34.618619472819,-58.4000392761863 -34.6186035670592,-58.3999390414581 -34.6196944691993,-58.40088417707 -34.6197341785073,-58.4021429679268 -34.619787065221,-58.402166399555 -34.6196631288613,-58.4022466233633 -34.6187558129454,-58.4009802074755 -34.6186673588157)))";;"2117";3_24_3;COMUNA 3;"24";"3";"651";"275";"376";"73,14%";"363";"362";"99,72%";"1";"0,28%";"276";"4";"1.45";"272";"98,55%";"1.45";1.450
"MULTIPOLYGON (((-58.4021429679268 -34.619787065221,-58.40088417707 -34.6197341785073,-58.3999390414581 -34.6196944691993,-58.3998276374659 -34.6209073413691,-58.4007723368648 -34.620979305959,-58.4017655082395 -34.6210548791288,-58.4021156879018 -34.6199314229101,-58.4021429679268 -34.619787065221)))";;"2118";3_24_4;COMUNA 3;"24";"4";"701";"328";"373";"87,94%";"375";"374";"99,73%";"1";"0,27%";"311";"41";"13.18";"270";"86,82%";"13.18";13.180
"MULTIPOLYGON (((-58.4017655082395 -34.6210548791288,-58.4007723368648 -34.620979305959,-58.3998276374659 -34.6209073413691,-58.3995725420303 -34.6220821798628,-58.4004528995557 -34.6222021434324,-58.4006087855944 -34.6222201108191,-58.4013747576558 -34.6223085295,-58.4017655082395 -34.6210548791288)))";;"2119";3_24_5;COMUNA 3;"24";"5";"517";"233";"284";"82,04%";"277";"277";"100,00%";"0";"0,00%";"225";"3";"1.33";"222";"98,67%";"1.33";1.330
"MULTIPOLYGON (((-58.4044865976268 -34.6214813635809,-58.404316242129 -34.6214457879797,-58.4028019554252 -34.6211338458684,-58.4017655082395 -34.6210548791288,-58.4013747576558 -34.6223085295,-58.4015591806638 -34.6223298199882,-58.4024789087181 -34.622440492566,-58.4042972764283 -34.622738147479,-58.4044581512883 -34.621714949639,-58.4044865976268 -34.6214813635809)))";;"2120";3_24_6;COMUNA 3;"24";"6";"1074";"476";"598";"79,60%";"473";"470";"99,37%";"3";"0,64%";"375";"57";"15.2";"318";"84,80%";"15.2";15.200
"MULTIPOLYGON (((-58.4042972764283 -34.622738147479,-58.4024789087181 -34.622440492566,-58.4021703955817 -34.623780456335,-58.4024712686594 -34.623817860057,-58.4032545460273 -34.6239139517826,-58.4034750907159 -34.623940961389,-58.4040161026407 -34.6240077744323,-58.4042669838852 -34.6229303931099,-58.4042972764283 -34.622738147479)))";;"2121";3_24_7;COMUNA 3;"24";"7";"674";"323";"351";"92,02%";"391";"391";"100,00%";"0";"0,00%";"297";"0";"0";"297";"100,00%";"0";0.000
"MULTIPOLYGON (((-58.4024789087181 -34.622440492566,-58.4015591806638 -34.6223298199882,-58.4013747576558 -34.6223085295,-58.4006087855944 -34.6222201108191,-58.4004495747069 -34.6233461951751,-58.4004212141809 -34.6235629486949,-58.4009630735252 -34.6236292123132,-58.4012837083848 -34.6236690234129,-58.4014016883223 -34.6236847875195,-58.4021703955817 -34.623780456335,-58.4024789087181 -34.622440492566)))";;"2122";3_24_8;COMUNA 3;"24";"8";"753";"337";"416";"81,01%";"366";"366";"100,00%";"0";"0,00%";"320";"33";"10.31";"287";"89,69%";"10.31";10.310
"MULTIPOLYGON (((-58.4006087855944 -34.6222201108191,-58.4004528995557 -34.6222021434324,-58.3995725420303 -34.6220821798628,-58.3993135427176 -34.6232278596339,-58.3992754021114 -34.6234184097262,-58.3994685993695 -34.6234429474817,-58.4002224790754 -34.6235381279123,-58.4004212141809 -34.6235629486949,-58.4004495747069 -34.6233461951751,-58.4006087855944 -34.6222201108191)))";;"2123";3_24_9;COMUNA 3;"24";"9";"458";"215";"243";"88,48%";"217";"216";"99,54%";"1";"0,46%";"185";"21";"11.35";"164";"88,65%";"11.35";11.350
"MULTIPOLYGON (((-58.4107613958501 -34.6215727207758,-58.4105884403036 -34.6226937421058,-58.411784132391 -34.6229234098657,-58.4120418912046 -34.6229747865517,-58.4123564056345 -34.6218685405263,-58.4124368166296 -34.6218833629295,-58.4125438811881 -34.6206423075662,-58.4108118314007 -34.6203362203815,-58.410792249706 -34.6205909392362,-58.4107613958501 -34.6215727207758)))";;"2124";3_25_1;COMUNA 3;"25";"1";"1221";"548";"673";"81,43%";"656";"654";"99,70%";"2";"0,31%";"510";"13";"2.55";"497";"97,45%";"2.55";2.550
"MULTIPOLYGON (((-58.4100790399964 -34.6201937888561,-58.409252050252 -34.6200234233942,-58.4077803593484 -34.6197201535171,-58.4075721622506 -34.6208745364648,-58.4091757766737 -34.6212638556608,-58.4099985236417 -34.6214269660054,-58.4107613958501 -34.6215727207758,-58.410792249706 -34.6205909392362,-58.4108118314007 -34.6203362203815,-58.4105191542498 -34.6202844740221,-58.4100790399964 -34.6201937888561)))";;"2125";3_25_2;COMUNA 3;"25";"2";"709";"341";"368";"92,66%";"337";"337";"100,00%";"0";"0,00%";"295";"38";"12.88";"257";"87,12%";"12.88";12.880
"MULTIPOLYGON (((-58.4063872116358 -34.6194330999076,-58.4050351282089 -34.6191545007976,-58.4047826738054 -34.6201972345368,-58.4062448711219 -34.620552298525,-58.4075721622506 -34.6208745364648,-58.4077803593484 -34.6197201535171,-58.4063872116358 -34.6194330999076)))";;"2126";3_25_3;COMUNA 3;"25";"3";"549";"255";"294";"86,73%";"247";"245";"99,19%";"2";"0,82%";"207";"50";"24.15";"157";"75,85%";"24.15";24.150
"MULTIPOLYGON (((-58.4062448711219 -34.620552298525,-58.4047826738054 -34.6201972345368,-58.4045109311422 -34.6212815091093,-58.4044865976268 -34.6214813635809,-58.4047933231389 -34.6215453145937,-58.4061514112461 -34.6218189189049,-58.4073601116165 -34.6220502558532,-58.4075721622506 -34.6208745364648,-58.4062448711219 -34.620552298525)))";;"2127";3_25_4;COMUNA 3;"25";"4";"696";"323";"373";"86,60%";"328";"327";"99,70%";"1";"0,31%";"272";"30";"11.03";"242";"88,97%";"11.03";11.030
"MULTIPOLYGON (((-58.4073601116165 -34.6220502558532,-58.4073393336552 -34.6221656025239,-58.4072162152531 -34.623215934893,-58.4088217439141 -34.6234786354207,-58.4089945810175 -34.6235065294938,-58.4090979506492 -34.6225302737559,-58.4091055263967 -34.6224075263703,-58.4092203489967 -34.622431028277,-58.4105884403036 -34.6226937421058,-58.4107613958501 -34.6215727207758,-58.4099985236417 -34.6214269660054,-58.4091757766737 -34.6212638556608,-58.4075721622506 -34.6208745364648,-58.4073601116165 -34.6220502558532)))";;"2128";3_25_5;COMUNA 3;"25";"5";"829";"386";"443";"87,13%";"204";"202";"99,02%";"2";"0,99%";"296";"74";"25";"222";"75,00%";"25";25.000
"MULTIPOLYGON (((-58.4061514112461 -34.6218189189049,-58.4047933231389 -34.6215453145937,-58.4044865976268 -34.6214813635809,-58.4044581512883 -34.621714949639,-58.4042972764283 -34.622738147479,-58.4059836245823 -34.6230141639316,-58.4072162152531 -34.623215934893,-58.4073393336552 -34.6221656025239,-58.4073601116165 -34.6220502558532,-58.4061514112461 -34.6218189189049)))";;"2129";3_25_6;COMUNA 3;"25";"6";"959";"444";"515";"86,21%";"350";"348";"99,43%";"2";"0,57%";"337";"61";"18.1";"276";"81,90%";"18.1";18.100
"MULTIPOLYGON (((-58.4059836245823 -34.6230141639316,-58.4042972764283 -34.622738147479,-58.4042669838852 -34.6229303931099,-58.4040161026407 -34.6240077744323,-58.4047079791475 -34.624093037802,-58.405812497292 -34.6242288442172,-58.4059836245823 -34.6230141639316)))";;"2130";3_25_7;COMUNA 3;"25";"7";"527";"252";"275";"91,64%";"269";"269";"100,00%";"0";"0,00%";"228";"42";"18.42";"186";"81,58%";"18.42";18.420
"MULTIPOLYGON (((-58.4072162152531 -34.623215934893,-58.4059836245823 -34.6230141639316,-58.405812497292 -34.6242288442172,-58.4062092081059 -34.6242776217912,-58.4070786986426 -34.6243901378652,-58.4072162152531 -34.623215934893)))";;"2131";3_25_8;COMUNA 3;"25";"8";"1553";"665";"888";"74,89%";"862";"862";"100,00%";"0";"0,00%";"716";"80";"11.17";"636";"88,83%";"11.17";11.170
"MULTIPOLYGON (((-58.4089945810175 -34.6235065294938,-58.4088217439141 -34.6234786354207,-58.4072162152531 -34.623215934893,-58.4070786986426 -34.6243901378652,-58.4072698556906 -34.6244148736081,-58.4088754572215 -34.6246007398124,-58.4089488101214 -34.6239380030063,-58.4089945810175 -34.6235065294938)))";;"2132";3_25_9;COMUNA 3;"25";"9";"746";"331";"415";"79,76%";"371";"371";"100,00%";"0";"0,00%";"319";"63";"19.75";"256";"80,25%";"19.75";19.750
"MULTIPOLYGON (((-58.4105884403036 -34.6226937421058,-58.4092203489967 -34.622431028277,-58.4091055263967 -34.6224075263703,-58.4090979506492 -34.6225302737559,-58.4089945810175 -34.6235065294938,-58.4089488101214 -34.6239380030063,-58.4088754572215 -34.6246007398124,-58.4091716526887 -34.6246349558195,-58.409725201008 -34.6246956924948,-58.4098537471054 -34.6247128615127,-58.4103673420384 -34.6247713947852,-58.4104490271486 -34.6239806985347,-58.4104730326363 -34.6237388695378,-58.4105528507538 -34.6229333830418,-58.4105884403036 -34.6226937421058)))";;"2133";3_26_1;COMUNA 3;"26";"1";"900";"384";"516";"74,42%";"462";"461";"99,78%";"1";"0,22%";"398";"60";"15.08";"338";"84,92%";"15.08";15.080
"MULTIPOLYGON (((-58.4104602815796 -34.6247819983634,-58.4118272878333 -34.6249379335475,-58.4120940956267 -34.6249692427754,-58.4121266704108 -34.6247781230019,-58.4122197515561 -34.6239925713041,-58.4123334674259 -34.6230328670315,-58.4120418912046 -34.6229747865517,-58.411784132391 -34.6229234098657,-58.4105884403036 -34.6226937421058,-58.4105528507538 -34.6229333830418,-58.4104730326363 -34.6237388695378,-58.4104490271486 -34.6239806985347,-58.4103673420384 -34.6247713947852,-58.4104602815796 -34.6247819983634)))";;"2134";3_26_2;COMUNA 3;"26";"2";"1162";"572";"590";"96,95%";"466";"466";"100,00%";"0";"0,00%";"440";"98";"22.27";"342";"77,73%";"22.27";22.270
"MULTIPOLYGON (((-58.4104602815796 -34.6247819983634,-58.4103673420384 -34.6247713947852,-58.4103566277921 -34.6248749852726,-58.4102085963288 -34.6263072943033,-58.410453771767 -34.6263331046591,-58.4119903327197 -34.6265045335513,-58.4120651975512 -34.6251381097809,-58.4120940956267 -34.6249692427754,-58.4118272878333 -34.6249379335475,-58.4104602815796 -34.6247819983634)))";;"2135";3_26_3;COMUNA 3;"26";"3";"803";"346";"457";"75,71%";"410";"408";"99,51%";"2";"0,49%";"334";"54";"16.17";"280";"83,83%";"16.17";16.170
"MULTIPOLYGON (((-58.409725201008 -34.6246956924948,-58.4091716526887 -34.6246349558195,-58.4088754572215 -34.6246007398124,-58.4087683396185 -34.6255680494044,-58.4087481151403 -34.6257512861239,-58.4086840345884 -34.6263801930716,-58.4089147403714 -34.6261711626845,-58.4095542563668 -34.6262384170938,-58.4102085963288 -34.6263072943033,-58.4103566277921 -34.6248749852726,-58.4103673420384 -34.6247713947852,-58.4098537471054 -34.6247128615127,-58.409725201008 -34.6246956924948)))";;"2136";3_26_4;COMUNA 3;"26";"4";"517";"244";"273";"89,38%";"295";"295";"100,00%";"0";"0,00%";"227";"3";"1.32";"224";"98,68%";"1.32";1.320
"MULTIPOLYGON (((-58.4069016609346 -34.6259267290534,-58.4067551210642 -34.6272033248252,-58.4076931635188 -34.6272810779979,-58.4078501061875 -34.6271343127341,-58.4086840674411 -34.6263798706481,-58.4087481151403 -34.6257512861239,-58.4087683396185 -34.6255680494044,-58.4088754572215 -34.6246007398124,-58.4072698556906 -34.6244148736081,-58.4070786986426 -34.6243901378652,-58.4070502524502 -34.6246328796617,-58.4069656742052 -34.6253692041673,-58.4069016609346 -34.6259267290534)))";;"2137";3_26_5;COMUNA 3;"26";"5";"834";"382";"452";"84,51%";"397";"396";"99,75%";"1";"0,25%";"341";"48";"14.08";"293";"85,92%";"14.08";14.080
"MULTIPOLYGON (((-58.4119903327197 -34.6265045335513,-58.410453771767 -34.6263331046591,-58.4102085963288 -34.6263072943033,-58.4095542563668 -34.6262384170938,-58.4089147403714 -34.6261711626845,-58.4086840345884 -34.6263801930716,-58.408684067444 -34.6263798706455,-58.4078501061875 -34.6271343127341,-58.4076931635188 -34.6272810779979,-58.4085856365046 -34.6273453525913,-58.4094828816405 -34.6274099748613,-58.410092348061 -34.6274538322574,-58.4110379849394 -34.6275219147701,-58.4119310594474 -34.6275862355657,-58.4119903327197 -34.6265045335513)))";;"2138";3_26_6;COMUNA 3;"26";"6";"605";"282";"323";"87,31%";"292";"292";"100,00%";"0";"0,00%";"246";"5";"2.03";"241";"97,97%";"2.03";2.030
"MULTIPOLYGON (((-58.4099731982226 -34.6287376267474,-58.4098887015284 -34.6296482544165,-58.409868953631 -34.6298883947093,-58.4100338734547 -34.6299280448123,-58.4108272944557 -34.6301224757813,-58.4115812778446 -34.630307236855,-58.4117793363578 -34.6303558424391,-58.4118423189936 -34.6292055486976,-58.4118741969917 -34.6286239228038,-58.4119310594474 -34.6275862355657,-58.4110379849394 -34.6275219147701,-58.410092348061 -34.6274538322574,-58.4099731982226 -34.6287376267474)))";;"2139";3_26_7;COMUNA 3;"26";"7";"815";"388";"427";"90,87%";"406";"405";"99,75%";"1";"0,25%";"312";"17";"5.45";"295";"94,55%";"5.45";5.450
"MULTIPOLYGON (((-58.4094828816405 -34.6274099748613,-58.4085856365046 -34.6273453525913,-58.4076931635188 -34.6272810779979,-58.4067551210642 -34.6272033248252,-58.4066503126829 -34.6281157721934,-58.4066318875077 -34.6282760507932,-58.4067870444994 -34.6281297086515,-58.4069771060996 -34.628149021623,-58.4084850590017 -34.6283328763423,-58.4099731982226 -34.6287376267474,-58.410092348061 -34.6274538322574,-58.4094828816405 -34.6274099748613)))";;"2140";3_26_8;COMUNA 3;"26";"8";"586";"276";"310";"89,03%";"288";"288";"100,00%";"0";"0,00%";"246";"17";"6.91";"229";"93,09%";"6.91";6.910
"MULTIPOLYGON (((-58.4067870444994 -34.6281297086515,-58.4066318875077 -34.6282760507932,-58.4065957222209 -34.6285911151451,-58.4065132816125 -34.6293040587761,-58.4067513073522 -34.6293309296445,-58.4083645004157 -34.6295159608545,-58.4094265029815 -34.6297758745829,-58.409868953631 -34.6298883947093,-58.4098887015284 -34.6296482544165,-58.4099731982226 -34.6287376267474,-58.4084850590017 -34.6283328763423,-58.4069771060996 -34.628149021623,-58.4067870444994 -34.6281297086515)))";;"2141";3_26_9;COMUNA 3;"26";"9";"790";"376";"414";"90,82%";"316";"315";"99,68%";"1";"0,32%";"292";"42";"14.38";"250";"85,62%";"14.38";14.380
"MULTIPOLYGON (((-58.4070786986426 -34.6243901378652,-58.4062092081059 -34.6242776217912,-58.405812497292 -34.6242288442172,-58.4057819349492 -34.624446231757,-58.4056012730916 -34.6257661218481,-58.4069016609346 -34.6259267290534,-58.4069656742052 -34.6253692041673,-58.4070502524502 -34.6246328796617,-58.4070786986426 -34.6243901378652)))";;"2142";3_27_1;COMUNA 3;"27";"1";"966";"443";"523";"84,70%";"466";"465";"99,79%";"1";"0,22%";"400";"35";"8.75";"365";"91,25%";"8.75";8.750
"MULTIPOLYGON (((-58.4034750907159 -34.623940961389,-58.4032545460273 -34.6239139517826,-58.4024712686594 -34.623817860057,-58.4021703955817 -34.623780456335,-58.4020985219614 -34.6240922623066,-58.4018453711006 -34.6252011881833,-58.4020965714732 -34.6252517374944,-58.4029231791726 -34.6254127142116,-58.403136310335 -34.6254473971099,-58.4033545527296 -34.6254829272217,-58.4041559036697 -34.6255851489025,-58.4047648192941 -34.6256627661979,-58.4056012730916 -34.6257661218481,-58.4057819349492 -34.624446231757,-58.405812497292 -34.6242288442172,-58.4047079791475 -34.624093037802,-58.4040161026407 -34.6240077744323,-58.4034750907159 -34.623940961389)))";;"2143";3_27_2;COMUNA 3;"27";"2";"842";"396";"446";"88,79%";"319";"318";"99,69%";"1";"0,31%";"330";"26";"7.88";"304";"92,12%";"7.88";7.880
"MULTIPOLYGON (((-58.4021703955817 -34.623780456335,-58.4014016883223 -34.6236847875195,-58.4012837083848 -34.6236690234129,-58.4009630735252 -34.6236292123132,-58.4004212141809 -34.6235629486949,-58.4002224790754 -34.6235381279123,-58.3994685993695 -34.6234429474817,-58.3992754021114 -34.6234184097262,-58.3992323013538 -34.6236336763764,-58.3990943681508 -34.6246473011384,-58.3989140217957 -34.6259726041069,-58.4001811451074 -34.6261715767029,-58.4001935414023 -34.6258869959538,-58.4001950149025 -34.6258534040212,-58.4001990887033 -34.6257605156356,-58.4002063705526 -34.6255931193218,-58.4002245174308 -34.6253651631307,-58.400232859479 -34.6252607976591,-58.4002376760467 -34.6251998121368,-58.4002417183161 -34.6251488969823,-58.4002629607213 -34.6248825607651,-58.4010413449404 -34.6250388775018,-58.4018453711006 -34.6252011881833,-58.4020985219614 -34.6240922623066,-58.4021703955817 -34.623780456335)))";;"2144";3_27_3;COMUNA 3;"27";"3";"906";"445";"461";"96,53%";"387";"387";"100,00%";"0";"0,00%";"355";"76";"21.41";"279";"78,59%";"21.41";21.410
"MULTIPOLYGON (((-58.4054329356291 -34.6269958732839,-58.4039414918537 -34.6267617757989,-58.4041559036697 -34.6255851489025,-58.4033545527296 -34.6254829272217,-58.403136310335 -34.6254473971099,-58.4029231791726 -34.6254127142116,-58.4020965714732 -34.6252517374944,-58.4018453711006 -34.6252011881833,-58.4010413449404 -34.6250388775018,-58.4002629607213 -34.6248825607651,-58.4002417183161 -34.6251488969823,-58.4002376760467 -34.6251998121368,-58.400232859479 -34.6252607976591,-58.4002245174308 -34.6253651631307,-58.4002063705526 -34.6255931193218,-58.4001990887033 -34.6257605156356,-58.4001950149025 -34.6258534040212,-58.4001935414023 -34.6258869959538,-58.4001811451074 -34.6261715767029,-58.3989140217957 -34.6259726041069,-58.3988971437125 -34.6260963318632,-58.3987564309814 -34.6271686887469,-58.3989104481761 -34.6271911645087,-58.4000890385274 -34.6273200893458,-58.4013287134468 -34.6274555830595,-58.402647347373 -34.6276218083301,-58.4037592327542 -34.6277619328276,-58.4043012058324 -34.6278302239652,-58.4046591709367 -34.6278753259088,-58.4053017555249 -34.6279543650178,-58.4054329356291 -34.6269958732839)))";;"2145";3_27_4;COMUNA 3;"27";"4";"834";"402";"432";"93,06%";"391";"391";"100,00%";"0";"0,00%";"313";"30";"9.58";"283";"90,42%";"9.58";9.580
"MULTIPOLYGON (((-58.4069016609346 -34.6259267290534,-58.4056012730916 -34.6257661218481,-58.4047648192941 -34.6256627661979,-58.4041559036697 -34.6255851489025,-58.4039414918537 -34.6267617757989,-58.4054329356291 -34.6269958732839,-58.4053017555249 -34.6279543650178,-58.4064432981844 -34.6280947606975,-58.4066503126829 -34.6281157721934,-58.4067551210642 -34.6272033248252,-58.4069016609346 -34.6259267290534)))";;"2146";3_27_5;COMUNA 3;"27";"5";"781";"358";"423";"84,63%";"380";"380";"100,00%";"0";"0,00%";"317";"28";"8.83";"289";"91,17%";"8.83";8.830
"MULTIPOLYGON (((-58.4066503126829 -34.6281157721934,-58.4064432981844 -34.6280947606975,-58.4053017555249 -34.6279543650178,-58.4046591709367 -34.6278753259088,-58.4043012058324 -34.6278302239652,-58.4037592327542 -34.6277619328276,-58.4035820154546 -34.6287345557292,-58.4035429137975 -34.6289689108022,-58.405454009253 -34.6291845481762,-58.405645775317 -34.6292061880411,-58.4065132816125 -34.6293040587761,-58.4065957222209 -34.6285911151451,-58.4066318875077 -34.6282760507932,-58.4066503126829 -34.6281157721934)))";;"2147";3_27_6;COMUNA 3;"27";"6";"838";"410";"428";"95,79%";"303";"303";"100,00%";"0";"0,00%";"306";"66";"21.57";"240";"78,43%";"21.57";21.570
"MULTIPOLYGON (((-58.4013287134468 -34.6274555830595,-58.4000890385274 -34.6273200893458,-58.3989104481761 -34.6271911645087,-58.3987564309814 -34.6271686887469,-58.3985941180819 -34.628405969026,-58.3999065507781 -34.6285607413891,-58.4008428791157 -34.6286641105827,-58.4011009209396 -34.6286932562238,-58.4023857658332 -34.6288382693391,-58.4035429137975 -34.6289689108022,-58.4035820154546 -34.6287345557292,-58.4037592327542 -34.6277619328276,-58.402647347373 -34.6276218083301,-58.4013287134468 -34.6274555830595)))";;"2148";3_27_7;COMUNA 3;"27";"7";"932";"426";"506";"84,19%";"405";"405";"100,00%";"0";"0,00%";"367";"25";"6.81";"342";"93,19%";"6.81";6.810
"MULTIPOLYGON (((-58.4047319711159 -34.5980369612585,-58.4045067070641 -34.5980359385108,-58.4037215185266 -34.5984550847024,-58.4041360467216 -34.5997585737145,-58.4041799822018 -34.5998959944065,-58.4043482872852 -34.5998776940236,-58.4052973046898 -34.5997701822883,-58.4047319711159 -34.5980369612585)))";;"2149";3_3_1;COMUNA 3;"3";"1";"1101";"485";"616";"78,73%";"657";"657";"100,00%";"0";"0,00%";"476";"0";"0";"476";"100,00%";"0";0.000
"MULTIPOLYGON (((-58.4035888170502 -34.6019578300839,-58.4034583271481 -34.6019705841855,-58.4023035866717 -34.6020907972958,-58.402217790776 -34.6034234810926,-58.40214620624 -34.6045349661369,-58.40213704815 -34.6047137006687,-58.4036307874391 -34.6047506314921,-58.4036411216904 -34.6045903488112,-58.4036227980147 -34.6034038869967,-58.4035888170502 -34.6019578300839)))";;"2150";3_3_10;COMUNA 3;"3";"10";"950";"470";"480";"97,92%";"338";"338";"100,00%";"0";"0,00%";"393";"114";"29.01";"279";"70,99%";"29.01";29.010
"MULTIPOLYGON (((-58.4051559313607 -34.6033429976314,-58.4037713389727 -34.6034018460704,-58.4036227980147 -34.6034038869967,-58.4036411216904 -34.6045903488112,-58.4036307874391 -34.6047506314921,-58.404480023678 -34.6046642758587,-58.4054694625903 -34.6045636838448,-58.4051915138065 -34.6034945694024,-58.4051559313607 -34.6033429976314)))";;"2151";3_3_11;COMUNA 3;"3";"11";"869";"345";"524";"65,84%";"405";"405";"100,00%";"0";"0,00%";"305";"0";"0";"305";"100,00%";"0";0.000
"MULTIPOLYGON (((-58.4037215185266 -34.5984550847024,-58.4030827802325 -34.5987960550108,-58.4032817289307 -34.5999940851983,-58.4041799822018 -34.5998959944065,-58.4041360467216 -34.5997585737145,-58.4037215185266 -34.5984550847024)))";;"2152";3_3_2;COMUNA 3;"3";"2";"860";"398";"462";"86,15%";"529";"528";"99,81%";"1";"0,19%";"373";"44";"11.8";"329";"88,20%";"11.8";11.800
"MULTIPOLYGON (((-58.4030827802325 -34.5987960550108,-58.4025368197199 -34.5990874883694,-58.4024743679909 -34.599120839122,-58.4024291274447 -34.6000871213166,-58.4025754581966 -34.6000711365564,-58.4032817289307 -34.5999940851983,-58.4030827802325 -34.5987960550108)))";;"2153";3_3_3;COMUNA 3;"3";"3";"614";"271";"343";"79,01%";"348";"348";"100,00%";"0";"0,00%";"260";"2";"0.77";"258";"99,23%";"0.77";0.770
"MULTIPOLYGON (((-58.4032817289307 -34.5999940851983,-58.4025754581966 -34.6000711365564,-58.4024291274447 -34.6000871213166,-58.4023771475992 -34.6009492411233,-58.4023706012545 -34.6010508614653,-58.4034344258031 -34.6009670838277,-58.4032981808191 -34.6000934631963,-58.4032817289307 -34.5999940851983)))";;"2154";3_3_4;COMUNA 3;"3";"4";"516";"230";"286";"80,42%";"273";"273";"100,00%";"0";"0,00%";"213";"8";"3.76";"205";"96,24%";"3.76";3.760
"MULTIPOLYGON (((-58.4041799822018 -34.5998959944065,-58.4032817289307 -34.5999940851983,-58.4032981808191 -34.6000934631963,-58.4034344258031 -34.6009670838277,-58.4044961189512 -34.6008833663215,-58.4041799822018 -34.5998959944065)))";;"2155";3_3_5;COMUNA 3;"3";"5";"579";"275";"304";"90,46%";"355";"354";"99,72%";"1";"0,28%";"245";"1";"0.41";"244";"99,59%";"0.41";0.410
"MULTIPOLYGON (((-58.4052973046898 -34.5997701822883,-58.4043482872852 -34.5998776940236,-58.4041799822018 -34.5998959944065,-58.4044961189512 -34.6008833663215,-58.4056312296585 -34.600793899067,-58.4052973046898 -34.5997701822883)))";;"2156";3_3_6;COMUNA 3;"3";"6";"823";"363";"460";"78,91%";"389";"388";"99,74%";"1";"0,26%";"302";"1";"0.33";"301";"99,67%";"0.33";0.330
"MULTIPOLYGON (((-58.4056312296585 -34.600793899067,-58.4044961189512 -34.6008833663215,-58.4048022347412 -34.6018395341427,-58.4049826372775 -34.6018219428843,-58.4059288566117 -34.6017273127713,-58.4058951288026 -34.6016029261637,-58.4056312296585 -34.600793899067)))";;"2157";3_3_7;COMUNA 3;"3";"7";"802";"355";"447";"79,42%";"390";"390";"100,00%";"0";"0,00%";"308";"18";"5.84";"290";"94,16%";"5.84";5.840
"MULTIPOLYGON (((-58.4035888170502 -34.6019578300839,-58.4036227980147 -34.6034038869967,-58.4037713389727 -34.6034018460704,-58.4051559313607 -34.6033429976314,-58.4048022347412 -34.6018395341427,-58.4044961189512 -34.6008833663215,-58.4034344258031 -34.6009670838277,-58.4035888170502 -34.6019578300839)))";;"2158";3_3_8;COMUNA 3;"3";"8";"726";"319";"407";"78,38%";"359";"358";"99,72%";"1";"0,28%";"263";"6";"2.28";"257";"97,72%";"2.28";2.280
"MULTIPOLYGON (((-58.4034344258031 -34.6009670838277,-58.4023706012545 -34.6010508614653,-58.4023035866717 -34.6020907972958,-58.4034583271481 -34.6019705841855,-58.4035888170502 -34.6019578300839,-58.4034344258031 -34.6009670838277)))";;"2159";3_3_9;COMUNA 3;"3";"9";"285";"136";"149";"91,28%";"190";"190";"100,00%";"0";"0,00%";"159";"22";"13.84";"137";"86,16%";"13.84";13.840
"MULTIPOLYGON (((-58.4024743679909 -34.599120839122,-58.4020082362967 -34.5993697022085,-58.4012081843027 -34.5994681082511,-58.4010694339109 -34.5994845881792,-58.4010293606152 -34.6002360754853,-58.4024291274447 -34.6000871213166,-58.4024743679909 -34.599120839122)))";;"2160";3_4_1;COMUNA 3;"4";"1";"736";"317";"419";"75,66%";"449";"449";"100,00%";"0";"0,00%";"354";"12";"3.39";"342";"96,61%";"3.39";3.390
"MULTIPOLYGON (((-58.4024291274447 -34.6000871213166,-58.4010293606152 -34.6002360754853,-58.4009772333166 -34.6011627040827,-58.4023706012545 -34.6010508614653,-58.4023771475992 -34.6009492411233,-58.4024291274447 -34.6000871213166)))";;"2161";3_4_2;COMUNA 3;"4";"2";"499";"224";"275";"81,45%";"269";"269";"100,00%";"0";"0,00%";"216";"17";"7.87";"199";"92,13%";"7.87";7.870
"MULTIPOLYGON (((-58.4010694339109 -34.5994845881792,-58.3999209290805 -34.5996215431604,-58.3998152037242 -34.6010199926778,-58.3998073808007 -34.6011161894804,-58.3999229525097 -34.6011204040818,-58.4009772333166 -34.6011627040827,-58.4010293606152 -34.6002360754853,-58.4010694339109 -34.5994845881792)))";;"2162";3_4_3;COMUNA 3;"4";"3";"681";"293";"388";"75,52%";"421";"416";"98,81%";"5";"1,20%";"279";"5";"1.79";"274";"98,21%";"1.79";1.790
"MULTIPOLYGON (((-58.4009772333166 -34.6011627040827,-58.3999229525097 -34.6011204040818,-58.3998073808007 -34.6011161894804,-58.3997176290632 -34.602222100548,-58.4009011669955 -34.6022110151333,-58.4021432838709 -34.6021074790414,-58.4023035866717 -34.6020907972958,-58.4023706012545 -34.6010508614653,-58.4009772333166 -34.6011627040827)))";;"2163";3_4_4;COMUNA 3;"4";"4";"772";"359";"413";"86,92%";"404";"404";"100,00%";"0";"0,00%";"326";"67";"20.55";"259";"79,45%";"20.55";20.550
"MULTIPOLYGON (((-58.4009011669955 -34.6022110151333,-58.3997176290632 -34.602222100548,-58.3997095476885 -34.6023218888767,-58.3995509520951 -34.6033449440284,-58.3997097910983 -34.6033531250272,-58.4008971862779 -34.603445566671,-58.402217790776 -34.6034234810926,-58.4023035866717 -34.6020907972958,-58.4021432838709 -34.6021074790414,-58.4009011669955 -34.6022110151333)))";;"2164";3_4_5;COMUNA 3;"4";"5";"683";"327";"356";"91,85%";"407";"407";"100,00%";"0";"0,00%";"288";"44";"15.28";"244";"84,72%";"15.28";15.280
"MULTIPOLYGON (((-58.3997176290632 -34.602222100548,-58.3995943869783 -34.6022225298481,-58.3984971496513 -34.6022035060436,-58.3984860844933 -34.6023050533506,-58.3983702482257 -34.6033046074467,-58.399438018873 -34.6033391106633,-58.3995509520951 -34.6033449440284,-58.3997095476885 -34.6023218888767,-58.3997176290632 -34.602222100548)))";;"2165";3_4_6;COMUNA 3;"4";"6";"655";"303";"352";"86,08%";"424";"424";"100,00%";"0";"0,00%";"308";"13";"4.22";"295";"95,78%";"4.22";4.220
"MULTIPOLYGON (((-58.3995509520951 -34.6033449440284,-58.399438018873 -34.6033391106633,-58.3983702482257 -34.6033046074467,-58.3982388890308 -34.6044385947157,-58.3982188490233 -34.6045803499895,-58.3994796223417 -34.6046353779863,-58.3995509520951 -34.6033449440284)))";;"2166";3_4_7;COMUNA 3;"4";"7";"674";"315";"359";"87,74%";"422";"422";"100,00%";"0";"0,00%";"270";"1";"0.37";"269";"99,63%";"0.37";0.370
"MULTIPOLYGON (((-58.4008971862779 -34.603445566671,-58.3997097910983 -34.6033531250272,-58.3995509520951 -34.6033449440284,-58.3994796223417 -34.6046353779863,-58.3996240710003 -34.6046416501598,-58.4006307940768 -34.6046709703296,-58.400835887216 -34.6046757225498,-58.401198633027 -34.6046840752503,-58.40213704815 -34.6047137006687,-58.40214620624 -34.6045349661369,-58.402217790776 -34.6034234810926,-58.4008971862779 -34.603445566671)))";;"2167";3_4_8;COMUNA 3;"4";"8";"724";"353";"371";"95,15%";"371";"371";"100,00%";"0";"0,00%";"271";"10";"3.69";"261";"96,31%";"3.69";3.690
"MULTIPOLYGON (((-58.3987230216627 -34.5997602924901,-58.3971856773585 -34.5997302503009,-58.3970995018389 -34.6010116612146,-58.3984907835183 -34.6010687414289,-58.3986204928763 -34.6010733872538,-58.3998073808007 -34.6011161894804,-58.3998152037242 -34.6010199926778,-58.3999209290805 -34.5996215431604,-58.3987230216627 -34.5997602924901)))";;"2168";3_5_1;COMUNA 3;"5";"1";"802";"380";"422";"90,05%";"583";"583";"100,00%";"0";"0,00%";"373";"40";"10.72";"333";"89,28%";"10.72";10.720
"MULTIPOLYGON (((-58.3998073808007 -34.6011161894804,-58.3986204928763 -34.6010733872538,-58.3984971496513 -34.6022035060436,-58.3995943869783 -34.6022225298481,-58.3997176290632 -34.602222100548,-58.3998073808007 -34.6011161894804)))";;"2169";3_5_2;COMUNA 3;"5";"2";"648";"281";"367";"76,57%";"418";"418";"100,00%";"0";"0,00%";"291";"1";"0.34";"290";"99,66%";"0.34";0.340
"MULTIPOLYGON (((-58.3986204928763 -34.6010733872538,-58.3984907835183 -34.6010687414289,-58.3970995018389 -34.6010116612146,-58.3970281471619 -34.6020718038145,-58.3970186886584 -34.6021858171136,-58.398354746459 -34.6022010365752,-58.3984971496513 -34.6022035060436,-58.3986204928763 -34.6010733872538)))";;"2170";3_5_3;COMUNA 3;"5";"3";"970";"432";"538";"80,30%";"672";"672";"100,00%";"0";"0,00%";"469";"7";"1.49";"462";"98,51%";"1.49";1.490
"MULTIPOLYGON (((-58.3970995018389 -34.6010116612146,-58.3969618727005 -34.6010060235536,-58.3957813091808 -34.6009397455242,-58.3956640352333 -34.6009346809625,-58.3956525123706 -34.6010717925094,-58.395544055925 -34.6020686015777,-58.3955345272329 -34.602161487164,-58.3956710483032 -34.6021704358104,-58.3970186886584 -34.6021858171136,-58.3970281471619 -34.6020718038145,-58.3970995018389 -34.6010116612146)))";;"2171";3_5_4;COMUNA 3;"5";"4";"542";"232";"310";"74,84%";"374";"374";"100,00%";"0";"0,00%";"262";"23";"8.78";"239";"91,22%";"8.78";8.780
"MULTIPOLYGON (((-58.3971856773585 -34.5997302503009,-58.3958163680119 -34.5997033796732,-58.3956721181407 -34.6008388366943,-58.3956640352333 -34.6009346809625,-58.3957813091808 -34.6009397455242,-58.3969618727005 -34.6010060235536,-58.3970995018389 -34.6010116612146,-58.3971856773585 -34.5997302503009)))";;"2172";3_5_5;COMUNA 3;"5";"5";"610";"256";"354";"72,32%";"524";"524";"100,00%";"0";"0,00%";"330";"3";"0.91";"327";"99,09%";"0.91";0.910
"MULTIPOLYGON (((-58.3942108443973 -34.600871970194,-58.3940575453859 -34.6008653345079,-58.3927655783273 -34.6008070634803,-58.3927474149045 -34.6009353677959,-58.3925922899731 -34.6019867270033,-58.3928066533949 -34.6019988926888,-58.3939629630812 -34.6020565235355,-58.3941018682877 -34.6020658274065,-58.3954026051109 -34.6021528930273,-58.3955345272329 -34.602161487164,-58.395544055925 -34.6020686015777,-58.3956525123706 -34.6010717925094,-58.3956640352333 -34.6009346809625,-58.3956721181407 -34.6008388366943,-58.3958163680119 -34.5997033796732,-58.3947117571341 -34.5996818529173,-58.3943961311923 -34.5996740003001,-58.3943720840706 -34.5998143443022,-58.3942219315017 -34.6007497886799,-58.3942108443973 -34.600871970194)))";;"2173";3_5_6;COMUNA 3;"5";"6";"441";"198";"243";"81,48%";"377";"377";"100,00%";"0";"0,00%";"215";"0";"0";"215";"100,00%";"0";0.000
"MULTIPOLYGON (((-58.3943961311923 -34.5996740003001,-58.3929308478483 -34.5996371135758,-58.3927655783273 -34.6008070634803,-58.3940575453859 -34.6008653345079,-58.3942108443973 -34.600871970194,-58.3942219315017 -34.6007497886799,-58.3943720840706 -34.5998143443022,-58.3943961311923 -34.5996740003001)))";;"2174";3_5_7;COMUNA 3;"5";"7";"768";"332";"436";"76,15%";"608";"608";"100,00%";"0";"0,00%";"368";"4";"1.09";"364";"98,91%";"1.09";1.090
"MULTIPOLYGON (((-58.3984971496513 -34.6022035060436,-58.398354746459 -34.6022010365752,-58.3970186886584 -34.6021858171136,-58.3969356205575 -34.6031922891595,-58.3969251580071 -34.6032831320044,-58.3971337425923 -34.6032840189436,-58.3982297185659 -34.603300026064,-58.3983702482257 -34.6033046074467,-58.3984860844933 -34.6023050533506,-58.3984971496513 -34.6022035060436)))";;"2175";3_6_1;COMUNA 3;"6";"1";"716";"310";"406";"76,35%";"624";"624";"100,00%";"0";"0,00%";"354";"3";"0.85";"351";"99,15%";"0.85";0.850
"MULTIPOLYGON (((-58.3970186886584 -34.6021858171136,-58.3956710483032 -34.6021704358104,-58.3955345272329 -34.602161487164,-58.3954358029231 -34.6031267508313,-58.3954213858155 -34.6032610437039,-58.3955951314209 -34.6032665621204,-58.3967973158031 -34.6032826404712,-58.3969251580071 -34.6032831320044,-58.3969356205575 -34.6031922891595,-58.3970186886584 -34.6021858171136)))";;"2176";3_6_2;COMUNA 3;"6";"2";"351";"169";"182";"92,86%";"224";"224";"100,00%";"0";"0,00%";"175";"16";"9.14";"159";"90,86%";"9.14";9.140
"MULTIPOLYGON (((-58.3955345272329 -34.602161487164,-58.3954026051109 -34.6021528930273,-58.3941018682877 -34.6020658274065,-58.3939629630812 -34.6020565235355,-58.3928066533949 -34.6019988926888,-58.3925922899731 -34.6019867270033,-58.3925729312706 -34.6021178475887,-58.392387066655 -34.6031553853221,-58.3924701094011 -34.6031547288958,-58.3927476850694 -34.6031525643147,-58.3939839045267 -34.603206649064,-58.394116000825 -34.6032124278247,-58.3952829004001 -34.6032566009049,-58.3954213858155 -34.6032610437039,-58.3954358029231 -34.6031267508313,-58.3955345272329 -34.602161487164)))";;"2177";3_6_3;COMUNA 3;"6";"3";"617";"288";"329";"87,54%";"503";"503";"100,00%";"0";"0,00%";"312";"7";"2.24";"305";"97,76%";"2.24";2.240
"MULTIPOLYGON (((-58.3924701094011 -34.6031547288958,-58.392387066655 -34.6031553853221,-58.3922863350328 -34.604436079428,-58.3935762597294 -34.6044568177603,-58.3936872384506 -34.6044585707854,-58.3938575806823 -34.6044626812481,-58.3939839045267 -34.603206649064,-58.3927476850694 -34.6031525643147,-58.3924701094011 -34.6031547288958)))";;"2178";3_6_4;COMUNA 3;"6";"4";"610";"274";"336";"81,55%";"445";"445";"100,00%";"0";"0,00%";"320";"4";"1.25";"316";"98,75%";"1.25";1.250
"MULTIPOLYGON (((-58.3954213858155 -34.6032610437039,-58.3952829004001 -34.6032566009049,-58.394116000825 -34.6032124278247,-58.3939839045267 -34.603206649064,-58.3938575806823 -34.6044626812481,-58.3952884563807 -34.6044968617064,-58.3954213858155 -34.6032610437039)))";;"2179";3_6_5;COMUNA 3;"6";"5";"866";"376";"490";"76,73%";"476";"474";"99,58%";"2";"0,42%";"329";"59";"17.93";"270";"82,07%";"17.93";17.930
"MULTIPOLYGON (((-58.3969251580071 -34.6032831320044,-58.3967973158031 -34.6032826404712,-58.3955951314209 -34.6032665621204,-58.3954213858155 -34.6032610437039,-58.3952884563807 -34.6044968617064,-58.3966123581874 -34.6045284321851,-58.3967795484825 -34.6045335932389,-58.3968015792151 -34.6043547252132,-58.3969251580071 -34.6032831320044)))";;"2180";3_6_6;COMUNA 3;"6";"6";"522";"226";"296";"76,35%";"414";"413";"99,76%";"1";"0,24%";"255";"2";"0.78";"253";"99,22%";"0.78";0.780
"MULTIPOLYGON (((-58.3983702482257 -34.6033046074467,-58.3982297185659 -34.603300026064,-58.3971337425923 -34.6032840189436,-58.3969251580071 -34.6032831320044,-58.3968015792151 -34.6043547252132,-58.3967795484825 -34.6045335932389,-58.3980450169121 -34.6045727929329,-58.3982188490233 -34.6045803499895,-58.3982388890308 -34.6044385947157,-58.3983702482257 -34.6033046074467)))";;"2181";3_6_7;COMUNA 3;"6";"7";"683";"300";"383";"78,33%";"435";"435";"100,00%";"0";"0,00%";"312";"2";"0.64";"310";"99,36%";"0.64";0.640
"MULTIPOLYGON (((-58.3994796223417 -34.6046353779863,-58.3982188490233 -34.6045803499895,-58.3981970101301 -34.6047352738116,-58.397991002812 -34.6059090112694,-58.3979774617285 -34.6060166841428,-58.3992104965887 -34.6060626857836,-58.3993339940938 -34.6060698629236,-58.3994713320912 -34.604785308869,-58.3994796223417 -34.6046353779863)))";;"2182";3_7_1;COMUNA 3;"7";"1";"310";"138";"172";"80,23%";"177";"177";"100,00%";"0";"0,00%";"136";"0";"0";"136";"100,00%";"0";0.000
"MULTIPOLYGON (((-58.3982188490233 -34.6045803499895,-58.3980450169121 -34.6045727929329,-58.3967795484825 -34.6045335932389,-58.3966365615685 -34.6056934182889,-58.3965912973775 -34.6059547415105,-58.3979774617285 -34.6060166841428,-58.397991002812 -34.6059090112694,-58.3981970101301 -34.6047352738116,-58.3982188490233 -34.6045803499895)))";;"2183";3_7_2;COMUNA 3;"7";"2";"864";"388";"476";"81,51%";"616";"616";"100,00%";"0";"0,00%";"415";"17";"4.1";"398";"95,90%";"4.1";4.100
"MULTIPOLYGON (((-58.3967795484825 -34.6045335932389,-58.3966123581874 -34.6045284321851,-58.3952884563807 -34.6044968617064,-58.3951421347506 -34.6058574652647,-58.3964318588002 -34.6059449363487,-58.3965912973775 -34.6059547415105,-58.3966365615685 -34.6056934182889,-58.3967795484825 -34.6045335932389)))";;"2184";3_7_3;COMUNA 3;"7";"3";"967";"450";"517";"87,04%";"624";"622";"99,68%";"2";"0,32%";"453";"37";"8.17";"416";"91,83%";"8.17";8.170
"MULTIPOLYGON (((-58.3935762597294 -34.6044568177603,-58.3922863350328 -34.604436079428,-58.3922056406931 -34.6054862128105,-58.3921939210968 -34.605647057087,-58.3923891291216 -34.6056599166856,-58.3935345605231 -34.6057494479138,-58.3936942531447 -34.6057601725321,-58.3949845711082 -34.6058467437229,-58.3951421347506 -34.6058574652647,-58.3952884563807 -34.6044968617064,-58.3938575806823 -34.6044626812481,-58.3936872384506 -34.6044585707854,-58.3935762597294 -34.6044568177603)))";;"2185";3_7_4;COMUNA 3;"7";"4";"914";"412";"502";"82,07%";"664";"658";"99,10%";"6";"0,91%";"369";"18";"4.88";"351";"95,12%";"4.88";4.880
"MULTIPOLYGON (((-58.3936942531447 -34.6057601725321,-58.3935345605231 -34.6057494479138,-58.3923891291216 -34.6056599166856,-58.3921939210968 -34.605647057087,-58.3921219608754 -34.6066397283369,-58.3921121248773 -34.606788671816,-58.3923150804389 -34.6068087193785,-58.39356450534 -34.6069238745904,-58.3935731874196 -34.6068281013219,-58.3936942531447 -34.6057601725321)))";;"2186";3_7_5;COMUNA 3;"7";"5";"579";"271";"308";"87,99%";"500";"495";"99,00%";"5";"1,01%";"268";"14";"5.22";"254";"94,78%";"5.22";5.220
"MULTIPOLYGON (((-58.3951421347506 -34.6058574652647,-58.3949845711082 -34.6058467437229,-58.3936942531447 -34.6057601725321,-58.3935731874196 -34.6068281013219,-58.39356450534 -34.6069238745904,-58.3948905007375 -34.6070460316757,-58.3950317990403 -34.6070556175162,-58.3950358096599 -34.6069415310179,-58.3951298620228 -34.6059720401877,-58.3951421347506 -34.6058574652647)))";;"2187";3_7_6;COMUNA 3;"7";"6";"584";"263";"321";"81,93%";"469";"466";"99,36%";"3";"0,64%";"283";"12";"4.24";"271";"95,76%";"4.24";4.240
"MULTIPOLYGON (((-58.3965912973775 -34.6059547415105,-58.3964318588002 -34.6059449363487,-58.3951421347506 -34.6058574652647,-58.3951298620228 -34.6059720401877,-58.3950358096599 -34.6069415310179,-58.3950317990403 -34.6070556175162,-58.3964699945392 -34.6071531003886,-58.3965705045492 -34.6060751572484,-58.3965912973775 -34.6059547415105)))";;"2188";3_7_7;COMUNA 3;"7";"7";"922";"416";"506";"82,21%";"668";"668";"100,00%";"0";"0,00%";"504";"29";"5.75";"475";"94,25%";"5.75";5.750
"MULTIPOLYGON (((-58.3979774617285 -34.6060166841428,-58.3965912973775 -34.6059547415105,-58.3965705045492 -34.6060751572484,-58.3964699945392 -34.6071531003886,-58.3977217537938 -34.6072378610628,-58.3978498570459 -34.6072390560208,-58.3979615211308 -34.6061431592544,-58.3979774617285 -34.6060166841428)))";;"2189";3_7_8;COMUNA 3;"7";"8";"395";"162";"233";"69,53%";"204";"202";"99,02%";"2";"0,99%";"159";"13";"8.18";"146";"91,82%";"8.18";8.180
"MULTIPOLYGON (((-58.3993339940938 -34.6060698629236,-58.3992104965887 -34.6060626857836,-58.3979774617285 -34.6060166841428,-58.3979615211308 -34.6061431592544,-58.3978498570459 -34.6072390560208,-58.3980076863747 -34.6072405483098,-58.3991171277048 -34.6073150074812,-58.3992563842933 -34.6073225450365,-58.3992605621777 -34.607204937231,-58.3993248151521 -34.606155776839,-58.3993339940938 -34.6060698629236)))";;"2190";3_7_9;COMUNA 3;"7";"9";"931";"397";"534";"74,34%";"665";"664";"99,85%";"1";"0,15%";"404";"16";"3.96";"388";"96,04%";"3.96";3.960
"MULTIPOLYGON (((-58.4054694625903 -34.6045636838448,-58.404480023678 -34.6046642758587,-58.4045733988064 -34.6056055526878,-58.4055351893644 -34.6055969926705,-58.4057132200563 -34.605572004594,-58.4055173737196 -34.6047480794016,-58.4054694625903 -34.6045636838448)))";;"2191";3_8_1;COMUNA 3;"8";"1";"647";"294";"353";"83,29%";"482";"482";"100,00%";"0";"0,00%";"321";"3";"0.93";"318";"99,07%";"0.93";0.930
"MULTIPOLYGON (((-58.4059448263322 -34.606546585395,-58.4046581495382 -34.6064586529138,-58.4046721055472 -34.6065992985715,-58.4047531237028 -34.6075560626188,-58.4047484767391 -34.6076243727928,-58.40487078277 -34.6076341494924,-58.4061198153138 -34.6077438236391,-58.4061302056917 -34.6076198802199,-58.4059843195677 -34.6067129479563,-58.4059448263322 -34.606546585395)))";;"2192";3_8_10;COMUNA 3;"8";"10";"547";"252";"295";"85,42%";"272";"272";"100,00%";"0";"0,00%";"256";"34";"13.28";"222";"86,72%";"13.28";13.280
"MULTIPOLYGON (((-58.4057132200563 -34.605572004594,-58.4055351893644 -34.6055969926705,-58.4045733988064 -34.6056055526878,-58.4046581495382 -34.6064586529138,-58.4059448263322 -34.606546585395,-58.4057132200563 -34.605572004594)))";;"2193";3_8_2;COMUNA 3;"8";"2";"552";"245";"307";"79,80%";"290";"290";"100,00%";"0";"0,00%";"212";"7";"3.3";"205";"96,70%";"3.3";3.300
"MULTIPOLYGON (((-58.404480023678 -34.6046642758587,-58.4036307874391 -34.6047506314921,-58.40213704815 -34.6047137006687,-58.4021257315912 -34.6049325060418,-58.4020427449266 -34.6062592747731,-58.4021718621969 -34.6062696209662,-58.4033740390339 -34.6063590175373,-58.4035341556353 -34.6063758564713,-58.4036973383939 -34.6063929783786,-58.4046581495382 -34.6064586529138,-58.4045733988064 -34.6056055526878,-58.404480023678 -34.6046642758587)))";;"2194";3_8_3;COMUNA 3;"8";"3";"839";"384";"455";"84,40%";"445";"445";"100,00%";"0";"0,00%";"341";"4";"1.17";"337";"98,83%";"1.17";1.170
"MULTIPOLYGON (((-58.40213704815 -34.6047137006687,-58.401198633027 -34.6046840752503,-58.400835887216 -34.6046757225498,-58.4008248377616 -34.6048743159149,-58.4007220201139 -34.6061535367147,-58.4020427449266 -34.6062592747731,-58.4021257315912 -34.6049325060418,-58.40213704815 -34.6047137006687)))";;"2195";3_8_4;COMUNA 3;"8";"4";"538";"242";"296";"81,76%";"369";"369";"100,00%";"0";"0,00%";"217";"3";"1.38";"214";"98,62%";"1.38";1.380
"MULTIPOLYGON (((-58.400835887216 -34.6046757225498,-58.4006307940768 -34.6046709703296,-58.3996240710003 -34.6046416501598,-58.3994796223417 -34.6046353779863,-58.3994713320912 -34.604785308869,-58.3993339940938 -34.6060698629236,-58.400584471454 -34.6061424804438,-58.4007220201139 -34.6061535367147,-58.4008248377616 -34.6048743159149,-58.400835887216 -34.6046757225498)))";;"2196";3_8_5;COMUNA 3;"8";"5";"496";"237";"259";"91,51%";"349";"349";"100,00%";"0";"0,00%";"216";"8";"3.7";"208";"96,30%";"3.7";3.700
"MULTIPOLYGON (((-58.4007220201139 -34.6061535367147,-58.400584471454 -34.6061424804438,-58.3993339940938 -34.6060698629236,-58.3993248151521 -34.606155776839,-58.3992605621777 -34.607204937231,-58.3992563842933 -34.6073225450365,-58.4004958971511 -34.6073891716218,-58.4006337910732 -34.6073968477606,-58.4007145412173 -34.6062460011367,-58.4007220201139 -34.6061535367147)))";;"2197";3_8_6;COMUNA 3;"8";"6";"478";"215";"263";"81,75%";"264";"264";"100,00%";"0";"0,00%";"203";"19";"9.36";"184";"90,64%";"9.36";9.360
"MULTIPOLYGON (((-58.4020427449266 -34.6062592747731,-58.4007220201139 -34.6061535367147,-58.4007145412173 -34.6062460011367,-58.4006337910732 -34.6073968477606,-58.4019681014475 -34.6074709726409,-58.4019735439233 -34.6073660418973,-58.4020427449266 -34.6062592747731)))";;"2198";3_8_7;COMUNA 3;"8";"7";"427";"194";"233";"83,26%";"226";"226";"100,00%";"0";"0,00%";"166";"42";"25.3";"124";"74,70%";"25.3";25.300
"MULTIPOLYGON (((-58.4035341556353 -34.6063758564713,-58.4033740390339 -34.6063590175373,-58.4021718621969 -34.6062696209662,-58.4020427449266 -34.6062592747731,-58.4019735439233 -34.6073660418973,-58.4019681014475 -34.6074709726409,-58.402106421471 -34.6074787177526,-58.4033166563465 -34.6075201593654,-58.4034663906529 -34.6075272042389,-58.4035341556353 -34.6063758564713)))";;"2199";3_8_8;COMUNA 3;"8";"8";"524";"246";"278";"88,49%";"280";"280";"100,00%";"0";"0,00%";"207";"26";"12.56";"181";"87,44%";"12.56";12.560
"MULTIPOLYGON (((-58.4046581495382 -34.6064586529138,-58.4036973383939 -34.6063929783786,-58.4035341556353 -34.6063758564713,-58.4034663906529 -34.6075272042389,-58.4036332448479 -34.6075349614693,-58.4047484767391 -34.6076243727928,-58.4047531237028 -34.6075560626188,-58.4046721055472 -34.6065992985715,-58.4046581495382 -34.6064586529138)))";;"2200";3_8_9;COMUNA 3;"8";"9";"718";"333";"385";"86,49%";"377";"377";"100,00%";"0";"0,00%";"304";"8";"2.63";"296";"97,37%";"2.63";2.630
"MULTIPOLYGON (((-58.4120364759797 -34.6051076639359,-58.41088365881 -34.6050980949618,-58.4107707970593 -34.6051091741562,-58.4108212255596 -34.6052368060085,-58.4113462895292 -34.6065329214565,-58.4122709467638 -34.606395203412,-58.4123989801268 -34.6063692693814,-58.4136448948344 -34.6061168095105,-58.413412361718 -34.6051190729599,-58.4120364759797 -34.6051076639359)))";;"2201";3_9_1;COMUNA 3;"9";"1";"860";"375";"485";"77,32%";"486";"486";"100,00%";"0";"0,00%";"388";"20";"5.15";"368";"94,85%";"5.15";5.150
"MULTIPOLYGON (((-58.4059854242534 -34.6097231297379,-58.4059659035084 -34.6101207408265,-58.406416988423 -34.6101517959489,-58.407665054284 -34.6102376501199,-58.4085818702511 -34.6103113023475,-58.4088822802862 -34.6103354501919,-58.4091641208348 -34.6103606455262,-58.4099942389885 -34.6104158681143,-58.4103464388983 -34.6104395417397,-58.4117332610533 -34.6105396396284,-58.4117791243822 -34.6092234134414,-58.4116315153684 -34.6092170134853,-58.4105348020228 -34.6091618996132,-58.4103842958077 -34.6091576800882,-58.4088348582774 -34.6091134831406,-58.4086663876696 -34.6090970700183,-58.4060294648944 -34.6088404417952,-58.4060062401884 -34.609299461929,-58.4059854242534 -34.6097231297379)))";;"2202";3_9_10;COMUNA 3;"9";"10";"787";"360";"427";"84,31%";"378";"376";"99,47%";"2";"0,53%";"326";"68";"20.86";"258";"79,14%";"20.86";20.860
"MULTIPOLYGON (((-58.4107707970593 -34.6051091741562,-58.4093775268675 -34.6052460431466,-58.4099752821275 -34.6067176252734,-58.4100844746126 -34.6067208415415,-58.4113462895292 -34.6065329214565,-58.4108212255596 -34.6052368060085,-58.4107707970593 -34.6051091741562)))";;"2203";3_9_2;COMUNA 3;"9";"2";"486";"221";"265";"83,40%";"273";"272";"99,63%";"1";"0,37%";"206";"3";"1.46";"203";"98,54%";"1.46";1.460
"MULTIPOLYGON (((-58.4093775268675 -34.6052460431466,-58.4083443046493 -34.6053475628688,-58.4082263356672 -34.6053527217199,-58.408522584221 -34.6061175299909,-58.4087383921473 -34.6066817310828,-58.4099752821275 -34.6067176252734,-58.4093775268675 -34.6052460431466)))";;"2204";3_9_3;COMUNA 3;"9";"3";"762";"341";"421";"81,00%";"435";"435";"100,00%";"0";"0,00%";"342";"3";"0.88";"339";"99,12%";"0.88";0.880
"MULTIPOLYGON (((-58.4082263356672 -34.6053527217199,-58.407100476511 -34.6054018636178,-58.4069488589398 -34.6054141892623,-58.4073228127737 -34.6066356021616,-58.407462749404 -34.606644609588,-58.4087383921473 -34.6066817310828,-58.408522584221 -34.6061175299909,-58.4082263356672 -34.6053527217199)))";;"2205";3_9_4;COMUNA 3;"9";"4";"1026";"482";"544";"88,60%";"468";"468";"100,00%";"0";"0,00%";"414";"45";"10.87";"369";"89,13%";"10.87";10.870
"MULTIPOLYGON (((-58.4069488589398 -34.6054141892623,-58.4068354864274 -34.605423433528,-58.4057132200563 -34.605572004594,-58.4059448263322 -34.606546585395,-58.4073228127737 -34.6066356021616,-58.4069488589398 -34.6054141892623)))";;"2206";3_9_5;COMUNA 3;"9";"5";"594";"284";"310";"91,61%";"270";"270";"100,00%";"0";"0,00%";"222";"23";"10.36";"199";"89,64%";"10.36";10.360
"MULTIPOLYGON (((-58.4104701532927 -34.6079359817769,-58.4102017607993 -34.6079387540185,-58.4092721661344 -34.6079070817314,-58.4091139980101 -34.6079003219795,-58.4091264680377 -34.6075817241433,-58.4088044616431 -34.6068543723193,-58.4087383921473 -34.6066817310828,-58.407462749404 -34.606644609588,-58.4073228127737 -34.6066356021616,-58.4059448263322 -34.606546585395,-58.4059843195677 -34.6067129479563,-58.4061302056917 -34.6076198802199,-58.4061198153138 -34.6077438236391,-58.406036862241 -34.6087343145721,-58.4060294648944 -34.6088404417952,-58.4086663876696 -34.6090970700183,-58.4088348582774 -34.6091134831406,-58.4103842958077 -34.6091576800882,-58.4105348020228 -34.6091618996132,-58.4116315153684 -34.6092170134853,-58.4117791243822 -34.6092234134414,-58.4117829382372 -34.6091152420489,-58.4118018625306 -34.6088117176679,-58.4118295610244 -34.6083667128445,-58.4118602699244 -34.607873256744,-58.4106359075677 -34.6079342919922,-58.4104701532927 -34.6079359817769)))";;"2207";3_9_6;COMUNA 3;"9";"6";"497";"238";"259";"91,89%";"267";"266";"99,63%";"1";"0,38%";"196";"7";"3.57";"189";"96,43%";"3.57";3.570
"MULTIPOLYGON (((-58.4099752821275 -34.6067176252734,-58.4087383921473 -34.6066817310828,-58.4088044616431 -34.6068543723193,-58.4091264680377 -34.6075817241433,-58.4091139980101 -34.6079003219795,-58.4092721661344 -34.6079070817314,-58.4102017607993 -34.6079387540185,-58.4104701532927 -34.6079359817769,-58.4106359075677 -34.6079342919922,-58.4118602699244 -34.607873256744,-58.4118641405434 -34.607811425088,-58.4113462895292 -34.6065329214565,-58.4100844746126 -34.6067208415415,-58.4099752821275 -34.6067176252734)))";;"2208";3_9_7;COMUNA 3;"9";"7";"776";"393";"383";"102,61%";"270";"268";"99,26%";"2";"0,75%";"292";"83";"28.42";"209";"71,58%";"28.42";28.420
"MULTIPOLYGON (((-58.4136448948344 -34.6061168095105,-58.4123989801268 -34.6063692693814,-58.4122709467638 -34.606395203412,-58.4113462895292 -34.6065329214565,-58.4118641405434 -34.607811425088,-58.4118602699244 -34.607873256744,-58.4118295610244 -34.6083667128445,-58.4118018625306 -34.6088117176679,-58.4117829382372 -34.6091152420489,-58.4117791243822 -34.6092234134414,-58.4119025435603 -34.6092288171982,-58.4131598964152 -34.6092965902045,-58.4131004963242 -34.6106380940144,-58.4144670534897 -34.6107363919603,-58.4145830004472 -34.6093763880048,-58.4146166101315 -34.6088470860407,-58.4146524549141 -34.6082814455338,-58.4146600031146 -34.608190036685,-58.4140989392073 -34.6079069871436,-58.413937006205 -34.6073460567284,-58.4139082751344 -34.6072463232406,-58.4136448948344 -34.6061168095105)))";;"2209";3_9_8;COMUNA 3;"9";"8";"740";"365";"375";"97,33%";"300";"299";"99,67%";"1";"0,33%";"312";"80";"25.64";"232";"74,36%";"25.64";25.640
"MULTIPOLYGON (((-58.4131598964152 -34.6092965902045,-58.4119025435603 -34.6092288171982,-58.4117791243822 -34.6092234134414,-58.4117332610533 -34.6105396396284,-58.4131004963242 -34.6106380940144,-58.4131598964152 -34.6092965902045)))";;"2210";3_9_9;COMUNA 3;"9";"9";"803";"368";"435";"84,60%";"460";"459";"99,78%";"1";"0,22%";"371";"10";"2.7";"361";"97,30%";"2.7";2.700
"MULTIPOLYGON (((-58.4326181468579 -34.6452159851866,-58.4321075608723 -34.6451636734593,-58.4310960348465 -34.6459183683566,-58.4297974997793 -34.6468465041043,-58.4299716240717 -34.6469928934651,-58.4301727535125 -34.6471625299268,-58.4304043813627 -34.647357879143,-58.4304875257286 -34.6474279736948,-58.4308287086816 -34.6477157481686,-58.4319648957725 -34.6468238999045,-58.4320702675062 -34.6469343523311,-58.4323056299374 -34.6471811089041,-58.432624304201 -34.6475152121968,-58.432967003288 -34.6478744621097,-58.4337651087253 -34.6472506209784,-58.434502426826 -34.64667528313,-58.4346055484089 -34.6465736225524,-58.4348172215991 -34.6463460108993,-58.4349231139056 -34.646236845097,-58.4335364478593 -34.645617910783,-58.4334815780674 -34.6455933898513,-58.4326181468579 -34.6452159851866)))";;"2211";4_1_1;COMUNA 4;"1";"1";"770";"360";"410";"87,80%";"231";"231";"100,00%";"0";"0,00%";"247";"14";"5.67";"233";"94,33%";"5.67";5.670
"MULTIPOLYGON (((-58.4222423031918 -34.6523209458625,-58.4214172318989 -34.6529163207681,-58.4205773146349 -34.6535223190169,-58.4197066932011 -34.6541504843431,-58.4189912258464 -34.6546661605942,-58.4182765765519 -34.6552292990718,-58.4180787509028 -34.655423880402,-58.4188406978358 -34.6556789530077,-58.4191133706443 -34.6557702506201,-58.4197113717879 -34.6559830747336,-58.4203723333681 -34.6562439473434,-58.4214643759461 -34.6566696859901,-58.4219057565958 -34.6563337683817,-58.42070265343 -34.6550909998224,-58.4215840198309 -34.6544538871823,-58.4224077416062 -34.6538585108577,-58.4232352027037 -34.6532603835564,-58.4222423031918 -34.6523209458625)))";;"2212";4_1_10;COMUNA 4;"1";"10";"491";"243";"248";"97,98%";"201";"201";"100,00%";"0";"0,00%";"157";"31";"19.75";"126";"80,25%";"19.75";19.750
"MULTIPOLYGON (((-58.4224077416062 -34.6538585108577,-58.4215840198309 -34.6544538871823,-58.42070265343 -34.6550909998224,-58.4219057565958 -34.6563337683817,-58.4214643759461 -34.6566696859901,-58.4214957331541 -34.656681880042,-58.4220017013441 -34.656896844922,-58.4230523412465 -34.6573211469892,-58.4232184961144 -34.6574002876926,-58.4234673778559 -34.6571790236109,-58.4228274904777 -34.6568338060678,-58.4235453352506 -34.6563262070784,-58.4242560952938 -34.6558235313048,-58.4243766445543 -34.6557352568227,-58.4245218318609 -34.6556290316671,-58.4252049592282 -34.6551442294925,-58.4246239818917 -34.6545872021743,-58.4245027636543 -34.6544659635251,-58.4243850383583 -34.6543481766562,-58.4232352027037 -34.6532603835564,-58.4224077416062 -34.6538585108577)))";;"2213";4_1_11;COMUNA 4;"1";"11";"593";"275";"318";"86,48%";"206";"206";"100,00%";"0";"0,00%";"200";"4";"2";"196";"98,00%";"2";2.000
"MULTIPOLYGON (((-58.4252049592282 -34.6551442294925,-58.4245218318609 -34.6556290316671,-58.4243766445543 -34.6557352568227,-58.4242560952938 -34.6558235313048,-58.4235453352506 -34.6563262070784,-58.4228274904777 -34.6568338060678,-58.4234673778559 -34.6571790236109,-58.4232184961144 -34.6574002876926,-58.4233642866324 -34.6574697030105,-58.4235062430038 -34.6575373563069,-58.4243460569879 -34.6579372827627,-58.4244805160615 -34.658002467702,-58.425224547752 -34.6583922168824,-58.4253825207974 -34.658480577726,-58.425452361072 -34.658394540275,-58.4257041199165 -34.658213062417,-58.4253340493766 -34.6580487899219,-58.4249673897412 -34.6576957091034,-58.4258009173195 -34.657107496516,-58.4259669052644 -34.6569904305728,-58.4266349455146 -34.6565168838823,-58.4273340096313 -34.6560212996001,-58.4274657227156 -34.6559276730349,-58.4273588082588 -34.6558252447465,-58.4267507218668 -34.6552413879876,-58.4274841304267 -34.6547210233994,-58.4275966603974 -34.6546403492566,-58.4269890062545 -34.6540584655881,-58.4268792837126 -34.6539530077683,-58.4260358184307 -34.6545541831837,-58.4259173196978 -34.6546386570146,-58.4252049592282 -34.6551442294925)))";;"2214";4_1_12;COMUNA 4;"1";"12";"529";"251";"278";"90,29%";"214";"214";"100,00%";"0";"0,00%";"183";"4";"2.19";"179";"97,81%";"2.19";2.190
"MULTIPOLYGON (((-58.4267799957424 -34.6586916402794,-58.4268783299996 -34.6585775162524,-58.4271373204325 -34.6583889868542,-58.4272805478013 -34.6582846593517,-58.4278288962134 -34.657895932991,-58.4279694784684 -34.6577948434436,-58.4286654792917 -34.6572941801911,-58.4287947208606 -34.6572016783132,-58.4280701562294 -34.6565071588042,-58.4274657227156 -34.6559276730349,-58.4273340096313 -34.6560212996001,-58.4266349455146 -34.6565168838823,-58.4259669052644 -34.6569904305728,-58.4258009173195 -34.657107496516,-58.4249673897412 -34.6576957091034,-58.4253340493766 -34.6580487899219,-58.4257041199165 -34.658213062417,-58.425452361072 -34.658394540275,-58.4253825207974 -34.658480577726,-58.4263622338297 -34.6590285653796,-58.426440334231 -34.6590722959665,-58.4267813889436 -34.6586922556612,-58.4267799957424 -34.6586916402794)))";;"2215";4_1_13;COMUNA 4;"1";"13";"405";"190";"215";"88,37%";"168";"168";"100,00%";"0";"0,00%";"136";"11";"8.09";"125";"91,91%";"8.09";8.090
"MULTIPOLYGON (((-58.4168005427892 -34.6591424568347,-58.4168064245902 -34.6592952098832,-58.4168223746542 -34.6594276140241,-58.4169089636458 -34.6594343369057,-58.4170066320763 -34.6594416976992,-58.4171101893492 -34.6594344123121,-58.4171871297423 -34.6594735971013,-58.4172477974876 -34.6595017191239,-58.4173483544936 -34.6595261938837,-58.417463821338 -34.6595604631042,-58.4175732449465 -34.6595800816744,-58.417626519809 -34.6595678475107,-58.4176857434832 -34.6595874474118,-58.4177331097524 -34.6596266209336,-58.4178277915115 -34.6596413041198,-58.4178987598286 -34.6596926697059,-58.4180245497046 -34.6597086318074,-58.4181280823352 -34.6597478257422,-58.4182020483371 -34.6597722900736,-58.4182968155744 -34.6597869729265,-58.41832935364 -34.6598236759557,-58.4183470709273 -34.6598432604232,-58.4183914702525 -34.6598530655767,-58.4184240317959 -34.6598457532536,-58.4186015323325 -34.6599069460789,-58.4187140236631 -34.6599289591682,-58.418817562053 -34.659958363508,-58.4189477786712 -34.6599853124772,-58.4190291594363 -34.6600110466082,-58.419144555203 -34.6600208768958,-58.4192659120003 -34.6600404277836,-58.4194168536888 -34.6600404814606,-58.4195056490127 -34.6600674151224,-58.4196062048157 -34.6600968177353,-58.4197008798388 -34.6601262181914,-58.4198459307904 -34.6601457768555,-58.4200621287167 -34.6602153288106,-58.4200782288581 -34.6602205082867,-58.4202409941491 -34.6602669748432,-58.4204570096662 -34.6603502212486,-58.4206079309092 -34.6603918239176,-58.4207558605935 -34.6604506089559,-58.4208889568028 -34.660516642455,-58.4210946674839 -34.6605864331085,-58.4212396136066 -34.6606476109742,-58.4212810099692 -34.6606989645248,-58.4213876233761 -34.6607185787144,-58.4214941322555 -34.6607772783879,-58.4216153957817 -34.6608164753467,-58.4217515675498 -34.660870325494,-58.4218669444501 -34.6609217036679,-58.421973457511 -34.6609730787718,-58.4220785235351 -34.6610208616494,-58.4221495039892 -34.6610551115959,-58.4221820525794 -34.6610747004344,-58.4222353110859 -34.661096690573,-58.4222560161978 -34.66110895131,-58.4223004154979 -34.6611211494723,-58.4223862298321 -34.6611480800444,-58.4224690516818 -34.6611945875859,-58.4225430995668 -34.6612313031728,-58.4226229373524 -34.6612802040601,-58.4227087437337 -34.6613242475606,-58.4227679616469 -34.6613609581451,-58.422818231535 -34.6613952009158,-58.4228863088959 -34.6614417033482,-58.4231214995544 -34.6615408672203,-58.4232132668745 -34.6615970957405,-58.4233109140782 -34.6616558613735,-58.4235091137305 -34.661758604189,-58.4236778260489 -34.6618564779551,-58.4237606424732 -34.6619176329116,-58.4238346006184 -34.661966601547,-58.4239115442562 -34.662010641371,-58.423932236198 -34.6620521984149,-58.4240111499906 -34.6620873240296,-58.4241246931952 -34.6619440271361,-58.4246123756264 -34.6613342006985,-58.4246979359646 -34.6612211809477,-58.4249419787505 -34.6609194552037,-58.4250287065924 -34.6608125775992,-58.4257180868058 -34.6599633279367,-58.4264411362897 -34.6590727450609,-58.426440334231 -34.6590722959665,-58.4263622338297 -34.6590285653796,-58.4253825207974 -34.658480577726,-58.425224547752 -34.6583922168824,-58.4244805160615 -34.658002467702,-58.4243460569879 -34.6579372827627,-58.4235062430038 -34.6575373563069,-58.4233642866324 -34.6574697030105,-58.4232184961144 -34.6574002876926,-58.4230523412465 -34.6573211469892,-58.4220017013441 -34.656896844922,-58.4214957331541 -34.656681880042,-58.4214643759461 -34.6566696859901,-58.4203723333681 -34.6562439473434,-58.4197113717879 -34.6559830747336,-58.4191133706443 -34.6557702506201,-58.4188406978358 -34.6556789530077,-58.4180787509028 -34.655423880402,-58.417597402286 -34.6558925901887,-58.4167297672644 -34.6567375019372,-58.4167098504768 -34.657152999387,-58.4167061432055 -34.6572299720401,-58.4167744868879 -34.6584808083946,-58.4168005427892 -34.6591424568347)))";;"2216";4_1_14;COMUNA 4;"1";"14";"749";"352";"397";"88,66%";"221";"221";"100,00%";"0";"0,00%";"236";"26";"11.02";"210";"88,98%";"11.02";11.020
"MULTIPOLYGON (((-58.432967003288 -34.6478744621097,-58.432624304201 -34.6475152121968,-58.4323056299374 -34.6471811089041,-58.4320702675062 -34.6469343523311,-58.4319648957725 -34.6468238999045,-58.4308287086816 -34.6477157481686,-58.4297051134478 -34.6485976592384,-58.4294648956713 -34.6487821066377,-58.4298548007646 -34.6491327862673,-58.4302108087738 -34.6494405669866,-58.4305894843589 -34.6497570148556,-58.4308162311281 -34.6495901679138,-58.4319619117205 -34.6486750823001,-58.4328401645705 -34.6479735186404,-58.432967003288 -34.6478744621097)))";;"2217";4_1_2;COMUNA 4;"1";"2";"795";"393";"402";"97,76%";"241";"241";"100,00%";"0";"0,00%";"263";"37";"14.07";"226";"85,93%";"14.07";14.070
"MULTIPOLYGON (((-58.4282514755452 -34.6479558997585,-58.4280670948425 -34.648089865692,-58.42781954811 -34.6482697301794,-58.4270560165701 -34.6488244557912,-58.426036054781 -34.6495656546601,-58.4266674361211 -34.6501698046971,-58.4270104529605 -34.6505485084852,-58.4280702504623 -34.6515675769182,-58.4282025602694 -34.6516602228159,-58.4290044348895 -34.6524297656925,-58.4295696100502 -34.6520244160718,-58.4296870757901 -34.6519411349057,-58.4296868299322 -34.6519404307586,-58.4300953254398 -34.6516474333454,-58.4312661549683 -34.6508092854277,-58.4309319607439 -34.6504956527512,-58.4309830594401 -34.6503412903597,-58.430846751902 -34.6502261809506,-58.4304299086964 -34.6498743002079,-58.4305172832411 -34.6498100960128,-58.4305894843589 -34.6497570148556,-58.4302108087738 -34.6494405669866,-58.4298548007646 -34.6491327862673,-58.4294648956713 -34.6487821066377,-58.4297051134478 -34.6485976592384,-58.4308287086816 -34.6477157481686,-58.4304875257286 -34.6474279736948,-58.4304043813627 -34.647357879143,-58.4301727535125 -34.6471625299268,-58.4299716240717 -34.6469928934651,-58.4297974997793 -34.6468465041043,-58.4286169107282 -34.6476903605554,-58.4284269051887 -34.6478284100982,-58.4282514755452 -34.6479558997585)))";;"2218";4_1_3;COMUNA 4;"1";"3";"635";"304";"331";"91,84%";"183";"183";"100,00%";"0";"0,00%";"215";"24";"11.16";"191";"88,84%";"11.16";11.160
"MULTIPOLYGON (((-58.4300953254398 -34.6516474333454,-58.4296868299322 -34.6519404307586,-58.4296870757901 -34.6519411349057,-58.4295696100502 -34.6520244160718,-58.4290044348895 -34.6524297656925,-58.4297185783108 -34.6531151925122,-58.4296278755508 -34.6531805219902,-58.4296278300992 -34.6531805168751,-58.4296243444824 -34.6531830616105,-58.4295081828128 -34.6532668079862,-58.4295066925919 -34.6532678717587,-58.4295708878277 -34.6533288207621,-58.4294809532699 -34.6533902769833,-58.4297564545746 -34.6536667683326,-58.4300252893626 -34.6539965686894,-58.4300709421753 -34.6540653857556,-58.4301181281788 -34.6541365272256,-58.4302486831109 -34.6543748084785,-58.4309584455876 -34.655668413437,-58.4312882726779 -34.6554275763288,-58.4313887878262 -34.6553346417201,-58.4319925969456 -34.6548965430208,-58.4311071473796 -34.6543633434406,-58.4310753661637 -34.6543441797099,-58.432234623106 -34.6535293804365,-58.4318841850492 -34.6533021025699,-58.4317700198887 -34.6532123527031,-58.4315522681408 -34.6530054601708,-58.4329906795993 -34.6519748025941,-58.4320307719377 -34.6512094716981,-58.4317978503958 -34.6510164493759,-58.4309830594401 -34.6503412903597,-58.4309319607439 -34.6504956527512,-58.4312661549683 -34.6508092854277,-58.4300953254398 -34.6516474333454)))";;"2219";4_1_4;COMUNA 4;"1";"4";"801";"399";"402";"99,25%";"196";"196";"100,00%";"0";"0,00%";"236";"29";"12.29";"207";"87,71%";"12.29";12.290
"MULTIPOLYGON (((-58.4336781429241 -34.6525147025054,-58.4329906795993 -34.6519748025941,-58.4315522681408 -34.6530054601708,-58.4317700198887 -34.6532123527031,-58.4318841850492 -34.6533021025699,-58.432234623106 -34.6535293804365,-58.43308272965 -34.6541004512761,-58.4344335176544 -34.6531130666909,-58.4336781429241 -34.6525147025054)))";;"2220";4_1_5;COMUNA 4;"1";"5";"824";"408";"416";"98,08%";"170";"170";"100,00%";"0";"0,00%";"234";"13";"5.56";"221";"94,44%";"5.56";5.560
"MULTIPOLYGON (((-58.43308272965 -34.6541004512761,-58.432234623106 -34.6535293804365,-58.4310753661637 -34.6543441797099,-58.4311071473796 -34.6543633434406,-58.4319925969456 -34.6548965430208,-58.4321177397101 -34.6548057267402,-58.43308272965 -34.6541004512761)))";;"2221";4_1_6;COMUNA 4;"1";"6";"725";"354";"371";"95,42%";"126";"126";"100,00%";"0";"0,00%";"206";"50";"24.27";"156";"75,73%";"24.27";24.270
"MULTIPOLYGON (((-58.4302486831109 -34.6543748084785,-58.4301181281788 -34.6541365272256,-58.4300709421753 -34.6540653857556,-58.4300252893626 -34.6539965686894,-58.4297564545746 -34.6536667683326,-58.4294809532699 -34.6533902769833,-58.4295708878277 -34.6533288207621,-58.4295066925919 -34.6532678717587,-58.4288277413604 -34.6537570799344,-58.4286761700525 -34.6538657733327,-58.4275966603974 -34.6546403492566,-58.4274841304267 -34.6547210233994,-58.4267507218668 -34.6552413879876,-58.4273588082588 -34.6558252447465,-58.4274657227156 -34.6559276730349,-58.4280701562294 -34.6565071588042,-58.4287947208606 -34.6572016783132,-58.4289058888334 -34.6571221294101,-58.4294838068092 -34.6567050930401,-58.4296335097783 -34.6565900599712,-58.429784917327 -34.6564738299585,-58.4309584455876 -34.655668413437,-58.4302486831109 -34.6543748084785)))";;"2222";4_1_7;COMUNA 4;"1";"7";"518";"233";"285";"81,75%";"162";"162";"100,00%";"0";"0,00%";"168";"12";"7.14";"156";"92,86%";"7.14";7.140
"MULTIPOLYGON (((-58.4270104529605 -34.6505485084852,-58.4266674361211 -34.6501698046971,-58.426036054781 -34.6495656546601,-58.4259514052294 -34.6496271803302,-58.4258236208681 -34.6497199614515,-58.4256920853265 -34.6498155582851,-58.4252932974348 -34.650110586327,-58.4249840175021 -34.6503393711727,-58.4248125829207 -34.6504662232436,-58.4239091192188 -34.6511181418078,-58.4249006576624 -34.6520620024463,-58.425964286476 -34.6530745406254,-58.4261644753969 -34.6532660148783,-58.4268792837126 -34.6539530077683,-58.4269890062545 -34.6540584655881,-58.4275966603974 -34.6546403492566,-58.4286761700525 -34.6538657733327,-58.4288277413604 -34.6537570799344,-58.4295066925919 -34.6532678717587,-58.4295081828128 -34.6532668079862,-58.4296243444824 -34.6531830616105,-58.4296278300992 -34.6531805168751,-58.4296278755508 -34.6531805219902,-58.4297185783108 -34.6531151925122,-58.4290044348895 -34.6524297656925,-58.4282025602694 -34.6516602228159,-58.4280702504623 -34.6515675769182,-58.4270104529605 -34.6505485084852)))";;"2223";4_1_8;COMUNA 4;"1";"8";"685";"337";"348";"96,84%";"252";"252";"100,00%";"0";"0,00%";"225";"13";"5.78";"212";"94,22%";"5.78";5.780
"MULTIPOLYGON (((-58.4245027636543 -34.6544659635251,-58.4246239818917 -34.6545872021743,-58.4252049592282 -34.6551442294925,-58.4259173196978 -34.6546386570146,-58.4260358184307 -34.6545541831837,-58.4268792837126 -34.6539530077683,-58.4261644753969 -34.6532660148783,-58.425964286476 -34.6530745406254,-58.4249006576624 -34.6520620024463,-58.4239091192188 -34.6511181418078,-58.4237875537682 -34.6512058521755,-58.4234623265485 -34.6514405436971,-58.4230680446913 -34.6517250725572,-58.4227292585197 -34.651969546718,-58.4222423031918 -34.6523209458625,-58.4232352027037 -34.6532603835564,-58.4243850383583 -34.6543481766562,-58.4245027636543 -34.6544659635251)))";;"2224";4_1_9;COMUNA 4;"1";"9";"650";"316";"334";"94,61%";"220";"220";"100,00%";"0";"0,00%";"224";"5";"2.23";"219";"97,77%";"2.23";2.230
"MULTIPOLYGON (((-58.3894015653654 -34.6462322119157,-58.3893540177271 -34.6468287447181,-58.3892388943322 -34.6482746341061,-58.3895431914166 -34.6482916490822,-58.3901481227643 -34.6483251089793,-58.3916600662589 -34.6484086089219,-58.3924611615043 -34.6484528754622,-58.3925042787487 -34.6478750219363,-58.3925353744237 -34.6474197735245,-58.3925518097445 -34.6473267261324,-58.3919747936757 -34.6470824841495,-58.3916491192677 -34.6469506579151,-58.3916080450188 -34.6469358629516,-58.391711797728 -34.6466094164384,-58.3925231685751 -34.6469613684622,-58.3925232123443 -34.6469094225872,-58.3925734817036 -34.6469302295354,-58.3956084256839 -34.6481994204208,-58.3956651193627 -34.6480488088448,-58.3957970438976 -34.6481423837888,-58.3957844277508 -34.6481995171265,-58.3960671439141 -34.6483762881814,-58.3960670940398 -34.6484386244314,-58.3973677939636 -34.6490159295463,-58.3987133974848 -34.6496134171237,-58.3987393230429 -34.6495661521283,-58.3988487096819 -34.6496102248585,-58.3989925132172 -34.6496722033361,-58.3991779519564 -34.6496694137653,-58.3992211604237 -34.6496671122524,-58.3999628025405 -34.6474272876442,-58.3999676743797 -34.6474098242815,-58.4000361660312 -34.6473257014613,-58.4001147209629 -34.6472337682782,-58.4004361720672 -34.6470979422301,-58.4006181007147 -34.6469966234486,-58.4012068939489 -34.6469489636702,-58.4013042180112 -34.6469411251441,-58.4013639583067 -34.6469360835293,-58.4015025064091 -34.6469526330616,-58.4015244783882 -34.6468581413187,-58.4015411481822 -34.6467864496528,-58.4013996219726 -34.6467678304922,-58.4013027648451 -34.6467575630344,-58.4011359104794 -34.6467368593371,-58.4010834209851 -34.6467311212752,-58.4008472064006 -34.6466375717995,-58.4006898204195 -34.6465760787963,-58.4006343417209 -34.6465437052862,-58.4004361732156 -34.6464258277861,-58.4004466460648 -34.6464062704759,-58.4003321044684 -34.6463578945636,-58.4003523980009 -34.646309566647,-58.4004924450384 -34.6459184273748,-58.4003798011761 -34.6459024544318,-58.3972765334344 -34.6445837458376,-58.3935073235812 -34.6429818289818,-58.3914001970958 -34.6420862207013,-58.3914712320043 -34.6408265045098,-58.3902440241791 -34.6403532304345,-58.3898815017365 -34.6402054746666,-58.3898601355575 -34.6404718798345,-58.3898475577329 -34.6406295533299,-58.3897570625027 -34.6418016480459,-58.3896733456888 -34.6428181084465,-58.3896649876927 -34.6429235297973,-58.3895735395425 -34.6441044974249,-58.3894659489068 -34.6454229235073,-58.3894618992336 -34.6454736268521,-58.3894614980125 -34.6454786762815,-58.3894121803417 -34.6460986870468,-58.3894028760182 -34.6462157977007,-58.3894015653654 -34.6462322119157)))";;"2225";4_10_1;COMUNA 4;"10";"1";"73";"29";"44";"65,91%";"11";"11";"100,00%";"0";"0,00%";"23";"1";"4.35";"22";"95,65%";"4.35";4.350
"MULTIPOLYGON (((-58.3977654190437 -34.6513639661719,-58.397507131227 -34.6514372549876,-58.3973627424477 -34.6514394722895,-58.3966408166426 -34.6514276104221,-58.3966333062977 -34.6514278839098,-58.3965413243008 -34.6514312333776,-58.3954257188249 -34.6515114704681,-58.3954185381205 -34.6516443577687,-58.3953806393906 -34.6520355456123,-58.3953214902984 -34.6527794785523,-58.3952829177374 -34.653264894039,-58.3954246383676 -34.6532707471293,-58.3956090504168 -34.6532830321905,-58.3956999957166 -34.6532673070847,-58.3957848751761 -34.6532702411021,-58.3959870138792 -34.6532821831953,-58.3960441073851 -34.6532893273033,-58.3960960777934 -34.6533086520427,-58.3961830630113 -34.6533427146075,-58.3962134314381 -34.6533062512257,-58.3962697041039 -34.653274097852,-58.3963294429561 -34.6532769473668,-58.3963604491888 -34.6535095062751,-58.3963677341513 -34.6535650048232,-58.3963754641001 -34.6537038159129,-58.3967165941071 -34.6537268889805,-58.3967798223194 -34.6537362192258,-58.3968067661453 -34.6536117230982,-58.3968389751606 -34.6535106811981,-58.3968959046402 -34.6531864770632,-58.3969222977308 -34.6530035281781,-58.3969167428207 -34.6529152127241,-58.3969561399944 -34.6528842471444,-58.3975816246707 -34.6529445141183,-58.3976241126056 -34.6525569901722,-58.3976742308905 -34.6521105248512,-58.3977654190437 -34.6513639661719)))";;"2226";4_10_6;COMUNA 4;"10";"6";"1004";"479";"525";"91,24%";"277";"277";"100,00%";"0";"0,00%";"306";"29";"9.48";"277";"90,52%";"9.48";9.480
"MULTIPOLYGON (((-58.3952107649703 -34.6541731201598,-58.3952089570651 -34.6541955846041,-58.3952005193427 -34.6543014280944,-58.3951510394926 -34.6548883896297,-58.3952395847173 -34.6548919598789,-58.3955716961639 -34.6549017913361,-58.3955760022385 -34.6549518655857,-58.3956720524556 -34.654949031015,-58.3958309904602 -34.6549559494652,-58.3959894122925 -34.6549689239401,-58.3961101835649 -34.6549586375409,-58.3961511855085 -34.6549473919923,-58.3963180379097 -34.6549687511666,-58.3963205341737 -34.6550445998016,-58.3965950240872 -34.6550676369113,-58.3966027718919 -34.6549698917899,-58.3966550126147 -34.6549722441083,-58.3966643317998 -34.6548273153604,-58.3966956520218 -34.654343163274,-58.3967018646086 -34.6542466849462,-58.3967053138564 -34.6541958402573,-58.3967125288433 -34.6541249265967,-58.3967367733635 -34.6539655688572,-58.3967619601536 -34.6538000142536,-58.3967798223194 -34.6537362192258,-58.3967165941071 -34.6537268889805,-58.3963754641001 -34.6537038159129,-58.3963677341513 -34.6535650048232,-58.3963604491888 -34.6535095062751,-58.3963294429561 -34.6532769473668,-58.3962697041039 -34.653274097852,-58.3962134314381 -34.6533062512257,-58.3961830630113 -34.6533427146075,-58.3960960777934 -34.6533086520427,-58.3960441073851 -34.6532893273033,-58.3959870138792 -34.6532821831953,-58.3957848751761 -34.6532702411021,-58.3956999957166 -34.6532673070847,-58.3956090504168 -34.6532830321905,-58.3954246383676 -34.6532707471293,-58.3952829177374 -34.653264894039,-58.3952107649703 -34.6541731201598)))";;"2227";4_24_1;COMUNA 4;"24";"1";"1396";"684";"712";"96,07%";"375";"375";"100,00%";"0";"0,00%";"415";"92";"22.17";"323";"77,83%";"22.17";22.170
"MULTIPOLYGON (((-58.3986510231023 -34.65257570344,-58.3983647141829 -34.6525278048303,-58.3983395742614 -34.6525270873176,-58.3982504243958 -34.6525370405256,-58.3981950068481 -34.6525670825319,-58.3981698353167 -34.6526071408179,-58.3981411849907 -34.6527373407586,-58.3981064040893 -34.6528604245568,-58.3980908553332 -34.6529097839699,-58.3980400127647 -34.6530839874986,-58.3980309539121 -34.6531165188626,-58.3980101304556 -34.653154044132,-58.3976378375208 -34.6529879256829,-58.3975816246707 -34.6529445141183,-58.3969561399944 -34.6528842471444,-58.3969167428207 -34.6529152127241,-58.3969222977308 -34.6530035281781,-58.3968959046402 -34.6531864770632,-58.3968389751606 -34.6535106811981,-58.3968067661453 -34.6536117230982,-58.3967798223194 -34.6537362192258,-58.3967619601536 -34.6538000142536,-58.3967367733635 -34.6539655688572,-58.3967125288433 -34.6541249265967,-58.3967053138564 -34.6541958402573,-58.3967018646086 -34.6542466849462,-58.3966956520218 -34.654343163274,-58.3966643317998 -34.6548273153604,-58.3970402367804 -34.6548519556901,-58.3974702435945 -34.6548968356711,-58.3975574519249 -34.6546485652006,-58.3976977090561 -34.6546764577633,-58.3977958776311 -34.6546888343595,-58.3979099770671 -34.6547090364717,-58.397958638852 -34.6547106116594,-58.3979669437569 -34.654661530131,-58.3979849730611 -34.6546010449797,-58.398016206694 -34.6545474684402,-58.3980546827897 -34.6544958676206,-58.3980763720292 -34.65444130006,-58.398082878502 -34.6544033446537,-58.3981758914788 -34.654139865083,-58.3983197424128 -34.653707393246,-58.398446109189 -34.6532904758334,-58.3986510231023 -34.65257570344)))";;"2228";4_24_2;COMUNA 4;"24";"2";"1852";"949";"903";"105,09%";"537";"537";"100,00%";"0";"0,00%";"538";"92";"17.1";"446";"82,90%";"17.1";17.100
"MULTIPOLYGON (((-58.3965950240872 -34.6550676369113,-58.3963205341737 -34.6550445998016,-58.3963180379097 -34.6549687511666,-58.3961511855085 -34.6549473919923,-58.3961101835649 -34.6549586375409,-58.3959894122925 -34.6549689239401,-58.3958309904602 -34.6549559494652,-58.3956720524556 -34.654949031015,-58.3955760022385 -34.6549518655857,-58.3955716961639 -34.6549017913361,-58.3952395847173 -34.6548919598789,-58.3951510394926 -34.6548883896297,-58.3950623179205 -34.6559411878865,-58.3951606666683 -34.655942932592,-58.39556402098 -34.6559649165384,-58.3961206900742 -34.6559945183913,-58.3961522272668 -34.6559898171613,-58.396175760297 -34.655976308485,-58.3963024853094 -34.6559829270433,-58.3963229273464 -34.6559980794561,-58.3963445688339 -34.6560053449662,-58.3964532263824 -34.6560116014113,-58.3965484310221 -34.656001864084,-58.3967726411131 -34.6560248735036,-58.3968199370834 -34.6560301809097,-58.3969127393621 -34.6560407242766,-58.3970013585006 -34.6560602796641,-58.3970801007862 -34.6560680687688,-58.3973794307558 -34.6561540770428,-58.3974479303592 -34.6561819314249,-58.3974986362608 -34.6561862544485,-58.3975157441938 -34.6561060500095,-58.3975727209304 -34.6559382587003,-58.3976635240306 -34.6556713980287,-58.3978161443065 -34.6555851388065,-58.3978780745817 -34.6554026312384,-58.3979418725714 -34.655229068547,-58.3978062273718 -34.655187305079,-58.3978224602768 -34.6551356924984,-58.3978501549364 -34.6550305633282,-58.3978393461302 -34.6550116837907,-58.3978405578152 -34.6549878809258,-58.3978658321217 -34.6549264137048,-58.3979133538262 -34.654859958155,-58.397958638852 -34.6547106116594,-58.3979099770671 -34.6547090364717,-58.3977958776311 -34.6546888343595,-58.3976977090561 -34.6546764577633,-58.3975574519249 -34.6546485652006,-58.3974702435945 -34.6548968356711,-58.3970402367804 -34.6548519556901,-58.3966643317998 -34.6548273153604,-58.3966550126147 -34.6549722441083,-58.3966027718919 -34.6549698917899,-58.3965950240872 -34.6550676369113)))";;"2229";4_24_3;COMUNA 4;"24";"3";"1220";"598";"622";"96,14%";"329";"329";"100,00%";"0";"0,00%";"373";"45";"12.06";"328";"87,94%";"12.06";12.060
"MULTIPOLYGON (((-58.3953664175274 -34.661167562318,-58.3953211839027 -34.660769158405,-58.3952363040973 -34.6607807993088,-58.3952555713619 -34.6602782328259,-58.395401783318 -34.6602198744115,-58.3954054831412 -34.6602187171474,-58.3953962843892 -34.6601977619015,-58.3953863400119 -34.6601637413672,-58.3953782971511 -34.6599916193896,-58.395365790496 -34.6598589326767,-58.3953516779132 -34.6597096953084,-58.3953435423587 -34.6595469397271,-58.3953436262919 -34.6594432044396,-58.3953475969088 -34.6593813034695,-58.3953501682484 -34.6593634170587,-58.3953597514846 -34.6593169421604,-58.3953983822516 -34.659184213244,-58.3954556268164 -34.6591148062371,-58.3955400628972 -34.6590408365882,-58.39558604726 -34.6589836067603,-58.3956541567202 -34.6588630774232,-58.3957148456264 -34.6587493751493,-58.3957682114256 -34.6586273587274,-58.3958145699242 -34.6585282968366,-58.3959017453666 -34.6583319305751,-58.3959915612695 -34.6581370446047,-58.3960995663122 -34.6578970263622,-58.396150514289 -34.6579195900363,-58.3965024031306 -34.6580461232314,-58.3965629414081 -34.6581198201607,-58.3968287220605 -34.6581760219759,-58.3968357260536 -34.6581566590091,-58.3968590948118 -34.6581359668135,-58.3968993870561 -34.6580540143907,-58.3969246060296 -34.6579567716959,-58.3969453975837 -34.6579617830532,-58.3969640435687 -34.6578777061947,-58.397015754883 -34.6576892075387,-58.3970322506156 -34.6576297781012,-58.3970564793331 -34.6575990860424,-58.3970838261619 -34.6575050135577,-58.3971389365062 -34.6573286296904,-58.3970870497397 -34.657307826536,-58.3970944088243 -34.6572702942068,-58.3971235638444 -34.6571526304538,-58.3971674121134 -34.6569913113618,-58.3972121192334 -34.6568214009144,-58.3972646788198 -34.6566364238032,-58.3973197971622 -34.6564486310529,-58.3973790244345 -34.656237459516,-58.3973794307558 -34.6561540770428,-58.3970801007862 -34.6560680687688,-58.3970013585006 -34.6560602796641,-58.3969127393621 -34.6560407242766,-58.3968199370834 -34.6560301809097,-58.3967726411131 -34.6560248735036,-58.3965484310221 -34.656001864084,-58.3964532263824 -34.6560116014113,-58.3963445688339 -34.6560053449662,-58.3963229273464 -34.6559980794561,-58.3963024853094 -34.6559829270433,-58.396175760297 -34.655976308485,-58.3961522272668 -34.6559898171613,-58.3961206900742 -34.6559945183913,-58.39556402098 -34.6559649165384,-58.3951606666683 -34.655942932592,-58.3950623179205 -34.6559411878865,-58.3950185554044 -34.6565168844498,-58.3949614441214 -34.6572622262863,-58.3949523140378 -34.6573802527692,-58.3948750338955 -34.6584010136456,-58.3948570178645 -34.6585460077553,-58.3947659921184 -34.6592797103268,-58.3947249762171 -34.6598270973376,-58.3947067081057 -34.6600713194051,-58.3946254225557 -34.6608762967266,-58.3946140646315 -34.6611119308055,-58.3951677624945 -34.6611689304805,-58.3953664175274 -34.661167562318)))";;"2230";4_24_4;COMUNA 4;"24";"4";"1929";"974";"955";"101,99%";"483";"483";"100,00%";"0";"0,00%";"534";"84";"15.73";"450";"84,27%";"15.73";15.730
"MULTIPOLYGON (((-58.3974986362608 -34.6561862544484,-58.3974479303592 -34.6561819314249,-58.3973794307558 -34.6561540770428,-58.3973790244345 -34.656237459516,-58.3973197971622 -34.6564486310529,-58.3972646788198 -34.6566364238032,-58.3972121192334 -34.6568214009144,-58.3971674121134 -34.6569913113618,-58.3971235638444 -34.6571526304538,-58.3970944088243 -34.6572702942068,-58.3970870497397 -34.657307826536,-58.3971389365062 -34.6573286296904,-58.3970838261619 -34.6575050135577,-58.3970564793331 -34.6575990860424,-58.3970322506156 -34.6576297781012,-58.397015754883 -34.6576892075387,-58.3969640435687 -34.6578777061947,-58.3969453975837 -34.6579617830532,-58.3969246060296 -34.6579567716959,-58.3968993870561 -34.6580540143907,-58.3968590948118 -34.6581359668135,-58.3968357260536 -34.6581566590091,-58.3968287220605 -34.6581760219759,-58.3968044596452 -34.658248968696,-58.3967796911736 -34.6583151543803,-58.3967536496552 -34.6583745081896,-58.3966922088266 -34.6583637704125,-58.3966406554063 -34.6584592381741,-58.3966197836985 -34.6585550746672,-58.3966313909223 -34.6586420552665,-58.3966922557592 -34.6589719991752,-58.3969462125775 -34.6588849353051,-58.3971209233176 -34.6588287065014,-58.397253051697 -34.6587478133295,-58.3974916861845 -34.658663456839,-58.3977984934036 -34.6585650554617,-58.3980498880848 -34.6585053459361,-58.3983253513007 -34.658383802126,-58.3984209325321 -34.6583522687806,-58.3985165319535 -34.6582970475402,-58.3987315498 -34.6582774206785,-58.3988366197966 -34.6583327473586,-58.3989416566736 -34.6584315016169,-58.3990180568951 -34.6584907611157,-58.3992358074567 -34.65739537482,-58.3994466491366 -34.6563986246919,-58.3992765376329 -34.656399381421,-58.3991521950058 -34.6563967813957,-58.3991003689022 -34.6564082335789,-58.3985892820343 -34.6563913457267,-58.398346770897 -34.6563372727558,-58.3980918151469 -34.6562857279933,-58.3979892133438 -34.6562727858883,-58.3975440525549 -34.6561977579306,-58.3974986362608 -34.6561862544484)))";;"2231";4_24_5;COMUNA 4;"24";"5";"1350";"654";"696";"93,97%";"207";"207";"100,00%";"0";"0,00%";"406";"77";"18.97";"329";"81,03%";"18.97";18.970
"MULTIPOLYGON (((-58.4024183339423 -34.6521228218814,-58.4024693937449 -34.6523398946859,-58.4026887711429 -34.6524360636761,-58.4025108913637 -34.6527028836417,-58.4023916437516 -34.6528516335777,-58.4022011669644 -34.6534166454962,-58.4021106983297 -34.6535088370358,-58.4021058777706 -34.6536901779913,-58.4020627223066 -34.6537367071995,-58.4019557525454 -34.6537567953936,-58.4018965445659 -34.653959870428,-58.4018833545289 -34.6540497256365,-58.4017319893744 -34.6544109986437,-58.4015949487623 -34.6544100145261,-58.401033899603 -34.6561644309701,-58.4027454410952 -34.655872952145,-58.4032391653005 -34.6544218840646,-58.40358053746 -34.6532705374183,-58.4038336664005 -34.6524019722939,-58.4039280276059 -34.6521312351525,-58.4039990755349 -34.651927530946,-58.404166935671 -34.6514794293232,-58.4043176126576 -34.6511055467724,-58.4044265180883 -34.6508710848357,-58.4046638024306 -34.6504595659938,-58.4041416678222 -34.6505703056044,-58.4034802686664 -34.6507001309244,-58.4034332206297 -34.6507093336942,-58.403230453579 -34.6507491657436,-58.4033691689463 -34.6511403013052,-58.40351809824 -34.6513111534055,-58.4033235503274 -34.6514152872796,-58.4032925878502 -34.6514535831966,-58.4032651225164 -34.6514875144832,-58.4031155064486 -34.6516812500376,-58.4030124902024 -34.6517777518162,-58.4029602213901 -34.6518170935847,-58.4028619170175 -34.6518787373539,-58.402770006126 -34.6519375672008,-58.4025855379738 -34.6520056474331,-58.4025222868562 -34.6520289267841,-58.4024183339423 -34.6521228218814)))";;"2232";4_25_3;COMUNA 4;"25";"3";"3945";"2012";"1933";"104,09%";"841";"841";"100,00%";"0";"0,00%";"1093";"244";"22.32";"849";"77,68%";"22.32";22.320
"MULTIPOLYGON (((-58.3959017447012 -34.6583319300245,-58.3958145685934 -34.6585282957355,-58.3957682100948 -34.6586273576263,-58.3957148442947 -34.6587493751485,-58.3956541560543 -34.6588630774228,-58.3955860465942 -34.65898360676,-58.3955400615664 -34.6590408354871,-58.3954556274827 -34.6591148056873,-58.3953983829174 -34.6591842132444,-58.3953597501524 -34.6593169427099,-58.3953501669167 -34.659363417058,-58.3953475955771 -34.6593813034688,-58.3953436269578 -34.6594432044399,-58.3953435430246 -34.6595469397275,-58.3953516779137 -34.6597096947582,-58.3953657898297 -34.6598589332265,-58.3953782958203 -34.6599916182885,-58.3953863386806 -34.6601637408163,-58.3953962843901 -34.6601977608011,-58.3954054815912 -34.6602187155226,-58.3954017824791 -34.6602198743851,-58.3952555707098 -34.6602782316426,-58.39523630364 -34.6607807995098,-58.395321184562 -34.6607691581778,-58.3953664159475 -34.6611675608853,-58.3951677624954 -34.6611689293801,-58.3946140652978 -34.6611119302557,-58.3946086894249 -34.6612230582325,-58.3945549040053 -34.6618535376919,-58.3945159329412 -34.6623009926303,-58.3946064475624 -34.6622916938139,-58.3947761577891 -34.6622793249932,-58.395062824653 -34.6622015860614,-58.3951684428294 -34.6621704856181,-58.3952892047067 -34.6620614935056,-58.3954363786666 -34.6619369371752,-58.3956890962648 -34.6618716415178,-58.3958738994558 -34.6618468143248,-58.3961190385675 -34.6618251377502,-58.3962736125962 -34.6618750765602,-58.3964659480213 -34.6618627182606,-58.3966544761466 -34.6618970947073,-58.396982559054 -34.6619003888223,-58.3972805045318 -34.6618631580429,-58.3976539477227 -34.6617293702737,-58.3976918258361 -34.6615143894063,-58.3977585838169 -34.6611854640165,-58.3979199905267 -34.6611644940427,-58.3990754412429 -34.6608562835028,-58.399168572818 -34.6608206358384,-58.3991220643815 -34.6607199383612,-58.3991256953518 -34.6606577597268,-58.3991400903123 -34.660577820838,-58.399150894991 -34.660506763008,-58.3991402010916 -34.6604327329932,-58.3991438342961 -34.6603675933787,-58.3992766165903 -34.6601130184367,-58.399330469863 -34.6599798024359,-58.3993915258814 -34.6597992145013,-58.3994920398861 -34.6595653493874,-58.3995189725092 -34.6593791209471,-58.3995711201509 -34.6592426437397,-58.3995532839131 -34.6591360392865,-58.3995527536833 -34.6590477031593,-58.3994382495572 -34.6588305053891,-58.3992950307853 -34.6586764601168,-58.3991422267018 -34.6585618893906,-58.3990180568951 -34.6584907611157,-58.3989416566736 -34.6584315016169,-58.3988366197966 -34.6583327473586,-58.3987315498 -34.6582774206785,-58.3985165319535 -34.6582970475402,-58.3984209325321 -34.6583522687806,-58.3983253513007 -34.658383802126,-58.3980498880848 -34.6585053459361,-58.3977984934036 -34.6585650554617,-58.3974916861845 -34.658663456839,-58.397253051697 -34.6587478133295,-58.3971209233176 -34.6588287065014,-58.3969462125775 -34.6588849353051,-58.3966922557592 -34.6589719991752,-58.396631389591 -34.6586420547156,-58.3966197836985 -34.6585550746672,-58.3966406547405 -34.6584592381738,-58.396692208827 -34.6583637698623,-58.3967536489889 -34.6583745087395,-58.3967796905077 -34.65831515438,-58.3968044589798 -34.6582489681454,-58.3968287220614 -34.6581760208755,-58.3965629407418 -34.6581198207105,-58.3965024037969 -34.6580461226816,-58.3961505129577 -34.6579195894854,-58.3960995656467 -34.6578970258116,-58.3959915606041 -34.6581370440542,-58.3959017447012 -34.6583319300245)))";;"2233";4_24_6;COMUNA 4;"24";"6";"1417";"691";"726";"95,18%";"347";"347";"100,00%";"0";"0,00%";"377";"44";"11.67";"333";"88,33%";"11.67";11.670
"MULTIPOLYGON (((-58.3916080452913 -34.6469358640091,-58.3916491172705 -34.6469506579139,-58.3919747936757 -34.6470824841495,-58.3925518097445 -34.6473267261324,-58.3925353744237 -34.6474197735245,-58.3925042787487 -34.6478750219363,-58.3924611615043 -34.6484528754622,-58.3934600390703 -34.648508096799,-58.394059262961 -34.6485411830312,-58.3955841702128 -34.6486254146393,-58.3955220048483 -34.6485695331057,-58.3955310660253 -34.6485363686336,-58.395575134254 -34.6484166715301,-58.395572704392 -34.6484156281277,-58.3957481043837 -34.6481076716825,-58.3956651193627 -34.6480488088447,-58.3956084256839 -34.6481994204208,-58.3925734817036 -34.6469302295354,-58.3925232123443 -34.6469094225872,-58.3925231685751 -34.6469613684622,-58.3917117980207 -34.6466094174824,-58.3916080452913 -34.6469358640091)))";;"2234";4_10_2;COMUNA 4;"10";"2";"1935";"927";"1008";"91,96%";"551";"551";"100,00%";"0";"0,00%";"661";"218";"32.98";"443";"67,02%";"32.98";32.980
"MULTIPOLYGON (((-58.3956422782596 -34.6486369258261,-58.3955451546759 -34.6500319048854,-58.3965335847836 -34.6500943990959,-58.3966167401952 -34.6500408807472,-58.3968870570976 -34.6500388437749,-58.3969686347021 -34.6497950765633,-58.3970908980059 -34.6498266222221,-58.3971363951642 -34.6498408730208,-58.3972400063921 -34.649860365886,-58.3972884876972 -34.649869406256,-58.3974119478475 -34.6498998254404,-58.3974871861084 -34.6499121900123,-58.3975653203587 -34.6499264581003,-58.3976301659502 -34.6499362102202,-58.3977354837141 -34.6499523947171,-58.3977935087761 -34.6499651719262,-58.3978821105862 -34.6499989530081,-58.3979251313211 -34.6500165825787,-58.3979391741382 -34.6500427874538,-58.3980567331869 -34.6500982734727,-58.39813553124 -34.6501369079223,-58.3982626415809 -34.6501849348873,-58.3983523499833 -34.650220898825,-58.3984051792861 -34.6502280390295,-58.3984835721224 -34.6502408266472,-58.3985524245358 -34.6502464968577,-58.3985798669667 -34.6502468650645,-58.3986274050896 -34.6502630167442,-58.3987230266717 -34.6502589113459,-58.3988310685208 -34.6502797438013,-58.3989365446587 -34.6499786621356,-58.3986396452324 -34.6497508940768,-58.3987096245908 -34.649620293101,-58.3987133974848 -34.6496134171237,-58.3973677939636 -34.6490159295463,-58.3960670940398 -34.6484386244314,-58.3960671439141 -34.6483762881814,-58.3957844277508 -34.6481995171265,-58.3957970438976 -34.6481423837888,-58.3957481043837 -34.6481076716826,-58.395572704392 -34.6484156281277,-58.395575134254 -34.6484166715302,-58.3955310660253 -34.6485363686336,-58.3955220048483 -34.6485695331057,-58.3955841702128 -34.6486254146393,-58.3956422782596 -34.6486369258261)))";;"2235";4_10_3;COMUNA 4;"10";"3";"1653";"812";"841";"96,55%";"491";"491";"100,00%";"0";"0,00%";"507";"114";"22.49";"393";"77,51%";"22.49";22.490
"MULTIPOLYGON (((-58.3966408166425 -34.6514276104221,-58.3966440850854 -34.651283626887,-58.3966999859133 -34.6507596330672,-58.396644604675 -34.6506285970505,-58.3973024990527 -34.6506289516568,-58.3973612188526 -34.6506647556719,-58.3975779541931 -34.6504457057155,-58.3979652817356 -34.6504412639243,-58.3987845843512 -34.6504421890858,-58.3988310685207 -34.6502797438012,-58.3987230260055 -34.6502589118958,-58.3986274064212 -34.650263016745,-58.3985798663014 -34.650246864514,-58.3985524258665 -34.6502464979588,-58.3984835727874 -34.6502408277479,-58.3984051806172 -34.6502280395804,-58.3983523499833 -34.650220898825,-58.3982626415809 -34.6501849348873,-58.3981355312396 -34.6501369084725,-58.3980567331865 -34.6500982740229,-58.3979391734724 -34.6500427874534,-58.3979251326531 -34.6500165820292,-58.3978821105862 -34.6499989530081,-58.3977935087756 -34.6499651724764,-58.3977354843798 -34.6499523947175,-58.3976301659493 -34.6499362113206,-58.3975653216902 -34.649926458101,-58.3974871867738 -34.6499121905629,-58.397411947847 -34.6498998259905,-58.3972884890283 -34.6498694068069,-58.3972400063917 -34.6498603664362,-58.3971363951638 -34.6498408735709,-58.3970908993366 -34.6498266233232,-58.3969686347013 -34.6497950776636,-58.3968870577634 -34.6500388437752,-58.3966167401952 -34.6500408807472,-58.3965335856932 -34.650094399886,-58.395545156152 -34.6500319058196,-58.3954644276544 -34.6509607712395,-58.3954364451512 -34.651314709985,-58.3954257188249 -34.6515114704681,-58.3965413243008 -34.6514312333776,-58.3966333062977 -34.6514278839097,-58.3966408166425 -34.6514276104221)))";;"2236";4_10_4;COMUNA 4;"10";"4";"464";"229";"235";"97,45%";"117";"117";"100,00%";"0";"0,00%";"124";"32";"25.81";"92";"74,19%";"25.81";25.810
"MULTIPOLYGON (((-58.3991779519564 -34.6496694137653,-58.3989925132172 -34.6496722033361,-58.3988487096819 -34.6496102248585,-58.3987393230429 -34.6495661521283,-58.3987096245908 -34.649620293101,-58.3986396452324 -34.6497508940768,-58.3989365446587 -34.6499786621356,-58.3988310685208 -34.6502797438013,-58.3987845843512 -34.6504421890858,-58.3979652810707 -34.6504412628236,-58.3975779541926 -34.6504457062657,-58.3973612181197 -34.6506647545422,-58.3973024996642 -34.650628952303,-58.3966446048068 -34.6506285976964,-58.3966999865033 -34.6507596329073,-58.3966440852178 -34.651283626804,-58.3966408158359 -34.6514276098305,-58.397362742107 -34.6514394719488,-58.3975071299145 -34.6514372543762,-58.3977654188469 -34.6513639668172,-58.3987612672188 -34.6510641672259,-58.3991631606209 -34.6509615578834,-58.3992052608005 -34.6509598180961,-58.3993998237112 -34.6509516801187,-58.3997520248687 -34.6509726371562,-58.3999025401925 -34.6512893438977,-58.4001059807256 -34.6519455237466,-58.4002907978819 -34.6523248555975,-58.4003223488098 -34.6520721183389,-58.4003546608423 -34.6519390328824,-58.4005650370662 -34.6510726356673,-58.4007590371979 -34.650219961901,-58.4008577873838 -34.64978605592,-58.4015025064091 -34.6469526330616,-58.4013639583067 -34.6469360835293,-58.4013042180112 -34.6469411251441,-58.4012068939489 -34.6469489636702,-58.4006181007147 -34.6469966234486,-58.4004361720672 -34.6470979422301,-58.4001147209629 -34.6472337682782,-58.4000361660312 -34.6473257014613,-58.3999676743797 -34.6474098242815,-58.3999628025405 -34.6474272876442,-58.3992211604237 -34.6496671122524,-58.3991779519564 -34.6496694137653)))";;"2237";4_10_5;COMUNA 4;"10";"5";"1659";"796";"863";"92,24%";"459";"459";"100,00%";"0";"0,00%";"519";"93";"17.92";"426";"82,08%";"17.92";17.920
"MULTIPOLYGON (((-58.4008589404482 -34.6497809909727,-58.40351683221 -34.6502499334073,-58.4034273258205 -34.6507104916901,-58.4034332206297 -34.6507093336942,-58.4034802686664 -34.6507001309244,-58.4041416678222 -34.6505703056044,-58.4046638024306 -34.6504595659938,-58.4047470775343 -34.6503150942364,-58.404933592192 -34.6499915814986,-58.4050450225269 -34.6497982481554,-58.4046061420181 -34.6494343669707,-58.4045016390823 -34.6493477652432,-58.4044328474841 -34.6492547014258,-58.4039264299008 -34.6485990865374,-58.4036100507216 -34.6481894142253,-58.4034809808434 -34.6480208253877,-58.4031269780637 -34.6475581741556,-58.4027980943885 -34.6471284225288,-58.4027476240549 -34.6470624568992,-58.4027466461986 -34.6470611788222,-58.4015244782841 -34.6468581417131,-58.4015025077406 -34.6469526330623,-58.4008589404482 -34.6497809909727)))";;"2238";4_26_3;COMUNA 4;"26";"3";"1219";"592";"627";"94,42%";"210";"210";"100,00%";"0";"0,00%";"340";"45";"13.24";"295";"86,76%";"13.24";13.240
"MULTIPOLYGON (((-58.4028696658704 -34.650819977289,-58.402560613565 -34.6508806721445,-58.4023157408888 -34.6509287215803,-58.4020381386017 -34.6509832333124,-58.401727977119 -34.6510440663529,-58.4015229923997 -34.6510843169989,-58.4014769671457 -34.6510927448552,-58.4013658246826 -34.6511130417211,-58.40119939414 -34.6511061267063,-58.4009476605035 -34.6510957174884,-58.400631587489 -34.6510825988828,-58.4005650377324 -34.6510726351174,-58.4003546615085 -34.6519390323326,-58.400322348144 -34.6520721183386,-58.4002907972157 -34.6523248561474,-58.4002864243572 -34.6523602774911,-58.400268488771 -34.6525259774281,-58.4003981700814 -34.6525613969112,-58.4004503339735 -34.6525506485864,-58.4004956790979 -34.6525412348285,-58.400669816576 -34.6525023083008,-58.400928934188 -34.6524444099567,-58.4009958444457 -34.6524294433905,-58.4011959574036 -34.6524131355537,-58.4014772272644 -34.6523617262793,-58.4017269605209 -34.6523160754088,-58.4020044763817 -34.652269592763,-58.4022856540105 -34.6522264916811,-58.4024183339423 -34.6521228218814,-58.4025222868562 -34.6520289267842,-58.4025855379738 -34.6520056474331,-58.402770006126 -34.6519375672008,-58.4028619170175 -34.6518787373539,-58.4029602213901 -34.6518170935847,-58.4030124902024 -34.6517777518162,-58.4031155064486 -34.6516812500376,-58.4032651225164 -34.6514875144832,-58.4032925878502 -34.6514535831966,-58.4033235503274 -34.6514152872796,-58.40351809824 -34.6513111534055,-58.4033691689463 -34.6511403013052,-58.403230453579 -34.6507491657436,-58.4031321809439 -34.6507684845521,-58.4028696658704 -34.650819977289)))";;"2239";4_26_1;COMUNA 4;"26";"1";"1008";"503";"505";"99,60%";"131";"131";"100,00%";"0";"0,00%";"261";"41";"15.71";"220";"84,29%";"15.71";15.710
"MULTIPOLYGON (((-58.398648885952 -34.6525831548178,-58.3988662712588 -34.6526495552084,-58.3985085519506 -34.6538214112835,-58.3985746967749 -34.6538729673965,-58.3982754085288 -34.6543106086449,-58.3985106792208 -34.6543799562213,-58.3985329363984 -34.6545411371454,-58.3986058297994 -34.6545491018376,-58.3990509259398 -34.654516044298,-58.3998207390366 -34.6546356118858,-58.4002684874402 -34.652525976327,-58.4002864230264 -34.65236027639,-58.4002907978819 -34.6523248555975,-58.4001059807256 -34.6519455237466,-58.3999025401925 -34.6512893438977,-58.3997520248687 -34.6509726371562,-58.3993998237112 -34.6509516801186,-58.3992052608005 -34.6509598180961,-58.3991631606209 -34.6509615578834,-58.3990748164672 -34.651368424776,-58.3990051960706 -34.6515838872334,-58.3988707328176 -34.6520101670316,-58.3986930528522 -34.6525557953439,-58.3986510224373 -34.6525757023393,-58.398648885952 -34.6525831548178)))";;"2240";4_10_8;COMUNA 4;"10";"8";"1602";"794";"808";"98,27%";"430";"430";"100,00%";"0";"0,00%";"492";"99";"20.12";"393";"79,88%";"20.12";20.120
"MULTIPOLYGON (((-58.3991631606213 -34.6509615573332,-58.3987612678846 -34.6510641672262,-58.3977654190437 -34.6513639661719,-58.3976742308905 -34.6521105248512,-58.3976241126056 -34.6525569901722,-58.3975816246707 -34.6529445141183,-58.3976378375208 -34.6529879256829,-58.3980101304556 -34.653154044132,-58.3980309539121 -34.6531165188626,-58.3980400127647 -34.6530839874986,-58.3980908553332 -34.6529097839699,-58.3981064040893 -34.6528604245568,-58.3981411849907 -34.6527373407586,-58.3981698353167 -34.6526071408179,-58.3981950068481 -34.6525670825319,-58.3982504243958 -34.6525370405256,-58.3983395742614 -34.6525270873176,-58.3983647141829 -34.6525278048303,-58.3986510231023 -34.65257570344,-58.3986930528522 -34.6525557953439,-58.3988707328168 -34.652010168132,-58.3990051974018 -34.6515838877843,-58.399074817133 -34.6513684247764,-58.3991631606213 -34.6509615573332)))";;"2241";4_10_7;COMUNA 4;"10";"7";"901";"433";"468";"92,52%";"249";"249";"100,00%";"0";"0,00%";"273";"49";"17.95";"224";"82,05%";"17.95";17.950
"MULTIPOLYGON (((-58.3894121816732 -34.6460986870476,-58.3877796238138 -34.6460060020577,-58.3872151868876 -34.6459739628761,-58.3865393814793 -34.6466794092369,-58.3864298842565 -34.646673636404,-58.3861010225613 -34.6465954701644,-58.3850247288835 -34.6463397816106,-58.3844652729721 -34.6478984148512,-58.385128284766 -34.6480578572862,-58.3855768472175 -34.6480813819377,-58.3861603025493 -34.6481120321461,-58.3868807814352 -34.6481498777248,-58.387599215892 -34.6481875769385,-58.3883977516847 -34.6482295462322,-58.388963569899 -34.6482592567605,-58.3892388943317 -34.6482746346562,-58.3893540183929 -34.6468287447185,-58.3894028753524 -34.6462157977003,-58.3894121816732 -34.6460986870476)))";;"2242";4_11_1;COMUNA 4;"11";"1";"862";"408";"454";"89,87%";"255";"255";"100,00%";"0";"0,00%";"293";"26";"8.87";"267";"91,13%";"8.87";8.870
"MULTIPOLYGON (((-58.3839366145861 -34.6493993872269,-58.3838741515436 -34.6495770282328,-58.3836778645804 -34.6501451575767,-58.3856834877649 -34.6505330720165,-58.3857383856392 -34.6503310584126,-58.3858952690655 -34.6495059918625,-58.386695775238 -34.6495495228835,-58.3874829887459 -34.6495923362048,-58.3873984645723 -34.6506146384663,-58.3873783856363 -34.6508608305639,-58.388615485487 -34.6511000462162,-58.3888253701119 -34.651138248068,-58.3890055211677 -34.6511754374752,-58.3890078586794 -34.6511759200165,-58.3890079761986 -34.6511744431983,-58.3890319886923 -34.6508726861599,-58.3891267834235 -34.6496814402819,-58.3892388943317 -34.6482746346562,-58.388963569899 -34.6482592567605,-58.3883977516847 -34.6482295462322,-58.387599215892 -34.6481875769385,-58.3868807814352 -34.6481498777248,-58.3861603025493 -34.6481120321461,-58.3855768472175 -34.6480813819377,-58.385128284766 -34.6480578572862,-58.3844652729721 -34.6478984148512,-58.3844191349039 -34.6480269102433,-58.3839366145861 -34.6493993872269)))";;"2243";4_11_2;COMUNA 4;"11";"2";"847";"384";"463";"82,94%";"384";"384";"100,00%";"0";"0,00%";"327";"1";"0.31";"326";"99,69%";"0.31";0.310
"MULTIPOLYGON (((-58.3834624327733 -34.6507688391404,-58.3834079975705 -34.6509263436402,-58.3831329099751 -34.6517253430236,-58.3830604412589 -34.6519357244574,-58.3827215961034 -34.6528283458376,-58.383766842336 -34.6531029786246,-58.3846115283847 -34.6533270501594,-58.3858764375687 -34.6536608211337,-58.387160239666 -34.6537533864555,-58.3871775574411 -34.6535462080273,-58.3872599356406 -34.6525472860565,-58.387268375117 -34.6523563701656,-58.3870087162443 -34.6523433215595,-58.3865073819386 -34.6523156845852,-58.3863208412434 -34.6523051450413,-58.3860687685118 -34.6522909019668,-58.3850524090028 -34.6522053973541,-58.3851329354309 -34.6520310068447,-58.3854652554002 -34.6511592201816,-58.3856327796143 -34.6507197356681,-58.3856834877649 -34.6505330720165,-58.3836778645804 -34.6501451575767,-58.3834624327733 -34.6507688391404)))";;"2244";4_11_3;COMUNA 4;"11";"3";"785";"370";"415";"89,16%";"346";"346";"100,00%";"0";"0,00%";"282";"3";"1.06";"279";"98,94%";"1.06";1.060
"MULTIPOLYGON (((-58.3873783856363 -34.6508608305639,-58.3873984645723 -34.6506146384663,-58.3874829887459 -34.6495923362048,-58.386695775238 -34.6495495228835,-58.3858952690655 -34.6495059918625,-58.3857383856392 -34.6503310584126,-58.3856834877649 -34.6505330720165,-58.3856327796143 -34.6507197356681,-58.3854652554002 -34.6511592201816,-58.3851329354309 -34.6520310068447,-58.3850524090028 -34.6522053973541,-58.3860687685118 -34.6522909019668,-58.3863208412434 -34.6523051450413,-58.3865073819386 -34.6523156845852,-58.3870087162443 -34.6523433215595,-58.387268375117 -34.6523563701656,-58.3878847563806 -34.6523873141847,-58.388064991746 -34.6523970728064,-58.3889069429219 -34.65244258656,-58.3890078586794 -34.6511759200165,-58.3890055211677 -34.6511754374752,-58.3888253701119 -34.651138248068,-58.388615485487 -34.6511000462162,-58.3873783856363 -34.6508608305639)))";;"2245";4_11_4;COMUNA 4;"11";"4";"643";"283";"360";"78,61%";"317";"317";"100,00%";"0";"0,00%";"250";"0";"0";"250";"100,00%";"0";0.000
"MULTIPOLYGON (((-58.3901481220976 -34.6483251100793,-58.3895431914166 -34.6482916490822,-58.3892388943317 -34.6482746346562,-58.3891267834235 -34.6496814402819,-58.3890319886923 -34.6508726861599,-58.3890079761986 -34.6511744431983,-58.3890078586794 -34.6511759200165,-58.3889069429219 -34.65244258656,-58.3892438088501 -34.6524608186551,-58.3897407988287 -34.6524882305063,-58.3905444029803 -34.6525325832102,-58.3921391721242 -34.6526204908628,-58.3922404635547 -34.651355582482,-58.3932814728867 -34.6514123784061,-58.3938380287015 -34.651438117264,-58.3943037399309 -34.6514632392638,-58.3948390689574 -34.651498116846,-58.3952765735733 -34.6515221630605,-58.3954257188249 -34.6515114704681,-58.3954364451512 -34.651314709985,-58.3954644276544 -34.6509607712395,-58.395545156152 -34.6500319058196,-58.395642278925 -34.6486369263766,-58.3955841695466 -34.6486254151891,-58.3940592636263 -34.6485411835818,-58.3934600390698 -34.6485080973492,-58.3924611621691 -34.6484528765629,-58.3916600675908 -34.6484086083724,-58.3901481220976 -34.6483251100793)))";;"2246";4_11_5;COMUNA 4;"11";"5";"456";"215";"241";"89,21%";"211";"210";"99,53%";"1";"0,48%";"185";"9";"4.86";"176";"95,14%";"4.86";4.860
"MULTIPOLYGON (((-58.3932814728867 -34.6514123784061,-58.3922404635547 -34.651355582482,-58.3921391721242 -34.6526204908628,-58.3927195925515 -34.6526525164227,-58.3931798558388 -34.652677850861,-58.393645658553 -34.6527035388222,-58.3936050129185 -34.6532106433817,-58.3935740984928 -34.6535954963011,-58.3935332797171 -34.6541047838261,-58.3940779191749 -34.654134317757,-58.3946226443045 -34.6541637788786,-58.3952089570651 -34.6541955846041,-58.3952107649703 -34.6541731201598,-58.3952829177374 -34.653264894039,-58.3953214902984 -34.6527794785523,-58.3953806393906 -34.6520355456123,-58.3954185381205 -34.6516443577687,-58.3954257188249 -34.6515114704681,-58.3952765735733 -34.6515221630605,-58.3948390689574 -34.651498116846,-58.3943037399309 -34.6514632392638,-58.3938380287015 -34.651438117264,-58.3932814728867 -34.6514123784061)))";;"2247";4_11_6;COMUNA 4;"11";"6";"964";"467";"497";"93,96%";"326";"325";"99,69%";"1";"0,31%";"320";"29";"9.06";"291";"90,94%";"9.06";9.060
"MULTIPOLYGON (((-58.3946140646315 -34.6611119308055,-58.3946254225557 -34.6608762967266,-58.3947067081057 -34.6600713194051,-58.3947249762171 -34.6598270973376,-58.3947659921184 -34.6592797103268,-58.3948570178645 -34.6585460077553,-58.3948750338955 -34.6584010136456,-58.3949523140378 -34.6573802527692,-58.3949614441214 -34.6572622262863,-58.3950185554044 -34.6565168844498,-58.3950623179205 -34.6559411878865,-58.3951510394926 -34.6548883896297,-58.3952005193427 -34.6543014280944,-58.3952089570651 -34.6541955846041,-58.3946226443045 -34.6541637788786,-58.3940779191749 -34.654134317757,-58.3935332797171 -34.6541047838261,-58.3935740984928 -34.6535954963011,-58.3936050129185 -34.6532106433817,-58.393645658553 -34.6527035388222,-58.3931798558388 -34.652677850861,-58.3927195925515 -34.6526525164227,-58.3921391721242 -34.6526204908628,-58.3905444029803 -34.6525325832102,-58.3897407988287 -34.6524882305063,-58.3892438088501 -34.6524608186551,-58.3889069429219 -34.65244258656,-58.3888510964838 -34.6531446860606,-58.3887954223521 -34.6538436164518,-58.3887115647609 -34.6548962018918,-58.3886534748388 -34.6556256243895,-58.388607363893 -34.65620490888,-58.3885513405761 -34.6569084866145,-58.3884491177757 -34.6581914892769,-58.3882605760136 -34.6601179077832,-58.3882623725184 -34.6603889857587,-58.3883401585746 -34.6603987727547,-58.3885674741255 -34.6605956497013,-58.3887406927767 -34.6606541920822,-58.3889327909312 -34.6606903447202,-58.3890824069118 -34.6607814997597,-58.3892722460184 -34.6607066198507,-58.3894808426597 -34.6607471643488,-58.3895762089453 -34.6608718875712,-58.3896209864462 -34.6608874976666,-58.3898142415347 -34.6609495811078,-58.3900720337018 -34.6610093895644,-58.3903195394504 -34.6610381466173,-58.390513956077 -34.6611210478834,-58.390653849914 -34.6612124387215,-58.3909218937984 -34.6613459066307,-58.3911472213116 -34.6614659570338,-58.3913165929025 -34.6615476248737,-58.3914814826276 -34.6617017276081,-58.3915624545689 -34.6617784736707,-58.3916728621687 -34.6618935862251,-58.3918222264504 -34.6620364924659,-58.3919576886187 -34.6621026293196,-58.3921205518871 -34.6621622919675,-58.3922766249145 -34.6622914309673,-58.3925435418799 -34.6624182796789,-58.3927094606078 -34.6624308388556,-58.3928829268523 -34.6624371702204,-58.3930262346 -34.662431020291,-58.393331635513 -34.6625028613789,-58.3935315075821 -34.6624998589794,-58.3937049792005 -34.6624999572694,-58.3938408014625 -34.6624252511546,-58.3940821838887 -34.662387995793,-58.3943085097995 -34.6623164560115,-58.3945159338257 -34.6623009924167,-58.3945549040049 -34.6618535382421,-58.3946086894254 -34.6612230576823,-58.3946140646315 -34.6611119308055)))";;"2248";4_11_7;COMUNA 4;"11";"7";"1049";"506";"543";"93,19%";"361";"361";"100,00%";"0";"0,00%";"328";"61";"18.6";"267";"81,40%";"18.6";18.600
"MULTIPOLYGON (((-58.383766842336 -34.6531029786246,-58.3827215961034 -34.6528283458376,-58.3823489947726 -34.6538098197332,-58.3822721694633 -34.6540268176641,-58.3833439371709 -34.6542979502933,-58.3841642757572 -34.6545054592655,-58.3854871527451 -34.654840116642,-58.3870376230946 -34.6552323675481,-58.3886534748388 -34.6556256243895,-58.3887115647609 -34.6548962018918,-58.3887954223521 -34.6538436164518,-58.3888510964838 -34.6531446860606,-58.3889069429219 -34.65244258656,-58.388064991746 -34.6523970728064,-58.3878847563806 -34.6523873141847,-58.387268375117 -34.6523563701656,-58.3872599356406 -34.6525472860565,-58.3871775574411 -34.6535462080273,-58.387160239666 -34.6537533864555,-58.3858764375687 -34.6536608211337,-58.3846115283847 -34.6533270501594,-58.383766842336 -34.6531029786246)))";;"2249";4_11_8;COMUNA 4;"11";"8";"922";"466";"456";"102,19%";"349";"349";"100,00%";"0";"0,00%";"313";"17";"5.43";"296";"94,57%";"5.43";5.430
"MULTIPOLYGON (((-58.3819867000236 -34.6549637689366,-58.381924120376 -34.6551651417794,-58.3814534568921 -34.6565295162995,-58.3811818955935 -34.657344710515,-58.3811074108765 -34.6573410690426,-58.3810110246729 -34.6573355818152,-58.3807327680961 -34.6573263103091,-58.3804665293942 -34.6573162011792,-58.3800567769797 -34.6572978250327,-58.3797412747233 -34.6572903570518,-58.379647871888 -34.6572845890784,-58.3792465948174 -34.6572287501228,-58.3788961729271 -34.6571984384967,-58.3786692233562 -34.6571893383836,-58.3784912943983 -34.6571652008598,-58.3783552056697 -34.6571471485374,-58.3783352519664 -34.6572944097836,-58.3784033359946 -34.6572951783227,-58.3784146994315 -34.657302232973,-58.3784218131723 -34.6572951910955,-58.3784573426411 -34.6572987390456,-58.3784772304479 -34.6573093229766,-58.3784900104629 -34.6573210764615,-58.3785141681832 -34.6573257910064,-58.3785383211572 -34.6573352034065,-58.3786051339705 -34.6573246793134,-58.3786193388863 -34.65733291037,-58.3786363911928 -34.6573364455251,-58.3786434978032 -34.6573364504245,-58.3786619797323 -34.6573317653011,-58.3786875658985 -34.6573294340016,-58.378714563907 -34.6573364993954,-58.378733038725 -34.657338861051,-58.3787671504558 -34.6573388845372,-58.3788182991191 -34.6573577111879,-58.3788580937821 -34.6573600874896,-58.3788836657629 -34.6573718497285,-58.3789262983528 -34.6573789258218,-58.3789973609509 -34.6573824980228,-58.379052784283 -34.6573907573176,-58.3790869078307 -34.6573790360647,-58.3791281273713 -34.6573778898581,-58.3791423299906 -34.6573884697838,-58.3791622067107 -34.6574102110202,-58.3791963008014 -34.6574278513607,-58.3792218634299 -34.6574490092482,-58.3792374956393 -34.6574513688812,-58.3792488744725 -34.6574431554093,-58.3792446199191 -34.6574337567712,-58.3792332599263 -34.6574231788035,-58.3792219011139 -34.6574114263697,-58.3792261756821 -34.6574008591042,-58.379267384639 -34.6574102830352,-58.3792915483127 -34.6574091251014,-58.3793398838899 -34.6573985879647,-58.3794066696282 -34.6574150761266,-58.379466345839 -34.6574344955633,-58.3794947723146 -34.6574345149649,-58.3795345717268 -34.657432193186,-58.3795573164254 -34.6574286853002,-58.379594267324 -34.6574322338882,-58.3796212630992 -34.6574416480113,-58.3796511110876 -34.6574439953122,-58.3796752769213 -34.657438161405,-58.3796965874116 -34.65744757164,-58.3797164812652 -34.6574522830441,-58.3797363844839 -34.6574475987252,-58.3797491728895 -34.6574511308233,-58.3797690667469 -34.6574558422189,-58.3797775923522 -34.6574581969488,-58.379794649412 -34.657457034082,-58.3798344523339 -34.6574511888104,-58.3798785133803 -34.6574512187469,-58.3798884591442 -34.6574547488995,-58.3799083588501 -34.6574535879475,-58.3799268442374 -34.6574453792374,-58.3799382136617 -34.6574465614209,-58.3799751599167 -34.6574548077534,-58.3799865305099 -34.6574548154674,-58.3800021592424 -34.6574606983973,-58.3800348392046 -34.6574712907496,-58.380046212132 -34.6574689495281,-58.3800746502757 -34.6574572241447,-58.3800902801803 -34.6574619325983,-58.3801172853414 -34.6574619508918,-58.380144295161 -34.6574572713194,-58.3801627793616 -34.6574502370385,-58.3802068567001 -34.6574338243467,-58.3802310261849 -34.6574267939018,-58.3802580348237 -34.6574232887691,-58.3803020888815 -34.6574303653425,-58.3803703170667 -34.6574257135676,-58.3804280996008 -34.657430900432,-58.380491289289 -34.6574283324195,-58.3805450060596 -34.6574205367255,-58.380586085401 -34.6574127324978,-58.3806366556647 -34.6573918814784,-58.3806808840495 -34.6573945218709,-58.3807156292327 -34.6574023771376,-58.3807409014983 -34.6574050047609,-58.3807630272575 -34.6573945770987,-58.3808009369393 -34.6573972132012,-58.3808419982774 -34.6574076833074,-58.38091150408 -34.6574077299505,-58.3809430745536 -34.6574312468219,-58.3809999455157 -34.6574286743087,-58.381044199537 -34.6574052082547,-58.3810947517693 -34.6574026314655,-58.3811610700884 -34.6574313927979,-58.3812084297578 -34.6574627520578,-58.3821656870989 -34.6574921050448,-58.3822509847189 -34.6574973826201,-58.3827817443671 -34.6575107848241,-58.3829674993132 -34.6575171729945,-58.383031045523 -34.6575172145321,-58.3831025318716 -34.6575205430537,-58.3832792682104 -34.6575222992182,-58.3833328853287 -34.6575223341306,-58.3835175899245 -34.6574978404676,-58.3837241368542 -34.6574750015911,-58.383857202206 -34.6574586785389,-58.3840239953866 -34.657475195445,-58.3842305003643 -34.6574966604368,-58.3846772265165 -34.6575855566204,-58.3846971662076 -34.6574986007887,-58.3847262669314 -34.657505895203,-58.3847416075199 -34.6575185910242,-58.3848039030312 -34.657537286738,-58.3848255757153 -34.6575387930539,-58.3848559764692 -34.657557775286,-58.3849176780085 -34.657552284091,-58.3849826863288 -34.6575672502641,-58.3850630360201 -34.6575941659476,-58.3851099624815 -34.6576307613817,-58.3851397574234 -34.6576382426979,-58.3851695412517 -34.6576576637755,-58.3852053815298 -34.6576646574469,-58.385220091261 -34.6576823216952,-58.3852549965681 -34.6576975073055,-58.3852823765937 -34.6577122106975,-58.385300415471 -34.6577368479369,-58.3853031011503 -34.6577622216647,-58.3855576353747 -34.6579101376896,-58.3855828100736 -34.6579032183876,-58.3856125275151 -34.6579096047926,-58.3856675370693 -34.6579460259195,-58.3856829071018 -34.6579915185794,-58.3856961048674 -34.6580051718002,-58.3857335351424 -34.6580042857744,-58.3857940583865 -34.658030704075,-58.3859205791222 -34.6581162917569,-58.3860041922326 -34.6581736528959,-58.3860823061378 -34.6582255525678,-58.3861747205714 -34.658289286732,-58.3863144425233 -34.6583857981942,-58.3863628524768 -34.6584167569166,-58.3863771462888 -34.6584358687027,-58.3863826306324 -34.6584577039502,-58.3863881299879 -34.6584631653458,-58.3863980328315 -34.658468629497,-58.3864189302262 -34.6584895647282,-58.3864189127226 -34.6585086675549,-58.3864233037103 -34.6585223151859,-58.3864475045765 -34.6585423428197,-58.3864518947375 -34.658556900108,-58.3864529789479 -34.6585750939645,-58.3864639651891 -34.6585996616251,-58.3864672511503 -34.658617856858,-58.3864771456889 -34.6586324175865,-58.3864947321948 -34.6586624473235,-58.3865123228758 -34.6586879287659,-58.3865255092349 -34.6587143171131,-58.3865254892586 -34.6587361489142,-58.3865397748408 -34.6587643572641,-58.3865562705051 -34.6587834704035,-58.3865463126937 -34.6588380437179,-58.386523178467 -34.6588553127853,-58.3865869711138 -34.6589190287458,-58.3866815539887 -34.6590205147157,-58.3866994873308 -34.6590069559362,-58.386734835553 -34.6590206133108,-58.3867890055137 -34.6590751884336,-58.3868054947399 -34.6590888340447,-58.3868243369134 -34.6591073508843,-58.3868408226018 -34.6591248923015,-58.3868478769964 -34.6591443757561,-58.3868620079768 -34.6591589938457,-58.3868926415255 -34.6591726482417,-58.3869126730687 -34.6591794783674,-58.386925621829 -34.6591979915278,-58.3869503716924 -34.6592009287665,-58.3869727606305 -34.6592077603469,-58.3870399442851 -34.6592097499617,-58.3870635092701 -34.6592195041151,-58.387072925533 -34.6592341192552,-58.3870799684899 -34.6592662640815,-58.3870870229524 -34.659285747522,-58.3871117542766 -34.659309137735,-58.387137659888 -34.6593373984369,-58.3871494123511 -34.6593753898968,-58.3871717819125 -34.6594036484001,-58.3871823504044 -34.6594474828424,-58.3871587592691 -34.6594664603168,-58.3873283203266 -34.6596555121783,-58.3874131007036 -34.6597505249951,-58.3874343252173 -34.6597417725202,-58.3874508041167 -34.6597671054746,-58.387470836729 -34.6597729615557,-58.3874885163443 -34.659773946416,-58.3875026616204 -34.6597729811876,-58.387530931065 -34.6597944255896,-58.3875627401413 -34.6598119763535,-58.3875945369292 -34.6598431624461,-58.38760747628 -34.6598723890114,-58.3876239745819 -34.659876294984,-58.3876416568554 -34.6598743579642,-58.3876510768059 -34.6598850772478,-58.3876534148921 -34.6599065056568,-58.3876592978646 -34.6599181967157,-58.3876769757575 -34.659921129454,-58.3876887566321 -34.6599279543746,-58.3876863886967 -34.6599396403558,-58.3876651632811 -34.659949366827,-58.3876580796544 -34.6599620238585,-58.3876651316773 -34.6599844291214,-58.3876851626017 -34.6599922330723,-58.3876969364669 -34.660006849613,-58.3877063617039 -34.6600117251764,-58.3877264005333 -34.660010763547,-58.3877440802021 -34.6600117483702,-58.3877511445287 -34.6600205182914,-58.3877570073563 -34.6600546102555,-58.3877676121826 -34.660058512586,-58.3877781994787 -34.6600818939678,-58.3877828888762 -34.6601101414904,-58.3877981892496 -34.6601354736724,-58.3878547136652 -34.6601949195247,-58.3878712111672 -34.6601997994164,-58.3878888865016 -34.6602056539816,-58.3878935934479 -34.6602144224478,-58.387930113212 -34.6602368457706,-58.3879348105423 -34.6602563277135,-58.3879583768029 -34.6602651077402,-58.3879619015554 -34.6602777712914,-58.3879784008285 -34.6602807032634,-58.3879972610127 -34.6602797408672,-58.3880161168275 -34.660283648231,-58.3880467352579 -34.6603148334817,-58.3880667549461 -34.6603352987531,-58.3880891407894 -34.6603460259381,-58.3881209475765 -34.6603664984129,-58.3881374477453 -34.6603684564108,-58.3881527613569 -34.6603791792589,-58.3882623725184 -34.6603889857587,-58.3882605760136 -34.6601179077832,-58.3884491177757 -34.6581914892769,-58.3885513405761 -34.6569084866145,-58.388607363893 -34.65620490888,-58.3886534748388 -34.6556256243895,-58.3870376230946 -34.6552323675481,-58.3854871527451 -34.654840116642,-58.3841642757572 -34.6545054592655,-58.3833439371709 -34.6542979502933,-58.3822721694633 -34.6540268176641,-58.3822025222151 -34.6542234675726,-58.382047740421 -34.6547674656064,-58.3819867000236 -34.6549637689366)))";;"2250";4_11_9;COMUNA 4;"11";"9";"885";"435";"450";"96,67%";"277";"277";"100,00%";"0";"0,00%";"269";"32";"11.9";"237";"88,10%";"11.9";11.900
"MULTIPOLYGON (((-58.3810970101545 -34.637079252219,-58.3810221475057 -34.6371319502681,-58.3810208415215 -34.637160401005,-58.3809968634378 -34.6371962311577,-58.3806813786006 -34.6384600736539,-58.3813540200949 -34.6384466504728,-58.381401563615 -34.6382743527691,-58.3817603755922 -34.6369548311206,-58.3824270042658 -34.634502516828,-58.3824448744219 -34.6340836417893,-58.3825039849166 -34.63410487854,-58.3825492615339 -34.6331839628992,-58.3825613414699 -34.6329376952092,-58.3826148783188 -34.6318425537339,-58.3826212940051 -34.6317579525394,-58.3822180095486 -34.6314895314205,-58.3815452508065 -34.6310417799532,-58.3813263761351 -34.630900099656,-58.3813241729846 -34.6311173371413,-58.3812806430156 -34.6323566168151,-58.3812503808197 -34.633070070587,-58.3812260471143 -34.6336452138798,-58.3812167111708 -34.6338694402709,-58.3810970101545 -34.637079252219)))";;"2251";4_12_1;COMUNA 4;"12";"1";"604";"304";"300";"101,33%";"171";"171";"100,00%";"0";"0,00%";"229";"71";"31";"158";"69,00%";"31";31.000
"MULTIPOLYGON (((-58.3810926782017 -34.6421106049305,-58.3809122800891 -34.6421165406078,-58.3807963281888 -34.6421284798531,-58.380582422668 -34.6421537292028,-58.3804309750747 -34.6421715060739,-58.3799471532004 -34.6422263154999,-58.3797013085312 -34.6420650870928,-58.3795880516539 -34.6419908527269,-58.3783618250723 -34.641186746444,-58.3770896399725 -34.6403525241264,-58.3758409819189 -34.6395336577974,-58.3757952051312 -34.6397159548617,-58.3756959295536 -34.6406204194741,-58.3755250747858 -34.6421763318385,-58.3754866183783 -34.642526808161,-58.3760088640343 -34.6425430260793,-58.3761536976585 -34.6425683409966,-58.3763187055139 -34.6426139523511,-58.3764930588592 -34.6426866131789,-58.3767326568279 -34.642786433281,-58.3775403348121 -34.6431651102295,-58.3778427677139 -34.6433184243595,-58.3777974158252 -34.6435041027455,-58.3775329137789 -34.644589303775,-58.3775925484399 -34.6446039937437,-58.3788841540451 -34.6449232783263,-58.3796071883672 -34.6451019475852,-58.3805599081674 -34.6453373889251,-58.3809014191641 -34.645387866311,-58.3810637874964 -34.6454100795468,-58.3811806093589 -34.6454263292543,-58.3810926782017 -34.6421106049305)))";;"2252";4_12_10;COMUNA 4;"12";"10";"884";"427";"457";"93,44%";"299";"299";"100,00%";"0";"0,00%";"284";"25";"8.8";"259";"91,20%";"8.8";8.800
"MULTIPOLYGON (((-58.3742922597808 -34.6403082031002,-58.3742401708614 -34.6405733848947,-58.374041992849 -34.6415956672316,-58.3738873427309 -34.6423879736607,-58.3754168783055 -34.6431312839927,-58.3754442899979 -34.6429127053103,-58.3754866183783 -34.642526808161,-58.3755250747858 -34.6421763318385,-58.3756959295536 -34.6406204194741,-58.3742922597808 -34.6403082031002)))";;"2253";4_12_11;COMUNA 4;"12";"11";"632";"277";"355";"78,03%";"296";"296";"100,00%";"0";"0,00%";"260";"7";"2.69";"253";"97,31%";"2.69";2.690
"MULTIPOLYGON (((-58.3754168783055 -34.6431312839927,-58.3738873427309 -34.6423879736607,-58.3738193983626 -34.6427362447956,-58.3737013796401 -34.6433744882782,-58.3736509013512 -34.6436439667667,-58.3739629746165 -34.6437015903737,-58.3752378700542 -34.6440022388951,-58.3751666680253 -34.6442921262838,-58.3751366211438 -34.6444223903968,-58.3760019153828 -34.6445525900619,-58.3767743435569 -34.644668844525,-58.3768532511276 -34.6444212868773,-58.3775329137789 -34.644589303775,-58.3777974158252 -34.6435041027455,-58.3778427677139 -34.6433184243595,-58.3775403348121 -34.6431651102295,-58.3767326568279 -34.642786433281,-58.3764930588592 -34.6426866131789,-58.3763187055139 -34.6426139523511,-58.3761536976585 -34.6425683409966,-58.3760088640343 -34.6425430260793,-58.3754866183783 -34.642526808161,-58.3754442899979 -34.6429127053103,-58.3754168783055 -34.6431312839927)))";;"2254";4_12_12;COMUNA 4;"12";"12";"573";"274";"299";"91,64%";"270";"270";"100,00%";"0";"0,00%";"223";"2";"0.9";"221";"99,10%";"0.9";0.900
"MULTIPOLYGON (((-58.3873214972016 -34.6358458240422,-58.3878799039257 -34.6350208595906,-58.3887636517506 -34.6337595266455,-58.3885568217639 -34.6337120051837,-58.3876524529162 -34.6334586269479,-58.3872677718033 -34.6333557806715,-58.3865198914028 -34.6331412947909,-58.3854169064102 -34.6328208721581,-58.383990006691 -34.6323967768547,-58.3833915497326 -34.6322205383677,-58.3826205559686 -34.6317316518978,-58.3826212940051 -34.6317579525394,-58.3826148783188 -34.6318425537339,-58.3825613414699 -34.6329376952092,-58.3825492615339 -34.6331839628992,-58.3825039849166 -34.63410487854,-58.3824448744219 -34.6340836417893,-58.3824270042658 -34.634502516828,-58.3817603755922 -34.6369548311206,-58.381401563615 -34.6382743527691,-58.3813540200949 -34.6384466504728,-58.3815246089003 -34.6384432428956,-58.3866569397129 -34.6395355994594,-58.3865231015025 -34.6371789622713,-58.3864712814204 -34.6371018851797,-58.3865462789129 -34.636991083419,-58.3873214972016 -34.6358458240422)))";;"2255";4_12_2;COMUNA 4;"12";"2";"540";"239";"301";"79,40%";"205";"205";"100,00%";"0";"0,00%";"216";"90";"41.67";"126";"58,33%";"41.67";41.670
"MULTIPOLYGON (((-58.3902487581623 -34.6353994850378,-58.3902823714577 -34.6349581527213,-58.3903309494978 -34.6343559789597,-58.3903526218416 -34.6341243645838,-58.3895154144318 -34.6339320983137,-58.3887636517506 -34.6337595266455,-58.3878799039257 -34.6350208595906,-58.3886530336611 -34.6352257746376,-58.3888701702465 -34.63528111932,-58.3884701578121 -34.6361174527479,-58.3894196595158 -34.636339160799,-58.3898622111313 -34.6364425277971,-58.3901641191531 -34.6365117240239,-58.3902313480565 -34.6356280736124,-58.3902487581623 -34.6353994850378)))";;"2256";4_12_3;COMUNA 4;"12";"3";"721";"341";"380";"89,74%";"337";"337";"100,00%";"0";"0,00%";"302";"58";"19.21";"244";"80,79%";"19.21";19.210
"MULTIPOLYGON (((-58.3888701702465 -34.63528111932,-58.3886530336611 -34.6352257746376,-58.3878799039257 -34.6350208595906,-58.3873214972016 -34.6358458240422,-58.3865462789129 -34.636991083419,-58.3878998263264 -34.6373158046513,-58.3881022332003 -34.6373643808714,-58.388865522849 -34.6375449215143,-58.3897657999232 -34.6377579347722,-58.3900640493478 -34.6378264247991,-58.3901641191531 -34.6365117240239,-58.3898622111313 -34.6364425277971,-58.3894196595158 -34.636339160799,-58.3884701578121 -34.6361174527479,-58.3888701702465 -34.63528111932)))";;"2257";4_12_4;COMUNA 4;"12";"4";"975";"459";"516";"88,95%";"266";"266";"100,00%";"0";"0,00%";"371";"52";"14.02";"319";"85,98%";"14.02";14.020
"MULTIPOLYGON (((-58.3865231015025 -34.6371789622713,-58.3866569397129 -34.6395355994594,-58.3880998999587 -34.639494376625,-58.3885718824846 -34.6394808611627,-58.3886110432205 -34.639520463673,-58.3890270131094 -34.6398306550154,-58.3895086740483 -34.6400534168247,-58.3898815017356 -34.640205475767,-58.3899669077329 -34.6391018299348,-58.3900640493478 -34.6378264247991,-58.3897657999232 -34.6377579347722,-58.388865522849 -34.6375449215143,-58.3881022332003 -34.6373643808714,-58.3878998263264 -34.6373158046513,-58.3865462789129 -34.636991083419,-58.3864712814204 -34.6371018851797,-58.3865231015025 -34.6371789622713)))";;"2258";4_12_5;COMUNA 4;"12";"5";"615";"292";"323";"90,40%";"256";"256";"100,00%";"0";"0,00%";"231";"28";"12.12";"203";"87,88%";"12.12";12.120
"MULTIPOLYGON (((-58.3894659502378 -34.6454229240583,-58.389573540874 -34.6441044974257,-58.3896649876927 -34.6429235297973,-58.3896733456883 -34.6428181089967,-58.3897570618365 -34.6418016485957,-58.3898475583986 -34.6406295533303,-58.3898601368889 -34.6404718798353,-58.3898815017356 -34.640205475767,-58.3895086740483 -34.6400534168247,-58.3890270131094 -34.6398306550154,-58.3886110432205 -34.639520463673,-58.3885718824846 -34.6394808611627,-58.3880998999587 -34.639494376625,-58.3866569397129 -34.6395355994594,-58.3815246089003 -34.6384432428956,-58.3813540200949 -34.6384466504728,-58.3806813786006 -34.6384600736539,-58.3806506180719 -34.6384606867864,-58.380604689915 -34.6384619939499,-58.3804792557274 -34.6384707829723,-58.380356825702 -34.6384573900928,-58.3803894099304 -34.6394569507021,-58.3804409461292 -34.6394721267953,-58.380476969607 -34.6402691479735,-58.3804203999281 -34.6403459432173,-58.380457557532 -34.6408574631721,-58.3804168898501 -34.6409665236585,-58.3805049937608 -34.6408835523048,-58.3807470882789 -34.6402641887804,-58.3808645070917 -34.6402639155031,-58.3809122800891 -34.6421165406078,-58.3810926782017 -34.6421106049305,-58.3811806093589 -34.6454263292543,-58.3817840455564 -34.6455697636751,-58.3828563159991 -34.6458235767483,-58.3839210087002 -34.6460775163418,-58.3850247288835 -34.6463397816106,-58.3861010225613 -34.6465954701644,-58.3864298842565 -34.646673636404,-58.3865393814793 -34.6466794092369,-58.3872151868876 -34.6459739628761,-58.3877796238138 -34.6460060020577,-58.3894121816732 -34.6460986870476,-58.3894619005646 -34.6454736274031,-58.3894659502378 -34.6454229240583)))";;"2259";4_12_6;COMUNA 4;"12";"6";"796";"379";"417";"90,89%";"238";"238";"100,00%";"0";"0,00%";"249";"42";"16.87";"207";"83,13%";"16.87";16.870
"MULTIPOLYGON (((-58.3804309750747 -34.6421715060739,-58.380582422668 -34.6421537292028,-58.3807963281888 -34.6421284798531,-58.3809122800891 -34.6421165406078,-58.3808645070917 -34.6402639155031,-58.3807470882789 -34.6402641887804,-58.3805049937608 -34.6408835523048,-58.3804168898501 -34.6409665236585,-58.380457557532 -34.6408574631721,-58.3804203999281 -34.6403459432173,-58.380476969607 -34.6402691479735,-58.3804409461292 -34.6394721267953,-58.3803894099304 -34.6394569507021,-58.380356825702 -34.6384573900928,-58.3789484996478 -34.6383035389461,-58.3776690830424 -34.6381637055844,-58.3763517578625 -34.6380197473314,-58.3762697979032 -34.6380108157556,-58.3762073537546 -34.6382448634113,-58.375905582344 -34.6392765125959,-58.3758409819189 -34.6395336577974,-58.3770896399725 -34.6403525241264,-58.3783618250723 -34.641186746444,-58.3795880516539 -34.6419908527269,-58.3797013085312 -34.6420650870928,-58.3799471532004 -34.6422263154999,-58.3804309750747 -34.6421715060739)))";;"2260";4_12_7;COMUNA 4;"12";"7";"484";"248";"236";"105,08%";"145";"145";"100,00%";"0";"0,00%";"157";"13";"8.28";"144";"91,72%";"8.28";8.280
"MULTIPOLYGON (((-58.3762697979032 -34.6380108157556,-58.3749506032625 -34.6378666297694,-58.3747289998941 -34.637847807564,-58.3746807628979 -34.6380991187556,-58.3745801200725 -34.6386754727609,-58.3758409819189 -34.6395336577974,-58.375905582344 -34.6392765125959,-58.3762073537546 -34.6382448634113,-58.3762697979032 -34.6380108157556)))";;"2261";4_12_8;COMUNA 4;"12";"8";"403";"183";"220";"83,18%";"255";"255";"100,00%";"0";"0,00%";"184";"27";"14.67";"157";"85,33%";"14.67";14.670
"MULTIPOLYGON (((-58.3758409819189 -34.6395336577974,-58.3745801200725 -34.6386754727609,-58.3745208823502 -34.6390148068501,-58.3744077137672 -34.6396695343122,-58.3743386975262 -34.6400685109343,-58.3742922597808 -34.6403082031002,-58.3756959295536 -34.6406204194741,-58.3757952051312 -34.6397159548617,-58.3758409819189 -34.6395336577974)))";;"2262";4_12_9;COMUNA 4;"12";"9";"739";"316";"423";"74,70%";"388";"388";"100,00%";"0";"0,00%";"312";"3";"0.96";"309";"99,04%";"0.96";0.960
"MULTIPOLYGON (((-58.3773387612986 -34.6295708021224,-58.3772384880243 -34.6297317935739,-58.3771061268414 -34.6299441725745,-58.3768161083565 -34.6306071595975,-58.3767183146252 -34.6308400561115,-58.3762335229705 -34.6319945399995,-58.376159192117 -34.6321929444714,-58.3777659928157 -34.6325347188724,-58.3781840511118 -34.6314676504173,-58.3782900524284 -34.631371664332,-58.37839111403 -34.6312735619931,-58.3784891735375 -34.6311951060287,-58.378602047778 -34.6311264492539,-58.3787059262967 -34.6311069427242,-58.3787890765734 -34.6311118592705,-58.3788632511769 -34.6311462776029,-58.3789433750518 -34.6311954187687,-58.3790145456547 -34.6312518779233,-58.3790425731869 -34.6312753912409,-58.3786227784576 -34.6304859311263,-58.3786602218901 -34.6303834367224,-58.3787355750786 -34.6301775663302,-58.3787620597622 -34.6301051173774,-58.3789812080657 -34.6295596832813,-58.3790823902279 -34.6293181340523,-58.3779265013996 -34.6286202924449,-58.3773387612986 -34.6295708021224)))";;"2263";4_13_1;COMUNA 4;"13";"1";"907";"428";"479";"89,35%";"499";"499";"100,00%";"0";"0,00%";"357";"0";"0";"357";"100,00%";"0";0.000
"MULTIPOLYGON (((-58.3736850625325 -34.6370336439762,-58.3735453357409 -34.6377398319677,-58.3743404912302 -34.6378149200452,-58.3747289998941 -34.637847807564,-58.374766184072 -34.6376541662621,-58.3748550293574 -34.6371933001423,-58.3750335739801 -34.6362668497549,-58.3738671071405 -34.6361129022445,-58.3736850625325 -34.6370336439762)))";;"2264";4_13_10;COMUNA 4;"13";"10";"491";"224";"267";"83,90%";"255";"255";"100,00%";"0";"0,00%";"202";"0";"0";"202";"100,00%";"0";0.000
"MULTIPOLYGON (((-58.3767811712683 -34.6362314020747,-58.3750639024085 -34.6361092608749,-58.3750335739801 -34.6362668497549,-58.3748550293574 -34.6371933001423,-58.374766184072 -34.6376541662621,-58.3747289998941 -34.637847807564,-58.3749506032625 -34.6378666297694,-58.3762697979032 -34.6380108157556,-58.3763244581666 -34.6378054254278,-58.3766922898282 -34.6365735334679,-58.3767811712683 -34.6362314020747)))";;"2265";4_13_11;COMUNA 4;"13";"11";"1139";"507";"632";"80,22%";"545";"545";"100,00%";"0";"0,00%";"448";"3";"0.67";"445";"99,33%";"0.67";0.670
"MULTIPOLYGON (((-58.3777659928157 -34.6325347188724,-58.376159192117 -34.6321929444714,-58.3757895049536 -34.6332544063276,-58.377454848773 -34.6333560778446,-58.3774922075366 -34.633233494332,-58.3777659928157 -34.6325347188724)))";;"2266";4_13_2;COMUNA 4;"13";"2";"618";"294";"324";"90,74%";"300";"300";"100,00%";"0";"0,00%";"240";"25";"10.42";"215";"89,58%";"10.42";10.420
"MULTIPOLYGON (((-58.3742849972408 -34.6318154612386,-58.3734396335369 -34.6323740187026,-58.373570958289 -34.6325057387464,-58.3743489191576 -34.6333221763613,-58.3752020401339 -34.6327632661258,-58.3756212953811 -34.6331923829323,-58.3757895049536 -34.6332544063276,-58.376159192117 -34.6321929444714,-58.3760061327517 -34.6321476934569,-58.3751382788515 -34.6312515512514,-58.3742849972408 -34.6318154612386)))";;"2267";4_13_3;COMUNA 4;"13";"3";"638";"289";"349";"82,81%";"298";"298";"100,00%";"0";"0,00%";"253";"40";"15.81";"213";"84,19%";"15.81";15.810
"MULTIPOLYGON (((-58.3757895049536 -34.6332544063276,-58.3756212953811 -34.6331923829323,-58.3752020401339 -34.6327632661258,-58.3743489191576 -34.6333221763613,-58.3744073884648 -34.6333832065956,-58.3753938911145 -34.6344119077551,-58.3757895049536 -34.6332544063276)))";;"2268";4_13_4;COMUNA 4;"13";"4";"486";"227";"259";"87,64%";"274";"274";"100,00%";"0";"0,00%";"226";"1";"0.44";"225";"99,56%";"0.44";0.440
"MULTIPOLYGON (((-58.377454848773 -34.6333560778446,-58.3757895049536 -34.6332544063276,-58.3753938911145 -34.6344119077551,-58.3753550125056 -34.6345991394829,-58.3771335203592 -34.6347132911402,-58.3771801530953 -34.6345216275201,-58.3773873977874 -34.6335771646222,-58.377454848773 -34.6333560778446)))";;"2269";4_13_5;COMUNA 4;"13";"5";"956";"419";"537";"78,03%";"462";"462";"100,00%";"0";"0,00%";"391";"0";"0";"391";"100,00%";"0";0.000
"MULTIPOLYGON (((-58.3771335203592 -34.6347132911402,-58.3770880849648 -34.6349003779644,-58.3768251411625 -34.6360622022718,-58.3767811712683 -34.6362314020747,-58.3766922898282 -34.6365735334679,-58.3763244581666 -34.6378054254278,-58.3762697979032 -34.6380108157556,-58.3763517578625 -34.6380197473314,-58.3776690830424 -34.6381637055844,-58.3789484996478 -34.6383035389461,-58.380356825702 -34.6384573900928,-58.3804792557274 -34.6384707829723,-58.380604689915 -34.6384619939499,-58.3806506180719 -34.6384606867864,-58.3806813786006 -34.6384600736539,-58.3809968634378 -34.6371962311577,-58.3810208415215 -34.637160401005,-58.3810221475057 -34.6371319502681,-58.3810970101545 -34.637079252219,-58.3812167111708 -34.6338694402709,-58.3812260471143 -34.6336452138798,-58.3812503808197 -34.633070070587,-58.3810683969082 -34.6330622726181,-58.3802922329228 -34.6330354822156,-58.3801433035535 -34.6330317194103,-58.3801133520331 -34.6327338725287,-58.380092152435 -34.632632164715,-58.3796357411639 -34.6323620572037,-58.3795776185334 -34.6322920153203,-58.3795100492231 -34.6322114032403,-58.3795256915635 -34.63216077845,-58.379470863213 -34.6320342580394,-58.3790425731869 -34.6312753912409,-58.3790145456547 -34.6312518779233,-58.3789433750518 -34.6311954187687,-58.3788632511769 -34.6311462776029,-58.3787890765734 -34.6311118592705,-58.3787059262967 -34.6311069427242,-58.378602047778 -34.6311264492539,-58.3784891735375 -34.6311951060287,-58.37839111403 -34.6312735619931,-58.3782900524284 -34.631371664332,-58.3781840511118 -34.6314676504173,-58.3777659928157 -34.6325347188724,-58.3774922075366 -34.633233494332,-58.377454848773 -34.6333560778446,-58.3773873977874 -34.6335771646222,-58.3771801530953 -34.6345216275201,-58.3771335203592 -34.6347132911402)))";;"2270";4_13_6;COMUNA 4;"13";"6";"576";"285";"291";"97,94%";"201";"201";"100,00%";"0";"0,00%";"204";"41";"20.1";"163";"79,90%";"20.1";20.100
"MULTIPOLYGON (((-58.3771335203592 -34.6347132911402,-58.3753550125056 -34.6345991394829,-58.3752266788908 -34.6352646323223,-58.3750639024085 -34.6361092608749,-58.3767811712683 -34.6362314020747,-58.3768251411625 -34.6360622022718,-58.3770880849648 -34.6349003779644,-58.3771335203592 -34.6347132911402)))";;"2271";4_13_7;COMUNA 4;"13";"7";"898";"387";"511";"75,73%";"530";"530";"100,00%";"0";"0,00%";"400";"0";"0";"400";"100,00%";"0";0.000
"MULTIPOLYGON (((-58.3744073884648 -34.6333832065956,-58.3742414621333 -34.6342210008207,-58.3740661947947 -34.6351061838051,-58.3752266788908 -34.6352646323223,-58.3753550125056 -34.6345991394829,-58.3753938911145 -34.6344119077551,-58.3744073884648 -34.6333832065956)))";;"2272";4_13_8;COMUNA 4;"13";"8";"409";"180";"229";"78,60%";"196";"196";"100,00%";"0";"0,00%";"174";"30";"17.24";"144";"82,76%";"17.24";17.240
"MULTIPOLYGON (((-58.3752266788908 -34.6352646323223,-58.3740661947947 -34.6351061838051,-58.3738671071405 -34.6361129022445,-58.3750335739801 -34.6362668497549,-58.3750639024085 -34.6361092608749,-58.3752266788908 -34.6352646323223)))";;"2273";4_13_9;COMUNA 4;"13";"9";"407";"175";"232";"75,43%";"209";"209";"100,00%";"0";"0,00%";"170";"0";"0";"170";"100,00%";"0";0.000
"MULTIPOLYGON (((-58.3765898354166 -34.6278736409418,-58.3755729247856 -34.6273015907834,-58.3754513459602 -34.6274681291712,-58.3746923397259 -34.6284290948362,-58.3745589178115 -34.6285930180351,-58.3747595712278 -34.6286610524438,-58.3756192348252 -34.6289675244283,-58.374917468235 -34.6297688085145,-58.3747900282856 -34.6299140032209,-58.3767183146252 -34.6308400561115,-58.3768161083565 -34.6306071595975,-58.3771061268414 -34.6299441725745,-58.3772384880243 -34.6297317935739,-58.3773387612986 -34.6295708021224,-58.3779265013996 -34.6286202924449,-58.3777037247305 -34.6284932441549,-58.3765898354166 -34.6278736409418)))";;"2274";4_14_1;COMUNA 4;"14";"1";"635";"320";"315";"101,59%";"340";"340";"100,00%";"0";"0,00%";"272";"127";"46.69";"145";"53,31%";"46.69";46.690
"MULTIPOLYGON (((-58.3745605590305 -34.6267993677996,-58.3738658936913 -34.6267808350979,-58.3734963697448 -34.6282423043868,-58.3736809209997 -34.6283086385986,-58.3743206210253 -34.628512209124,-58.3745589178115 -34.6285930180351,-58.3746923397259 -34.6284290948362,-58.3754513459602 -34.6274681291712,-58.3755729247856 -34.6273015907834,-58.3745605590305 -34.6267993677996)))";;"2275";4_14_2;COMUNA 4;"14";"2";"588";"269";"319";"84,33%";"313";"313";"100,00%";"0";"0,00%";"259";"73";"28.19";"186";"71,81%";"28.19";28.190
"MULTIPOLYGON (((-58.3738658936913 -34.6267808350979,-58.3727853037786 -34.6267520142383,-58.3725472821684 -34.6267383169728,-58.3709636823314 -34.6266471332655,-58.370947387366 -34.6268224789971,-58.370793632074 -34.6281152233031,-58.3723115708223 -34.6282081212019,-58.372373332247 -34.6279782297204,-58.3724088061862 -34.6277913483467,-58.3733066236579 -34.6281742054663,-58.3734963697448 -34.6282423043868,-58.3738658936913 -34.6267808350979)))";;"2276";4_14_3;COMUNA 4;"14";"3";"645";"318";"327";"97,25%";"360";"360";"100,00%";"0";"0,00%";"277";"72";"25.99";"205";"74,01%";"25.99";25.990
"MULTIPOLYGON (((-58.3723115708223 -34.6282081212019,-58.370793632074 -34.6281152233031,-58.3707091842683 -34.6288258874771,-58.3707105988193 -34.6289337090193,-58.3707118620997 -34.6290242059281,-58.3706930213838 -34.6291894084559,-58.3720265396624 -34.6292693533263,-58.3720859075554 -34.629048263361,-58.3723115708223 -34.6282081212019)))";;"2277";4_14_4;COMUNA 4;"14";"4";"1110";"502";"608";"82,57%";"654";"654";"100,00%";"0";"0,00%";"495";"8";"1.62";"487";"98,38%";"1.62";1.620
"MULTIPOLYGON (((-58.3727740286138 -34.6302535307343,-58.3719820564409 -34.6294348891083,-58.3720265396624 -34.6292693533263,-58.3706930213838 -34.6291894084559,-58.3706888922277 -34.6292253220228,-58.370658180048 -34.6294937584333,-58.371049577053 -34.6298850519782,-58.3716627373378 -34.6305229969487,-58.3719332798163 -34.6308044049996,-58.3726884256781 -34.6303118497974,-58.3727740286138 -34.6302535307343)))";;"2278";4_14_5;COMUNA 4;"14";"5";"669";"294";"375";"78,40%";"344";"344";"100,00%";"0";"0,00%";"302";"2";"0.66";"300";"99,34%";"0.66";0.660
"MULTIPOLYGON (((-58.3727740286138 -34.6302535307343,-58.3726884256781 -34.6303118497974,-58.3719332798163 -34.6308044049996,-58.3726074737157 -34.6315057728964,-58.3727275566949 -34.6316306543514,-58.3729787873188 -34.6318920451374,-58.3733255062299 -34.6322549875875,-58.3734396335369 -34.6323740187026,-58.3742849972408 -34.6318154612386,-58.3734593787106 -34.6309620151219,-58.3727740286138 -34.6302535307343)))";;"2279";4_14_6;COMUNA 4;"14";"6";"497";"231";"266";"86,84%";"297";"297";"100,00%";"0";"0,00%";"208";"0";"0";"208";"100,00%";"0";0.000
"MULTIPOLYGON (((-58.3727740286138 -34.6302535307343,-58.3734593787106 -34.6309620151219,-58.3742849972408 -34.6318154612386,-58.3751382788515 -34.6312515512514,-58.374333354061 -34.6304042527852,-58.3736612910896 -34.6296966984644,-58.3736949888028 -34.6296552428144,-58.3731874963167 -34.6294638087856,-58.3734963697448 -34.6282423043868,-58.3733066236579 -34.6281742054663,-58.3724088061862 -34.6277913483467,-58.372373332247 -34.6279782297204,-58.3723115708223 -34.6282081212019,-58.3720859075554 -34.629048263361,-58.3720265396624 -34.6292693533263,-58.3719820564409 -34.6294348891083,-58.3727740286138 -34.6302535307343)))";;"2280";4_14_7;COMUNA 4;"14";"7";"757";"351";"406";"86,45%";"335";"335";"100,00%";"0";"0,00%";"289";"33";"11.42";"256";"88,58%";"11.42";11.420
"MULTIPOLYGON (((-58.3745589178115 -34.6285930180351,-58.3743206210253 -34.628512209124,-58.3736809209997 -34.6283086385986,-58.3734963697448 -34.6282423043868,-58.3731874963167 -34.6294638087856,-58.3736949888028 -34.6296552428144,-58.3736612910896 -34.6296966984644,-58.374333354061 -34.6304042527852,-58.3746449303664 -34.6300793969784,-58.3747900282856 -34.6299140032209,-58.374917468235 -34.6297688085145,-58.3756192348252 -34.6289675244283,-58.3747595712278 -34.6286610524438,-58.3745589178115 -34.6285930180351)))";;"2281";4_14_8;COMUNA 4;"14";"8";"992";"460";"532";"86,47%";"440";"440";"100,00%";"0";"0,00%";"410";"72";"17.56";"338";"82,44%";"17.56";17.560
"MULTIPOLYGON (((-58.3747900282856 -34.6299140032209,-58.3746449303664 -34.6300793969784,-58.374333354061 -34.6304042527852,-58.3751382788515 -34.6312515512514,-58.3760061327517 -34.6321476934569,-58.376159192117 -34.6321929444714,-58.3762335229705 -34.6319945399995,-58.3767183146252 -34.6308400561115,-58.3747900282856 -34.6299140032209)))";;"2282";4_14_9;COMUNA 4;"14";"9";"664";"326";"338";"96,45%";"363";"363";"100,00%";"0";"0,00%";"262";"18";"6.87";"244";"93,13%";"6.87";6.870
"MULTIPOLYGON (((-58.370658180048 -34.6294937584333,-58.3706312527386 -34.6297293092715,-58.3706145622112 -34.6298759212284,-58.3705331869382 -34.6308098341619,-58.3704523261658 -34.6317390992463,-58.3704356711472 -34.6319299379526,-58.3703592564114 -34.6326894119143,-58.3705666082955 -34.6327155554805,-58.3712902883937 -34.632814060919,-58.3713751120613 -34.6319929005246,-58.3713978641279 -34.6318342504045,-58.3714201866333 -34.6316787690722,-58.3715745355035 -34.631087104543,-58.3715830295868 -34.6310328837579,-58.3719332798163 -34.6308044049996,-58.3716627373378 -34.6305229969487,-58.371049577053 -34.6298850519782,-58.370658180048 -34.6294937584333)))";;"2283";4_15_1;COMUNA 4;"15";"1";"639";"295";"344";"85,76%";"328";"328";"100,00%";"0";"0,00%";"259";"3";"1.16";"256";"98,84%";"1.16";1.160
"MULTIPOLYGON (((-58.3715453125626 -34.6375510236538,-58.3706423871822 -34.6374656948887,-58.3707858529376 -34.6366360583906,-58.37013003715 -34.6365483060881,-58.3698042539858 -34.6365097473037,-58.3696702821552 -34.637374883983,-58.3695705530264 -34.6380183493919,-58.3705251598913 -34.6381435855747,-58.3714006234289 -34.6382584026247,-58.3715453125626 -34.6375510236538)))";;"2284";4_15_10;COMUNA 4;"15";"10";"527";"246";"281";"87,54%";"204";"204";"100,00%";"0";"0,00%";"188";"2";"1.06";"186";"98,94%";"1.06";1.060
"MULTIPOLYGON (((-58.3719332798163 -34.6308044049996,-58.3715830295868 -34.6310328837579,-58.3715745355035 -34.631087104543,-58.3714201866333 -34.6316787690722,-58.3713978641279 -34.6318342504045,-58.3713751120613 -34.6319929005246,-58.3712902883937 -34.632814060919,-58.3714852861711 -34.6328406162129,-58.3724680222953 -34.6329807883445,-58.3725103419038 -34.6327684183734,-58.3727275566949 -34.6316306543514,-58.3726074737157 -34.6315057728964,-58.3719332798163 -34.6308044049996)))";;"2285";4_15_2;COMUNA 4;"15";"2";"1292";"580";"712";"81,46%";"793";"793";"100,00%";"0";"0,00%";"624";"9";"1.44";"615";"98,56%";"1.44";1.440
"MULTIPOLYGON (((-58.3734396335369 -34.6323740187026,-58.3733255062299 -34.6322549875875,-58.3729787873188 -34.6318920451374,-58.3727275566949 -34.6316306543514,-58.3725103419038 -34.6327684183734,-58.3724680222953 -34.6329807883445,-58.3734500802025 -34.6331208816362,-58.3732664889041 -34.6340556366025,-58.3742414621333 -34.6342210008207,-58.3744073884648 -34.6333832065956,-58.3743489191576 -34.6333221763613,-58.373570958289 -34.6325057387464,-58.3734396335369 -34.6323740187026)))";;"2286";4_15_3;COMUNA 4;"15";"3";"1064";"476";"588";"80,95%";"579";"579";"100,00%";"0";"0,00%";"483";"0";"0";"483";"100,00%";"0";0.000
"MULTIPOLYGON (((-58.3734500802025 -34.6331208816362,-58.3724680222953 -34.6329807883445,-58.3714852861711 -34.6328406162129,-58.3712902883937 -34.632814060919,-58.3705666082955 -34.6327155554805,-58.3703592564114 -34.6326894119143,-58.370335393532 -34.63292580998,-58.3702790724755 -34.6333890922066,-58.370247800529 -34.6336218929478,-58.3705240764695 -34.6336544974676,-58.3711944399472 -34.6337419064654,-58.3719930168661 -34.6338460274539,-58.3722868315737 -34.6338919513126,-58.3724688793812 -34.6339203264765,-58.3732664889041 -34.6340556366025,-58.3734500802025 -34.6331208816362)))";;"2287";4_15_4;COMUNA 4;"15";"4";"732";"335";"397";"84,38%";"352";"352";"100,00%";"0";"0,00%";"297";"4";"1.35";"293";"98,65%";"1.35";1.350
"MULTIPOLYGON (((-58.3732664889041 -34.6340556366025,-58.3724688793812 -34.6339203264765,-58.3722868315737 -34.6338919513126,-58.3719930168661 -34.6338460274539,-58.3711944399472 -34.6337419064654,-58.3710960914953 -34.6346942577473,-58.3720998944481 -34.6348341669412,-58.3730844475848 -34.6349713775884,-58.3733418102985 -34.6350072717903,-58.3740661947947 -34.6351061838051,-58.3742414621333 -34.6342210008207,-58.3732664889041 -34.6340556366025)))";;"2288";4_15_5;COMUNA 4;"15";"5";"542";"251";"291";"86,25%";"258";"258";"100,00%";"0";"0,00%";"219";"4";"1.83";"215";"98,17%";"1.83";1.830
"MULTIPOLYGON (((-58.3711944399472 -34.6337419064654,-58.3705240764695 -34.6336544974676,-58.370247800529 -34.6336218929478,-58.3702301032146 -34.63375308096,-58.3701059204967 -34.6345579423063,-58.3699505815285 -34.6355646171857,-58.3699176253046 -34.6357780496597,-58.3698042539858 -34.6365097473037,-58.37013003715 -34.6365483060881,-58.3707858529376 -34.6366360583906,-58.3717088316453 -34.6367638672024,-58.3717433498427 -34.6365987468404,-58.3718984063325 -34.6358332041079,-58.3719460362403 -34.6355981616046,-58.3720512317053 -34.6350795612127,-58.3720998944481 -34.6348341669412,-58.3710960914953 -34.6346942577473,-58.3711944399472 -34.6337419064654)))";;"2289";4_15_6;COMUNA 4;"15";"6";"594";"273";"321";"85,05%";"315";"315";"100,00%";"0";"0,00%";"240";"13";"5.42";"227";"94,58%";"5.42";5.420
"MULTIPOLYGON (((-58.3730844475848 -34.6349713775884,-58.3720998944481 -34.6348341669412,-58.3720512317053 -34.6350795612127,-58.3719460362403 -34.6355981616046,-58.3718984063325 -34.6358332041079,-58.3721498903742 -34.6358706457903,-58.3726371023218 -34.6359398819823,-58.3728810065145 -34.6359747812672,-58.3735789840248 -34.6360748739377,-58.3738671071405 -34.6361129022445,-58.3740661947947 -34.6351061838051,-58.3733418102985 -34.6350072717903,-58.3730844475848 -34.6349713775884)))";;"2290";4_15_7;COMUNA 4;"15";"7";"644";"292";"352";"82,95%";"317";"317";"100,00%";"0";"0,00%";"274";"2";"0.73";"272";"99,27%";"0.73";0.730
"MULTIPOLYGON (((-58.3728810065145 -34.6359747812672,-58.3726371023218 -34.6359398819823,-58.3721498903742 -34.6358706457903,-58.3718984063325 -34.6358332041079,-58.3717433498427 -34.6365987468404,-58.3717088316453 -34.6367638672024,-58.3726924728565 -34.6368981224674,-58.3736850625325 -34.6370336439762,-58.3738671071405 -34.6361129022445,-58.3735789840248 -34.6360748739377,-58.3728810065145 -34.6359747812672)))";;"2291";4_15_8;COMUNA 4;"15";"8";"671";"298";"373";"79,89%";"340";"340";"100,00%";"0";"0,00%";"270";"0";"0";"270";"100,00%";"0";0.000
"MULTIPOLYGON (((-58.3726924728565 -34.6368981224674,-58.3717088316453 -34.6367638672024,-58.3707858529376 -34.6366360583906,-58.3706423871822 -34.6374656948887,-58.3715453125626 -34.6375510236538,-58.3714006234289 -34.6382584026247,-58.372397748211 -34.6383892899523,-58.3733777519208 -34.6385178325722,-58.373436961817 -34.6382880095009,-58.3735453357409 -34.6377398319677,-58.3736850625325 -34.6370336439762,-58.3726924728565 -34.6368981224674)))";;"2292";4_15_9;COMUNA 4;"15";"9";"663";"316";"347";"91,07%";"290";"290";"100,00%";"0";"0,00%";"254";"8";"3.15";"246";"96,85%";"3.15";3.150
"MULTIPOLYGON (((-58.3679712229014 -34.6251954311299,-58.3664879107171 -34.6251953265707,-58.3664687779063 -34.6253856700048,-58.3663352965605 -34.6264755308145,-58.3663022421228 -34.6266953712127,-58.3662409795714 -34.6268486377699,-58.3661109203304 -34.6270393863002,-58.3669594780465 -34.6272558371348,-58.3673696859701 -34.6276380725614,-58.3675680172508 -34.627494138094,-58.3679768648694 -34.6269028167969,-58.3679657947906 -34.6254738870033,-58.3679712229014 -34.6251954311299)))";;"2293";4_16_1;COMUNA 4;"16";"1";"681";"309";"372";"83,06%";"290";"290";"100,00%";"0";"0,00%";"259";"0";"0";"259";"100,00%";"0";0.000
"MULTIPOLYGON (((-58.3600424218401 -34.6310492103992,-58.3594318053936 -34.6314523700947,-58.3605229212334 -34.6319061910962,-58.3608148460168 -34.6320236926336,-58.3609395500035 -34.6319786544246,-58.362354069077 -34.6310474719936,-58.3616187709282 -34.630293389464,-58.3614516521769 -34.630118526809,-58.3600424218401 -34.6310492103992)))";;"2294";4_16_10;COMUNA 4;"16";"10";"786";"361";"425";"84,94%";"317";"317";"100,00%";"0";"0,00%";"280";"17";"6.07";"263";"93,93%";"6.07";6.070
"MULTIPOLYGON (((-58.368305448133 -34.6273688617268,-58.3680912982142 -34.6271893940552,-58.3680233366538 -34.627167509609,-58.3679451553048 -34.6271423776415,-58.3679784282022 -34.6271014866239,-58.3679776098197 -34.6269969754534,-58.3679768648694 -34.6269028167969,-58.3675680172508 -34.627494138094,-58.3673696859701 -34.6276380725614,-58.3668868245152 -34.6279806633927,-58.3669860636343 -34.6280680681521,-58.3666109910353 -34.6283208098349,-58.3660779218642 -34.628680048551,-58.3655620684843 -34.6290303546659,-58.3658429051044 -34.6293759415184,-58.3659829019104 -34.6295823270189,-58.3661884704648 -34.6299634178933,-58.3663133911733 -34.6302414835647,-58.3664507422604 -34.6306016038527,-58.3664639473289 -34.6306761237595,-58.3665181224187 -34.6309816694651,-58.3665745723967 -34.632122173757,-58.3665938891471 -34.6325122720957,-58.3665780572207 -34.6328681162488,-58.3665410155201 -34.633219013922,-58.366489459745 -34.6335215182692,-58.366349841493 -34.6339388863326,-58.3662431440222 -34.6341799365364,-58.365710270084 -34.6339718312001,-58.3652399381359 -34.6337632805484,-58.3648246082188 -34.6343876864146,-58.3646820465876 -34.6346189173981,-58.3645636428623 -34.6348110818838,-58.3641860615778 -34.6354241774357,-58.3640416180591 -34.6356586456482,-58.3637685213689 -34.6361024526935,-58.3636856126137 -34.63624936193,-58.3639306400057 -34.6363406198446,-58.3646926932413 -34.6366503993662,-58.3649435724492 -34.6367669424381,-58.3651198702718 -34.636833705454,-58.3652245110458 -34.6367540682856,-58.3656006533255 -34.6360583602357,-58.3656407001174 -34.6359848686376,-58.3657701557271 -34.6357400341861,-58.3657613176282 -34.6357200969472,-58.3660999363958 -34.6351190787508,-58.3669227283229 -34.635214308147,-58.3672197147126 -34.6342786658445,-58.3675098534527 -34.6333647081686,-58.3678060569127 -34.6324315988257,-58.368095327624 -34.6315203853624,-58.3683864729899 -34.6306033272585,-58.3671621214288 -34.6303363093258,-58.3674677433318 -34.6293563047538,-58.3675777306908 -34.6293594188462,-58.368350887726 -34.6295248839438,-58.3686154490954 -34.6295823437103,-58.3687162592769 -34.6295642518142,-58.369444475919 -34.6283231498969,-58.3686345906136 -34.6276446181408,-58.368305448133 -34.6273688617268)))";;"2295";4_16_2;COMUNA 4;"16";"2";"1933";"866";"1067";"81,16%";"1405";"1405";"100,00%";"0";"0,00%";"929";"48";"5.17";"881";"94,83%";"5.17";5.170
"MULTIPOLYGON (((-58.3687162592769 -34.6295642518142,-58.3686154490954 -34.6295823437103,-58.368350887726 -34.6295248839438,-58.3675777306908 -34.6293594188462,-58.3674677433318 -34.6293563047538,-58.3671621214288 -34.6303363093258,-58.3683864729899 -34.6306033272585,-58.3687162592769 -34.6295642518142)))";;"2296";4_16_3;COMUNA 4;"16";"3";"1245";"557";"688";"80,96%";"470";"470";"100,00%";"0";"0,00%";"438";"5";"1.14";"433";"98,86%";"1.14";1.140
"MULTIPOLYGON (((-58.3702480543503 -34.6290923786603,-58.3696300935623 -34.6284999172518,-58.369444475919 -34.6283231498969,-58.3687162592769 -34.6295642518142,-58.3683864729899 -34.6306033272585,-58.368095327624 -34.6315203853624,-58.3691100456013 -34.6316134247237,-58.3693711028081 -34.6306980313802,-58.3705331869382 -34.6308098341619,-58.3706145622112 -34.6298759212284,-58.3706312527386 -34.6297293092715,-58.370658180048 -34.6294937584333,-58.3704592064597 -34.6292947987362,-58.3702480543503 -34.6290923786603)))";;"2297";4_16_4;COMUNA 4;"16";"4";"646";"277";"369";"75,07%";"299";"299";"100,00%";"0";"0,00%";"267";"16";"5.99";"251";"94,01%";"5.99";5.990
"MULTIPOLYGON (((-58.3691100456013 -34.6316134247237,-58.3688474434594 -34.6325337459152,-58.370095509143 -34.6326561122834,-58.3703592564114 -34.6326894119143,-58.3704356711472 -34.6319299379526,-58.3704523261658 -34.6317390992463,-58.3705331869382 -34.6308098341619,-58.3693711028081 -34.6306980313802,-58.3691100456013 -34.6316134247237)))";;"2298";4_16_5;COMUNA 4;"16";"5";"970";"432";"538";"80,30%";"462";"462";"100,00%";"0";"0,00%";"412";"18";"4.37";"394";"95,63%";"4.37";4.370
"MULTIPOLYGON (((-58.3703592564114 -34.6326894119143,-58.370095509143 -34.6326561122834,-58.3688474434594 -34.6325337459152,-58.3685824401244 -34.6334626563719,-58.3685838207411 -34.6336735797551,-58.3684721555168 -34.6343956999491,-58.3698698567327 -34.6345262829768,-58.3701059204967 -34.6345579423063,-58.3702301032146 -34.63375308096,-58.370247800529 -34.6336218929478,-58.3702790724755 -34.6333890922066,-58.370335393532 -34.63292580998,-58.3703592564114 -34.6326894119143)))";;"2299";4_16_6;COMUNA 4;"16";"6";"557";"256";"301";"85,05%";"289";"289";"100,00%";"0";"0,00%";"248";"37";"14.92";"211";"85,08%";"14.92";14.920
"MULTIPOLYGON (((-58.3678060569127 -34.6324315988257,-58.3675098534527 -34.6333647081686,-58.3672197147126 -34.6342786658445,-58.3684721555168 -34.6343956999491,-58.3685838207411 -34.6336735797551,-58.3685824401244 -34.6334626563719,-58.3688474434594 -34.6325337459152,-58.3691100456013 -34.6316134247237,-58.368095327624 -34.6315203853624,-58.3678060569127 -34.6324315988257)))";;"2300";4_16_7;COMUNA 4;"16";"7";"401";"188";"213";"88,26%";"186";"186";"100,00%";"0";"0,00%";"156";"5";"3.21";"151";"96,79%";"3.21";3.210
"MULTIPOLYGON (((-58.3640798606601 -34.6299113070416,-58.3631782935331 -34.628978360922,-58.3624491023954 -34.6294598923734,-58.3614516521769 -34.630118526809,-58.3616187709282 -34.630293389464,-58.362354069077 -34.6310474719936,-58.3633023266557 -34.6319910961082,-58.3630808869955 -34.6321357088941,-58.3623523327828 -34.6326309024273,-58.363786800353 -34.6331934303903,-58.364500123889 -34.6334731707508,-58.3652399381359 -34.6337632805484,-58.365710270084 -34.6339718312001,-58.3662431440222 -34.6341799365364,-58.366349841493 -34.6339388863326,-58.366489459745 -34.6335215182692,-58.3665410155201 -34.633219013922,-58.3665780572207 -34.6328681162488,-58.3665938891471 -34.6325122720957,-58.3665745723967 -34.632122173757,-58.3665181224187 -34.6309816694651,-58.3664639473289 -34.6306761237595,-58.3664507422604 -34.6306016038527,-58.3663133911733 -34.6302414835647,-58.3661884704648 -34.6299634178933,-58.3659829019104 -34.6295823270189,-58.3658429051044 -34.6293759415184,-58.3655620684843 -34.6290303546659,-58.3655111931181 -34.6289677768598,-58.3653109932646 -34.6291007201714,-58.3648065719678 -34.6294328625755,-58.3640798606601 -34.6299113070416)))";;"2301";4_16_8;COMUNA 4;"16";"8";"611";"297";"314";"94,59%";"258";"258";"100,00%";"0";"0,00%";"219";"65";"29.68";"154";"70,32%";"29.68";29.680
"MULTIPOLYGON (((-58.362354069077 -34.6310474719936,-58.3609395500035 -34.6319786544246,-58.3608148460168 -34.6320236926336,-58.3612304229978 -34.6321909459036,-58.3623523327828 -34.6326309024273,-58.3630808869955 -34.6321357088941,-58.3633023266557 -34.6319910961082,-58.362354069077 -34.6310474719936)))";;"2302";4_16_9;COMUNA 4;"16";"9";"1064";"491";"573";"85,69%";"514";"514";"100,00%";"0";"0,00%";"431";"25";"5.8";"406";"94,20%";"5.8";5.800
"MULTIPOLYGON (((-58.3606790552028 -34.6276230822949,-58.3614172752275 -34.6271382588024,-58.3614173730586 -34.6271382048865,-58.3615993136318 -34.6270186875167,-58.3621407411558 -34.6266589821996,-58.3621408442118 -34.626658929441,-58.362754552338 -34.6262511631562,-58.3640534589856 -34.6265917389227,-58.3642371685492 -34.6266399171288,-58.3652266930287 -34.6268761422766,-58.3653456522954 -34.6269996921079,-58.3656661120542 -34.6273327050396,-58.3661109203304 -34.6270393863002,-58.3662409795714 -34.6268486377699,-58.3663022421228 -34.6266953712127,-58.3663352965605 -34.6264755308145,-58.3664687779063 -34.6253856700048,-58.3664879107171 -34.6251953265707,-58.3637271095944 -34.6251279747271,-58.3634550081614 -34.6251213449807,-58.3630909852653 -34.6251124564278,-58.3629990105463 -34.6250122370681,-58.3622066467854 -34.6241446561818,-58.3619472292777 -34.6238669680075,-58.3618971167095 -34.6238124881423,-58.3617902592024 -34.6239043747394,-58.3610269271687 -34.6243981238105,-58.3612623080159 -34.6246845970445,-58.361199638585 -34.6247275041096,-58.3597792714405 -34.6256416968707,-58.3595507735313 -34.6257846072553,-58.3594712683285 -34.6257996813511,-58.3594452623715 -34.6258171247146,-58.3593190819029 -34.6258916682293,-58.3593345626028 -34.625911611594,-58.3558281865124 -34.6281846515979,-58.355803626404 -34.6282028701171,-58.3557751454177 -34.6282224936916,-58.3557487112241 -34.6282404992821,-58.3557241507203 -34.6282589994842,-58.3556956679781 -34.6282799611108,-58.3556632638062 -34.6283027503361,-58.3556401518866 -34.6283210405176,-58.3556143995712 -34.6283387649778,-58.3555811386764 -34.6283652155218,-58.3555529102764 -34.6283870928612,-58.3555319296868 -34.6284042580963,-58.3555057492536 -34.6284236019289,-58.3554847681015 -34.6284411897044,-58.3554652380114 -34.6284566660061,-58.3554485219597 -34.6284701728828,-58.35542412945 -34.6284904337929,-58.3553950465457 -34.628514211815,-58.3553730422546 -34.6285323620698,-58.355350099423 -34.6285515678676,-58.3553342359418 -34.6285645825046,-58.3553129132936 -34.6285826629236,-58.3552886055522 -34.6286032055802,-58.3552576427804 -34.6286312074053,-58.355236916571 -34.6286492179112,-58.3552103921146 -34.6286709558217,-58.3551824181975 -34.6286935375469,-58.3551628814496 -34.6287140843835,-58.3551356671931 -34.6287421599066,-58.3551184361186 -34.6287585537024,-58.35510325196 -34.6287732591047,-58.3550815012199 -34.6287928884517,-58.3550599188636 -34.6288140672902,-58.3550341584485 -34.6288378481568,-58.3549924451319 -34.6288778126493,-58.3549698379013 -34.6289008920378,-58.3549488526919 -34.6289214375599,-58.3549345185382 -34.6289376226136,-58.3549200148033 -34.6289531736921,-58.3549032095402 -34.6289696382579,-58.3548777845388 -34.6289975040288,-58.3548550932309 -34.629019667798,-58.3548293274069 -34.6290475332572,-58.3548105566312 -34.6290685736874,-58.3547928948768 -34.629088488298,-58.3547708842837 -34.629111286477,-58.3547554392066 -34.6291300058209,-58.3547347049187 -34.6291540727701,-58.3547148257007 -34.6291757460276,-58.3546954575688 -34.6291974901592,-58.3546713929488 -34.6292273994113,-58.3546590199773 -34.6292422480964,-58.3546466470014 -34.6292570967803,-58.3546342739297 -34.6292720158876,-58.3546219009449 -34.6292868645688,-58.3546096132451 -34.6293016428995,-58.3545972402515 -34.6293164915782,-58.3545848672536 -34.6293313402556,-58.3545724941598 -34.6293462593564,-58.354560121153 -34.6293611080311,-58.3545477481417 -34.6293759567046,-58.3545354603243 -34.6293908054523,-58.3545230873956 -34.6294055836984,-58.3545106290816 -34.6294205027172,-58.3544983412509 -34.6294353514611,-58.3544859682176 -34.629450200128,-58.3544735951799 -34.6294650487937,-58.354451067722 -34.6294920719458,-58.3544399717311 -34.6295076259898,-58.3544288758276 -34.629523109608,-58.3544178651182 -34.6295385933007,-58.3544066838251 -34.6295542176907,-58.3543955879092 -34.6295697013057,-58.3543844919891 -34.6295851849196,-58.3543733108665 -34.6296006684568,-58.3543622149382 -34.6296161520686,-58.3543511189142 -34.6296317061041,-58.354340022886 -34.6296472601386,-58.3543288417468 -34.6296627436716,-58.354317745802 -34.6296782272792,-58.3543067349598 -34.6296937813861,-58.3542956390067 -34.6297092649916,-58.354284457851 -34.6297247485203,-58.3542733617063 -34.6297403729732,-58.3542622657408 -34.6297558565755,-58.3542444268054 -34.6297807711108,-58.3542265030275 -34.6298054038684,-58.3542102822026 -34.6298308128114,-58.3541986700705 -34.6298500988902,-58.3541841603538 -34.6298700162136,-58.3541699020075 -34.6298931733018,-58.3541556422774 -34.6299173867597,-58.3541396791151 -34.6299411761506,-58.3541238809278 -34.629969120752,-58.3541062072558 -34.6299979087796,-58.354090752228 -34.630024022636,-58.3540758071902 -34.6300510524675,-58.3540591538507 -34.6300813907431,-58.3540439513593 -34.6301098288379,-58.3540243088711 -34.6301456575832,-58.3540055161512 -34.6301831772787,-58.3539845082403 -34.6302206949966,-58.3539640098507 -34.630259480812,-58.3539421422829 -34.6303028430175,-58.3539277031021 -34.6303338874964,-58.3539097660568 -34.6303685205205,-58.3538939616427 -34.6304011131239,-58.3538767855684 -34.6304401835864,-58.3538587568414 -34.6304797462592,-58.353831422973 -34.6305333855916,-58.3538090310932 -34.6305866772051,-58.3537843412852 -34.6306380652916,-58.353763653981 -34.6306908654441,-58.3537457915857 -34.630733456515,-58.3537253576219 -34.6307879470825,-58.3537074937124 -34.630831664943,-58.3536908241455 -34.6308741866458,-58.3536771417108 -34.6309127672254,-58.3536603818444 -34.6309591622086,-58.3536418227178 -34.631013231887,-58.3536278010971 -34.6310505445099,-58.3536091488929 -34.6311106002098,-58.3535869961784 -34.6311762163365,-58.3537950679361 -34.6312313336618,-58.3540885636587 -34.6306573512734,-58.3542580929057 -34.6303436890345,-58.3545104421598 -34.6300239026448,-58.3548703389211 -34.6295501212683,-58.355286330638 -34.629178433815,-58.3556503378074 -34.6288810679553,-58.3559754035672 -34.6286530354147,-58.3568428454117 -34.6280801103594,-58.3570462113255 -34.6279450005061,-58.357301845968 -34.6277752160237,-58.3584649495773 -34.627026190546,-58.3596783772205 -34.6282803616632,-58.3599490120908 -34.6281025558712,-58.3604338325815 -34.6277841499117,-58.3606348025864 -34.6276522011733,-58.3606790552028 -34.6276230822949)))";;"2303";4_17_1;COMUNA 4;"17";"1";"577";"273";"304";"89,80%";"249";"249";"100,00%";"0";"0,00%";"221";"1";"0.45";"220";"99,55%";"0.45";0.450
"MULTIPOLYGON (((-58.3584649495773 -34.627026190546,-58.357301845968 -34.6277752160237,-58.3570462113255 -34.6279450005061,-58.3568428454117 -34.6280801103594,-58.3559754035672 -34.6286530354147,-58.3556503378074 -34.6288810679553,-58.355286330638 -34.629178433815,-58.3548703389211 -34.6295501212683,-58.3545104421598 -34.6300239026448,-58.3542580929057 -34.6303436890345,-58.3564016040205 -34.6312247595773,-58.3565701269045 -34.631293993088,-58.3575281295864 -34.6316898357699,-58.3580196653758 -34.6308651612788,-58.3581708315448 -34.6309157151036,-58.3592355085903 -34.6302132195567,-58.3606460117247 -34.6292825462218,-58.3599385777036 -34.6285498858427,-58.3598384321501 -34.6284431077599,-58.3596783772205 -34.6282803616632,-58.3584649495773 -34.627026190546)))";;"2304";4_17_10;COMUNA 4;"17";"10";"881";"425";"456";"93,20%";"301";"301";"100,00%";"0";"0,00%";"280";"47";"16.79";"233";"83,21%";"16.79";16.790
"MULTIPOLYGON (((-58.3666109910353 -34.6283208098349,-58.3669860636343 -34.6280680681521,-58.3668868245152 -34.6279806633927,-58.3673696859701 -34.6276380725614,-58.3669594780464 -34.6272558371348,-58.3661109203304 -34.6270393863002,-58.3656661120542 -34.6273327050396,-58.3653456522954 -34.6269996921079,-58.3652266930287 -34.6268761422766,-58.3642371685492 -34.6266399171288,-58.3640534589856 -34.6265917389227,-58.3635220223444 -34.6269358748695,-58.3635917339927 -34.6270224972685,-58.3637006780118 -34.6271416136255,-58.3639926257675 -34.6274808993489,-58.364228968031 -34.6277282521413,-58.3645548172116 -34.6280692785593,-58.3646676864386 -34.6279946752431,-58.3655737883437 -34.6289162757176,-58.3655415470797 -34.6289475891055,-58.3655111931181 -34.6289677768598,-58.3655620684843 -34.6290303546659,-58.3660779218642 -34.628680048551,-58.3666109910353 -34.6283208098349)))";;"2305";4_17_2;COMUNA 4;"17";"2";"590";"268";"322";"83,23%";"297";"297";"100,00%";"0";"0,00%";"240";"8";"3.33";"232";"96,67%";"3.33";3.330
"MULTIPOLYGON (((-58.3639058563318 -34.628497809695,-58.3631782935331 -34.628978360922,-58.3640798606601 -34.6299113070416,-58.3648065719678 -34.6294328625755,-58.3653109932646 -34.6291007201714,-58.3655111931181 -34.6289677768598,-58.3655415470798 -34.6289475891055,-58.3655737883437 -34.6289162757176,-58.3646676864386 -34.6279946752431,-58.3645548172116 -34.6280692785593,-58.3641857777208 -34.6283129595354,-58.3639058563318 -34.628497809695)))";;"2306";4_17_3;COMUNA 4;"17";"3";"584";"273";"311";"87,78%";"261";"261";"100,00%";"0";"0,00%";"217";"30";"13.82";"187";"86,18%";"13.82";13.820
"MULTIPOLYGON (((-58.3621408442118 -34.626658929441,-58.3622262517814 -34.6266835222946,-58.3628885940809 -34.6273644791133,-58.3629540772806 -34.6273205875527,-58.3636735656349 -34.6280318312301,-58.3638097327829 -34.6279410231872,-58.3638451593177 -34.6279765841348,-58.3641857777208 -34.6283129595354,-58.3645548172116 -34.6280692785593,-58.364228968031 -34.6277282521413,-58.3639926257675 -34.6274808993489,-58.3637006780118 -34.6271416136255,-58.3635917339927 -34.6270224972685,-58.3635220223444 -34.6269358748695,-58.3640534589856 -34.6265917389227,-58.362754552338 -34.6262511631562,-58.3621408442118 -34.626658929441)))";;"2307";4_17_4;COMUNA 4;"17";"4";"675";"286";"389";"73,52%";"340";"340";"100,00%";"0";"0,00%";"296";"1";"0.34";"295";"99,66%";"0.34";0.340
"MULTIPOLYGON (((-58.362156755938 -34.6278488261825,-58.3623641357759 -34.6280643538124,-58.3628569827587 -34.6285764653309,-58.363673565635 -34.6280318312301,-58.3629540772806 -34.6273205875527,-58.3628885940809 -34.6273644791133,-58.3622262517814 -34.6266835222946,-58.3621408442118 -34.626658929441,-58.3621407411558 -34.6266589821996,-58.3615993136318 -34.6270186875167,-58.3614173730586 -34.6271382048865,-58.3616379312828 -34.6273708979165,-58.3617293030231 -34.6273194648105,-58.3621335465196 -34.6277165693238,-58.3620680948308 -34.6277613942741,-58.3621566835268 -34.6278487547753,-58.362156755938 -34.6278488261825)))";;"2308";4_17_5;COMUNA 4;"17";"5";"759";"343";"416";"82,45%";"394";"394";"100,00%";"0";"0,00%";"328";"0";"0";"328";"100,00%";"0";0.000
"MULTIPOLYGON (((-58.3621566835268 -34.6278487547753,-58.3620680948308 -34.6277613942741,-58.3621335465196 -34.6277165693238,-58.3617293030231 -34.6273194648105,-58.3616379312828 -34.6273708979165,-58.3614173730586 -34.6271382048865,-58.3614172752275 -34.6271382588024,-58.3606790552028 -34.6276230822949,-58.3606348025864 -34.6276522011733,-58.3608836071293 -34.6279059386578,-58.3613102749869 -34.6283940567156,-58.3615261631939 -34.6282550060094,-58.3618653416346 -34.628036476794,-58.3621566835268 -34.6278487547753)))";;"2309";4_17_6;COMUNA 4;"17";"6";"607";"271";"336";"80,65%";"342";"342";"100,00%";"0";"0,00%";"280";"1";"0.36";"279";"99,64%";"0.36";0.360
"MULTIPOLYGON (((-58.3620805680993 -34.6290791538316,-58.3623469915309 -34.6293543119695,-58.3624491023954 -34.6294598923734,-58.3631782935331 -34.628978360922,-58.3639058563318 -34.628497809695,-58.3641857777208 -34.6283129595354,-58.3638482810304 -34.6279797176897,-58.3638451593177 -34.6279765841348,-58.3638097327829 -34.6279410231872,-58.363673565635 -34.6280318312301,-58.3628569827587 -34.6285764653309,-58.3623641357759 -34.6280643538124,-58.3621566858131 -34.6278487533021,-58.3618653416346 -34.628036476794,-58.3615261631939 -34.6282550060094,-58.3613102749869 -34.6283940567156,-58.3615721756592 -34.6286713255589,-58.3616415819645 -34.628625536495,-58.3620805680993 -34.6290791538316)))";;"2310";4_17_7;COMUNA 4;"17";"7";"609";"281";"328";"85,67%";"303";"303";"100,00%";"0";"0,00%";"255";"14";"5.49";"241";"94,51%";"5.49";5.490
"MULTIPOLYGON (((-58.3592355085903 -34.6302132195567,-58.3581708315448 -34.6309157151036,-58.3580196653758 -34.6308651612788,-58.3575281295864 -34.6316898357699,-58.3577894743127 -34.6317978108242,-58.3589810716979 -34.6322929304954,-58.3590679055186 -34.6321448304785,-58.3594318053936 -34.6314523700947,-58.3600424218401 -34.6310492103992,-58.3614516521769 -34.630118526809,-58.3624491023954 -34.6294598923734,-58.3623469915309 -34.6293543119695,-58.3620805680993 -34.6290791538316,-58.3616415819645 -34.628625536495,-58.3615721756592 -34.6286713255589,-58.3606460117247 -34.6292825462218,-58.3592355085903 -34.6302132195567)))";;"2311";4_17_8;COMUNA 4;"17";"8";"994";"496";"498";"99,60%";"409";"409";"100,00%";"0";"0,00%";"358";"87";"24.3";"271";"75,70%";"24.3";24.300
"MULTIPOLYGON (((-58.3604338325815 -34.6277841499117,-58.3599490120908 -34.6281025558712,-58.3596783772205 -34.6282803616632,-58.3598384321501 -34.6284431077599,-58.3599385777036 -34.6285498858427,-58.3606460117247 -34.6292825462218,-58.3615721756592 -34.6286713255589,-58.3613102749869 -34.6283940567156,-58.3608836071293 -34.6279059386578,-58.3606348025864 -34.6276522011733,-58.3604338325815 -34.6277841499117)))";;"2312";4_17_9;COMUNA 4;"17";"9";"757";"332";"425";"78,12%";"438";"438";"100,00%";"0";"0,00%";"337";"1";"0.3";"336";"99,70%";"0.3";0.300
"MULTIPOLYGON (((-58.3512390781477 -34.6193067940371,-58.3508569622711 -34.6194695485226,-58.3508744819718 -34.6196182316785,-58.3507853072851 -34.6196687150237,-58.3506782891782 -34.6195579791839,-58.3501603620579 -34.6197346212564,-58.3495799795767 -34.619793030146,-58.3490911076151 -34.6196500357256,-58.3483201111846 -34.6190599991832,-58.3478429354891 -34.6189649701183,-58.3473016984109 -34.6189325568243,-58.3472246652592 -34.618949597197,-58.3465568284368 -34.6191088278735,-58.346340827548 -34.6190225627307,-58.3459680293682 -34.6188522007099,-58.3459150491449 -34.6188476428046,-58.3451985835873 -34.6188148410306,-58.3445824178875 -34.6189987593942,-58.3445288469689 -34.6190503290101,-58.3445729713016 -34.6193529877996,-58.3446604856481 -34.6196352653139,-58.3452059975449 -34.6198405877071,-58.3454384877922 -34.6198934188473,-58.3459026142149 -34.6195756137269,-58.3462421630626 -34.6193398034611,-58.3463361398795 -34.6192073533623,-58.3465547041359 -34.6192884095048,-58.3466706507527 -34.6194066224992,-58.3468914104631 -34.6196249383687,-58.3471517509877 -34.6199899865093,-58.3471001842438 -34.6205628446251,-58.3469629224326 -34.6210082226726,-58.3464533163137 -34.6216202237996,-58.3465093681689 -34.6219893742699,-58.3461841581186 -34.6225645765765,-58.3460590175482 -34.6226824891528,-58.3460231262523 -34.6228226004209,-58.3460408175259 -34.6229038876981,-58.3459294887694 -34.6229527969226,-58.3459430490781 -34.6226380809344,-58.3459522834343 -34.6224315334729,-58.3460953733809 -34.622210183943,-58.346113542077 -34.6220109691869,-58.3458370085156 -34.6218926723993,-58.3457488708726 -34.6221109052122,-58.3457449130038 -34.6219566003987,-58.3457189093273 -34.6218498112706,-58.3456229801631 -34.6216711216131,-58.3454804192766 -34.6215159794284,-58.3452841164668 -34.6214124772605,-58.3450343583514 -34.6213385016991,-58.3448646705317 -34.6213309432871,-58.3446951217222 -34.6213455686284,-58.3445164906078 -34.6213969467513,-58.3443379127677 -34.6214706493678,-58.3441929335465 -34.621580371507,-58.3441055507695 -34.6216843746353,-58.3440875452864 -34.6217655570745,-58.3440429895537 -34.6217064976513,-58.3440877763486 -34.6216031574076,-58.3440789362987 -34.6215294139073,-58.3441593126102 -34.6214999135671,-58.3442308276779 -34.6214114588984,-58.3442399928798 -34.6212564625159,-58.3442758340683 -34.6211532543576,-58.3442314044244 -34.621005600547,-58.3442315827602 -34.6208801034771,-58.3442763686744 -34.6207769039984,-58.3443212699766 -34.6205923638035,-58.3443393481632 -34.6204596303241,-58.3443127232413 -34.6203119938004,-58.3442711660269 -34.6201215244027,-58.3441970631114 -34.6200536332136,-58.3441971994499 -34.619957714563,-58.3441277281114 -34.6198079940344,-58.3440905689892 -34.6196402760954,-58.3440283991308 -34.6194483780527,-58.3439035114867 -34.6193301538451,-58.3438501502573 -34.6192341830756,-58.3436896231956 -34.6191380373562,-58.3434796091957 -34.6189776155066,-58.3433417675942 -34.6189237464721,-58.3432242440706 -34.6188991235419,-58.3430729538756 -34.6188377759852,-58.3430569668591 -34.6187587434978,-58.3429966274866 -34.6186586808554,-58.3429316094515 -34.618613404212,-58.3428525248918 -34.6185755787617,-58.3426718993944 -34.6185363153217,-58.3424139807196 -34.6185169056921,-58.3420445500609 -34.6184990050524,-58.3416093510333 -34.6184839254531,-58.3414411027771 -34.618486504906,-58.3409679518793 -34.6185597686202,-58.3405303973288 -34.6186406016219,-58.3403964074447 -34.6186920888611,-58.3403071962075 -34.6186477725128,-58.3401599151088 -34.6185845943169,-58.3399057562858 -34.6184997583703,-58.3396038638238 -34.6184925524731,-58.3392031367688 -34.6185547552541,-58.3389147274025 -34.618646367522,-58.3385841084834 -34.6188228686702,-58.3384233761018 -34.6189262297222,-58.338317308406 -34.6189895040833,-58.3382025276604 -34.6191257297138,-58.3381283098595 -34.6193096743541,-58.3381178756447 -34.6195083324883,-58.3381332517428 -34.61953708157,-58.3381290995369 -34.6196363765095,-58.3381086217001 -34.6197152315396,-58.3380684572216 -34.6197994891747,-58.3380193200919 -34.6198453560293,-58.337966368239 -34.6199355866793,-58.3379336916376 -34.6199685825628,-58.3378707681226 -34.6200617608179,-58.3378328606109 -34.6201745427817,-58.337787001809 -34.6204201380283,-58.3377468197837 -34.6205724964448,-58.3376438965788 -34.620866203812,-58.3376349761712 -34.620963451501,-58.3375873065283 -34.6210526310099,-58.337524182068 -34.6211086244982,-58.3374636019995 -34.6211720856082,-58.3373616838993 -34.6213060700005,-58.3372504416127 -34.6214653976899,-58.3371626206806 -34.6216284114745,-58.3371586891295 -34.6216934800593,-58.3371335005178 -34.6217316244432,-58.3371267390934 -34.6218090144745,-58.3371271905119 -34.6218486641709,-58.3370664218875 -34.6219801553552,-58.3370449973641 -34.6222338742744,-58.337114858364 -34.6224005715712,-58.3371371770409 -34.6225146124851,-58.3371938223144 -34.6226323508105,-58.3372442587653 -34.6226868411504,-58.3373283902616 -34.6227684796954,-58.3374511317281 -34.6228381151706,-58.337567400764 -34.6228497137555,-58.3377982934949 -34.6228907968358,-58.3380042743298 -34.6228991064322,-58.3382479296817 -34.622837099636,-58.3385335648087 -34.6227880228487,-58.3386929343509 -34.6227467046894,-58.3387973090989 -34.6227364582869,-58.3388719744464 -34.6227111107088,-58.3390131658629 -34.6226913941251,-58.3390826862124 -34.6226885771737,-58.3392023229066 -34.622669683625,-58.3392981983902 -34.6226459066048,-58.3394443968222 -34.6226390823463,-58.3395888864145 -34.6226356365838,-58.3396407625559 -34.6226392805983,-58.339971726946 -34.6226998273299,-58.3400215652906 -34.6226988915127,-58.3401227618539 -34.6227062470084,-58.3403083728669 -34.6227205887867,-58.3406086737254 -34.622719833344,-58.3407475763326 -34.6226920840211,-58.3408664250445 -34.6226874843103,-58.3410093152577 -34.6226708658086,-58.3410659600371 -34.6226759928973,-58.341193924576 -34.6227295729379,-58.3413544668267 -34.6228180455885,-58.3415260899215 -34.6228440621348,-58.3416674138022 -34.6228501885546,-58.3417835567919 -34.6228316411325,-58.341836575665 -34.6228111295998,-58.3418986221439 -34.6227924580321,-58.3419436507276 -34.6227596846041,-58.3420034325141 -34.6226576276384,-58.3420242852735 -34.6225531376896,-58.341899491418 -34.622486533048,-58.3418731541519 -34.622436857395,-58.3418713919866 -34.6224183338954,-58.3419065070188 -34.6223482958756,-58.3419354429536 -34.6223095203933,-58.3420143213898 -34.6222564980648,-58.3420542085318 -34.6222442131586,-58.34210481707 -34.6222406715294,-58.3422366702571 -34.622256154441,-58.3423191781658 -34.6222853213841,-58.3424179255832 -34.6223366881356,-58.3424831548041 -34.6223554854655,-58.3425438554338 -34.6223836448145,-58.3426767227235 -34.6224642008767,-58.3427010962164 -34.6225172548209,-58.3427265426095 -34.6225351677799,-58.3428439688041 -34.6225716928962,-58.3429294654054 -34.6225963551672,-58.3429875094554 -34.6226356388236,-58.3430578216062 -34.6226745823606,-58.3424964259846 -34.6232546134576,-58.3423917594949 -34.6233488092303,-58.3423265640382 -34.6234240995671,-58.3422192536408 -34.6235789988504,-58.341879897836 -34.6233679518784,-58.3418816756837 -34.6231405516011,-58.340673579151 -34.6231343489062,-58.3400860489353 -34.6233402455959,-58.3384885158368 -34.6246631104402,-58.3382314825959 -34.6247233434206,-58.338224782505 -34.6247031246401,-58.3377964556087 -34.6247996618811,-58.3377764413652 -34.6247386534314,-58.3377572867959 -34.6247293377279,-58.3375029853625 -34.6247853464765,-58.337251667818 -34.6247831163797,-58.3371639913032 -34.6247913363172,-58.3370436145667 -34.6248467071861,-58.3370179026346 -34.6248922455995,-58.3360616080987 -34.6256746629385,-58.3360283884227 -34.6256706142278,-58.3359510181888 -34.6256796186669,-58.3358113400914 -34.6257647579747,-58.3357409889882 -34.6258637725728,-58.3356973179024 -34.6258975310515,-58.3357047820789 -34.6259750766093,-58.3351421976962 -34.6264488715263,-58.335144059897 -34.6271248113176,-58.3362467279162 -34.6280382430037,-58.3361886530419 -34.6281872721904,-58.3363336711265 -34.6282350297111,-58.3364099839655 -34.628082005124,-58.336972048234 -34.6282379429867,-58.3369136369155 -34.6283848594228,-58.3381403898825 -34.6287279605289,-58.3382139880655 -34.6285652134213,-58.3387824494262 -34.6287207269163,-58.3387260564695 -34.6288872947937,-58.338863425457 -34.6289242665288,-58.3389354008286 -34.6287634188129,-58.3391001096445 -34.6288061224322,-58.3391712152013 -34.6287718975644,-58.3392187603945 -34.6286535615403,-58.3393406422632 -34.6286776997379,-58.3393869278847 -34.6286619009493,-58.3394446836745 -34.6286097745131,-58.339727101132 -34.6278672886563,-58.3397354874867 -34.6278421554372,-58.3402531937662 -34.6279811315014,-58.3405369040019 -34.6277452814299,-58.3406363789867 -34.6278270738506,-58.3407661997406 -34.6277235383033,-58.3406654464971 -34.6276419559828,-58.3410621769463 -34.6273118483778,-58.3411659074226 -34.6273966024603,-58.3412992169083 -34.6272951121339,-58.341190463561 -34.6272078178649,-58.3415134877332 -34.6269417219493,-58.34158958721 -34.6268695416155,-58.3416971371643 -34.6269641585261,-58.3417754084703 -34.6269216995256,-58.3418031682363 -34.6268726409086,-58.341803380611 -34.6268436964978,-58.3417147081922 -34.6267738175337,-58.3419662324257 -34.6265787785804,-58.3421116941916 -34.6264380022977,-58.3422266558613 -34.6265328373497,-58.3423226794283 -34.626468000416,-58.3423547648585 -34.62643197454,-58.3422401457934 -34.6263358722977,-58.3424344417143 -34.6261823969365,-58.3427315573203 -34.6262132539114,-58.3427136754942 -34.6263252823026,-58.3428901862429 -34.6263346814599,-58.3429081369357 -34.6262338506659,-58.3433146191802 -34.6262815746975,-58.343298801972 -34.6263802244682,-58.3434685970719 -34.6264389840529,-58.3434912012022 -34.626300691688,-58.3442756309481 -34.626393430666,-58.344364807788 -34.6264692943784,-58.3438213063598 -34.6269161046986,-58.3437011484351 -34.6268191533376,-58.343571332025 -34.6269231850078,-58.343692254497 -34.6270216865881,-58.3433207973247 -34.6273214743965,-58.3432047259771 -34.6272264984486,-58.3430785730555 -34.6273296176516,-58.3431958298776 -34.6274296654696,-58.3428128462105 -34.6277443000594,-58.3427057093184 -34.6276570791589,-58.3426792826306 -34.6276680394374,-58.342579561522 -34.6277557610761,-58.3426849009656 -34.6278487551558,-58.34231973271 -34.6281543208928,-58.3421949798331 -34.6280534197409,-58.3421418416462 -34.6280952700215,-58.3420763127646 -34.6281627426732,-58.3421881266179 -34.6282560957024,-58.3418031735644 -34.6285722744719,-58.3416945859659 -34.6284866710289,-58.3416359228324 -34.6285192899491,-58.341563671629 -34.6285805582609,-58.3416770158485 -34.6286760964423,-58.3413902362846 -34.6289134954237,-58.3413921197711 -34.6289657525319,-58.341542824063 -34.6290902725929,-58.3418549521055 -34.6291746694909,-58.3418181706351 -34.6292755518434,-58.3419789457037 -34.6293300790491,-58.3420226379294 -34.6292223722766,-58.3423729232694 -34.6293153974243,-58.3423294011311 -34.6294235974629,-58.3423406914978 -34.6294519898148,-58.3424885342856 -34.6294946017885,-58.3425413769653 -34.6293627481297,-58.3428378376719 -34.629442197337,-58.3431816778057 -34.6291592155959,-58.3432751237631 -34.6292300136671,-58.3433140349163 -34.6292470241457,-58.3433993520477 -34.6291638654567,-58.3434043339483 -34.6291356299666,-58.3433090275574 -34.6290551115437,-58.3436758945694 -34.6287534179149,-58.3437895863605 -34.6288460670538,-58.3439178692368 -34.6287439351647,-58.3438048611305 -34.6286498078883,-58.3441884443163 -34.6283332693424,-58.3443101397359 -34.6284293765964,-58.344404986211 -34.6283539027487,-58.3444166290821 -34.6283144056961,-58.3443135777286 -34.6282282465481,-58.3445678553395 -34.6280129225878,-58.3449962340507 -34.6283684892648,-58.3464543257081 -34.6271886513387,-58.3467080867795 -34.6273994632675,-58.3452651413727 -34.6285926290666,-58.3453534638366 -34.6286725054263,-58.3470544932488 -34.627277605035,-58.3487578661377 -34.6286761556587,-58.3487760736455 -34.6287565978491,-58.3484424956465 -34.628778047115,-58.3484304601067 -34.6287945856809,-58.3484409661746 -34.6289615024222,-58.3487769384333 -34.6289342101354,-58.3487826980057 -34.6290836570482,-58.3487234075281 -34.6292652273456,-58.3486829013128 -34.6293546290449,-58.3484988986886 -34.6293981907376,-58.3484792007371 -34.6294107079161,-58.348481042035 -34.6295591652138,-58.3484609218417 -34.6298175351193,-58.3484325608891 -34.6298722286549,-58.3479592761834 -34.6299382654041,-58.3479026066867 -34.6300708924779,-58.3478860765748 -34.6301338367239,-58.3482573328386 -34.6301016493479,-58.3482941340879 -34.6302912675318,-58.3482589713443 -34.6303354613422,-58.3481347238543 -34.630417107937,-58.3480832010927 -34.63077221196,-58.3479756949923 -34.6310082453397,-58.3479221329564 -34.6311729890417,-58.3478381867328 -34.6311905162241,-58.3477347518453 -34.6308831552568,-58.3476614536958 -34.6309022417008,-58.3477577369762 -34.6312056521996,-58.3477234682041 -34.6312806927636,-58.3476908587017 -34.6313263677303,-58.3476199108424 -34.631370738875,-58.3475750653025 -34.6313925986748,-58.3474726216758 -34.6314163759534,-58.3473330027107 -34.6314603299128,-58.347224093763 -34.6314768471102,-58.3471647165987 -34.6314714385943,-58.3471180153308 -34.6314797044773,-58.3469483507854 -34.6315017274012,-58.3468854798228 -34.6314967379826,-58.3468495110089 -34.6315069858479,-58.3467679925498 -34.6314938093765,-58.3467512236742 -34.6314825958904,-58.3467336700292 -34.6314230702287,-58.3461376925957 -34.631545745573,-58.3460931458501 -34.6316581714288,-58.3477866362005 -34.6321205682578,-58.3477181206643 -34.6321306448604,-58.3476861996255 -34.6321711090321,-58.347695950309 -34.6322054855351,-58.3477252750873 -34.6322559373473,-58.347776601019 -34.6322924657715,-58.3477936051149 -34.632318679822,-58.347729868131 -34.6325086258986,-58.3477078066253 -34.6325045204623,-58.3476905918373 -34.6325692246307,-58.347705165521 -34.6326279022373,-58.3477468136755 -34.6325773060594,-58.3477639975329 -34.6325349969433,-58.3477542273547 -34.6325147053911,-58.3478058128084 -34.6323631293782,-58.3478498043731 -34.6323430293136,-58.3479499982134 -34.6323450955123,-58.3481725510148 -34.6324019262363,-58.3483779045744 -34.6324506415812,-58.348546443207 -34.6325053082389,-58.3486981070498 -34.632501435875,-58.3488619270556 -34.6325177865895,-58.3489842047133 -34.6325078299056,-58.3490330141212 -34.6325159038306,-58.3490720581541 -34.6325624205854,-58.3501160653809 -34.6323485226201,-58.3509156890261 -34.6315790922718,-58.351138361261 -34.6313557677503,-58.3512510697731 -34.6311731887862,-58.3513450852186 -34.6309521406901,-58.351949761185 -34.629532151797,-58.3518471434254 -34.6294973391293,-58.3518542686452 -34.6294569217418,-58.3517889472952 -34.6294375659544,-58.3518491389876 -34.6292781083875,-58.3519014282956 -34.6292949170112,-58.3519967256446 -34.6292604249377,-58.3521856190425 -34.6291892558547,-58.352385250037 -34.6289871059622,-58.3526416785837 -34.629064452822,-58.3529552423813 -34.6291669218094,-58.3529881357316 -34.6291616695362,-58.3533883088117 -34.6287084927491,-58.3539254317597 -34.6280921919782,-58.3541471065903 -34.6279671740452,-58.354532180074 -34.6277169444467,-58.3562869874451 -34.6265714075356,-58.3571778347053 -34.6259979368964,-58.3573113780847 -34.6258964292272,-58.3576519378156 -34.6256646025325,-58.3576764499991 -34.6256158896107,-58.3599572937757 -34.6241486980537,-58.3600143026012 -34.624205860664,-58.3604948367996 -34.6238904789005,-58.3608183268315 -34.6242278735932,-58.3608351756608 -34.6242437332705,-58.3608547601349 -34.6242518484887,-58.3608770759481 -34.6242557404888,-58.3608978704178 -34.624249701302,-58.3617706873972 -34.623674702877,-58.3614461926738 -34.6233213938102,-58.3603435384869 -34.6221528281762,-58.3598051449845 -34.621601772344,-58.3592858738157 -34.6210702793935,-58.3588853110227 -34.6206602772093,-58.3587647568686 -34.62053263496,-58.3577894472019 -34.6195000743947,-58.3576808068317 -34.6193850473677,-58.3572562916502 -34.6189319190298,-58.3566990693153 -34.6183371197365,-58.3564549148839 -34.6180764757592,-58.356386472095 -34.6180393725909,-58.3563393112635 -34.6180138376382,-58.3562352828083 -34.6178926159218,-58.3562337167328 -34.6178946131557,-58.3560026388234 -34.6176393369889,-58.3557976657254 -34.6181430574223,-58.3555371757176 -34.6187268945905,-58.3553940196766 -34.6190349329556,-58.3553921056702 -34.6190346093558,-58.3552475220566 -34.6193352102132,-58.3551428496741 -34.6195528309668,-58.3542491596341 -34.6194643012338,-58.3540718296357 -34.6197015460115,-58.3535174718528 -34.6194047028665,-58.3530817295946 -34.6195384012291,-58.3529301538711 -34.6197522159685,-58.3526902397425 -34.619770099067,-58.3525632726188 -34.6195396948767,-58.3522155793571 -34.6196343837481,-58.3519196539775 -34.6196203120827,-58.3514633115781 -34.6193565778844,-58.3515521109707 -34.6193314466858,-58.3516133268236 -34.61922931582,-58.3515188502092 -34.6191678896059,-58.3515012985321 -34.6192340026518,-58.351467837561 -34.619284466847,-58.3513412115934 -34.6193119579094,-58.3512390781477 -34.6193067940371)))";;"2313";4_18_1;COMUNA 4;"18";"1";"74";"70";"4";"1750,00%";"45";"45";"100,00%";"0";"0,00%";"45";"40";"88.89";"5";"11,11%";"88.89";88.890
"MULTIPOLYGON (((-58.3623523327828 -34.6326309024273,-58.3612304229978 -34.6321909459036,-58.3608148460168 -34.6320236926336,-58.3604293485765 -34.6326878986277,-58.3603360259635 -34.6328484593493,-58.3618687323037 -34.6334728548091,-58.3619726274442 -34.6333042732324,-58.3623523327828 -34.6326309024273)))";;"2314";4_19_1;COMUNA 4;"19";"1";"674";"295";"379";"77,84%";"287";"287";"100,00%";"0";"0,00%";"255";"48";"18.82";"207";"81,18%";"18.82";18.820
"MULTIPOLYGON (((-58.3579073836394 -34.636953500262,-58.3577144047826 -34.6368757966299,-58.357250264209 -34.636692784791,-58.3571748096635 -34.6366630002768,-58.3571176652659 -34.6366404148946,-58.3566212507069 -34.6364446258303,-58.356180404354 -34.6372391259449,-58.356102898008 -34.6374222463445,-58.3560146926544 -34.6375411189679,-58.3566312336212 -34.6382408180468,-58.3568743428451 -34.63851533991,-58.356938561856 -34.6385878564061,-58.3580225376213 -34.6392269101987,-58.3583225872559 -34.6392250234145,-58.3584769964897 -34.6389492646123,-58.3584739782253 -34.6389489078272,-58.3588508131 -34.638365971525,-58.3589781880352 -34.6381688201866,-58.3592578471528 -34.637749819129,-58.3593825854155 -34.6375473128284,-58.3595106526582 -34.6373395273522,-58.3597458022154 -34.6369420374264,-58.3598727623787 -34.6367322787195,-58.3597118042626 -34.6366669295713,-58.3583904888207 -34.636146987363,-58.35828990668 -34.6363149348129,-58.3579917421272 -34.6368142725249,-58.3579073836394 -34.636953500262)))";;"2315";4_19_10;COMUNA 4;"19";"10";"644";"313";"331";"94,56%";"290";"290";"100,00%";"0";"0,00%";"263";"68";"25.86";"195";"74,14%";"25.86";25.860
"MULTIPOLYGON (((-58.3618687323037 -34.6334728548091,-58.3603360259635 -34.6328484593493,-58.3602619995618 -34.6329757252654,-58.35986621989 -34.6336797107471,-58.3600916428235 -34.6337677907552,-58.3613689701663 -34.6342845794828,-58.3614327434376 -34.6341805445936,-58.3618687323037 -34.6334728548091)))";;"2316";4_19_2;COMUNA 4;"19";"2";"735";"357";"378";"94,44%";"295";"295";"100,00%";"0";"0,00%";"259";"19";"7.34";"240";"92,66%";"7.34";7.340
"MULTIPOLYGON (((-58.3608148460168 -34.6320236926336,-58.3605229212334 -34.6319061910962,-58.3594318053936 -34.6314523700947,-58.3590679055186 -34.6321448304785,-58.3589810716979 -34.6322929304954,-58.3586023120461 -34.6329389667983,-58.35849729139 -34.6331167701971,-58.3590033281459 -34.6333047427451,-58.3592024549782 -34.6333659701884,-58.3592551751386 -34.6333821421945,-58.3597001162802 -34.6335771729198,-58.3597794645086 -34.633626185143,-58.35986621989 -34.6336797107471,-58.3602619995618 -34.6329757252654,-58.3603360259635 -34.6328484593493,-58.3604293485765 -34.6326878986277,-58.3608148460168 -34.6320236926336)))";;"2317";4_19_3;COMUNA 4;"19";"3";"904";"425";"479";"88,73%";"351";"351";"100,00%";"0";"0,00%";"323";"72";"22.29";"251";"77,71%";"22.29";22.290
"MULTIPOLYGON (((-58.3589810716979 -34.6322929304954,-58.3577894743127 -34.6317978108242,-58.3575281295864 -34.6316898357699,-58.3565701269045 -34.631293993088,-58.3564016040205 -34.6312247595773,-58.3542580929057 -34.6303436890345,-58.3540885636587 -34.6306573512734,-58.3537950679361 -34.6312313336618,-58.353494012158 -34.6321098958675,-58.3554019445263 -34.6328840085912,-58.3565501272678 -34.6333498874295,-58.358012731401 -34.633943212908,-58.3581323630257 -34.6337341538669,-58.35849729139 -34.6331167701971,-58.3586023120461 -34.6329389667983,-58.3589810716979 -34.6322929304954)))";;"2318";4_19_4;COMUNA 4;"19";"4";"1134";"526";"608";"86,51%";"375";"375";"100,00%";"0";"0,00%";"375";"152";"40.53";"223";"59,47%";"40.53";40.530
"MULTIPOLYGON (((-58.3590033281459 -34.6333047427451,-58.35849729139 -34.6331167701971,-58.3581323630257 -34.6337341538669,-58.358012731401 -34.633943212908,-58.3585004410077 -34.6341411016855,-58.358570953467 -34.6341696839494,-58.3593708641905 -34.634494177469,-58.3592660978529 -34.6346727563723,-58.3589986719793 -34.6351291636348,-58.3588846847019 -34.6353216080328,-58.3590813246693 -34.6353994537907,-58.3603656517072 -34.6359209773119,-58.3608672314411 -34.635102145599,-58.3609850480145 -34.6349097025302,-58.3613689701663 -34.6342845794828,-58.3600916428235 -34.6337677907552,-58.35986621989 -34.6336797107471,-58.3597794645086 -34.633626185143,-58.3597001162802 -34.6335771729198,-58.3592551751386 -34.6333821421945,-58.3592024549782 -34.6333659701884,-58.3590033281459 -34.6333047427451)))";;"2319";4_19_5;COMUNA 4;"19";"5";"805";"369";"436";"84,63%";"312";"312";"100,00%";"0";"0,00%";"286";"28";"9.79";"258";"90,21%";"9.79";9.790
"MULTIPOLYGON (((-58.3575421159863 -34.6347848773512,-58.3570733614394 -34.6356297810047,-58.3575734363754 -34.6358252897074,-58.3576393520781 -34.6358513332488,-58.3583904888207 -34.636146987363,-58.3597118042626 -34.6366669295713,-58.3598727623787 -34.6367322787195,-58.3602231585536 -34.6361536115647,-58.3603656517072 -34.6359209773119,-58.3590813246693 -34.6353994537907,-58.3588846847019 -34.6353216080328,-58.3589986719793 -34.6351291636348,-58.3592660978529 -34.6346727563723,-58.3593708641905 -34.634494177469,-58.358570953467 -34.6341696839494,-58.3585004410077 -34.6341411016855,-58.358012731401 -34.633943212908,-58.3578917328261 -34.6341547355172,-58.3575421159863 -34.6347848773512)))";;"2320";4_19_6;COMUNA 4;"19";"6";"1147";"573";"574";"99,83%";"377";"377";"100,00%";"0";"0,00%";"363";"174";"47.93";"189";"52,07%";"47.93";47.930
"MULTIPOLYGON (((-58.358012731401 -34.633943212908,-58.3565501272678 -34.6333498874295,-58.3560771829474 -34.634204854551,-58.3556094384728 -34.6350503873535,-58.355716823499 -34.6350949900595,-58.3569305441402 -34.6355739512332,-58.3570733614394 -34.6356297810047,-58.3575421159863 -34.6347848773512,-58.3578917328261 -34.6341547355172,-58.358012731401 -34.633943212908)))";;"2321";4_19_7;COMUNA 4;"19";"7";"933";"456";"477";"95,60%";"272";"272";"100,00%";"0";"0,00%";"287";"202";"70.38";"85";"29,62%";"70.38";70.380
"MULTIPOLYGON (((-58.3537950679361 -34.6312313336618,-58.3535869961784 -34.6311762163365,-58.3535588680813 -34.6312504893657,-58.3535399611044 -34.6313098405767,-58.3530073917242 -34.6328502578249,-58.3529801347882 -34.632844458474,-58.3529566940914 -34.6329169045144,-58.3529825841122 -34.6329255196333,-58.3529580366981 -34.6329972604293,-58.3529295863353 -34.6329918825423,-58.3529064076538 -34.6330593990705,-58.352932980071 -34.6330674514155,-58.3529147587661 -34.6331230706134,-58.3528857980795 -34.6331169880088,-58.3528615884557 -34.6331909122562,-58.352887649327 -34.6331992458495,-58.3527538883136 -34.6335818841547,-58.3528021681561 -34.6337338339611,-58.3529701494426 -34.6342806224752,-58.3532436745119 -34.6351714601272,-58.3534712857935 -34.6356678067622,-58.353496774247 -34.6357234651607,-58.3541310948984 -34.6365300429902,-58.3542375267222 -34.6365877451473,-58.3546347161041 -34.636800531553,-58.3547317533074 -34.6366332933805,-58.3547332779161 -34.6366342428114,-58.3551575695759 -34.6358672693509,-58.3556094384728 -34.6350503873535,-58.3560771829474 -34.634204854551,-58.3565501272678 -34.6333498874295,-58.3554019445263 -34.6328840085912,-58.353494012158 -34.6321098958675,-58.3537950679361 -34.6312313336618)))";;"2322";4_19_8;COMUNA 4;"19";"8";"1520";"768";"752";"102,13%";"277";"277";"100,00%";"0";"0,00%";"459";"184";"40.09";"275";"59,91%";"40.09";40.090
"MULTIPOLYGON (((-58.3570733614394 -34.6356297810047,-58.3569305441402 -34.6355739512332,-58.355716823499 -34.6350949900595,-58.3556094384728 -34.6350503873535,-58.3551575695759 -34.6358672693509,-58.3547332779161 -34.6366342428114,-58.3547317533074 -34.6366332933805,-58.3546347161041 -34.636800531553,-58.3560125052859 -34.6375386365439,-58.3560146926544 -34.6375411189679,-58.356102898008 -34.6374222463445,-58.356180404354 -34.6372391259449,-58.3566212507069 -34.6364446258303,-58.3571176652659 -34.6366404148946,-58.3571748096635 -34.6366630002768,-58.357250264209 -34.636692784791,-58.3577144047826 -34.6368757966299,-58.3579073836394 -34.636953500262,-58.3579917421272 -34.6368142725249,-58.35828990668 -34.6363149348129,-58.3583904888207 -34.636146987363,-58.3576393520781 -34.6358513332488,-58.3575734363754 -34.6358252897074,-58.3570733614394 -34.6356297810047)))";;"2323";4_19_9;COMUNA 4;"19";"9";"1129";"570";"559";"101,97%";"339";"339";"100,00%";"0";"0,00%";"339";"159";"46.9";"180";"53,10%";"46.9";46.900
"MULTIPOLYGON (((-58.4237374648477 -34.6511613982344,-58.4237875537682 -34.6512058521755,-58.4239091192188 -34.6511181418078,-58.4248125829207 -34.6504662232436,-58.4249840175021 -34.6503393711727,-58.4252932974348 -34.650110586327,-58.4247285597597 -34.6500844955095,-58.4240947109562 -34.6500552111073,-58.4225593465565 -34.6499843611375,-58.4224820206715 -34.6500504644068,-58.422398711664 -34.6499769135658,-58.4210250074204 -34.6499134921866,-58.4199294553183 -34.6498607873326,-58.419419088509 -34.6498392685866,-58.4184258835712 -34.6497922909042,-58.4182771691504 -34.6502846459717,-58.4182347415826 -34.6504220994177,-58.4181575693182 -34.6506717970406,-58.4180668230841 -34.6509652937623,-58.4178006282459 -34.6518513492071,-58.4186828103667 -34.6517439915866,-58.4188611891229 -34.6517233510053,-58.4195825440027 -34.6516400141708,-58.4200143846411 -34.6515901646149,-58.4207834636918 -34.6515013442488,-58.4211429462494 -34.651459775907,-58.4216506357426 -34.651401424999,-58.4222823276737 -34.651328746515,-58.4226168375912 -34.6512902642305,-58.4237374648477 -34.6511613982344)))";;"2324";4_2_1;COMUNA 4;"2";"1";"753";"344";"409";"84,11%";"316";"316";"100,00%";"0";"0,00%";"274";"41";"14.96";"233";"85,04%";"14.96";14.960
"MULTIPOLYGON (((-58.4072962618936 -34.6492787831728,-58.4075535167699 -34.6493092528088,-58.4084408751082 -34.6493454970204,-58.4087004437102 -34.6493571618836,-58.4101003782843 -34.6494180572794,-58.4118886442334 -34.6495001560043,-58.4119485419082 -34.6492388350517,-58.4120145059501 -34.6489508256338,-58.4120817493882 -34.6486602109849,-58.4120817656654 -34.648660130006,-58.4121010464562 -34.6485808996477,-58.4104603156181 -34.6483178852073,-58.4103695096746 -34.6483036178517,-58.4090996167447 -34.6480981259652,-58.4090079975653 -34.6480834350007,-58.406365449203 -34.6476596754338,-58.4049992030786 -34.6474405597865,-58.4049596114314 -34.6474342099169,-58.4036449120786 -34.647214809885,-58.4035768404342 -34.6472034495159,-58.4027476240549 -34.6470624568992,-58.4027980943885 -34.6471284225288,-58.4031269780637 -34.6475581741557,-58.4034809808434 -34.6480208253877,-58.4036100507216 -34.6481894142252,-58.4039264299008 -34.6485990865374,-58.4044328474841 -34.6492547014258,-58.4045016390823 -34.6493477652432,-58.4046061420181 -34.6494343669707,-58.4050450225269 -34.6497982481554,-58.4052228583979 -34.6499456604685,-58.4053357098212 -34.6500388149898,-58.4054891471594 -34.6501011424596,-58.4058292333027 -34.6498878444409,-58.4059103131917 -34.6498345003449,-58.4059674340743 -34.6497992441848,-58.4060693965825 -34.6497398531761,-58.4061286459432 -34.6497073444895,-58.4062647878609 -34.6496378984431,-58.4063271029048 -34.6496084193383,-58.4064368126093 -34.6495597361484,-58.4065164291963 -34.6495269549693,-58.4065970671604 -34.6494959348242,-58.406662616504 -34.6494720910072,-58.406760981379 -34.6494388253094,-58.4068280627255 -34.6494177286675,-58.4069284699842 -34.6493885483999,-58.4072962618936 -34.6492787831728)))";;"2325";4_2_10;COMUNA 4;"2";"10";"1051";"513";"538";"95,35%";"310";"310";"100,00%";"0";"0,00%";"316";"37";"11.71";"279";"88,29%";"11.71";11.710
"MULTIPOLYGON (((-58.4195825440027 -34.6516400141708,-58.4188611891229 -34.6517233510053,-58.4186828103667 -34.6517439915866,-58.4178006282459 -34.6518513492071,-58.4178625827007 -34.653278386091,-58.4189281733947 -34.6535058222107,-58.4189912258464 -34.6546661605942,-58.4197066932011 -34.6541504843431,-58.4205773146349 -34.6535223190169,-58.4214172318989 -34.6529163207681,-58.4222423031918 -34.6523209458625,-58.4227292585197 -34.651969546718,-58.4230680446913 -34.6517250725572,-58.4234623265485 -34.6514405436971,-58.4237875537682 -34.6512058521755,-58.4237374648477 -34.6511613982344,-58.4226168375912 -34.6512902642305,-58.4222823276737 -34.651328746515,-58.4216506357426 -34.651401424999,-58.4211429462494 -34.651459775907,-58.4207834636918 -34.6515013442488,-58.4200143846411 -34.6515901646149,-58.4195825440027 -34.6516400141708)))";;"2326";4_2_2;COMUNA 4;"2";"2";"826";"363";"463";"78,40%";"342";"341";"99,71%";"1";"0,29%";"282";"25";"8.87";"257";"91,13%";"8.87";8.870
"MULTIPOLYGON (((-58.4164910305064 -34.6497057254076,-58.4163423265466 -34.6496997532961,-58.4163501374719 -34.6500584994381,-58.4163578927719 -34.6508235957249,-58.4163676741485 -34.6517766560233,-58.4163700964669 -34.6520180725678,-58.4163725230692 -34.6522518128203,-58.4163761595687 -34.6526085853351,-58.4163884179868 -34.653399106295,-58.4163954548404 -34.6542312461076,-58.4164092384892 -34.6547317589587,-58.4164141065219 -34.6548666239048,-58.4164465109555 -34.6557525775229,-58.4164799227911 -34.6566673350361,-58.4164811562632 -34.6567482533371,-58.4164874092758 -34.6571521406129,-58.4164881501646 -34.6571992549289,-58.4167098504768 -34.657152999387,-58.4167297672644 -34.6567375019372,-58.417597402286 -34.6558925901887,-58.4180787509028 -34.655423880402,-58.4182765765519 -34.6552292990718,-58.4189912258464 -34.6546661605942,-58.4189281733947 -34.6535058222107,-58.4178625827007 -34.653278386091,-58.4178006282459 -34.6518513492071,-58.4180668230841 -34.6509652937623,-58.4181575693182 -34.6506717970406,-58.4182347415826 -34.6504220994177,-58.4182771691504 -34.6502846459717,-58.4184258835712 -34.6497922909042,-58.4176479366898 -34.6497574274659,-58.4167759968173 -34.6497171010044,-58.4164910305064 -34.6497057254076)))";;"2327";4_2_3;COMUNA 4;"2";"3";"1049";"478";"571";"83,71%";"457";"455";"99,56%";"2";"0,44%";"383";"37";"9.66";"346";"90,34%";"9.66";9.660
"MULTIPOLYGON (((-58.4164092384892 -34.6547317589587,-58.4163954548404 -34.6542312461076,-58.4163884179868 -34.653399106295,-58.4162508002748 -34.6533682783953,-58.4152115555879 -34.6531353360204,-58.4139197508433 -34.6528458034667,-58.4137561529369 -34.653521602912,-58.4136754595666 -34.6534998797166,-58.4134194231101 -34.6539769736348,-58.4147929403001 -34.6543237283483,-58.4144340170117 -34.6549909302669,-58.4142627009857 -34.6553093927514,-58.4141788343184 -34.6554649977436,-58.415066254581 -34.6559596577968,-58.4162703719555 -34.6566307754936,-58.416309904604 -34.656652833432,-58.4164811562632 -34.6567482533371,-58.4164799227911 -34.6566673350361,-58.4164465109555 -34.6557525775229,-58.4164141065219 -34.6548666239048,-58.4164092384892 -34.6547317589587)))";;"2328";4_2_4;COMUNA 4;"2";"4";"796";"376";"420";"89,52%";"263";"263";"100,00%";"0";"0,00%";"273";"14";"5.13";"259";"94,87%";"5.13";5.130
"MULTIPOLYGON (((-58.4139197508433 -34.6528458034667,-58.4125251060583 -34.6525331860944,-58.4121137104281 -34.6524409711423,-58.411979845133 -34.652410985071,-58.4114616838395 -34.6522928072013,-58.4113299171552 -34.6525916338477,-58.4113232061386 -34.6526948735092,-58.4113626888887 -34.6527927099302,-58.4114284369407 -34.6528633734823,-58.4114518651362 -34.6528762710355,-58.4115270909738 -34.6529177123017,-58.4118701381536 -34.6530127881635,-58.4117042733364 -34.6533268831008,-58.4116030815562 -34.6535184660984,-58.4114233925489 -34.6538585415114,-58.4113323508899 -34.6540342125751,-58.411257179374 -34.6541792555613,-58.4129830998783 -34.65479851072,-58.4141788343184 -34.6554649977436,-58.4142627009857 -34.6553093927514,-58.4144340170117 -34.6549909302669,-58.4147929403001 -34.6543237283483,-58.4134194231101 -34.6539769736348,-58.4136754595666 -34.6534998797166,-58.4137561529369 -34.653521602912,-58.4139197508433 -34.6528458034667)))";;"2329";4_2_5;COMUNA 4;"2";"5";"738";"343";"395";"86,84%";"275";"274";"99,64%";"1";"0,36%";"231";"45";"19.48";"186";"80,52%";"19.48";19.480
"MULTIPOLYGON (((-58.4110714809756 -34.6516988221791,-58.4108834507843 -34.6521617843348,-58.4114616838395 -34.6522928072013,-58.411979845133 -34.652410985071,-58.4121137104281 -34.6524409711423,-58.4125251060583 -34.6525331860944,-58.4139197508433 -34.6528458034667,-58.4152115555879 -34.6531353360204,-58.4162508002748 -34.6533682783953,-58.4163884179868 -34.653399106295,-58.4163761595687 -34.6526085853351,-58.4163725230692 -34.6522518128203,-58.4163700964669 -34.6520180725678,-58.4163676741485 -34.6517766560233,-58.4162202386065 -34.6517818113368,-58.4155457846698 -34.651805426338,-58.4151758447711 -34.6517959162445,-58.4144244323919 -34.6516781527954,-58.4143369182858 -34.6516644557391,-58.4142108034636 -34.6516432078412,-58.4136768611494 -34.6515534846451,-58.4127244476121 -34.6511009014598,-58.4115173465184 -34.6507466578185,-58.4114605934317 -34.6507409295883,-58.4110714809756 -34.6516988221791)))";;"2330";4_2_6;COMUNA 4;"2";"6";"683";"313";"370";"84,59%";"292";"292";"100,00%";"0";"0,00%";"257";"10";"3.89";"247";"96,11%";"3.89";3.890
"MULTIPOLYGON (((-58.4118886442334 -34.6495001560043,-58.4117905510351 -34.6499286490946,-58.4117193708931 -34.6501038358807,-58.4114605934317 -34.6507409295883,-58.4115173465184 -34.6507466578185,-58.4127244476121 -34.6511009014598,-58.4136768611494 -34.6515534846451,-58.4142108034636 -34.6516432078412,-58.4143369182858 -34.6516644557391,-58.4144244323919 -34.6516781527954,-58.4151758447711 -34.6517959162445,-58.4155457846698 -34.651805426338,-58.4162202386065 -34.6517818113368,-58.4163676741485 -34.6517766560233,-58.4163578927719 -34.6508235957249,-58.4163501374719 -34.6500584994381,-58.4163423265466 -34.6496997532961,-58.4161747048463 -34.6496922244446,-58.4162042468175 -34.6491336977619,-58.4163300278684 -34.6491362809437,-58.4163287837852 -34.6490748701671,-58.4162067518473 -34.6490733447833,-58.4160805444091 -34.6490714655579,-58.4160775804132 -34.6490381535603,-58.4158580596684 -34.6490349003241,-58.4156986178491 -34.6490317402887,-58.4155148097355 -34.6490177252212,-58.4153853639408 -34.6490161257219,-58.4149616083747 -34.648954409413,-58.4149499055273 -34.6490031386964,-58.4148543843105 -34.6489882416519,-58.4148538048368 -34.6489881443334,-58.4147606531988 -34.6489725001403,-58.4142889274925 -34.6488986495841,-58.4142915834515 -34.6488881595828,-58.4140056956231 -34.6488412111387,-58.4135618374002 -34.6487677914416,-58.4134671703824 -34.6487503583664,-58.4134670882884 -34.6487504075751,-58.4133707983341 -34.6487341217472,-58.4133681527836 -34.6487457283736,-58.4131716562557 -34.6487129840527,-58.4130605434381 -34.6486936425151,-58.4129398866775 -34.6486735927355,-58.4127937295949 -34.6486487286447,-58.4127906509084 -34.648659789157,-58.4127122003835 -34.6486465269678,-58.4126288650868 -34.6486333937908,-58.4125140027857 -34.6486142614894,-58.4123890006267 -34.6485934347049,-58.4122978264104 -34.6485786078752,-58.4122006024831 -34.6485625812528,-58.4122042755408 -34.6485496422625,-58.4121122483523 -34.6485348677384,-58.4121010464562 -34.6485808996477,-58.4120817656654 -34.648660130006,-58.4120817493882 -34.6486602109849,-58.4120145059501 -34.6489508256338,-58.4119485419082 -34.6492388350517,-58.4118886442334 -34.6495001560043)))";;"2331";4_2_7;COMUNA 4;"2";"7";"899";"438";"461";"95,01%";"375";"375";"100,00%";"0";"0,00%";"314";"17";"5.41";"297";"94,59%";"5.41";5.410
"MULTIPOLYGON (((-58.4096877924004 -34.6505546732718,-58.4096092687632 -34.6507449264858,-58.4091843806107 -34.6517755461022,-58.4087891859929 -34.6527339919601,-58.4089299874838 -34.6528435644054,-58.4092454154992 -34.653077371955,-58.4102185429708 -34.6537986609539,-58.411257179374 -34.6541792555613,-58.4113323508899 -34.6540342125751,-58.4114233925489 -34.6538585415114,-58.4116030815562 -34.6535184660984,-58.4117042733364 -34.6533268831008,-58.4118701381536 -34.6530127881635,-58.4115270909738 -34.6529177123017,-58.4114518651362 -34.6528762710355,-58.4114284369407 -34.6528633734823,-58.4113626888887 -34.6527927099302,-58.4113232061386 -34.6526948735092,-58.4113299171552 -34.6525916338477,-58.4114616838395 -34.6522928072013,-58.4108834507843 -34.6521617843348,-58.4110714809756 -34.6516988221791,-58.4114605934317 -34.6507409295883,-58.4117193708931 -34.6501038358807,-58.4117905510351 -34.6499286490946,-58.4118886442334 -34.6495001560043,-58.4101003782843 -34.6494180572794,-58.4100262212342 -34.6497139496587,-58.4099837116634 -34.6498252726606,-58.4099232762046 -34.6499834907041,-58.4096877924004 -34.6505546732718)))";;"2332";4_2_8;COMUNA 4;"2";"8";"520";"258";"262";"98,47%";"209";"209";"100,00%";"0";"0,00%";"189";"29";"15.34";"160";"84,66%";"15.34";15.340
"MULTIPOLYGON (((-58.4062370929189 -34.6507672856291,-58.4068074139907 -34.6512337594542,-58.4072172723449 -34.6515689565933,-58.4074055181482 -34.651708342013,-58.4085525534536 -34.6525576847214,-58.4087891859929 -34.6527339919601,-58.4091843806107 -34.6517755461022,-58.4096092687632 -34.6507449264858,-58.4096877924004 -34.6505546732718,-58.4099232762046 -34.6499834907041,-58.4099837116634 -34.6498252726606,-58.4100262212342 -34.6497139496587,-58.4101003782843 -34.6494180572794,-58.4087004437102 -34.6493571618836,-58.4084408751082 -34.6493454970204,-58.4075535167699 -34.6493092528088,-58.4072962618936 -34.6492787831728,-58.4069284699842 -34.6493885483999,-58.4068280627255 -34.6494177286675,-58.406760981379 -34.6494388253094,-58.406662616504 -34.6494720910072,-58.4065970671604 -34.6494959348242,-58.4065164291963 -34.6495269549693,-58.4064368126093 -34.6495597361484,-58.4063271029048 -34.6496084193383,-58.4062647878609 -34.6496378984431,-58.4061286459432 -34.6497073444895,-58.4060693965825 -34.6497398531761,-58.4059674340743 -34.6497992441848,-58.4059103131917 -34.6498345003449,-58.4058292333027 -34.6498878444409,-58.4054891471594 -34.6501011424596,-58.4056893488124 -34.6503192709178,-58.4062370929189 -34.6507672856291)))";;"2333";4_2_9;COMUNA 4;"2";"9";"621";"295";"326";"90,49%";"218";"218";"100,00%";"0";"0,00%";"209";"13";"6.22";"196";"93,78%";"6.22";6.220
"MULTIPOLYGON (((-58.3667221886218 -34.6363708776271,-58.3666197101411 -34.6370153949186,-58.3680397336152 -34.6371836233097,-58.3680715707387 -34.6369849797311,-58.368177319856 -34.636301589262,-58.3695956983759 -34.6364850804515,-58.3698042539858 -34.6365097473037,-58.3699176253046 -34.6357780496597,-58.3699505815285 -34.6355646171857,-58.3701059204967 -34.6345579423063,-58.3698698567327 -34.6345262829768,-58.3684721555168 -34.6343956999491,-58.3672197147126 -34.6342786658445,-58.3669227283229 -34.635214308147,-58.3667622641324 -34.6361237181737,-58.3667221886218 -34.6363708776271)))";;"2334";4_20_1;COMUNA 4;"20";"1";"931";"467";"464";"100,65%";"321";"321";"100,00%";"0";"0,00%";"324";"75";"23.15";"249";"76,85%";"23.15";23.150
"MULTIPOLYGON (((-58.3629723606191 -34.6359634900169,-58.3622718102011 -34.6356766384361,-58.3621745689482 -34.6358367042856,-58.3617762924164 -34.6364937906794,-58.361648654735 -34.6367043959166,-58.3612910788842 -34.6373076393952,-58.3614367099587 -34.6373667059256,-58.3627025998988 -34.6378817807482,-58.3631953882861 -34.6370663128946,-58.3632947645448 -34.6369017408177,-58.363590237198 -34.6364184447813,-58.3636856126137 -34.63624936193,-58.3635173216 -34.6361866879854,-58.3629723606191 -34.6359634900169)))";;"2335";4_20_10;COMUNA 4;"20";"10";"1125";"513";"612";"83,82%";"390";"390";"100,00%";"0";"0,00%";"364";"69";"18.96";"295";"81,04%";"18.96";18.960
"MULTIPOLYGON (((-58.3627025998988 -34.6378817807482,-58.3614367099587 -34.6373667059256,-58.3612910788842 -34.6373076393952,-58.3598727623787 -34.6367322787195,-58.3597458022154 -34.6369420374264,-58.3595106526582 -34.6373395273522,-58.3593825854155 -34.6375473128284,-58.3608108873823 -34.6381179690211,-58.3602981550472 -34.6389829893491,-58.3602980406754 -34.6389829806204,-58.3601790076488 -34.6392133333825,-58.3603485721724 -34.6392122642121,-58.3611105079404 -34.6394193161877,-58.3611106222993 -34.6394194897481,-58.3614225262395 -34.6398928576001,-58.36162090982 -34.6397121159422,-58.3616197876736 -34.6397097484222,-58.36181812561 -34.6393848826026,-58.36222984001 -34.6386853612112,-58.3625834992077 -34.6380790132115,-58.3627025998988 -34.6378817807482)))";;"2336";4_20_11;COMUNA 4;"20";"11";"913";"418";"495";"84,44%";"376";"376";"100,00%";"0";"0,00%";"323";"81";"25.08";"242";"74,92%";"25.08";25.080
"MULTIPOLYGON (((-58.3608108873823 -34.6381179690211,-58.3593825854155 -34.6375473128284,-58.3592578471528 -34.637749819129,-58.3589781880352 -34.6381688201866,-58.3588508131 -34.638365971525,-58.3584739782253 -34.6389489078272,-58.3584769964897 -34.6389492646123,-58.3583225872559 -34.6392250234145,-58.3601790076488 -34.6392133333825,-58.3602980406754 -34.6389829806204,-58.3602981550472 -34.6389829893491,-58.3608108873823 -34.6381179690211)))";;"2337";4_20_12;COMUNA 4;"20";"12";"1169";"521";"648";"80,40%";"548";"548";"100,00%";"0";"0,00%";"471";"13";"2.76";"458";"97,24%";"2.76";2.760
"MULTIPOLYGON (((-58.3678956469056 -34.6380848075542,-58.3678414079448 -34.6384256212152,-58.3677611290023 -34.6389608573056,-58.3693918598406 -34.639171981596,-58.369531244382 -34.6382721302109,-58.3695705530264 -34.6380183493919,-58.3696702821552 -34.637374883983,-58.3698042539858 -34.6365097473037,-58.3695956983759 -34.6364850804515,-58.368177319856 -34.636301589262,-58.3680715707387 -34.6369849797311,-58.3680397336152 -34.6371836233097,-58.3679490267045 -34.6377498384376,-58.3678956469056 -34.6380848075542)))";;"2338";4_20_2;COMUNA 4;"20";"2";"705";"337";"368";"91,58%";"286";"286";"100,00%";"0";"0,00%";"257";"23";"8.95";"234";"91,05%";"8.95";8.950
"MULTIPOLYGON (((-58.3680397336152 -34.6371836233097,-58.3666197101411 -34.6370153949186,-58.3664750879386 -34.637924535073,-58.3650819877162 -34.6377500422251,-58.3646379667807 -34.6385533733619,-58.3653059747127 -34.6386432776558,-58.3656347418625 -34.6386857241842,-58.366045807763 -34.6387387987893,-58.3663395603211 -34.6387768493287,-58.3677611290023 -34.6389608573056,-58.3678414079448 -34.6384256212152,-58.3678956469056 -34.6380848075542,-58.3679490267045 -34.6377498384376,-58.3680397336152 -34.6371836233097)))";;"2339";4_20_3;COMUNA 4;"20";"3";"849";"423";"426";"99,30%";"285";"285";"100,00%";"0";"0,00%";"281";"120";"42.7";"161";"57,30%";"42.7";42.700
"MULTIPOLYGON (((-58.3651198702718 -34.636833705454,-58.3650298968439 -34.6369030018365,-58.3646457809792 -34.637560953938,-58.3646299576707 -34.6376119991698,-58.3645837815702 -34.6377516847614,-58.3642052614637 -34.6384269643685,-58.364156285107 -34.6384117834833,-58.3641190265887 -34.6384787004482,-58.3641346225859 -34.6384855992786,-58.3646379667807 -34.6385533733619,-58.3650819877162 -34.6377500422251,-58.3664750879386 -34.637924535073,-58.3666197101411 -34.6370153949186,-58.3667221886218 -34.6363708776271,-58.3667622641324 -34.6361237181737,-58.3669227283229 -34.635214308147,-58.3660999363958 -34.6351190787508,-58.3657613176282 -34.6357200969472,-58.3657701557271 -34.6357400341861,-58.3656407001174 -34.6359848686376,-58.3656006533255 -34.6360583602357,-58.3652245110458 -34.6367540682856,-58.3651198702718 -34.636833705454)))";;"2340";4_20_4;COMUNA 4;"20";"4";"603";"296";"307";"96,42%";"239";"239";"100,00%";"0";"0,00%";"221";"96";"43.44";"125";"56,56%";"43.44";43.440
"MULTIPOLYGON (((-58.3637606021819 -34.6383226575148,-58.364005344337 -34.638428939301,-58.3640051965884 -34.6384293856737,-58.3641163611575 -34.6384778790553,-58.3641190265887 -34.6384787004482,-58.364156285107 -34.6384117834833,-58.3642052614637 -34.6384269643685,-58.3645837815702 -34.6377516847614,-58.3646299576707 -34.6376119991698,-58.3646457809792 -34.637560953938,-58.3650298968439 -34.6369030018365,-58.3651198702718 -34.636833705454,-58.3649435724492 -34.6367669424381,-58.3646926932413 -34.6366503993662,-58.3639306400057 -34.6363406198446,-58.3636856126137 -34.63624936193,-58.363590237198 -34.6364184447813,-58.3632947645448 -34.6369017408177,-58.3631953882861 -34.6370663128946,-58.3627025998988 -34.6378817807482,-58.3628456777861 -34.637939998402,-58.3637606021819 -34.6383226575148)))";;"2341";4_20_5;COMUNA 4;"20";"5";"756";"346";"410";"84,39%";"250";"250";"100,00%";"0";"0,00%";"211";"75";"35.55";"136";"64,45%";"35.55";35.550
"MULTIPOLYGON (((-58.3632715049139 -34.6340443065087,-58.3628911721265 -34.6346732414598,-58.3627742274419 -34.6348530810578,-58.3634796310721 -34.6351384548144,-58.3629723606191 -34.6359634900169,-58.3635173216 -34.6361866879854,-58.3636856126137 -34.63624936193,-58.3637685213689 -34.6361024526935,-58.3640416180591 -34.6356586456482,-58.3641860615778 -34.6354241774357,-58.3645636428623 -34.6348110818838,-58.3646820465876 -34.6346189173981,-58.3648246082188 -34.6343876864146,-58.3652399381359 -34.6337632805484,-58.364500123889 -34.6334731707508,-58.363786800353 -34.6331934303903,-58.3632715049139 -34.6340443065087)))";;"2342";4_20_6;COMUNA 4;"20";"6";"868";"413";"455";"90,77%";"332";"332";"100,00%";"0";"0,00%";"305";"99";"32.46";"206";"67,54%";"32.46";32.460
"MULTIPOLYGON (((-58.363786800353 -34.6331934303903,-58.3623523327828 -34.6326309024273,-58.3619726274442 -34.6333042732324,-58.3618687323037 -34.6334728548091,-58.3614327434376 -34.6341805445936,-58.3613689701663 -34.6342845794828,-58.3627742274419 -34.6348530810578,-58.3628911721265 -34.6346732414598,-58.3632715049139 -34.6340443065087,-58.363786800353 -34.6331934303903)))";;"2343";4_20_7;COMUNA 4;"20";"7";"849";"399";"450";"88,67%";"324";"324";"100,00%";"0";"0,00%";"290";"46";"15.86";"244";"84,14%";"15.86";15.860
"MULTIPOLYGON (((-58.3627742274419 -34.6348530810578,-58.3613689701663 -34.6342845794828,-58.3609850480145 -34.6349097025302,-58.3608672314411 -34.635102145599,-58.3619434234905 -34.6355422083778,-58.3622718102011 -34.6356766384361,-58.3629723606191 -34.6359634900169,-58.3634796310721 -34.6351384548144,-58.3627742274419 -34.6348530810578)))";;"2344";4_20_8;COMUNA 4;"20";"8";"797";"376";"421";"89,31%";"266";"266";"100,00%";"0";"0,00%";"243";"80";"32.92";"163";"67,08%";"32.92";32.920
"MULTIPOLYGON (((-58.3603656517072 -34.6359209773119,-58.3602231585536 -34.6361536115647,-58.3598727623787 -34.6367322787195,-58.3612910788842 -34.6373076393952,-58.361648654735 -34.6367043959166,-58.3617762924164 -34.6364937906794,-58.3621745689482 -34.6358367042856,-58.3622718102011 -34.6356766384361,-58.3619434234905 -34.6355422083778,-58.3608672314411 -34.635102145599,-58.3603656517072 -34.6359209773119)))";;"2345";4_20_9;COMUNA 4;"20";"9";"849";"406";"443";"91,65%";"320";"320";"100,00%";"0";"0,00%";"293";"49";"16.72";"244";"83,28%";"16.72";16.720
"MULTIPOLYGON (((-58.3677611290023 -34.6389608573056,-58.3663395603211 -34.6387768493287,-58.3661928713666 -34.639699438373,-58.3660632608541 -34.6405142907934,-58.3664186713014 -34.6405871093703,-58.3671926236181 -34.6407423002107,-58.3674845709391 -34.6408008401689,-58.369090927485 -34.641122938788,-58.3692456913694 -34.6401158429501,-58.3692904116988 -34.6398248117579,-58.3693559833721 -34.6394035107153,-58.3693918598406 -34.639171981596,-58.3677611290023 -34.6389608573056)))";;"2346";4_21_1;COMUNA 4;"21";"1";"703";"337";"366";"92,08%";"259";"259";"100,00%";"0";"0,00%";"245";"107";"43.67";"138";"56,33%";"43.67";43.670
"MULTIPOLYGON (((-58.3633674382434 -34.6459409809322,-58.3633677442177 -34.6459399133575,-58.3633674404342 -34.6459407751151,-58.363369692581 -34.6457291998045,-58.3631316567701 -34.6450632549461,-58.363130242128 -34.6450625749901,-58.3630889672124 -34.6450187009314,-58.3630563138694 -34.6449865586486,-58.3626862575221 -34.643926411099,-58.3628167091729 -34.6436950128579,-58.3626242350993 -34.6436059086752,-58.3624522758215 -34.6435216427493,-58.3622081207941 -34.6434107717911,-58.3616504406809 -34.6443642133936,-58.3609883954023 -34.6440325261495,-58.359767193807 -34.6434206377517,-58.3580609479497 -34.6425657791961,-58.3580603971798 -34.6425684801336,-58.3578763851241 -34.642478906533,-58.3577658836121 -34.6427497566845,-58.3574744131314 -34.6434605132659,-58.3573173093073 -34.6440443391192,-58.3575905973915 -34.6449824204228,-58.3583851563926 -34.6452604785655,-58.3587459382009 -34.6453867328433,-58.3597966648504 -34.6459828532827,-58.3599049455123 -34.6460744966672,-58.3608836618259 -34.6468959762895,-58.3609759795238 -34.6469903428825,-58.3612395925918 -34.6472598050004,-58.3616204767048 -34.6477089375858,-58.3615201699045 -34.6477843496205,-58.3617087311606 -34.6479447924154,-58.3617687955549 -34.6478858262932,-58.3623629676202 -34.6482080163922,-58.3629431882418 -34.6482291972657,-58.363568453194 -34.6482090727402,-58.3639355237297 -34.6481764118549,-58.364254562106 -34.6482875885031,-58.3643321397177 -34.6481301564479,-58.3645040614693 -34.6480525774336,-58.3645211942762 -34.6480527252551,-58.3644493289463 -34.6479640590527,-58.3642908465239 -34.6478413361839,-58.3640376962991 -34.6475068400294,-58.3637880724083 -34.6470647341025,-58.3633671443569 -34.6459416150121,-58.3633673911513 -34.6459409149183,-58.3633674382434 -34.6459409809322)))";;"2347";4_21_10;COMUNA 4;"21";"10";"733";"371";"362";"102,49%";"231";"230";"99,57%";"1";"0,43%";"234";"134";"57.26";"100";"42,74%";"57.26";57.260
"MULTIPOLYGON (((-58.3651581095863 -34.6395419905389,-58.3636738834757 -34.6393074068341,-58.3636738437408 -34.6393073447284,-58.3636455344446 -34.6393577375042,-58.3633358240684 -34.6399105310489,-58.3633016753744 -34.6399650823925,-58.364760876783 -34.6402583847458,-58.3657010359117 -34.640440057266,-58.3660632608541 -34.6405142907934,-58.3661928713666 -34.639699438373,-58.3663395603211 -34.6387768493287,-58.366045807763 -34.6387387987893,-58.3656347418625 -34.6386857241842,-58.3651581095863 -34.6395419905389)))";;"2348";4_21_2;COMUNA 4;"21";"2";"799";"381";"418";"91,15%";"273";"273";"100,00%";"0";"0,00%";"263";"161";"61.22";"102";"38,78%";"61.22";61.220
"MULTIPOLYGON (((-58.3636738437408 -34.6393073447284,-58.3636738834757 -34.6393074068341,-58.3651581095863 -34.6395419905389,-58.3656347418625 -34.6386857241842,-58.3653059747127 -34.6386432776558,-58.3646379667807 -34.6385533733619,-58.3641346225859 -34.6384855992786,-58.3641190265887 -34.6384787004482,-58.3641163611575 -34.6384778790553,-58.3640051965884 -34.6384293856737,-58.364005344337 -34.638428939301,-58.3637606021819 -34.6383226575148,-58.3628456777861 -34.637939998402,-58.3627025998988 -34.6378817807482,-58.3625834992077 -34.6380790132115,-58.36222984001 -34.6386853612112,-58.36181812561 -34.6393848826026,-58.3619250284663 -34.6394296292493,-58.3631137931528 -34.6398920622784,-58.3632270670281 -34.6399359361462,-58.3633016753744 -34.6399650823925,-58.3633358240684 -34.6399105310489,-58.3636455344446 -34.6393577375042,-58.3636738437408 -34.6393073447284)))";;"2349";4_21_3;COMUNA 4;"21";"3";"561";"251";"310";"80,97%";"232";"232";"100,00%";"0";"0,00%";"207";"41";"19.81";"166";"80,19%";"19.81";19.810
"MULTIPOLYGON (((-58.3633016753744 -34.6399650823925,-58.3632270670281 -34.6399359361462,-58.3631137931528 -34.6398920622784,-58.3619250284663 -34.6394296292493,-58.36181812561 -34.6393848826026,-58.3616197876736 -34.6397097484222,-58.36162090982 -34.6397121159422,-58.3614225262395 -34.6398928576001,-58.3614226472874 -34.6398930413099,-58.360902795731 -34.6407228456488,-58.3584810286523 -34.6415546288277,-58.3584790766373 -34.6415563526773,-58.3586484992718 -34.6417289682701,-58.3586497854151 -34.6417275951708,-58.3604147548912 -34.6425630576437,-58.3607514608261 -34.6421171990642,-58.361768418474 -34.6426415822274,-58.3619745649431 -34.6422734314505,-58.3620880740106 -34.6423378229065,-58.3623294088911 -34.6424660538862,-58.362330079607 -34.6424661234416,-58.3624710961481 -34.6425429582332,-58.3624711087953 -34.6425427220814,-58.3624690533284 -34.6424805353766,-58.3625126843282 -34.6417698450489,-58.3625154806954 -34.6417119582304,-58.3625162301487 -34.6417122268087,-58.3637022181964 -34.6421372362455,-58.3652178146101 -34.642404310412,-58.3657461810405 -34.641405545745,-58.3654912807886 -34.6413629471527,-58.3642628798484 -34.6411519553092,-58.3643823368631 -34.6409419747177,-58.364760876783 -34.6402583847458,-58.3633016753744 -34.6399650823925)))";;"2350";4_21_4;COMUNA 4;"21";"4";"767";"386";"381";"101,31%";"257";"257";"100,00%";"0";"0,00%";"249";"122";"49";"127";"51,00%";"49";49.000
"MULTIPOLYGON (((-58.3660632608541 -34.6405142907934,-58.3657010359117 -34.640440057266,-58.364760876783 -34.6402583847458,-58.3643823368631 -34.6409419747177,-58.3642628798484 -34.6411519553092,-58.3654912807886 -34.6413629471527,-58.3657461810405 -34.641405545745,-58.3659169949777 -34.6414341330085,-58.366200520781 -34.6414816126706,-58.3673519155915 -34.6416797779387,-58.3674845709391 -34.6408008401689,-58.3671926236181 -34.6407423002107,-58.3664186713014 -34.6405871093703,-58.3660632608541 -34.6405142907934)))";;"2351";4_21_5;COMUNA 4;"21";"5";"655";"304";"351";"86,61%";"271";"271";"100,00%";"0";"0,00%";"238";"76";"31.93";"162";"68,07%";"31.93";31.930
"MULTIPOLYGON (((-58.3673519155915 -34.6416797779387,-58.366200520781 -34.6414816126706,-58.3659169949777 -34.6414341330085,-58.3657461810405 -34.641405545745,-58.3652178146101 -34.642404310412,-58.3657575226143 -34.6424965040215,-58.3671947617654 -34.6427421526164,-58.3685751098104 -34.6428928078715,-58.368822618284 -34.6429217319302,-58.3689661803611 -34.6419553336133,-58.3690604552653 -34.641320949724,-58.369090927485 -34.641122938788,-58.3674845709391 -34.6408008401689,-58.3673519155915 -34.6416797779387)))";;"2352";4_21_6;COMUNA 4;"21";"6";"732";"351";"381";"92,13%";"309";"309";"100,00%";"0";"0,00%";"270";"40";"14.81";"230";"85,19%";"14.81";14.810
"MULTIPOLYGON (((-58.3669430735577 -34.6445710958869,-58.3685539458823 -34.6447299605686,-58.368581767887 -34.6445417368583,-58.3686463077342 -34.6441351544938,-58.3686918317727 -34.6438153206361,-58.3687351228505 -34.6435106263342,-58.368822618284 -34.6429217319302,-58.3685751098104 -34.6428928078715,-58.3671947617654 -34.6427421526164,-58.3657575226143 -34.6424965040215,-58.3652178146101 -34.642404310412,-58.3646673161304 -34.6434449575208,-58.3655989954757 -34.6435485933841,-58.3655619006793 -34.6437911769171,-58.3654613466024 -34.6444504831515,-58.3669430735577 -34.6445710958869)))";;"2353";4_21_7;COMUNA 4;"21";"7";"838";"396";"442";"89,59%";"282";"282";"100,00%";"0";"0,00%";"275";"39";"14.18";"236";"85,82%";"14.18";14.180
"MULTIPOLYGON (((-58.3628167091729 -34.6436950128579,-58.3641970842275 -34.6443338311927,-58.3654613466024 -34.6444504831515,-58.3655619006793 -34.6437911769171,-58.3655989954757 -34.6435485933841,-58.3646673161304 -34.6434449575208,-58.3652178146101 -34.642404310412,-58.3637022181964 -34.6421372362455,-58.3625162301487 -34.6417122268087,-58.3625154806954 -34.6417119582304,-58.3625126843282 -34.6417698450489,-58.3624690533284 -34.6424805353766,-58.3624711087953 -34.6425427220814,-58.3624710961481 -34.6425429582332,-58.3624618687391 -34.6427152550135,-58.3625059831872 -34.6430905140748,-58.3626242350993 -34.6436059086752,-58.3628167091729 -34.6436950128579)))";;"2354";4_21_8;COMUNA 4;"21";"8";"981";"470";"511";"91,98%";"300";"300";"100,00%";"0";"0,00%";"294";"73";"24.83";"221";"75,17%";"24.83";24.830
"MULTIPOLYGON (((-58.3607514608261 -34.6421171990642,-58.3604147548912 -34.6425630576437,-58.3586497854151 -34.6417275951708,-58.3586484992718 -34.6417289682701,-58.3584790766373 -34.6415563526773,-58.3581253056995 -34.6418687706588,-58.3578763851241 -34.642478906533,-58.3580603971798 -34.6425684801336,-58.3580609479497 -34.6425657791961,-58.359767193807 -34.6434206377517,-58.3609883954023 -34.6440325261495,-58.3616504406809 -34.6443642133936,-58.3622081207941 -34.6434107717911,-58.3624522758215 -34.6435216427493,-58.3626242350993 -34.6436059086752,-58.3625059831872 -34.6430905140748,-58.3624618687391 -34.6427152550135,-58.3624710961481 -34.6425429582332,-58.362330079607 -34.6424661234416,-58.3623294088911 -34.6424660538862,-58.3620880740106 -34.6423378229065,-58.3619745649431 -34.6422734314505,-58.361768418474 -34.6426415822274,-58.3607514608261 -34.6421171990642)))";;"2355";4_21_9;COMUNA 4;"21";"9";"835";"416";"419";"99,28%";"250";"250";"100,00%";"0";"0,00%";"253";"131";"51.78";"122";"48,22%";"51.78";51.780
"MULTIPOLYGON (((-58.3745801200725 -34.6386754727609,-58.3746807628979 -34.6380991187556,-58.3747289998941 -34.637847807564,-58.3743404912302 -34.6378149200452,-58.3735453357409 -34.6377398319677,-58.373436961817 -34.6382880095009,-58.3733777519208 -34.6385178325722,-58.372397748211 -34.6383892899523,-58.3722034794796 -34.6394050934716,-58.3724603502003 -34.6394354960229,-58.372919649874 -34.6394907663067,-58.3731708123771 -34.639520951885,-58.3744077137672 -34.6396695343122,-58.3745208823502 -34.6390148068501,-58.3745801200725 -34.6386754727609)))";;"2356";4_22_1;COMUNA 4;"22";"1";"589";"284";"305";"93,11%";"317";"317";"100,00%";"0";"0,00%";"257";"18";"7";"239";"93,00%";"7";7.000
"MULTIPOLYGON (((-58.3730894218033 -34.6466650560933,-58.3727620311431 -34.6465778406146,-58.3718907334864 -34.6463900061426,-58.3708421485672 -34.6461639322829,-58.3698302882804 -34.6459457649395,-58.3696714259222 -34.6467277097837,-58.3706833001089 -34.6469415121064,-58.3717446788352 -34.6471657658128,-58.3729554993845 -34.647421529746,-58.372998197969 -34.6471795116111,-58.3730577017547 -34.6468417282641,-58.3730894218033 -34.6466650560933)))";;"2357";4_22_10;COMUNA 4;"22";"10";"563";"252";"311";"81,03%";"294";"294";"100,00%";"0";"0,00%";"229";"6";"2.62";"223";"97,38%";"2.62";2.620
"MULTIPOLYGON (((-58.3729554993845 -34.647421529746,-58.3717446788352 -34.6471657658128,-58.3706833001089 -34.6469415121064,-58.3696714259222 -34.6467277097837,-58.3683053145839 -34.6464390456557,-58.3682721613008 -34.6466683931182,-58.3681729815746 -34.6473338997266,-58.3694995359849 -34.6475736603719,-58.370516566227 -34.6477574670957,-58.3716012500836 -34.6479534993593,-58.3725232907995 -34.6481201051549,-58.372823708145 -34.6481750468914,-58.372861439459 -34.6479566174319,-58.372929260875 -34.6475720079234,-58.3729554993845 -34.647421529746)))";;"2358";4_22_11;COMUNA 4;"22";"11";"728";"348";"380";"91,58%";"353";"353";"100,00%";"0";"0,00%";"290";"34";"11.72";"256";"88,28%";"11.72";11.720
"MULTIPOLYGON (((-58.3676456441128 -34.6501441905936,-58.3686376496985 -34.6506697106237,-58.3694041430375 -34.6511695337632,-58.369526891137 -34.6508340211786,-58.3695277590734 -34.6508344129153,-58.369897045922 -34.6509417074654,-58.3700621726525 -34.6509896838056,-58.3700651383349 -34.6509901976473,-58.3711738486696 -34.6511822901018,-58.3713444953189 -34.651211854951,-58.3714234191665 -34.6512031109774,-58.371533417846 -34.6511445295635,-58.3716854079043 -34.6509502711666,-58.3718493101583 -34.650772430385,-58.3722064674117 -34.6499885177897,-58.372509723629 -34.6492380158902,-58.3726789945731 -34.6488189735205,-58.372823708145 -34.6481750468914,-58.3725232907995 -34.6481201051549,-58.3716012500836 -34.6479534993593,-58.370516566227 -34.6477574670957,-58.3694995359849 -34.6475736603719,-58.3681729815746 -34.6473338997266,-58.3681198276999 -34.6476903481035,-58.368076772449 -34.6479335614402,-58.3676806770445 -34.6499552151607,-58.367680599141 -34.6499551764075,-58.3676456441128 -34.6501441905936)))";;"2359";4_22_12;COMUNA 4;"22";"12";"605";"300";"305";"98,36%";"255";"255";"100,00%";"0";"0,00%";"218";"45";"20.64";"173";"79,36%";"20.64";20.640
"MULTIPOLYGON (((-58.3707861365567 -34.6413219103955,-58.3710126899189 -34.6413412364559,-58.3718085713564 -34.6414051440375,-58.3718661454911 -34.6411184174429,-58.3719644994367 -34.6406294613195,-58.3720158169426 -34.6403751253413,-58.3729905200268 -34.6404620460883,-58.3730283121818 -34.6402625605973,-58.3731708123771 -34.639520951885,-58.372919649874 -34.6394907663067,-58.3724603502003 -34.6394354960229,-58.3722034794796 -34.6394050934716,-58.372397748211 -34.6383892899523,-58.3714006234289 -34.6382584026247,-58.3705251598913 -34.6381435855747,-58.3695705530264 -34.6380183493919,-58.369531244382 -34.6382721302109,-58.3693918598406 -34.639171981596,-58.3693559833721 -34.6394035107153,-58.3692904116988 -34.6398248117579,-58.3692456913694 -34.6401158429501,-58.369090927485 -34.641122938788,-58.3706281712709 -34.6413084105424,-58.3707861365567 -34.6413219103955)))";;"2360";4_22_2;COMUNA 4;"22";"2";"745";"345";"400";"86,25%";"350";"350";"100,00%";"0";"0,00%";"297";"30";"10.1";"267";"89,90%";"10.1";10.100
"MULTIPOLYGON (((-58.3729905200268 -34.6404620460883,-58.3728360092137 -34.6412759013945,-58.3727964169829 -34.6414843998299,-58.3730344749186 -34.641503519341,-58.374041992849 -34.6415956672316,-58.3742401708614 -34.6405733848947,-58.3742922597808 -34.6403082031002,-58.3743386975262 -34.6400685109343,-58.3744077137672 -34.6396695343122,-58.3731708123771 -34.639520951885,-58.3730283121818 -34.6402625605973,-58.3729905200268 -34.6404620460883)))";;"2361";4_22_3;COMUNA 4;"22";"3";"886";"407";"479";"84,97%";"410";"410";"100,00%";"0";"0,00%";"352";"3";"0.85";"349";"99,15%";"0.85";0.850
"MULTIPOLYGON (((-58.374041992849 -34.6415956672316,-58.3730344749186 -34.641503519341,-58.3727964169829 -34.6414843998299,-58.3726790113017 -34.64210172676,-58.372638977605 -34.642323746335,-58.3738873427309 -34.6423879736607,-58.374041992849 -34.6415956672316)))";;"2362";4_22_4;COMUNA 4;"22";"4";"1305";"583";"722";"80,75%";"566";"566";"100,00%";"0";"0,00%";"495";"1";"0.2";"494";"99,80%";"0.2";0.200
"MULTIPOLYGON (((-58.3727964169829 -34.6414843998299,-58.3728360092137 -34.6412759013945,-58.3729905200268 -34.6404620460883,-58.3720158169426 -34.6403751253413,-58.3719644994367 -34.6406294613195,-58.3718661454911 -34.6411184174429,-58.3718085713564 -34.6414051440375,-58.3710126899189 -34.6413412364559,-58.3707861365567 -34.6413219103955,-58.3706281712709 -34.6413084105424,-58.369090927485 -34.641122938788,-58.3690604552653 -34.641320949724,-58.3689661803611 -34.6419553336133,-58.368822618284 -34.6429217319302,-58.3690097195023 -34.6429435666232,-58.370400154303 -34.643148506418,-58.3712314365149 -34.6432710379026,-58.3714233146798 -34.6432895625143,-58.371610506709 -34.6433076607758,-58.3724425820374 -34.6434091276105,-58.3724953011915 -34.6431197210805,-58.372638977605 -34.642323746335,-58.3726790113017 -34.64210172676,-58.3727964169829 -34.6414843998299)))";;"2363";4_22_5;COMUNA 4;"22";"5";"765";"355";"410";"86,59%";"331";"331";"100,00%";"0";"0,00%";"284";"23";"8.1";"261";"91,90%";"8.1";8.100
"MULTIPOLYGON (((-58.3738873427309 -34.6423879736607,-58.372638977605 -34.642323746335,-58.3724953011915 -34.6431197210805,-58.3724425820374 -34.6434091276105,-58.3733293717966 -34.6435845748139,-58.3736509013512 -34.6436439667667,-58.3737013796401 -34.6433744882782,-58.3738193983626 -34.6427362447956,-58.3738873427309 -34.6423879736607)))";;"2364";4_22_6;COMUNA 4;"22";"6";"599";"267";"332";"80,42%";"293";"293";"100,00%";"0";"0,00%";"255";"1";"0.39";"254";"99,61%";"0.39";0.390
"MULTIPOLYGON (((-58.3736509013512 -34.6436439667667,-58.3733293717966 -34.6435845748139,-58.3724425820374 -34.6434091276105,-58.3721102264079 -34.6452355568461,-58.3720716591618 -34.6454384216948,-58.3718907334864 -34.6463900061426,-58.3727620311431 -34.6465778406146,-58.3730894218033 -34.6466650560933,-58.3731334865396 -34.6464197993494,-58.3732260545856 -34.6459216831756,-58.373271223895 -34.6456786807516,-58.3733169074766 -34.6454326504166,-58.373595623456 -34.6439390058806,-58.3736509013512 -34.6436439667667)))";;"2365";4_22_7;COMUNA 4;"22";"7";"903";"411";"492";"83,54%";"483";"483";"100,00%";"0";"0,00%";"402";"11";"2.74";"391";"97,26%";"2.74";2.740
"MULTIPOLYGON (((-58.370400154303 -34.643148506418,-58.3690097195023 -34.6429435666232,-58.368822618284 -34.6429217319302,-58.3687351228505 -34.6435106263342,-58.3686918317727 -34.6438153206361,-58.3686463077342 -34.6441351544938,-58.368581767887 -34.6445417368583,-58.3685539458823 -34.6447299605686,-58.3700169094209 -34.6450269353042,-58.3698302882804 -34.6459457649395,-58.3708421485672 -34.6461639322829,-58.3718907334864 -34.6463900061426,-58.3720716591618 -34.6454384216948,-58.3721102264079 -34.6452355568461,-58.3724425820374 -34.6434091276105,-58.371610506709 -34.6433076607758,-58.3714233146798 -34.6432895625143,-58.3712314365149 -34.6432710379026,-58.370400154303 -34.643148506418)))";;"2366";4_22_8;COMUNA 4;"22";"8";"987";"463";"524";"88,36%";"426";"426";"100,00%";"0";"0,00%";"363";"37";"10.19";"326";"89,81%";"10.19";10.190
"MULTIPOLYGON (((-58.3684215987727 -34.6456420691992,-58.3683915377961 -34.6458502917138,-58.3683368349466 -34.64622173953,-58.3683053145839 -34.6464390456557,-58.3696714259222 -34.6467277097837,-58.3698302882804 -34.6459457649395,-58.3700169094209 -34.6450269353042,-58.3685539458823 -34.6447299605686,-58.368521916888 -34.6449459283428,-58.3684215987727 -34.6456420691992)))";;"2367";4_22_9;COMUNA 4;"22";"9";"685";"311";"374";"83,16%";"268";"268";"100,00%";"0";"0,00%";"259";"40";"15.44";"219";"84,56%";"15.44";15.440
"MULTIPOLYGON (((-58.3850247288835 -34.6463397816106,-58.3839210087002 -34.6460775163418,-58.3828563159991 -34.6458235767483,-58.3817840455564 -34.6455697636751,-58.3811806093589 -34.6454263292543,-58.3810637874964 -34.6454100795468,-58.3809014191641 -34.645387866311,-58.3805599081674 -34.6453373889251,-58.3796071883672 -34.6451019475852,-58.3790862991924 -34.6466038908107,-58.3799739502471 -34.6468185167728,-58.3801509018741 -34.6468611027593,-58.3803658510951 -34.6469127989315,-58.3804091306646 -34.6469231805708,-58.3804091432961 -34.6469231136318,-58.3805832545434 -34.6469651294348,-58.3805832712977 -34.6469650597859,-58.3812383449979 -34.6471225461477,-58.3823061144135 -34.6473793188365,-58.383378405919 -34.6476371414813,-58.3844652729721 -34.6478984148512,-58.3850247288835 -34.6463397816106)))";;"2368";4_23_1;COMUNA 4;"23";"1";"834";"401";"433";"92,61%";"295";"295";"100,00%";"0";"0,00%";"272";"27";"9.93";"245";"90,07%";"9.93";9.930
"MULTIPOLYGON (((-58.3760359293294 -34.6519098069647,-58.3760038812521 -34.651996336025,-58.3758504823415 -34.6523235604249,-58.3758260545022 -34.6523757276539,-58.3768903594489 -34.6526528273983,-58.3768325893871 -34.6528079321207,-58.3765407413056 -34.6535947915008,-58.3774823837439 -34.6538317277127,-58.377930884236 -34.6539445083955,-58.378570578544 -34.654105730756,-58.3785665433919 -34.654050726372,-58.3785491896825 -34.6537661990708,-58.3786171884022 -34.6534379265441,-58.3787792667101 -34.6531997213779,-58.378882748797 -34.6531661506801,-58.3788415923978 -34.653155636595,-58.3789615905781 -34.6526587745417,-58.3789922626451 -34.6526666127319,-58.3790066411019 -34.6526057757466,-58.3789804846158 -34.6525991378785,-58.3791332194107 -34.6519878162285,-58.3791789713267 -34.6519997493333,-58.3791930529955 -34.6519408633074,-58.3791930259526 -34.6519408409228,-58.3792086645826 -34.6518786393406,-58.3791679391551 -34.6518683294562,-58.3791996870073 -34.6517379248218,-58.3792958679565 -34.6513461480961,-58.3793725442048 -34.6510278812449,-58.3794147360336 -34.6508497357792,-58.3794601470476 -34.6508611051504,-58.3794746209461 -34.6508020444458,-58.3794746938103 -34.6508017471234,-58.3791315139739 -34.6507150309817,-58.3779442773471 -34.6504151181875,-58.3777409870036 -34.650371947274,-58.3775433201427 -34.6503299771674,-58.3766699561778 -34.6501965432886,-58.3765696280698 -34.6504676072748,-58.3760359293294 -34.6519098069647)))";;"2369";4_23_10;COMUNA 4;"23";"10";"804";"385";"419";"91,89%";"253";"253";"100,00%";"0";"0,00%";"259";"47";"18.15";"212";"81,85%";"18.15";18.150
"MULTIPOLYGON (((-58.3718493101583 -34.650772430385,-58.3716854079043 -34.6509502711666,-58.371533417846 -34.6511445295635,-58.3714234191665 -34.6512031109774,-58.3713444953189 -34.651211854951,-58.3711738486696 -34.6511822901018,-58.3700651383349 -34.6509901976473,-58.3700621726525 -34.6509896838056,-58.369897045922 -34.6509417074654,-58.3695277590734 -34.6508344129153,-58.369526891137 -34.6508340211786,-58.3694041430375 -34.6511695337632,-58.3696567353069 -34.651334244444,-58.3698600947838 -34.651772370074,-58.3700120172243 -34.6521027770341,-58.3696709775562 -34.653231986965,-58.3697869195921 -34.6535787051755,-58.3703025747928 -34.6539890384937,-58.370598062759 -34.6541217049174,-58.3725354509782 -34.654991513659,-58.3736589590285 -34.6564467002061,-58.3738490345214 -34.6566781163613,-58.3740907337981 -34.6564926265357,-58.3743134549506 -34.6563079237321,-58.3746054275596 -34.6555933961747,-58.3750666762257 -34.6543687635586,-58.3754747785848 -34.6532627563725,-58.3757132253032 -34.6526162176516,-58.3758260545022 -34.6523757276539,-58.3758504823415 -34.6523235604249,-58.3760038812521 -34.651996336025,-58.3760359293294 -34.6519098069647,-58.3765696280698 -34.6504676072748,-58.3745443953712 -34.6498079714203,-58.3740035266073 -34.6496317993319,-58.373268599645 -34.6493923822038,-58.3731229241426 -34.6493472739387,-58.3728223732044 -34.6492540922709,-58.3727791227277 -34.6492165240547,-58.3727532838539 -34.6491539679213,-58.3727511608212 -34.6490681891471,-58.3726789945731 -34.6488189735205,-58.372509723629 -34.6492380158902,-58.3722064674117 -34.6499885177897,-58.3718493101583 -34.650772430385)))";;"2370";4_23_11;COMUNA 4;"23";"11";"573";"291";"282";"103,19%";"197";"197";"100,00%";"0";"0,00%";"206";"110";"53.4";"96";"46,60%";"53.4";53.400
"MULTIPOLYGON (((-58.3740907337981 -34.6564926265357,-58.3738490345214 -34.6566781163613,-58.3739329018457 -34.6567706884439,-58.3740615217532 -34.6568910463075,-58.3749961648804 -34.65706286751,-58.3752424273002 -34.6571000487933,-58.3760287350146 -34.6569226764393,-58.3760788930772 -34.6569388578848,-58.3761003562564 -34.6569498872631,-58.3761388656859 -34.6569468551266,-58.3761530436685 -34.6569540352636,-58.3761381067314 -34.656964599579,-58.3761373592283 -34.6569713299071,-58.3761492003106 -34.6569780691716,-58.3761914033751 -34.6569836061878,-58.3762202722681 -34.6569940289027,-58.3762580285023 -34.6570032341193,-58.376299460601 -34.6570381415712,-58.3763372124208 -34.6570516300337,-58.3762246434807 -34.6570631762784,-58.376229046477 -34.657101728864,-58.3764934236405 -34.6570860067666,-58.3765660229819 -34.6570572989503,-58.3765889792928 -34.6570567032686,-58.3766215786268 -34.6570402050883,-58.3766267577377 -34.6570444920181,-58.3766371197562 -34.6570493945024,-58.3767052443823 -34.6570512782568,-58.3767304304217 -34.6570427294698,-58.3767422892514 -34.6570323355944,-58.3767519158232 -34.6570323423804,-58.3767570930454 -34.6570384649922,-58.3767570842023 -34.6570470315334,-58.3767644873641 -34.65704887244,-58.3768148423811 -34.657048296023,-58.3768489097432 -34.6570443426889,-58.3768748463638 -34.6570260040607,-58.3769096602094 -34.6570162382206,-58.3769229893064 -34.6570162475983,-58.3769400089544 -34.6570278855989,-58.3769533147356 -34.657050535118,-58.3770058748941 -34.6570658694752,-58.3770406748907 -34.6570695653055,-58.3770688034143 -34.6570799872993,-58.3771154571766 -34.6570781843663,-58.3771332324636 -34.6570751373605,-58.377140640038 -34.6570726949737,-58.3771458462158 -34.6570506703619,-58.3771651245099 -34.6570262080373,-58.377172538365 -34.6570176466905,-58.3771747718242 -34.6570060222283,-58.3772155058985 -34.6569999318309,-58.3772717993659 -34.6569852857746,-58.3772947525138 -34.6569877494391,-58.3773184329902 -34.6570030634298,-58.377334719087 -34.657007970003,-58.3773598950134 -34.6570092114189,-58.3773865613567 -34.6570012754286,-58.377410999284 -34.6570000687326,-58.3774324651626 -34.6570086502933,-58.3774539391906 -34.6570092772047,-58.3774717106922 -34.6570099015244,-58.3774865139099 -34.6570166427295,-58.3775027906268 -34.6570307277175,-58.377510195682 -34.6570307328914,-58.3775161115873 -34.6570386916758,-58.3775205327096 -34.6570601111332,-58.3775301517732 -34.6570674606075,-58.3775345891749 -34.6570729707732,-58.3775397620759 -34.6570833766224,-58.3775597494802 -34.6570895095431,-58.3775715844381 -34.6571023676276,-58.3775686055199 -34.6571188867463,-58.3775722836507 -34.6571427532677,-58.3775618977873 -34.6571611029034,-58.3775478162693 -34.6571727190987,-58.3775334164389 -34.6571800993847,-58.3775328064631 -34.6571930492882,-58.3777039549749 -34.6572257726816,-58.3780802812646 -34.6572983004017,-58.3781063577914 -34.6573011354779,-58.3781322635087 -34.6573043225528,-58.3781549369042 -34.6573013100209,-58.3781499266913 -34.657283418712,-58.3781518203461 -34.6572650392184,-58.3781743157693 -34.6572694211369,-58.3781984236408 -34.6572805649251,-58.3783352519664 -34.6572944097836,-58.3783552056697 -34.6571471485374,-58.3783086343081 -34.6571375563913,-58.378429613727 -34.656655374499,-58.3781938513258 -34.6563635059773,-58.378410455582 -34.6562825845046,-58.3786104108395 -34.655423331621,-58.3786357116974 -34.6553497553925,-58.3786636597359 -34.6552709695641,-58.3787829302072 -34.6548074467442,-58.3787888959878 -34.6547228005095,-58.3788066065663 -34.6546541487336,-58.3788862743292 -34.6546708237208,-58.3790437058861 -34.6542242287228,-58.3789402692103 -34.6541995091102,-58.3789391969692 -34.6541991882787,-58.3788841237356 -34.6541827094792,-58.378625700439 -34.6541233044962,-58.378570578544 -34.654105730756,-58.377930884236 -34.6539445083955,-58.3774823837439 -34.6538317277127,-58.3765407413056 -34.6535947915008,-58.3768325893871 -34.6528079321207,-58.3768903594489 -34.6526528273983,-58.3758260545022 -34.6523757276539,-58.3757132253032 -34.6526162176516,-58.3754747785848 -34.6532627563725,-58.3750666762257 -34.6543687635586,-58.3746054275596 -34.6555933961747,-58.3743134549506 -34.6563079237321,-58.3740907337981 -34.6564926265357)))";;"2371";4_23_12;COMUNA 4;"23";"12";"780";"377";"403";"93,55%";"225";"224";"99,56%";"1";"0,45%";"232";"33";"14.22";"199";"85,78%";"14.22";14.220
"MULTIPOLYGON (((-58.3803970533892 -34.6469857095249,-58.3803493428945 -34.6469749727659,-58.3803176103064 -34.6470936168955,-58.3802981184847 -34.6471567746507,-58.3802828099053 -34.6472121885164,-58.3802669885428 -34.6472690809509,-58.380252535155 -34.6473213967047,-58.3802374690557 -34.6473900505635,-58.3802197552158 -34.6474647591498,-58.3802002430716 -34.6475482695985,-58.380184938262 -34.6475997396699,-58.3801738212034 -34.6476389586822,-58.3801643182309 -34.6476832493613,-58.380153709731 -34.6477252152771,-58.3801432741675 -34.6477646460212,-58.3801329236017 -34.6478042880956,-58.3801207762748 -34.6478511826918,-58.3801154729821 -34.6478711797029,-58.3801116816667 -34.6479132910797,-58.3801090211481 -34.6479322335102,-58.3800962005727 -34.6479705358391,-58.3800645447029 -34.6480969970713,-58.3800601800299 -34.6481157270715,-58.380040686514 -34.6481801524172,-58.3800284501573 -34.6482307794475,-58.3800132173275 -34.6482953485253,-58.3799969605338 -34.6483612549745,-58.3799913109927 -34.648386604017,-58.3800489037233 -34.6484011505436,-58.3800353801257 -34.6484607910554,-58.3800353071952 -34.648461111552,-58.3800218567183 -34.6485202202912,-58.3799603438229 -34.648505741517,-58.3797632260615 -34.6492848563031,-58.3798374370658 -34.6492993438045,-58.3798162952776 -34.6493925716588,-58.3797931202853 -34.6493880487279,-58.3797666120192 -34.6493933125504,-58.3797509156496 -34.6494094995412,-58.3797495312468 -34.6494304851417,-58.3797612757886 -34.6494461978245,-58.3798002939787 -34.6494582669693,-58.3797934986891 -34.6494827425615,-58.3799638809732 -34.649514244732,-58.3803645696637 -34.6495881601804,-58.3803844816978 -34.6495314817905,-58.3814885510828 -34.6497332844154,-58.3817548133779 -34.6497819840246,-58.3823192032648 -34.6498872900662,-58.3825760926966 -34.6499357000043,-58.3826498335519 -34.6497311648688,-58.3828539844661 -34.6491444501889,-58.383378405919 -34.6476371414813,-58.3823061144135 -34.6473793188365,-58.3812383449979 -34.6471225461477,-58.3805832712977 -34.6469650597859,-58.3805832545434 -34.6469651294348,-58.3804091432961 -34.6469231136318,-58.3804091306646 -34.6469231805708,-58.3803970533892 -34.6469857095249)))";;"2372";4_23_2;COMUNA 4;"23";"2";"873";"429";"444";"96,62%";"340";"339";"99,71%";"1";"0,29%";"288";"48";"16.67";"240";"83,33%";"16.67";16.670
"MULTIPOLYGON (((-58.3785658187591 -34.648104352791,-58.3782886487994 -34.6489034105767,-58.3782384892435 -34.6490379573371,-58.3781730338225 -34.6492134806126,-58.3792661207711 -34.6493949430292,-58.3796060903055 -34.649448275341,-58.3797935043766 -34.6494828541028,-58.3797934986891 -34.6494827425615,-58.3798002939787 -34.6494582669693,-58.3797612757886 -34.6494461978245,-58.3797495312468 -34.6494304851417,-58.3797509156496 -34.6494094995412,-58.3797666120192 -34.6493933125504,-58.3797931202853 -34.6493880487279,-58.3798162952776 -34.6493925716588,-58.3798374370658 -34.6492993438045,-58.3797632260615 -34.6492848563031,-58.3799603438229 -34.648505741517,-58.3800218567183 -34.6485202202912,-58.3800353071952 -34.648461111552,-58.3800353801257 -34.6484607910554,-58.3800489037233 -34.6484011505436,-58.3799913109927 -34.648386604017,-58.3799969605338 -34.6483612549745,-58.3800132173275 -34.6482953485253,-58.3800284501573 -34.6482307794475,-58.380040686514 -34.6481801524172,-58.3800601800299 -34.6481157270715,-58.3800645447029 -34.6480969970713,-58.3800962005727 -34.6479705358391,-58.3801090211481 -34.6479322335102,-58.3801116816667 -34.6479132910797,-58.3801154729821 -34.6478711797029,-58.3801207762748 -34.6478511826918,-58.3801329236017 -34.6478042880956,-58.3801432741675 -34.6477646460212,-58.380153709731 -34.6477252152771,-58.3801643182309 -34.6476832493613,-58.3801738212034 -34.6476389586822,-58.380184938262 -34.6475997396699,-58.3802002430716 -34.6475482695985,-58.3802197552158 -34.6474647591498,-58.3802374690557 -34.6473900505635,-58.380252535155 -34.6473213967047,-58.3802669885428 -34.6472690809509,-58.3802828099053 -34.6472121885164,-58.3802981184847 -34.6471567746507,-58.3803176103064 -34.6470936168955,-58.3803493428945 -34.6469749727659,-58.3803970533892 -34.6469857095249,-58.3804091306646 -34.6469231805708,-58.3803658510951 -34.6469127989315,-58.3801509018741 -34.6468611027593,-58.3799739502471 -34.6468185167728,-58.3790862991924 -34.6466038908107,-58.3796071883672 -34.6451019475852,-58.3788841540451 -34.6449232783263,-58.3788006988336 -34.6451228045066,-58.3782194402593 -34.6463942729407,-58.3781243839006 -34.6466023823801,-58.3776289298324 -34.6476957327755,-58.3775604292664 -34.6478488585959,-58.3778268256683 -34.6479250324995,-58.3785658187591 -34.648104352791)))";;"2373";4_23_3;COMUNA 4;"23";"3";"819";"390";"429";"90,91%";"300";"300";"100,00%";"0";"0,00%";"258";"44";"17.05";"214";"82,95%";"17.05";17.050
"MULTIPOLYGON (((-58.3775329137789 -34.644589303775,-58.3768532511276 -34.6444212868773,-58.3767743435569 -34.644668844525,-58.3760019153828 -34.6445525900619,-58.3759195284356 -34.6448655692113,-58.3758223254009 -34.6452488919941,-58.3754001316323 -34.6469142044566,-58.3753091911568 -34.6472531636449,-58.3752235543144 -34.6475721963727,-58.374927583743 -34.6485542667328,-58.3771298885909 -34.6489500691684,-58.377169968836 -34.6488401644195,-58.3772414119975 -34.6486445044208,-58.377470233755 -34.6480503509495,-58.3775604292664 -34.6478488585959,-58.3776289298324 -34.6476957327755,-58.3781243839006 -34.6466023823801,-58.3782194402593 -34.6463942729407,-58.3788006988336 -34.6451228045066,-58.3788841540451 -34.6449232783263,-58.3775925484399 -34.6446039937437,-58.3775329137789 -34.644589303775)))";;"2374";4_23_4;COMUNA 4;"23";"4";"827";"385";"442";"87,10%";"312";"312";"100,00%";"0";"0,00%";"265";"11";"4.15";"254";"95,85%";"4.15";4.150
"MULTIPOLYGON (((-58.3752378700542 -34.6440022388951,-58.3739629746165 -34.6437015903737,-58.3736509013512 -34.6436439667667,-58.373595623456 -34.6439390058806,-58.3733169074766 -34.6454326504166,-58.373271223895 -34.6456786807516,-58.3732260545856 -34.6459216831756,-58.3731334865396 -34.6464197993494,-58.3730894218033 -34.6466650560933,-58.3742992312959 -34.646987286842,-58.3745838586016 -34.6470631289274,-58.3751387199322 -34.6472083921256,-58.3753091911568 -34.6472531636449,-58.3754001316323 -34.6469142044566,-58.3758223254009 -34.6452488919941,-58.3759195284356 -34.6448655692113,-58.3760019153828 -34.6445525900619,-58.3751366211438 -34.6444223903968,-58.3751666680253 -34.6442921262838,-58.3752378700542 -34.6440022388951)))";;"2375";4_23_5;COMUNA 4;"23";"5";"543";"247";"296";"83,45%";"244";"244";"100,00%";"0";"0,00%";"227";"11";"4.85";"216";"95,15%";"4.85";4.850
"MULTIPOLYGON (((-58.3771298885909 -34.6489500691684,-58.374927583743 -34.6485542667328,-58.3752235543144 -34.6475721963727,-58.3753091911568 -34.6472531636449,-58.3751387199322 -34.6472083921256,-58.3745838586016 -34.6470631289274,-58.3742992312959 -34.646987286842,-58.3730894218033 -34.6466650560933,-58.3730577017547 -34.6468417282641,-58.372998197969 -34.6471795116111,-58.3729554993845 -34.647421529746,-58.372929260875 -34.6475720079234,-58.372861439459 -34.6479566174319,-58.372823708145 -34.6481750468914,-58.3726789945731 -34.6488189735205,-58.3727511608212 -34.6490681891471,-58.3727532838539 -34.6491539679213,-58.3727791227277 -34.6492165240547,-58.3728223732044 -34.6492540922709,-58.3731229241426 -34.6493472739387,-58.373268599645 -34.6493923822038,-58.3740035266073 -34.6496317993319,-58.3745443953712 -34.6498079714203,-58.3765696280698 -34.6504676072748,-58.3766699561778 -34.6501965432886,-58.37673763895 -34.6500135574107,-58.3770511805517 -34.6491659358608,-58.3770991233138 -34.6490344162966,-58.3771298885909 -34.6489500691684)))";;"2376";4_23_6;COMUNA 4;"23";"6";"695";"319";"376";"84,84%";"413";"412";"99,76%";"1";"0,24%";"304";"18";"5.92";"286";"94,08%";"5.92";5.920
"MULTIPOLYGON (((-58.377169968836 -34.6488401644195,-58.3771298885909 -34.6489500691684,-58.3770991233138 -34.6490344162966,-58.3770511805517 -34.6491659358608,-58.37673763895 -34.6500135574107,-58.3766699561778 -34.6501965432886,-58.3775433201427 -34.6503299771674,-58.3777409870036 -34.650371947274,-58.3779442773471 -34.6504151181875,-58.3791315139739 -34.6507150309817,-58.3794746938103 -34.6508017471234,-58.3794902665003 -34.6507390798367,-58.379450564024 -34.6507289820171,-58.3794828896597 -34.650616465533,-58.3795138713884 -34.6504842292262,-58.3795338110132 -34.6504007192201,-58.379554178032 -34.6503158714331,-58.3795640346735 -34.6502593976016,-58.3795714854013 -34.6502227114495,-58.3795752623352 -34.6501953892681,-58.3795814224595 -34.6501710265454,-58.3795887731222 -34.6501491999204,-58.3795911789459 -34.6501294826637,-58.3796036577345 -34.6500926590863,-58.3796121503146 -34.6500366772917,-58.3796226703711 -34.6499985143092,-58.3796588932027 -34.6498229703728,-58.3796663583844 -34.6497717063227,-58.3796732117176 -34.6497357944256,-58.3796839970528 -34.6496879130168,-58.3796907629763 -34.6496541842223,-58.3797131223174 -34.6495365902982,-58.3797758319396 -34.6495481121743,-58.3797935043766 -34.6494828541028,-58.3796060903055 -34.649448275341,-58.3792661207711 -34.6493949430292,-58.3781730338225 -34.6492134806126,-58.3782384892435 -34.6490379573371,-58.3782886487994 -34.6489034105767,-58.3785658187591 -34.648104352791,-58.3778268256683 -34.6479250324995,-58.3775604292664 -34.6478488585959,-58.377470233755 -34.6480503509495,-58.3772414119975 -34.6486445044208,-58.377169968836 -34.6488401644195)))";;"2377";4_23_7;COMUNA 4;"23";"7";"653";"297";"356";"83,43%";"267";"266";"99,63%";"1";"0,38%";"233";"20";"8.58";"213";"91,42%";"8.58";8.580
"MULTIPOLYGON (((-58.3797934986891 -34.6494827425615,-58.3797935043766 -34.6494828541028,-58.3797758319396 -34.6495481121743,-58.3797131223174 -34.6495365902982,-58.3796907629763 -34.6496541842223,-58.3796839970528 -34.6496879130168,-58.3796732117176 -34.6497357944256,-58.3796663583844 -34.6497717063227,-58.3796588932027 -34.6498229703728,-58.3796226703711 -34.6499985143092,-58.3796121503146 -34.6500366772917,-58.3796036577345 -34.6500926590863,-58.3795911789459 -34.6501294826637,-58.3795887731222 -34.6501491999204,-58.3795814224595 -34.6501710265454,-58.3795752623352 -34.6501953892681,-58.3795714854013 -34.6502227114495,-58.3795640346735 -34.6502593976016,-58.379554178032 -34.6503158714331,-58.3795338110132 -34.6504007192201,-58.3795138713884 -34.6504842292262,-58.3794828896597 -34.650616465533,-58.379450564024 -34.6507289820171,-58.3794902665003 -34.6507390798367,-58.3794746938103 -34.6508017471234,-58.3794746209461 -34.6508020444458,-58.379631901819 -34.6508413657194,-58.3796318854432 -34.6508414329439,-58.3798797287532 -34.6509040681666,-58.3809856990117 -34.6511834845329,-58.3820413235663 -34.651450110714,-58.3829211862238 -34.6516723862265,-58.3831329099751 -34.6517253430236,-58.3834079975705 -34.6509263436402,-58.3834624327733 -34.6507688391404,-58.3836778645804 -34.6501451575767,-58.3838741515436 -34.6495770282328,-58.3839366145861 -34.6493993872269,-58.3844191349039 -34.6480269102433,-58.3844652729721 -34.6478984148512,-58.383378405919 -34.6476371414813,-58.3828539844661 -34.6491444501889,-58.3826498335519 -34.6497311648688,-58.3825760926966 -34.6499357000043,-58.3823192032648 -34.6498872900662,-58.3817548133779 -34.6497819840246,-58.3814885510828 -34.6497332844154,-58.3803844816978 -34.6495314817905,-58.3803645696637 -34.6495881601804,-58.3799638809732 -34.649514244732,-58.3797934986891 -34.6494827425615)))";;"2378";4_23_8;COMUNA 4;"23";"8";"845";"392";"453";"86,53%";"347";"346";"99,71%";"1";"0,29%";"288";"16";"5.56";"272";"94,44%";"5.56";5.560
"MULTIPOLYGON (((-58.3794746209461 -34.6508020444458,-58.3794601470476 -34.6508611051504,-58.3794147360336 -34.6508497357792,-58.3793725442048 -34.6510278812449,-58.3792958679565 -34.6513461480961,-58.3791996870073 -34.6517379248218,-58.3791679391551 -34.6518683294562,-58.3792086645826 -34.6518786393406,-58.3791930259526 -34.6519408409228,-58.3791930529955 -34.6519408633074,-58.3791789713267 -34.6519997493333,-58.3791332194107 -34.6519878162285,-58.3789804846158 -34.6525991378785,-58.3790066411019 -34.6526057757466,-58.3789922626451 -34.6526666127319,-58.3789615905781 -34.6526587745417,-58.3788415923978 -34.653155636595,-58.378882748797 -34.6531661506801,-58.3787792667101 -34.6531997213779,-58.3786171884022 -34.6534379265441,-58.3785491896825 -34.6537661990708,-58.3785665433919 -34.654050726372,-58.378570578544 -34.654105730756,-58.378625700439 -34.6541233044962,-58.3788841237356 -34.6541827094792,-58.3789391969692 -34.6541991882787,-58.3789402692103 -34.6541995091102,-58.3790437058861 -34.6542242287228,-58.3788862743292 -34.6546708237208,-58.3788066065663 -34.6546541487336,-58.3787888959878 -34.6547228005095,-58.3787829302072 -34.6548074467442,-58.3786636597359 -34.6552709695641,-58.3786357116974 -34.6553497553925,-58.3786104108395 -34.655423331621,-58.378410455582 -34.6562825845046,-58.3781938513258 -34.6563635059773,-58.378429613727 -34.656655374499,-58.3783086343081 -34.6571375563913,-58.3783552056697 -34.6571471485374,-58.3784912943983 -34.6571652008598,-58.3786692233562 -34.6571893383836,-58.3788961729271 -34.6571984384967,-58.3792465948174 -34.6572287501228,-58.379647871888 -34.6572845890784,-58.3797412747233 -34.6572903570518,-58.3800567769797 -34.6572978250327,-58.3804665293942 -34.6573162011792,-58.3807327680961 -34.6573263103091,-58.3810110246729 -34.6573355818152,-58.3811074108765 -34.6573410690426,-58.3811818955935 -34.657344710515,-58.3814534568921 -34.6565295162995,-58.381924120376 -34.6551651417794,-58.3819867000236 -34.6549637689366,-58.382047740421 -34.6547674656064,-58.3822025222151 -34.6542234675726,-58.3822721694633 -34.6540268176641,-58.3823489947726 -34.6538098197332,-58.3827215961034 -34.6528283458376,-58.3830604412589 -34.6519357244574,-58.3831329099751 -34.6517253430236,-58.3829211862238 -34.6516723862265,-58.3820413235663 -34.651450110714,-58.3809856990117 -34.6511834845329,-58.3798797287532 -34.6509040681666,-58.3796318854432 -34.6508414329439,-58.379631901819 -34.6508413657194,-58.3794746209461 -34.6508020444458)))";;"2379";4_23_9;COMUNA 4;"23";"9";"471";"226";"245";"92,24%";"129";"129";"100,00%";"0";"0,00%";"150";"22";"14.67";"128";"85,33%";"14.67";14.670
"MULTIPOLYGON (((-58.4306554652857 -34.6439429810439,-58.431263677245 -34.6440482834558,-58.4321749769685 -34.6442022521319,-58.4322161835523 -34.6436040748261,-58.4322527952888 -34.6429861773744,-58.4323061342064 -34.6422963099315,-58.4323444260195 -34.6417412316153,-58.4321137773488 -34.6416940598292,-58.431421663172 -34.6415507107652,-58.4311582980382 -34.6414945848319,-58.4309236468991 -34.6414445927681,-58.4301238277 -34.6413091662205,-58.4299224010162 -34.6412814353217,-58.4298813354673 -34.6414827686478,-58.4296575500068 -34.6423981595066,-58.4296203386311 -34.6425470273208,-58.429474223395 -34.643130456542,-58.4293282768168 -34.6437131813304,-58.4299116048966 -34.6438141877683,-58.4306554652857 -34.6439429810439)))";;"2380";4_3_1;COMUNA 4;"3";"1";"974";"432";"542";"79,70%";"367";"367";"100,00%";"0";"0,00%";"342";"20";"5.85";"322";"94,15%";"5.85";5.850
"MULTIPOLYGON (((-58.4236365184371 -34.6434453559386,-58.4228145128295 -34.6428257747795,-58.4221582926248 -34.6423052604325,-58.4218975465131 -34.6426509589392,-58.4211198998126 -34.643681784757,-58.4209638565374 -34.6438886392901,-58.4203447055982 -34.6447115499155,-58.4196664479986 -34.645612959981,-58.4196804041347 -34.6463098877121,-58.4197027800916 -34.6465441985545,-58.4201300584919 -34.6460319383861,-58.4206487880307 -34.6464909352458,-58.4216611534985 -34.6454493467294,-58.4225686288799 -34.6445156058141,-58.4235662727341 -34.6435101945915,-58.4236365184371 -34.6434453559386)))";;"2381";4_3_10;COMUNA 4;"3";"10";"822";"377";"445";"84,72%";"327";"327";"100,00%";"0";"0,00%";"293";"17";"5.8";"276";"94,20%";"5.8";5.800
"MULTIPOLYGON (((-58.4260251863092 -34.6456054603212,-58.4257601153502 -34.6453399496026,-58.4254280824627 -34.6450412478112,-58.4252584848789 -34.6448986562441,-58.4255214963512 -34.644807747983,-58.4245978217703 -34.644148569243,-58.4236365184371 -34.6434453559386,-58.4235662727341 -34.6435101945915,-58.4225686288799 -34.6445156058141,-58.4233019882827 -34.6452156552986,-58.4241605710365 -34.6460352506493,-58.424496513174 -34.6463559295724,-58.4248373982791 -34.6466813275431,-58.4251108492417 -34.6466971168445,-58.4254088281391 -34.6467450266945,-58.4255278670527 -34.6467627396355,-58.425751968906 -34.6467997102782,-58.4259552744633 -34.6468451956318,-58.4261494580932 -34.6468998331219,-58.4262701108264 -34.6469305039644,-58.4264327638868 -34.6469873147447,-58.4267047225278 -34.6471071172906,-58.4269028979964 -34.6471953473324,-58.4271112917506 -34.6473025946982,-58.4272792210993 -34.647379265647,-58.4272240642443 -34.6474300962347,-58.4272709255419 -34.6474487019746,-58.4273441056602 -34.6474983726148,-58.4273872095995 -34.6475355693364,-58.4274481222668 -34.6475766445494,-58.4277800954655 -34.6478558330692,-58.4280670948425 -34.648089865692,-58.4282514755452 -34.6479558997585,-58.4284269051887 -34.6478284100982,-58.4282488752282 -34.6476497629452,-58.4281337929397 -34.6475393044787,-58.4276412679642 -34.6470667550922,-58.4272442365789 -34.6466858540077,-58.4268274469981 -34.6462859311295,-58.4264422629992 -34.6459164396734,-58.4260640671202 -34.6455535690012,-58.4260251863092 -34.6456054603212)))";;"2382";4_3_11;COMUNA 4;"3";"11";"920";"430";"490";"87,76%";"353";"352";"99,72%";"1";"0,28%";"307";"17";"5.54";"290";"94,46%";"5.54";5.540
"MULTIPOLYGON (((-58.4197027800916 -34.6465441985545,-58.4191756670541 -34.6471349451123,-58.419631366785 -34.6475376543863,-58.4200048734948 -34.6478677253429,-58.4201797705361 -34.6478063057096,-58.4216505741466 -34.6473770782893,-58.4216843880353 -34.6474118794598,-58.4217822321862 -34.647380643771,-58.4219860998241 -34.6473207101769,-58.4226738409556 -34.647095400553,-58.4229365721518 -34.6468984113055,-58.4230920837598 -34.646873102989,-58.4231478741614 -34.6469282636273,-58.4235293467837 -34.6468331021539,-58.4237010736643 -34.6467981561231,-58.4239622845287 -34.6467476040273,-58.4241740609115 -34.6467162617044,-58.4244511076229 -34.6466957144808,-58.4248373982791 -34.6466813275431,-58.424496513174 -34.6463559295724,-58.4241605710365 -34.6460352506493,-58.4233019882827 -34.6452156552986,-58.4225686288799 -34.6445156058141,-58.4216611534985 -34.6454493467294,-58.4206487880307 -34.6464909352458,-58.4201300584919 -34.6460319383861,-58.4197027800916 -34.6465441985545)))";;"2383";4_3_12;COMUNA 4;"3";"12";"1065";"516";"549";"93,99%";"359";"359";"100,00%";"0";"0,00%";"341";"42";"12.32";"299";"87,68%";"12.32";12.320
"MULTIPOLYGON (((-58.4248373982791 -34.6466813275431,-58.4244511076229 -34.6466957144808,-58.4241740609115 -34.6467162617044,-58.4239622845287 -34.6467476040273,-58.4237010736643 -34.6467981561231,-58.4235293467837 -34.6468331021539,-58.4231478741614 -34.6469282636273,-58.4230920837598 -34.646873102989,-58.4229365721518 -34.6468984113055,-58.4226738409556 -34.647095400553,-58.4219860998241 -34.6473207101769,-58.4217822321862 -34.647380643771,-58.4216843880353 -34.6474118794598,-58.4216505741466 -34.6473770782893,-58.4201797705361 -34.6478063057096,-58.4200048734948 -34.6478677253429,-58.419631366785 -34.6475376543863,-58.4191756670541 -34.6471349451123,-58.4191330330155 -34.6471842975914,-58.4184214000875 -34.6474860223082,-58.417644811379 -34.6478158183189,-58.4174276276924 -34.6479085576041,-58.4164336002935 -34.6483350060143,-58.4162816801356 -34.6483977079488,-58.416192854974 -34.648474166444,-58.4162067518473 -34.6490733447833,-58.4163287837852 -34.6490748701671,-58.4163300278684 -34.6491362809437,-58.4162042468175 -34.6491336977619,-58.4161747048463 -34.6496922244446,-58.4163423265466 -34.6496997532961,-58.4164910305064 -34.6497057254076,-58.4167759968173 -34.6497171010044,-58.4176479366898 -34.6497574274659,-58.4184258835712 -34.6497922909042,-58.419419088509 -34.6498392685866,-58.4199294553183 -34.6498607873326,-58.4210250074204 -34.6499134921866,-58.422398711664 -34.6499769135658,-58.4224820206715 -34.6500504644068,-58.4225593465565 -34.6499843611375,-58.4240947109562 -34.6500552111073,-58.4247285597597 -34.6500844955095,-58.4252932974348 -34.650110586327,-58.4256920853265 -34.6498155582851,-58.4258236208681 -34.6497199614515,-58.4259514052294 -34.6496271803302,-58.426036054781 -34.6495656546601,-58.4270560165701 -34.6488244557912,-58.42781954811 -34.6482697301794,-58.4280670948425 -34.648089865692,-58.4277800954655 -34.6478558330692,-58.4274481222668 -34.6475766445494,-58.4273872095995 -34.6475355693364,-58.4273441056602 -34.6474983726148,-58.4272709255419 -34.6474487019746,-58.4272240642443 -34.6474300962347,-58.4272792210993 -34.647379265647,-58.4271112917506 -34.6473025946982,-58.4269028979964 -34.6471953473324,-58.4267047225278 -34.6471071172906,-58.4264327638868 -34.6469873147447,-58.4262701108264 -34.6469305039644,-58.4261494580932 -34.6468998331219,-58.4259552744633 -34.6468451956318,-58.425751968906 -34.6467997102782,-58.4255278670527 -34.6467627396355,-58.4254088281391 -34.6467450266945,-58.4251108492417 -34.6466971168445,-58.4248373982791 -34.6466813275431)))";;"2384";4_3_13;COMUNA 4;"3";"13";"590";"279";"311";"89,71%";"192";"192";"100,00%";"0";"0,00%";"197";"24";"12.18";"173";"87,82%";"12.18";12.180
"MULTIPOLYGON (((-58.4285016389702 -34.6457571000809,-58.4276412679642 -34.6470667550922,-58.4281337929397 -34.6475393044787,-58.4282488752282 -34.6476497629452,-58.4284269051887 -34.6478284100982,-58.4286169107282 -34.6476903605554,-58.4297974997793 -34.6468465041043,-58.4310960348465 -34.6459183683566,-58.4321075608723 -34.6451636734593,-58.4321749769685 -34.6442022521319,-58.431263677245 -34.6440482834558,-58.4306554652857 -34.6439429810439,-58.4304159186126 -34.6450742909501,-58.4302902308441 -34.6450655953723,-58.4296542036046 -34.6450340152601,-58.4294629867573 -34.6450238925609,-58.4292746671571 -34.6450139816301,-58.4289681545698 -34.6450061505145,-58.4285016389702 -34.6457571000809)))";;"2385";4_3_2;COMUNA 4;"3";"2";"849";"416";"433";"96,07%";"309";"309";"100,00%";"0";"0,00%";"297";"17";"5.72";"280";"94,28%";"5.72";5.720
"MULTIPOLYGON (((-58.4255214963512 -34.644807747983,-58.4252584848789 -34.6448986562441,-58.4254280824627 -34.6450412478112,-58.4257601153502 -34.6453399496026,-58.4260251863092 -34.6456054603212,-58.4260640671202 -34.6455535690012,-58.4264422629992 -34.6459164396734,-58.4268274469981 -34.6462859311295,-58.4272442365789 -34.6466858540077,-58.4276412679642 -34.6470667550922,-58.4285016389702 -34.6457571000809,-58.4289681545698 -34.6450061505145,-58.4282988885761 -34.6449894841741,-58.4275924669876 -34.6449786487209,-58.4273837805903 -34.6449709121712,-58.4269826872089 -34.644947555202,-58.4267014873841 -34.6449312044103,-58.4263764909064 -34.6449072340642,-58.4261987399153 -34.6448940819942,-58.4255214963512 -34.644807747983)))";;"2386";4_3_3;COMUNA 4;"3";"3";"643";"298";"345";"86,38%";"229";"229";"100,00%";"0";"0,00%";"221";"7";"3.17";"214";"96,83%";"3.17";3.170
"MULTIPOLYGON (((-58.4279653089028 -34.64347723003,-58.4273822411883 -34.6433762143537,-58.426798748828 -34.6432751957635,-58.42664579212 -34.6438664366496,-58.4263764909064 -34.6449072340642,-58.4267014873841 -34.6449312044103,-58.4269826872089 -34.644947555202,-58.4273837805903 -34.6449709121712,-58.4275924669876 -34.6449786487209,-58.4282988885761 -34.6449894841741,-58.4289681545698 -34.6450061505145,-58.4292746671571 -34.6450139816301,-58.4294629867573 -34.6450238925609,-58.4296542036046 -34.6450340152601,-58.4302902308441 -34.6450655953723,-58.4304159186126 -34.6450742909501,-58.4306554652857 -34.6439429810439,-58.4299116048966 -34.6438141877683,-58.4293282768168 -34.6437131813304,-58.4286472179427 -34.6435952429162,-58.4279653089028 -34.64347723003)))";;"2387";4_3_4;COMUNA 4;"3";"4";"904";"440";"464";"94,83%";"328";"328";"100,00%";"0";"0,00%";"298";"33";"11.07";"265";"88,93%";"11.07";11.070
"MULTIPOLYGON (((-58.4273822411883 -34.6433762143537,-58.4279653089028 -34.64347723003,-58.4286472179427 -34.6435952429162,-58.4293282768168 -34.6437131813304,-58.429474223395 -34.643130456542,-58.4296203386311 -34.6425470273208,-58.4296575500068 -34.6423981595066,-58.4298813354673 -34.6414827686478,-58.4299224010162 -34.6412814353217,-58.4297318808435 -34.641255115534,-58.4292509860134 -34.6411732918705,-58.4285663685187 -34.6410569717553,-58.4283544655379 -34.6410209252121,-58.4279964374909 -34.6409604698411,-58.4274227587238 -34.6408635416297,-58.4271003879924 -34.6421094730831,-58.426798748828 -34.6432751957635,-58.4273822411883 -34.6433762143537)))";;"2388";4_3_5;COMUNA 4;"3";"5";"1061";"502";"559";"89,80%";"365";"365";"100,00%";"0";"0,00%";"361";"8";"2.22";"353";"97,78%";"2.22";2.220
"MULTIPOLYGON (((-58.4271003879924 -34.6421094730831,-58.4274227587238 -34.6408635416297,-58.4267683081506 -34.6407529949692,-58.4261667706773 -34.6406514046021,-58.4259380141201 -34.641544814737,-58.4248506662469 -34.6424247914362,-58.4257694317521 -34.6431626313812,-58.4245978217703 -34.644148569243,-58.4255214963512 -34.644807747983,-58.4261987399153 -34.6448940819942,-58.4263764909064 -34.6449072340642,-58.42664579212 -34.6438664366496,-58.426798748828 -34.6432751957635,-58.4271003879924 -34.6421094730831)))";;"2389";4_3_6;COMUNA 4;"3";"6";"902";"421";"481";"87,53%";"321";"321";"100,00%";"0";"0,00%";"296";"12";"4.05";"284";"95,95%";"4.05";4.050
"MULTIPOLYGON (((-58.4248506662469 -34.6424247914362,-58.4259380141201 -34.641544814737,-58.4261667706773 -34.6406514046021,-58.4250696076495 -34.6404659947288,-58.4249183723409 -34.6404400316581,-58.4234919060627 -34.6402003484821,-58.4232482737709 -34.6411395953605,-58.4239344723933 -34.6416889876208,-58.4228770898346 -34.642581914368,-58.4228145128295 -34.6428257747795,-58.4236365184371 -34.6434453559386,-58.4245978217703 -34.644148569243,-58.4257694317521 -34.6431626313812,-58.4248506662469 -34.6424247914362)))";;"2390";4_3_7;COMUNA 4;"3";"7";"686";"348";"338";"102,96%";"257";"257";"100,00%";"0";"0,00%";"229";"20";"8.73";"209";"91,27%";"8.73";8.730
"MULTIPOLYGON (((-58.4206597061952 -34.6407295626784,-58.4205762099401 -34.6410479241915,-58.4215480765172 -34.6418212380637,-58.4217810378862 -34.6420059701319,-58.4221582926248 -34.6423052604325,-58.4228145128295 -34.6428257747795,-58.4228770898346 -34.642581914368,-58.4239344723933 -34.6416889876208,-58.4232482737709 -34.6411395953605,-58.4234919060627 -34.6402003484821,-58.4223060647256 -34.6399891097316,-58.4209177911051 -34.6397418032042,-58.4208634069928 -34.6399529884415,-58.4206597061952 -34.6407295626784)))";;"2391";4_3_8;COMUNA 4;"3";"8";"844";"416";"428";"97,20%";"305";"304";"99,67%";"1";"0,33%";"275";"25";"9.09";"250";"90,91%";"9.09";9.090
"MULTIPOLYGON (((-58.4199433883586 -34.6434705263181,-58.4196544530806 -34.6445841916202,-58.4196593053366 -34.6452533689235,-58.4196664479986 -34.645612959981,-58.4203447055982 -34.6447115499155,-58.4209638565374 -34.6438886392901,-58.4211198998126 -34.643681784757,-58.4218975465131 -34.6426509589392,-58.4221582926248 -34.6423052604325,-58.4217810378862 -34.6420059701319,-58.4215480765172 -34.6418212380637,-58.4205762099401 -34.6410479241915,-58.4205347176494 -34.6412062246993,-58.4202366689357 -34.6423426358405,-58.4201811735676 -34.6425539611446,-58.4199433883586 -34.6434705263181)))";;"2392";4_3_9;COMUNA 4;"3";"9";"575";"265";"310";"85,48%";"200";"200";"100,00%";"0";"0,00%";"183";"1";"0.55";"182";"99,45%";"0.55";0.550
"MULTIPOLYGON (((-58.4170868058096 -34.6391082978067,-58.4161358013451 -34.6389475812043,-58.4160785247666 -34.6401956270998,-58.4160782426935 -34.6403951403422,-58.4167096666876 -34.6405110175441,-58.4182487435461 -34.6407932168311,-58.4184707790761 -34.6408339326419,-58.4196120605422 -34.6410397702149,-58.4205347176494 -34.6412062246993,-58.4205762099401 -34.6410479241915,-58.4206597061952 -34.6407295626784,-58.4208634069928 -34.6399529884415,-58.4209177911051 -34.6397418032042,-58.4197565006879 -34.6395349143968,-58.4195341259133 -34.6394965952413,-58.4192953075563 -34.6394554528383,-58.4186226377428 -34.6393571802987,-58.4184799245802 -34.6393363533288,-58.4172579733651 -34.6391372358618,-58.4170868058096 -34.6391082978067)))";;"2393";4_4_1;COMUNA 4;"4";"1";"668";"315";"353";"89,24%";"283";"282";"99,65%";"1";"0,35%";"236";"4";"1.69";"232";"98,31%";"1.69";1.690
"MULTIPOLYGON (((-58.4121122483523 -34.6485348677384,-58.4122042755408 -34.6485496422625,-58.4122006024831 -34.6485625812528,-58.4122978264104 -34.6485786078752,-58.4123890006267 -34.6485934347049,-58.4125140027857 -34.6486142614894,-58.4126288650868 -34.6486333937908,-58.4127122003835 -34.6486465269678,-58.4127906509084 -34.648659789157,-58.4127937295949 -34.6486487286447,-58.4129398866775 -34.6486735927355,-58.4130605434381 -34.6486936425151,-58.4131716562557 -34.6487129840527,-58.4133681527836 -34.6487457283736,-58.4133707983341 -34.6487341217472,-58.4134670882884 -34.6487504075751,-58.4134671703824 -34.6487503583664,-58.4135618374002 -34.6487677914416,-58.4140056956231 -34.6488412111387,-58.4142915834515 -34.6488881595828,-58.4142889274925 -34.6488986495841,-58.4147606531988 -34.6489725001403,-58.4148538048368 -34.6489881443334,-58.4148543843105 -34.6489882416519,-58.4149499055273 -34.6490031386964,-58.4149616083747 -34.648954409413,-58.4153853639408 -34.6490161257219,-58.4155148097355 -34.6490177252212,-58.4156986178491 -34.6490317402887,-58.4158580596684 -34.6490349003241,-58.4160775804132 -34.6490381535603,-58.4160805444091 -34.6490714655579,-58.4162067518473 -34.6490733447833,-58.416192854974 -34.648474166444,-58.4162816801356 -34.6483977079488,-58.4158691298542 -34.6477663985143,-58.4155418509127 -34.6473146558715,-58.4153381749806 -34.6470293569751,-58.4153005232032 -34.6471547687064,-58.4139260302557 -34.6469262620089,-58.4136434732458 -34.6480497039792,-58.4122842226449 -34.6478233681011,-58.4122409942323 -34.648002510588,-58.4121122483523 -34.6485348677384)))";;"2394";4_4_10;COMUNA 4;"4";"10";"661";"318";"343";"92,71%";"327";"327";"100,00%";"0";"0,00%";"273";"23";"8.42";"250";"91,58%";"8.42";8.420
"MULTIPOLYGON (((-58.4196804041347 -34.6463098877121,-58.4196664479986 -34.645612959981,-58.4196593053366 -34.6452533689235,-58.418384744667 -34.6452667156639,-58.4173824455946 -34.6452772631488,-58.4174006163854 -34.6463370911886,-58.4161700093107 -34.6463517691607,-58.4162060891787 -34.6473600531517,-58.4162255788753 -34.6477101416561,-58.416258822542 -34.6483052428056,-58.4162816801356 -34.6483977079488,-58.4164336002935 -34.6483350060143,-58.4174276276924 -34.6479085576041,-58.417644811379 -34.6478158183189,-58.4184214000875 -34.6474860223082,-58.4191330330155 -34.6471842975914,-58.4191756670541 -34.6471349451123,-58.4197027800916 -34.6465441985545,-58.4196804041347 -34.6463098877121)))";;"2395";4_4_11;COMUNA 4;"4";"11";"960";"439";"521";"84,26%";"333";"333";"100,00%";"0";"0,00%";"344";"35";"10.17";"309";"89,83%";"10.17";10.170
"MULTIPOLYGON (((-58.4158438221148 -34.6388963409886,-58.4145533072027 -34.6386698452381,-58.4142008499011 -34.6400522847105,-58.4155564733345 -34.6402998663372,-58.4160782426935 -34.6403951403422,-58.4160785247666 -34.6401956270998,-58.4161358013451 -34.6389475812043,-58.4158438221148 -34.6388963409886)))";;"2396";4_4_2;COMUNA 4;"4";"2";"738";"318";"420";"75,71%";"355";"355";"100,00%";"0";"0,00%";"295";"2";"0.68";"293";"99,32%";"0.68";0.680
"MULTIPOLYGON (((-58.4125406213901 -34.640922204047,-58.412749620313 -34.640957924752,-58.4138927603964 -34.6411698027025,-58.4142552912794 -34.641237062037,-58.4147813242808 -34.6413345264388,-58.4153316409709 -34.6414365051887,-58.4152806684555 -34.6413159182097,-58.4155564733345 -34.6402998663372,-58.4142008499011 -34.6400522847105,-58.4145533072027 -34.6386698452381,-58.4131919992311 -34.6384309123483,-58.4118797732766 -34.6382005061188,-58.4116257957169 -34.6381590606751,-58.4112604638686 -34.6380993277679,-58.4113666806097 -34.6384353691628,-58.4117546919784 -34.639449648632,-58.4118257380824 -34.6396184160357,-58.4122332875212 -34.6406096730438,-58.4123485776973 -34.6408893774001,-58.4125406213901 -34.640922204047)))";;"2397";4_4_3;COMUNA 4;"4";"3";"902";"414";"488";"84,84%";"390";"390";"100,00%";"0";"0,00%";"320";"3";"0.94";"317";"99,06%";"0.94";0.940
"MULTIPOLYGON (((-58.4153316409709 -34.6414365051887,-58.4147813242808 -34.6413345264388,-58.4142552912794 -34.641237062037,-58.4138927603964 -34.6411698027025,-58.412749620313 -34.640957924752,-58.4125406213901 -34.640922204047,-58.4123485776973 -34.6408893774001,-58.4124888841021 -34.6412294459477,-58.4126983663937 -34.6417387733591,-58.4129384830142 -34.6423223405464,-58.413051062688 -34.6425826762541,-58.4131481557148 -34.6428073002168,-58.4132482275534 -34.6430388973503,-58.4134364708582 -34.6434551836722,-58.4136036108016 -34.6438246287432,-58.4149561123569 -34.6435274100183,-58.4161083304067 -34.6432741858013,-58.4161041905607 -34.6427536046125,-58.4161021425193 -34.6421495708616,-58.4161073521948 -34.6416714592707,-58.4161045073783 -34.6415778636958,-58.4160778225954 -34.6406890227008,-58.4160782426935 -34.6403951403422,-58.4155564733345 -34.6402998663372,-58.4152806684555 -34.6413159182097,-58.4153316409709 -34.6414365051887)))";;"2398";4_4_4;COMUNA 4;"4";"4";"1041";"523";"518";"100,97%";"366";"365";"99,73%";"1";"0,27%";"330";"7";"2.12";"323";"97,88%";"2.12";2.120
"MULTIPOLYGON (((-58.4205347176494 -34.6412062246993,-58.4196120605422 -34.6410397702149,-58.4184707790761 -34.6408339326419,-58.4182487435461 -34.6407932168311,-58.4167096666876 -34.6405110175441,-58.4160782426935 -34.6403951403422,-58.4160778225954 -34.6406890227008,-58.4161045073783 -34.6415778636958,-58.4161073521948 -34.6416714592707,-58.4161021425193 -34.6421495708616,-58.4161041905607 -34.6427536046125,-58.4176445839395 -34.643037713407,-58.4178867287817 -34.6421400985177,-58.417946922962 -34.641916381215,-58.4181023326424 -34.6419451010163,-58.4191944627279 -34.6421485300401,-58.4202366689357 -34.6423426358405,-58.4205347176494 -34.6412062246993)))";;"2399";4_4_5;COMUNA 4;"4";"5";"1016";"497";"519";"95,76%";"439";"439";"100,00%";"0";"0,00%";"366";"19";"5.19";"347";"94,81%";"5.19";5.190
"MULTIPOLYGON (((-58.4202366689357 -34.6423426358405,-58.4191944627279 -34.6421485300401,-58.4181023326424 -34.6419451010163,-58.417946922962 -34.641916381215,-58.4178867287817 -34.6421400985177,-58.4176445839395 -34.643037713407,-58.4173700728534 -34.6440551785274,-58.4173689692337 -34.6442041263956,-58.4175918878292 -34.6442037160809,-58.418369554594 -34.6443471746985,-58.4196544530806 -34.6445841916202,-58.4199433883586 -34.6434705263181,-58.4201811735676 -34.6425539611446,-58.4202366689357 -34.6423426358405)))";;"2400";4_4_6;COMUNA 4;"4";"6";"795";"370";"425";"87,06%";"311";"311";"100,00%";"0";"0,00%";"286";"18";"6.29";"268";"93,71%";"6.29";6.290
"MULTIPOLYGON (((-58.4161642063887 -34.6452989177125,-58.4161661974069 -34.6460059120348,-58.4161667620754 -34.6462154257167,-58.4161700093107 -34.6463517691607,-58.4174006163854 -34.6463370911886,-58.4173824455946 -34.6452772631488,-58.418384744667 -34.6452667156639,-58.4196593053366 -34.6452533689235,-58.4196544530806 -34.6445841916202,-58.418369554594 -34.6443471746985,-58.4175918878292 -34.6442037160809,-58.4173689692337 -34.6442041263956,-58.4173700728534 -34.6440551785274,-58.4176445839395 -34.643037713407,-58.4161041905607 -34.6427536046125,-58.4161083304067 -34.6432741858013,-58.4161509404695 -34.6441822584404,-58.4161618607836 -34.6444640318941,-58.4161642063887 -34.6452989177125)))";;"2401";4_4_7;COMUNA 4;"4";"7";"886";"422";"464";"90,95%";"401";"400";"99,75%";"1";"0,25%";"329";"14";"4.26";"315";"95,74%";"4.26";4.260
"MULTIPOLYGON (((-58.4149561123569 -34.6435274100183,-58.4136036108016 -34.6438246287432,-58.4137136482033 -34.6440679199719,-58.4139513498424 -34.6445790169501,-58.4140063289195 -34.6446971411552,-58.4141179044333 -34.6449371226382,-58.414321774811 -34.6453117926928,-58.4145196882896 -34.6456755442027,-58.4145596117188 -34.6457488720806,-58.4146621871075 -34.6459373690197,-58.4151390984488 -34.6467504681661,-58.4153381749806 -34.6470293569751,-58.4155418509127 -34.6473146558715,-58.4158691298542 -34.6477663985143,-58.4162816801356 -34.6483977079488,-58.416258822542 -34.6483052428056,-58.4162255788753 -34.6477101416561,-58.4162060891787 -34.6473600531517,-58.4161700093107 -34.6463517691607,-58.4161667620754 -34.6462154257167,-58.4161661974069 -34.6460059120348,-58.4161642063887 -34.6452989177125,-58.4161618607836 -34.6444640318941,-58.4161509404695 -34.6441822584404,-58.4161083304067 -34.6432741858013,-58.4149561123569 -34.6435274100183)))";;"2402";4_4_8;COMUNA 4;"4";"8";"780";"377";"403";"93,55%";"342";"342";"100,00%";"0";"0,00%";"288";"36";"12.5";"252";"87,50%";"12.5";12.500
"MULTIPOLYGON (((-58.4139260302557 -34.6469262620089,-58.4153005232032 -34.6471547687064,-58.4153381749806 -34.6470293569751,-58.4151390984488 -34.6467504681661,-58.4146621871075 -34.6459373690197,-58.4145596117188 -34.6457488720806,-58.4145196882896 -34.6456755442027,-58.414321774811 -34.6453117926928,-58.4141179044333 -34.6449371226382,-58.4140063289195 -34.6446971411552,-58.4139513498424 -34.6445790169501,-58.4137136482033 -34.6440679199719,-58.4136036108016 -34.6438246287432,-58.4134364708582 -34.6434551836722,-58.4133392324495 -34.6434733139322,-58.4131028708902 -34.6444440932023,-58.4130299195997 -34.6447439319309,-58.4128285751818 -34.6455707062122,-58.412804997799 -34.6456676713785,-58.4125559756331 -34.6466985163105,-58.4122842226449 -34.6478233681011,-58.4136434732458 -34.6480497039792,-58.4139260302557 -34.6469262620089)))";;"2403";4_4_9;COMUNA 4;"4";"9";"850";"386";"464";"83,19%";"321";"321";"100,00%";"0";"0,00%";"285";"20";"7.02";"265";"92,98%";"7.02";7.020
"MULTIPOLYGON (((-58.4091416801609 -34.6366747785376,-58.4090536704313 -34.6377213227351,-58.4108011586181 -34.6380242716346,-58.4112604638686 -34.6380993277679,-58.4110021971106 -34.6372814459036,-58.4109273635771 -34.6370431670748,-58.4107060144903 -34.6363341768605,-58.4105119670987 -34.6357094259257,-58.4104885758959 -34.6352374992263,-58.4105653491697 -34.6350945696848,-58.4093471699681 -34.6347200870849,-58.4093359528551 -34.6349396667738,-58.4092681473072 -34.6354449351584,-58.407792356868 -34.6351311005409,-58.407667833264 -34.6363531965913,-58.4078339591408 -34.6363906670079,-58.4089146434789 -34.6366180570865,-58.4091416801609 -34.6366747785376)))";;"2404";4_5_1;COMUNA 4;"5";"1";"891";"409";"482";"84,85%";"440";"440";"100,00%";"0";"0,00%";"369";"9";"2.44";"360";"97,56%";"2.44";2.440
"MULTIPOLYGON (((-58.4049992030786 -34.6474405597865,-58.406365449203 -34.6476596754338,-58.4090079975653 -34.6480834350007,-58.4090996167447 -34.6480981259652,-58.4103695096746 -34.6483036178517,-58.4104603156181 -34.6483178852073,-58.4121010464562 -34.6485808996477,-58.4121122483523 -34.6485348677384,-58.4122409942323 -34.648002510588,-58.4122842226449 -34.6478233681011,-58.4105566251026 -34.6475357315019,-58.4091950907459 -34.6473089376552,-58.4078436182416 -34.6470838233211,-58.4081049484 -34.6459572864586,-58.4083672971156 -34.6448260308228,-58.4076857444294 -34.6447129048847,-58.4069726679731 -34.6445945493068,-58.4063253711311 -34.6444871358139,-58.4056361556523 -34.6443727272304,-58.4054001013833 -34.6455058204567,-58.4040312883581 -34.6452754442496,-58.4038482000977 -34.6461867924206,-58.4037973149742 -34.6464440292356,-58.4036589397872 -34.6471439132309,-58.4036456836546 -34.6472110215295,-58.4036449120786 -34.647214809885,-58.4049596114314 -34.6474342099169,-58.4049992030786 -34.6474405597865)))";;"2405";4_5_10;COMUNA 4;"5";"10";"1258";"609";"649";"93,84%";"399";"399";"100,00%";"0";"0,00%";"397";"71";"17.88";"326";"82,12%";"17.88";17.880
"MULTIPOLYGON (((-58.4108318104175 -34.6464087722377,-58.4110614532669 -34.6454683478981,-58.4111067322303 -34.6452824458515,-58.4099504935002 -34.6450887762394,-58.4097124297243 -34.6450493056228,-58.4083672971156 -34.6448260308228,-58.4081049484 -34.6459572864586,-58.4078436182416 -34.6470838233211,-58.4091950907459 -34.6473089376552,-58.4105566251026 -34.6475357315019,-58.4122842226449 -34.6478233681011,-58.4125559756331 -34.6466985163105,-58.4122996717239 -34.6466558741398,-58.4108318104175 -34.6464087722377)))";;"2406";4_5_11;COMUNA 4;"5";"11";"1016";"503";"513";"98,05%";"359";"359";"100,00%";"0";"0,00%";"340";"41";"12.06";"299";"87,94%";"12.06";12.060
"MULTIPOLYGON (((-58.4093471699681 -34.6347200870849,-58.4078801730656 -34.6342690697811,-58.406275192204 -34.6337756457263,-58.4060072086137 -34.6336810817553,-58.4058863605485 -34.6347257778495,-58.407792356868 -34.6351311005409,-58.4092681473072 -34.6354449351584,-58.4093359528551 -34.6349396667738,-58.4093471699681 -34.6347200870849)))";;"2407";4_5_2;COMUNA 4;"5";"2";"639";"292";"347";"84,15%";"283";"283";"100,00%";"0";"0,00%";"260";"58";"22.31";"202";"77,69%";"22.31";22.310
"MULTIPOLYGON (((-58.407792356868 -34.6351311005409,-58.4058863605485 -34.6347257778495,-58.4057482808374 -34.635920329592,-58.407667833264 -34.6363531965913,-58.407792356868 -34.6351311005409)))";;"2408";4_5_3;COMUNA 4;"5";"3";"797";"345";"452";"76,33%";"388";"388";"100,00%";"0";"0,00%";"331";"1";"0.3";"330";"99,70%";"0.3";0.300
"MULTIPOLYGON (((-58.4043008804667 -34.6343736091368,-58.4042764251052 -34.6344979676654,-58.4040517774779 -34.6355390907832,-58.4054283005566 -34.6358482056021,-58.4057482808374 -34.635920329592,-58.4058863605485 -34.6347257778495,-58.4060072086137 -34.6336810817553,-58.4045392722037 -34.6331634018749,-58.4043008804667 -34.6343736091368)))";;"2409";4_5_4;COMUNA 4;"5";"4";"715";"341";"374";"91,18%";"303";"303";"100,00%";"0";"0,00%";"279";"42";"15.05";"237";"84,95%";"15.05";15.050
"MULTIPOLYGON (((-58.4057482808374 -34.635920329592,-58.4054283005566 -34.6358482056021,-58.4040517774779 -34.6355390907832,-58.4037808764872 -34.6367944232078,-58.4052481993363 -34.637052103312,-58.4056062717234 -34.6371235413523,-58.4056455976954 -34.6368076341199,-58.4057482808374 -34.635920329592)))";;"2410";4_5_5;COMUNA 4;"5";"5";"453";"203";"250";"81,20%";"229";"228";"99,56%";"1";"0,44%";"203";"5";"2.46";"198";"97,54%";"2.46";2.460
"MULTIPOLYGON (((-58.407667833264 -34.6363531965913,-58.4057482808374 -34.635920329592,-58.4056455976954 -34.6368076341199,-58.4056062717234 -34.6371235413523,-58.4075548842507 -34.6374614206152,-58.4090536704313 -34.6377213227351,-58.4091416801609 -34.6366747785376,-58.4089146434789 -34.6366180570865,-58.4078339591408 -34.6363906670079,-58.407667833264 -34.6363531965913)))";;"2411";4_5_6;COMUNA 4;"5";"6";"936";"442";"494";"89,47%";"420";"419";"99,76%";"1";"0,24%";"349";"9";"2.58";"340";"97,42%";"2.58";2.580
"MULTIPOLYGON (((-58.4046607678548 -34.6420961398659,-58.4060701163962 -34.6422892732464,-58.4064376848878 -34.6423393745109,-58.4073936714488 -34.642470167981,-58.408627086018 -34.6426388953609,-58.4088618244068 -34.6426701973715,-58.4093061664133 -34.6427293382231,-58.4091212538291 -34.6416736607398,-58.4089091792442 -34.6404624025317,-58.4088719947299 -34.6402499146294,-58.4088503462314 -34.6401263096183,-58.4088148596372 -34.6399239636026,-58.4087646331294 -34.6398516151682,-58.408710161645 -34.6397555316873,-58.4086620140984 -34.6396311402267,-58.4086371342676 -34.6394980968147,-58.4086101875197 -34.6393989267922,-58.4085786579738 -34.6392714439707,-58.408645331679 -34.6392086546442,-58.4087843173131 -34.6389285664183,-58.4088890166961 -34.6385657842078,-58.4090290968593 -34.637906388266,-58.4090536704313 -34.6377213227351,-58.4075548842507 -34.6374614206152,-58.4056062717234 -34.6371235413523,-58.4055778876125 -34.6373873393355,-58.4053960786607 -34.6383469326019,-58.4053748702224 -34.6384588276097,-58.4051451074719 -34.6396313622748,-58.4050428632252 -34.6401147799738,-58.4050155583526 -34.6402925895772,-58.4048577899944 -34.6410947232109,-58.4046607678548 -34.6420961398659)))";;"2412";4_5_7;COMUNA 4;"5";"7";"834";"356";"478";"74,48%";"294";"291";"98,98%";"3";"1,03%";"251";"17";"6.77";"234";"93,23%";"6.77";6.770
"MULTIPOLYGON (((-58.413051062688 -34.6425826762541,-58.4129384830142 -34.6423223405464,-58.4126983663937 -34.6417387733591,-58.4124888841021 -34.6412294459477,-58.4123485776973 -34.6408893774001,-58.4122332875212 -34.6406096730438,-58.4118257380824 -34.6396184160357,-58.4117546919784 -34.639449648632,-58.4113666806097 -34.6384353691628,-58.4112604638686 -34.6380993277679,-58.4108011586181 -34.6380242716346,-58.4090536704313 -34.6377213227351,-58.4090290968593 -34.637906388266,-58.4088890166961 -34.6385657842078,-58.4087843173131 -34.6389285664183,-58.408645331679 -34.6392086546442,-58.4085786579738 -34.6392714439707,-58.4086101875197 -34.6393989267922,-58.4086371342676 -34.6394980968147,-58.4086620140984 -34.6396311402267,-58.408710161645 -34.6397555316873,-58.4087646331294 -34.6398516151682,-58.4088148596372 -34.6399239636026,-58.4088503462314 -34.6401263096183,-58.4088719947299 -34.6402499146294,-58.4089091792442 -34.6404624025317,-58.4091212538291 -34.6416736607398,-58.4093061664133 -34.6427293382231,-58.4095418558661 -34.6440751872247,-58.4097124297243 -34.6450493056228,-58.4099504935002 -34.6450887762394,-58.4111067322303 -34.6452824458515,-58.4110614532669 -34.6454683478981,-58.4108318104175 -34.6464087722377,-58.4122996717239 -34.6466558741398,-58.4125559756331 -34.6466985163105,-58.412804997799 -34.6456676713785,-58.4128285751818 -34.6455707062122,-58.4130299195997 -34.6447439319309,-58.4131028708902 -34.6444440932023,-58.4133392324495 -34.6434733139322,-58.4134364708582 -34.6434551836722,-58.4132482275534 -34.6430388973503,-58.4131481557148 -34.6428073002168,-58.413051062688 -34.6425826762541)))";;"2413";4_5_8;COMUNA 4;"5";"8";"1082";"481";"601";"80,03%";"301";"298";"99,00%";"3";"1,01%";"247";"11";"4.45";"236";"95,55%";"4.45";4.450
"MULTIPOLYGON (((-58.4056361556523 -34.6443727272304,-58.4063253711311 -34.6444871358139,-58.4069726679731 -34.6445945493068,-58.4076857444294 -34.6447129048847,-58.4083672971156 -34.6448260308228,-58.4097124297243 -34.6450493056228,-58.4095418558661 -34.6440751872247,-58.4093061664133 -34.6427293382231,-58.4088618244068 -34.6426701973715,-58.408627086018 -34.6426388953609,-58.4073936714488 -34.642470167981,-58.4064376848878 -34.6423393745109,-58.4060701163962 -34.6422892732464,-58.4046607678548 -34.6420961398659,-58.4045339654486 -34.6427177889946,-58.4044006578326 -34.6433782388391,-58.4042262943284 -34.6441329674775,-58.4040662853065 -34.6450705956272,-58.4040312883581 -34.6452754442496,-58.4054001013833 -34.6455058204567,-58.4056361556523 -34.6443727272304)))";;"2414";4_5_9;COMUNA 4;"5";"9";"2162";"1028";"1134";"90,65%";"665";"665";"100,00%";"0";"0,00%";"634";"70";"11.04";"564";"88,96%";"11.04";11.040
"MULTIPOLYGON (((-58.4082874664738 -34.6303212350026,-58.4082258448938 -34.6308770710031,-58.4089857092517 -34.6310600901038,-58.4097407213493 -34.6312418347126,-58.4096372086175 -34.6323036557311,-58.4096167952849 -34.6325162594723,-58.411135623308 -34.6328868527581,-58.4114776591965 -34.6329675629023,-58.4115205838471 -34.6328567322147,-58.4116345272361 -34.6316978685949,-58.4116509028005 -34.6315309685304,-58.4117664119792 -34.6305922533439,-58.4117793363578 -34.6303558424391,-58.4115812778446 -34.630307236855,-58.4108272944557 -34.6301224757813,-58.4100338734547 -34.6299280448123,-58.409868953631 -34.6298883947093,-58.4094265029815 -34.6297758745829,-58.4083645004157 -34.6295159608545,-58.4082874664738 -34.6303212350026)))";;"2415";4_6_1;COMUNA 4;"6";"1";"1090";"492";"598";"82,27%";"517";"517";"100,00%";"0";"0,00%";"431";"22";"5.1";"409";"94,90%";"5.1";5.100
"MULTIPOLYGON (((-58.4024438873807 -34.6351780840936,-58.4021163386899 -34.6364997250449,-58.4025141113058 -34.6365718961294,-58.4029759528698 -34.6366530412562,-58.4037808764872 -34.6367944232078,-58.4040517774779 -34.6355390907832,-58.4042764251052 -34.6344979676654,-58.4043008804667 -34.6343736091368,-58.4040616846528 -34.6342950411167,-58.403505222259 -34.6340546236543,-58.4028227020295 -34.6337597738554,-58.4028706283846 -34.6335820450958,-58.4015901489483 -34.633192524315,-58.4012573624193 -34.6340990768446,-58.4009138964638 -34.6350348492165,-58.4012179588223 -34.6350767647869,-58.4024438873807 -34.6351780840936)))";;"2416";4_6_10;COMUNA 4;"6";"10";"730";"312";"418";"74,64%";"255";"254";"99,61%";"1";"0,39%";"215";"4";"1.86";"211";"98,14%";"1.86";1.860
"MULTIPOLYGON (((-58.4024438873807 -34.6351780840936,-58.4012179588223 -34.6350767647869,-58.4009138964638 -34.6350348492165,-58.4004848733266 -34.6362036829608,-58.4021163386899 -34.6364997250449,-58.4024438873807 -34.6351780840936)))";;"2417";4_6_11;COMUNA 4;"6";"11";"654";"297";"357";"83,19%";"272";"272";"100,00%";"0";"0,00%";"246";"2";"0.81";"244";"99,19%";"0.81";0.810
"MULTIPOLYGON (((-58.4089857092517 -34.6310600901038,-58.4082258448938 -34.6308770710031,-58.4081015055071 -34.6320976190912,-58.4080944738442 -34.6321665618746,-58.4082342696175 -34.6321960619686,-58.4087585258372 -34.6323068619653,-58.4096167952849 -34.6325162594723,-58.4096372086175 -34.6323036557311,-58.4097407213493 -34.6312418347126,-58.4089857092517 -34.6310600901038)))";;"2418";4_6_2;COMUNA 4;"6";"2";"787";"361";"426";"84,74%";"356";"356";"100,00%";"0";"0,00%";"320";"12";"3.75";"308";"96,25%";"3.75";3.750
"MULTIPOLYGON (((-58.4081015055071 -34.6320976190912,-58.4082258448938 -34.6308770710031,-58.4082874664738 -34.6303212350026,-58.4083645004157 -34.6295159608545,-58.4067513073522 -34.6293309296445,-58.4065132816125 -34.6293040587761,-58.4064002447398 -34.6302817152549,-58.4063316842731 -34.6308747314226,-58.4062185575788 -34.6318528804113,-58.4071400763571 -34.6320004211825,-58.4080944738442 -34.6321665618746,-58.4081015055071 -34.6320976190912)))";;"2419";4_6_3;COMUNA 4;"6";"3";"751";"351";"400";"87,75%";"309";"309";"100,00%";"0";"0,00%";"285";"38";"13.33";"247";"86,67%";"13.33";13.330
"MULTIPOLYGON (((-58.4096167952849 -34.6325162594723,-58.4087585258372 -34.6323068619653,-58.4082342696175 -34.6321960619686,-58.4080944738442 -34.6321665618746,-58.4071400763571 -34.6320004211825,-58.4062185575788 -34.6318528804113,-58.4061292595041 -34.6326171599355,-58.406821395789 -34.6328060063033,-58.4079966291224 -34.6331266199711,-58.4078801730656 -34.6342690697811,-58.4093471699681 -34.6347200870849,-58.4105653491697 -34.6350945696848,-58.4108802872865 -34.6345084876698,-58.4109869624709 -34.6342333127167,-58.4114776591965 -34.6329675629023,-58.411135623308 -34.6328868527581,-58.4096167952849 -34.6325162594723)))";;"2420";4_6_4;COMUNA 4;"6";"4";"955";"430";"525";"81,90%";"366";"366";"100,00%";"0";"0,00%";"320";"17";"5.31";"303";"94,69%";"5.31";5.310
"MULTIPOLYGON (((-58.406821395789 -34.6328060063033,-58.4061292595041 -34.6326171599355,-58.4062185575788 -34.6318528804113,-58.4047721622182 -34.631645786796,-58.4045660352896 -34.6330274946919,-58.4045392722037 -34.6331634018749,-58.4060072086137 -34.6336810817553,-58.406275192204 -34.6337756457263,-58.4078801730656 -34.6342690697811,-58.4079966291224 -34.6331266199711,-58.406821395789 -34.6328060063033)))";;"2421";4_6_5;COMUNA 4;"6";"5";"733";"340";"393";"86,51%";"316";"315";"99,68%";"1";"0,32%";"275";"18";"6.55";"257";"93,45%";"6.55";6.550
"MULTIPOLYGON (((-58.4063316842731 -34.6308747314226,-58.4049164812225 -34.6306783584853,-58.4047721622182 -34.631645786796,-58.4062185575788 -34.6318528804113,-58.4063316842731 -34.6308747314226)))";;"2422";4_6_6;COMUNA 4;"6";"6";"929";"408";"521";"78,31%";"429";"429";"100,00%";"0";"0,00%";"375";"2";"0.53";"373";"99,47%";"0.53";0.530
"MULTIPOLYGON (((-58.4049683207289 -34.6303773167123,-58.4049312039438 -34.6305797002175,-58.4049164812225 -34.6306783584853,-58.4063316842731 -34.6308747314226,-58.4064002447398 -34.6302817152549,-58.4065132816125 -34.6293040587761,-58.405645775317 -34.6292061880411,-58.405454009253 -34.6291845481762,-58.4035429137975 -34.6289689108022,-58.4023857658332 -34.6288382693391,-58.4023483038503 -34.6290390321634,-58.4022255828465 -34.6301453462434,-58.4033882244547 -34.6302436668628,-58.4049683207289 -34.6303773167123)))";;"2423";4_6_7;COMUNA 4;"6";"7";"766";"351";"415";"84,58%";"312";"312";"100,00%";"0";"0,00%";"310";"36";"11.61";"274";"88,39%";"11.61";11.610
"MULTIPOLYGON (((-58.4032561806535 -34.6314172329746,-58.4031479709748 -34.6323783385921,-58.4031075089893 -34.6326045234375,-58.4038150797209 -34.632885791796,-58.4043108165244 -34.63308279713,-58.4045392722037 -34.6331634018749,-58.4045660352896 -34.6330274946919,-58.4047721622182 -34.631645786796,-58.4049164812225 -34.6306783584853,-58.4049312039438 -34.6305797002175,-58.4049683207289 -34.6303773167123,-58.4033882244547 -34.6302436668628,-58.4022255828465 -34.6301453462434,-58.4021039737432 -34.6312412376704,-58.4032561806535 -34.6314172329746)))";;"2424";4_6_8;COMUNA 4;"6";"8";"920";"417";"503";"82,90%";"356";"356";"100,00%";"0";"0,00%";"317";"53";"16.72";"264";"83,28%";"16.72";16.720
"MULTIPOLYGON (((-58.4038150797209 -34.632885791796,-58.4031075089893 -34.6326045234375,-58.4031479709748 -34.6323783385921,-58.4032561806535 -34.6314172329746,-58.4021039737432 -34.6312412376704,-58.4020010575887 -34.6321692452413,-58.4015901489483 -34.633192524315,-58.4028706283846 -34.6335820450958,-58.4028227020295 -34.6337597738554,-58.403505222259 -34.6340546236543,-58.4040616846528 -34.6342950411167,-58.4043008804667 -34.6343736091368,-58.4045392722037 -34.6331634018749,-58.4043108165244 -34.63308279713,-58.4038150797209 -34.632885791796)))";;"2425";4_6_9;COMUNA 4;"6";"9";"707";"319";"388";"82,22%";"309";"309";"100,00%";"0";"0,00%";"274";"1";"0.36";"273";"99,64%";"0.36";0.360
"MULTIPOLYGON (((-58.4008613047884 -34.6300109957964,-58.4006329975155 -34.6299763012215,-58.3995626281678 -34.6297721535485,-58.3991623563307 -34.6311242440245,-58.4005282714757 -34.631597428284,-58.4006822743264 -34.6316508183014,-58.4020010575887 -34.6321692452413,-58.4021039737432 -34.6312412376704,-58.4022255828465 -34.6301453462434,-58.4023483038503 -34.6290390321634,-58.4023857658332 -34.6288382693391,-58.4011009209396 -34.6286932562238,-58.4008613047884 -34.6300109957964)))";;"2426";4_7_1;COMUNA 4;"7";"1";"902";"454";"448";"101,34%";"365";"364";"99,73%";"1";"0,27%";"304";"27";"8.88";"277";"91,12%";"8.88";8.880
"MULTIPOLYGON (((-58.3968570268648 -34.6330478733056,-58.3958288355492 -34.632802235483,-58.3956146807948 -34.632749440102,-58.3955733745303 -34.6329404095393,-58.3952349067708 -34.6339440583458,-58.3948354476508 -34.6351288751656,-58.3959551752261 -34.6353733037648,-58.3962591868513 -34.6345155546571,-58.3963726440533 -34.6342370158149,-58.3968570268648 -34.6330478733056)))";;"2427";4_7_10;COMUNA 4;"7";"10";"610";"267";"343";"77,84%";"356";"356";"100,00%";"0";"0,00%";"287";"0";"0";"287";"100,00%";"0";0.000
"MULTIPOLYGON (((-58.3977501094853 -34.6306493295815,-58.3962579788315 -34.6303670377128,-58.3962966848588 -34.6302280400998,-58.3965427070579 -34.6291962380843,-58.3968070164921 -34.6280870483159,-58.3953455006943 -34.6278292695942,-58.3942928785819 -34.6276424099532,-58.3932061026106 -34.627449394806,-58.3921594529537 -34.6272635765247,-58.3917220185579 -34.6295086090652,-58.3914966179187 -34.6306650653136,-58.3912976539355 -34.6316862502653,-58.3913932288666 -34.6317098280777,-58.3946382098504 -34.6325090321093,-58.3938533076798 -34.6349126135239,-58.3941466958193 -34.6349784851324,-58.3948354476508 -34.6351288751656,-58.3952349067708 -34.6339440583458,-58.3955733745303 -34.6329404095393,-58.3956146807948 -34.632749440102,-58.3958288355492 -34.632802235483,-58.3968570268648 -34.6330478733056,-58.3969206255939 -34.6328917757553,-58.397295823915 -34.6318453234747,-58.3973529481404 -34.6316860530768,-58.3977501094853 -34.6306493295815)))";;"2428";4_7_11;COMUNA 4;"7";"11";"1277";"496";"781";"63,51%";"235";"232";"98,72%";"3";"1,29%";"212";"33";"15.57";"179";"84,43%";"15.57";15.570
"MULTIPOLYGON (((-58.3921594529537 -34.6272635765247,-58.3911698240387 -34.627252999868,-58.3910614930745 -34.6281994468917,-58.3909253131393 -34.6293283481459,-58.3908900448041 -34.6296206610456,-58.3907830275837 -34.6305183742185,-58.3906624480134 -34.6315298857156,-58.3905573140608 -34.6324116835041,-58.3905268471557 -34.6326661808509,-58.3903526218416 -34.6341243645838,-58.3906897037176 -34.6342017496688,-58.3908971333537 -34.6342483523419,-58.3919508950909 -34.6344867927616,-58.3938533076798 -34.6349126135239,-58.3946382098504 -34.6325090321093,-58.3913932288666 -34.6317098280777,-58.3912976539355 -34.6316862502653,-58.3914966179187 -34.6306650653136,-58.3917220185579 -34.6295086090652,-58.3921594529537 -34.6272635765247)))";;"2429";4_7_12;COMUNA 4;"7";"12";"866";"461";"405";"113,83%";"306";"301";"98,37%";"5";"1,66%";"272";"64";"23.53";"208";"76,47%";"23.53";23.530
"MULTIPOLYGON (((-58.4011009209396 -34.6286932562238,-58.4008428791157 -34.6286641105827,-58.3999065507781 -34.6285607413891,-58.3995626281678 -34.6297721535485,-58.4006329975155 -34.6299763012215,-58.4008613047884 -34.6300109957964,-58.4011009209396 -34.6286932562238)))";;"2430";4_7_2;COMUNA 4;"7";"2";"756";"356";"400";"89,00%";"325";"325";"100,00%";"0";"0,00%";"290";"1";"0.34";"289";"99,66%";"0.34";0.340
"MULTIPOLYGON (((-58.3965427070579 -34.6291962380843,-58.3962966848588 -34.6302280400998,-58.3962579788315 -34.6303670377128,-58.3977501094853 -34.6306493295815,-58.3978143099827 -34.6304818229936,-58.3981936874499 -34.6295111469174,-58.3995626281678 -34.6297721535485,-58.3999065507781 -34.6285607413891,-58.3985941180819 -34.628405969026,-58.3968657089348 -34.6280975028923,-58.3968070164921 -34.6280870483159,-58.3965427070579 -34.6291962380843)))";;"2431";4_7_3;COMUNA 4;"7";"3";"938";"430";"508";"84,65%";"267";"264";"98,88%";"3";"1,14%";"302";"87";"28.81";"215";"71,19%";"28.81";28.810
"MULTIPOLYGON (((-58.3995626281678 -34.6297721535485,-58.3981936874499 -34.6295111469174,-58.3978143099827 -34.6304818229936,-58.3977501094853 -34.6306493295815,-58.3991623563307 -34.6311242440245,-58.3995626281678 -34.6297721535485)))";;"2432";4_7_4;COMUNA 4;"7";"4";"2159";"898";"1261";"71,21%";"918";"917";"99,89%";"1";"0,11%";"814";"25";"3.07";"789";"96,93%";"3.07";3.070
"MULTIPOLYGON (((-58.3991623563307 -34.6311242440245,-58.3977501094853 -34.6306493295815,-58.3973529481404 -34.6316860530768,-58.397295823915 -34.6318453234747,-58.3969206255939 -34.6328917757553,-58.3968570268648 -34.6330478733056,-58.3982955678499 -34.6333915399212,-58.3987312303428 -34.6322520135665,-58.4001275433781 -34.6326585258478,-58.4004153772723 -34.6319440722423,-58.4005282714757 -34.631597428284,-58.3991623563307 -34.6311242440245)))";;"2433";4_7_5;COMUNA 4;"7";"5";"763";"349";"414";"84,30%";"349";"349";"100,00%";"0";"0,00%";"297";"50";"16.84";"247";"83,16%";"16.84";16.840
"MULTIPOLYGON (((-58.4015901489483 -34.633192524315,-58.4020010575887 -34.6321692452413,-58.4006822743264 -34.6316508183014,-58.4005282714757 -34.631597428284,-58.4004153772723 -34.6319440722423,-58.4001275433781 -34.6326585258478,-58.3987312303428 -34.6322520135665,-58.3982955678499 -34.6333915399212,-58.3996972345609 -34.6337264378367,-58.4012573624193 -34.6340990768446,-58.4015901489483 -34.633192524315)))";;"2434";4_7_6;COMUNA 4;"7";"6";"861";"404";"457";"88,40%";"344";"343";"99,71%";"1";"0,29%";"287";"11";"3.83";"276";"96,17%";"3.83";3.830
"MULTIPOLYGON (((-58.3992953991223 -34.6347597139085,-58.3989056429781 -34.6359170833022,-58.4004848733266 -34.6362036829608,-58.4009138964638 -34.6350348492165,-58.4012573624193 -34.6340990768446,-58.3996972345609 -34.6337264378367,-58.3993692672006 -34.6345402381227,-58.3992953991223 -34.6347597139085)))";;"2435";4_7_7;COMUNA 4;"7";"7";"785";"355";"430";"82,56%";"376";"375";"99,73%";"1";"0,27%";"314";"7";"2.23";"307";"97,77%";"2.23";2.230
"MULTIPOLYGON (((-58.3978686019295 -34.6345082514806,-58.3974322327263 -34.635649604985,-58.3985787572043 -34.6358577550479,-58.3989056429781 -34.6359170833022,-58.3992953991223 -34.6347597139085,-58.3993692672006 -34.6345402381227,-58.3996972345609 -34.6337264378367,-58.3982955678499 -34.6333915399212,-58.3978686019295 -34.6345082514806)))";;"2436";4_7_8;COMUNA 4;"7";"8";"689";"314";"375";"83,73%";"348";"348";"100,00%";"0";"0,00%";"286";"4";"1.4";"282";"98,60%";"1.4";1.400
"MULTIPOLYGON (((-58.3982955678499 -34.6333915399212,-58.3968570268648 -34.6330478733056,-58.3963726440533 -34.6342370158149,-58.3962591868513 -34.6345155546571,-58.3959551752261 -34.6353733037648,-58.3961796497089 -34.6354223012185,-58.3974322327263 -34.635649604985,-58.3978686019295 -34.6345082514806,-58.3982955678499 -34.6333915399212)))";;"2437";4_7_9;COMUNA 4;"7";"9";"744";"322";"422";"76,30%";"290";"289";"99,66%";"1";"0,35%";"273";"27";"9.89";"246";"90,11%";"9.89";9.890
"MULTIPOLYGON (((-58.403563367643 -34.6392847495325,-58.4045389199866 -34.6409916105759,-58.4047790632331 -34.64108391086,-58.4048577899944 -34.6410947232109,-58.4050155583526 -34.6402925895772,-58.4050428632252 -34.6401147799738,-58.4051451074719 -34.6396313622748,-58.4053748702224 -34.6384588276097,-58.4053960786607 -34.6383469326019,-58.4049582573711 -34.6382606670215,-58.4035254404633 -34.6379784219668,-58.403488167318 -34.6381512967175,-58.4033265279456 -34.6388703959603,-58.4032488273645 -34.6392158620356,-58.403563367643 -34.6392847495325)))";;"2438";4_8_1;COMUNA 4;"8";"1";"705";"313";"392";"79,85%";"380";"380";"100,00%";"0";"0,00%";"304";"2";"0.66";"302";"99,34%";"0.66";0.660
"MULTIPOLYGON (((-58.4009346618979 -34.6416189426809,-58.4026490010298 -34.6418786802154,-58.402714046126 -34.6416016613006,-58.4029840074987 -34.6403939389279,-58.4032488273645 -34.6392158620356,-58.402910603458 -34.6391417506856,-58.4015659612543 -34.6388695261593,-58.3998253429396 -34.6385171511845,-58.3996642377736 -34.6384874896172,-58.3980036091493 -34.638181399026,-58.397811263269 -34.6386614529615,-58.3976783359544 -34.6389930828363,-58.3975314058562 -34.6393599174484,-58.3992194000285 -34.6395649691355,-58.399128506015 -34.6396456285685,-58.3985193578923 -34.6401864533721,-58.3982685582149 -34.6412150154469,-58.3997030809708 -34.6414323914022,-58.4009346618979 -34.6416189426809)))";;"2439";4_8_10;COMUNA 4;"8";"10";"763";"371";"392";"94,64%";"247";"247";"100,00%";"0";"0,00%";"238";"26";"10.92";"212";"89,08%";"10.92";10.920
"MULTIPOLYGON (((-58.4027466461986 -34.6470611788222,-58.4027476240549 -34.6470624568992,-58.4035768404342 -34.6472034495159,-58.4036449120786 -34.647214809885,-58.4036456836546 -34.6472110215295,-58.4036589397872 -34.6471439132309,-58.4037973149742 -34.6464440292356,-58.4038482000977 -34.6461867924206,-58.4040312883581 -34.6452754442496,-58.4040662853065 -34.6450705956272,-58.4042262943284 -34.6441329674775,-58.4044006578326 -34.6433782388391,-58.4045339654486 -34.6427177889946,-58.4046607678548 -34.6420961398659,-58.4048577899944 -34.6410947232109,-58.4047790632331 -34.64108391086,-58.4045389199866 -34.6409916105759,-58.403563367643 -34.6392847495325,-58.4032488273645 -34.6392158620356,-58.4029840074987 -34.6403939389279,-58.402714046126 -34.6416016613006,-58.4026490010298 -34.6418786802154,-58.4025216288788 -34.6424430012545,-58.4023733107386 -34.6431002019591,-58.4022169546137 -34.6437926812076,-58.4019661294711 -34.644903788037,-58.4018383204717 -34.6454701501757,-58.4017440115632 -34.6457869437717,-58.4016903336656 -34.6461255892654,-58.4016384392584 -34.6463556407449,-58.4015585011231 -34.6467118791671,-58.4015411475161 -34.6467864502026,-58.4015244782841 -34.6468581417131,-58.4027466461986 -34.6470611788222)))";;"2440";4_8_11;COMUNA 4;"8";"11";"899";"431";"468";"92,09%";"324";"324";"100,00%";"0";"0,00%";"281";"20";"7.12";"261";"92,88%";"7.12";7.120
"MULTIPOLYGON (((-58.4029759528698 -34.6366530412562,-58.4025141113058 -34.6365718961294,-58.4021163386899 -34.6364997250449,-58.4020575446008 -34.636736956972,-58.4018492382366 -34.6376404032999,-58.4016040858307 -34.6387034132236,-58.4015659612543 -34.6388695261593,-58.402910603458 -34.6391417506856,-58.4032488273645 -34.6392158620356,-58.4033265279456 -34.6388703959603,-58.403488167318 -34.6381512967175,-58.4035254404633 -34.6379784219668,-58.4049582573711 -34.6382606670215,-58.4053960786607 -34.6383469326019,-58.4055778876125 -34.6373873393355,-58.4056062717234 -34.6371235413523,-58.4052481993363 -34.637052103312,-58.4037808764872 -34.6367944232078,-58.4029759528698 -34.6366530412562)))";;"2441";4_8_2;COMUNA 4;"8";"2";"767";"336";"431";"77,96%";"400";"400";"100,00%";"0";"0,00%";"311";"7";"2.25";"304";"97,75%";"2.25";2.250
"MULTIPOLYGON (((-58.4018492382366 -34.6376404032999,-58.4020575446008 -34.636736956972,-58.4021163386899 -34.6364997250449,-58.4004848733266 -34.6362036829608,-58.4003836989292 -34.6364793444045,-58.4000913420524 -34.6372952771957,-58.3987829331059 -34.6370469849494,-58.3984805798795 -34.6369908384103,-58.3980036091493 -34.638181399026,-58.3996642377736 -34.6384874896172,-58.3998253429396 -34.6385171511845,-58.4015659612543 -34.6388695261593,-58.4016040858307 -34.6387034132236,-58.4018492382366 -34.6376404032999)))";;"2442";4_8_3;COMUNA 4;"8";"3";"630";"302";"328";"92,07%";"306";"305";"99,67%";"1";"0,33%";"240";"6";"2.5";"234";"97,50%";"2.5";2.500
"MULTIPOLYGON (((-58.3970281145748 -34.6367209014068,-58.3955623685858 -34.6364485453463,-58.3952149039397 -34.6373911302684,-58.3951217245512 -34.6376612985728,-58.3953220964317 -34.6377038051524,-58.3965756529089 -34.6379257659046,-58.3976186128668 -34.6381104877121,-58.3980036091493 -34.638181399026,-58.3984805798795 -34.6369908384103,-58.3987829331059 -34.6370469849494,-58.4000913420524 -34.6372952771957,-58.4003836989292 -34.6364793444045,-58.4004848733266 -34.6362036829608,-58.3989056429781 -34.6359170833022,-58.3985787572043 -34.6358577550479,-58.3974322327263 -34.635649604985,-58.3973273007764 -34.6359241351052,-58.3970281145748 -34.6367209014068)))";;"2443";4_8_4;COMUNA 4;"8";"4";"800";"405";"395";"102,53%";"308";"308";"100,00%";"0";"0,00%";"293";"35";"11.95";"258";"88,05%";"11.95";11.950
"MULTIPOLYGON (((-58.3974322327263 -34.635649604985,-58.3961796497089 -34.6354223012185,-58.3959551752261 -34.6353733037648,-58.3948354476508 -34.6351288751656,-58.3941466958193 -34.6349784851324,-58.3938533076798 -34.6349126135239,-58.3937802735255 -34.6351360302074,-58.393425610944 -34.6361099451944,-58.3930355836402 -34.6371808137275,-58.3948064290065 -34.6375942903424,-58.3951217245512 -34.6376612985728,-58.3952149039397 -34.6373911302684,-58.3955623685858 -34.6364485453463,-58.3970281145748 -34.6367209014068,-58.3973273007764 -34.6359241351052,-58.3974322327263 -34.635649604985)))";;"2444";4_8_5;COMUNA 4;"8";"5";"594";"270";"324";"83,33%";"349";"349";"100,00%";"0";"0,00%";"268";"0";"0";"268";"100,00%";"0";0.000
"MULTIPOLYGON (((-58.3938533076798 -34.6349126135239,-58.3919508950909 -34.6344867927616,-58.3908971333537 -34.6342483523419,-58.3906897037176 -34.6342017496688,-58.3903526218416 -34.6341243645838,-58.3903309494978 -34.6343559789597,-58.3902823714577 -34.6349581527213,-58.3902487581623 -34.6353994850378,-58.3915481330842 -34.6356901184859,-58.393425610944 -34.6361099451944,-58.3937802735255 -34.6351360302074,-58.3938533076798 -34.6349126135239)))";;"2445";4_8_6;COMUNA 4;"8";"6";"710";"321";"389";"82,52%";"330";"330";"100,00%";"0";"0,00%";"274";"54";"19.71";"220";"80,29%";"19.71";19.710
"MULTIPOLYGON (((-58.3901641191531 -34.6365117240239,-58.3900640493478 -34.6378264247991,-58.3903640030358 -34.6378953376557,-58.390781699928 -34.6379798127129,-58.3926099324308 -34.6383496212123,-58.3930355836402 -34.6371808137275,-58.393425610944 -34.6361099451944,-58.3915481330842 -34.6356901184859,-58.3902487581623 -34.6353994850378,-58.3902313480565 -34.6356280736124,-58.3901641191531 -34.6365117240239)))";;"2446";4_8_7;COMUNA 4;"8";"7";"2464";"1192";"1272";"93,71%";"993";"993";"100,00%";"0";"0,00%";"837";"93";"11.11";"744";"88,89%";"11.11";11.110
"MULTIPOLYGON (((-58.3951217245512 -34.6376612985728,-58.3948064290065 -34.6375942903424,-58.3930355836402 -34.6371808137275,-58.3926099324308 -34.6383496212123,-58.390781699928 -34.6379798127129,-58.3903640030358 -34.6378953376557,-58.3900640493478 -34.6378264247991,-58.3899669077329 -34.6391018299348,-58.3898815017356 -34.640205475767,-58.3902440241781 -34.6403532315349,-58.39147123267 -34.6408265045102,-58.3914001970958 -34.6420862207013,-58.3935073242474 -34.642981828432,-58.397276534765 -34.6445837469387,-58.4003798025072 -34.6459024549827,-58.4004924450376 -34.6459184284752,-58.4003523993328 -34.6463095660975,-58.4003321049595 -34.6463578954366,-58.4004466462594 -34.6464062717607,-58.4004361729673 -34.6464258276714,-58.4006343419798 -34.6465437050817,-58.4006898215895 -34.6465760781929,-58.4008472067909 -34.6466375713705,-58.4010834225659 -34.6467311219872,-58.4011359120093 -34.6467368598678,-58.4013027647295 -34.6467575629367,-58.4013996217356 -34.6467678309787,-58.4015411475161 -34.6467864502026,-58.4015585011231 -34.6467118791671,-58.4016384392584 -34.6463556407449,-58.4016903336656 -34.6461255892654,-58.4017440115632 -34.6457869437717,-58.4018383204717 -34.6454701501757,-58.4019661294711 -34.644903788037,-58.4022169546137 -34.6437926812076,-58.4023733107386 -34.6431002019591,-58.4025216288788 -34.6424430012545,-58.4026490010298 -34.6418786802154,-58.4009346618979 -34.6416189426809,-58.3997030809708 -34.6414323914022,-58.3982685582149 -34.6412150154469,-58.3981295964124 -34.6411939553783,-58.3969001300987 -34.640935261968,-58.3955520794538 -34.6406516309871,-58.394204378792 -34.6403680557193,-58.3947396014258 -34.6387746428075,-58.394809385643 -34.638566787749,-58.3951217245512 -34.6376612985728)))";;"2447";4_8_8;COMUNA 4;"8";"8";"405";"215";"190";"113,16%";"117";"114";"97,44%";"3";"2,63%";"97";"19";"19.59";"78";"80,41%";"19.59";19.590
"MULTIPOLYGON (((-58.3992194000285 -34.6395649691355,-58.3975314058562 -34.6393599174484,-58.3976783359544 -34.6389930828363,-58.397811263269 -34.6386614529615,-58.3980036091493 -34.638181399026,-58.3976186128668 -34.6381104877121,-58.3965756529089 -34.6379257659046,-58.3953220964317 -34.6377038051524,-58.3951217245512 -34.6376612985728,-58.394809385643 -34.638566787749,-58.3947396014258 -34.6387746428075,-58.394204378792 -34.6403680557193,-58.3955520794538 -34.6406516309871,-58.3969001300987 -34.640935261968,-58.3981295964124 -34.6411939553783,-58.3982685582149 -34.6412150154469,-58.3985193578923 -34.6401864533721,-58.399128506015 -34.6396456285685,-58.3992194000285 -34.6395649691355)))";;"2448";4_8_9;COMUNA 4;"8";"9";"1093";"543";"550";"98,73%";"321";"321";"100,00%";"0";"0,00%";"350";"56";"16";"294";"84,00%";"16";16.000
"MULTIPOLYGON (((-58.4164811562632 -34.6567482533371,-58.416309904604 -34.656652833432,-58.4162703719555 -34.6566307754936,-58.415066254581 -34.6559596577968,-58.4141788343184 -34.6554649977436,-58.4129830998783 -34.65479851072,-58.4128312260637 -34.655090006509,-58.4125686866114 -34.6555939276187,-58.4122834525622 -34.6561331918762,-58.4119461668261 -34.656770887311,-58.4117891689083 -34.6570677318385,-58.4116325087903 -34.6573678158202,-58.4129004906443 -34.657835677674,-58.4131946791303 -34.6572900775498,-58.4140112107513 -34.6576271765967,-58.4141425999396 -34.6576805403842,-58.4142985288955 -34.6577439844856,-58.4148547745683 -34.6579495620377,-58.4147966664069 -34.6580681341755,-58.4144660302478 -34.658741483618,-58.4148325391401 -34.6588537253804,-58.4150027907633 -34.6589348837809,-58.4151240145743 -34.6589444713401,-58.4151788332453 -34.6589850385577,-58.4153722269689 -34.6589779586311,-58.415450139802 -34.6590137645899,-58.4155444972448 -34.6590444395343,-58.4156786239719 -34.6590854079945,-58.4157791116618 -34.6591546095429,-58.4159609332745 -34.6591952252157,-58.4161398746461 -34.6592251067954,-58.4164256117783 -34.6592586062647,-58.4165022123821 -34.6592663262217,-58.4168064245902 -34.6592952098832,-58.4168005427892 -34.6591424568347,-58.4167744868879 -34.6584808083946,-58.4167061432055 -34.6572299720401,-58.4167098504768 -34.657152999387,-58.4164881501646 -34.6571992549289,-58.4164874092758 -34.6571521406129,-58.4164811562632 -34.6567482533371)))";;"2449";4_9_1;COMUNA 4;"9";"1";"1495";"740";"755";"98,01%";"312";"312";"100,00%";"0";"0,00%";"463";"70";"15.12";"393";"84,88%";"15.12";15.120
"MULTIPOLYGON (((-58.4094750859579 -34.6576168299157,-58.4093028293946 -34.6575033710594,-58.4088408457366 -34.6571901306887,-58.4076723994795 -34.6563979663974,-58.4074345572844 -34.6562344033932,-58.4061747353849 -34.6553775334222,-58.405984631168 -34.6559554196757,-58.4055682888884 -34.6572205435453,-58.4068797647087 -34.6578465210801,-58.4061176549203 -34.6600544423593,-58.4063716350356 -34.66009510579,-58.4063935905205 -34.66004354326,-58.4064836948786 -34.6600189362521,-58.4065743664471 -34.6600378517982,-58.4066754635149 -34.660015996265,-58.4068262437467 -34.6600025439449,-58.4069262175284 -34.6600033643876,-58.4069925216675 -34.6600100850301,-58.407119597671 -34.6600121149112,-58.4072347458248 -34.6600024845762,-58.4073493995521 -34.659977781855,-58.4074554432094 -34.6599505756559,-58.4079496576657 -34.659869246974,-58.4080983664237 -34.6598946664918,-58.4082689181536 -34.6598831931266,-58.4084181831386 -34.6598400190079,-58.4085980843553 -34.6597367861768,-58.408816896128 -34.659693431135,-58.4090257492943 -34.6596292256541,-58.4091366656122 -34.6595777940951,-58.4092961804054 -34.6594982843403,-58.4094518779054 -34.659471607078,-58.4096510764899 -34.6594168377793,-58.4097522152234 -34.6592380030524,-58.4097844046226 -34.6591798261641,-58.4098417018556 -34.6592261166335,-58.4099081137357 -34.6591879846187,-58.4099112868891 -34.6590822727492,-58.410069888937 -34.6589734001204,-58.4101305291955 -34.6589328804418,-58.4102435961007 -34.6589428347254,-58.4103325659451 -34.6589520477779,-58.4103977063124 -34.658915717056,-58.4104872897437 -34.6589025156366,-58.4105499514565 -34.6588725415978,-58.4106021045134 -34.6588833388485,-58.4106354625278 -34.6588294783202,-58.4106761189555 -34.6588400975279,-58.4107020802367 -34.6588663441455,-58.4108551118714 -34.658782932583,-58.4109879117135 -34.658742443138,-58.4110514052069 -34.6587543952975,-58.411008039534 -34.6588664742424,-58.411207219422 -34.6588379379303,-58.41136311043 -34.6587974578267,-58.4114093208469 -34.6587521613354,-58.4116691513491 -34.6586640235297,-58.4118105981435 -34.6586426172024,-58.4118712387709 -34.658599711606,-58.4119436284689 -34.658557979876,-58.4121714590376 -34.658542595202,-58.4123677556837 -34.6585069006485,-58.4124572296437 -34.6585140926993,-58.4125611341657 -34.6585236756689,-58.4126650430121 -34.6585261034031,-58.4128468960053 -34.6585094825464,-58.4129625577264 -34.6585129055193,-58.4131701397418 -34.6585644704226,-58.4132798271173 -34.658557359782,-58.4133606476709 -34.658555007464,-58.413525146986 -34.6585980048106,-58.4138512989098 -34.6586172163107,-58.4139725081642 -34.6586506555044,-58.4140475350795 -34.6586840761581,-58.4141456783214 -34.6586745750823,-58.4143044137916 -34.6587032587847,-58.4144660302478 -34.658741483618,-58.4147966664069 -34.6580681341755,-58.4148547745683 -34.6579495620377,-58.4142985288955 -34.6577439844856,-58.4141425999396 -34.6576805403842,-58.4140112107513 -34.6576271765967,-58.4131946791303 -34.6572900775498,-58.4129004906443 -34.657835677674,-58.4116325087903 -34.6573678158202,-58.4117891689083 -34.6570677318385,-58.4119461668261 -34.656770887311,-58.4122834525622 -34.6561331918762,-58.4125686866114 -34.6555939276187,-58.4128312260637 -34.655090006509,-58.4129830998783 -34.65479851072,-58.411257179374 -34.6541792555613,-58.411109054083 -34.6544649759972,-58.4106061372611 -34.655435001756,-58.4102743796734 -34.6560750894322,-58.409932121433 -34.6567352425944,-58.4094750859579 -34.6576168299157)))";;"2450";4_9_2;COMUNA 4;"9";"2";"765";"359";"406";"88,42%";"263";"263";"100,00%";"0";"0,00%";"254";"30";"11.81";"224";"88,19%";"11.81";11.810
"MULTIPOLYGON (((-58.4102185429708 -34.6537986609539,-58.4092454154992 -34.653077371955,-58.4089299874838 -34.6528435644054,-58.4087891859929 -34.6527339919601,-58.4085525534536 -34.6525576847214,-58.4074055181482 -34.651708342013,-58.4073018613718 -34.652006472826,-58.4069715894804 -34.6529559278734,-58.4069221450104 -34.6531062618106,-58.4066187283106 -34.6540282624144,-58.4065488722306 -34.6542407012783,-58.4061747353849 -34.6553775334222,-58.4074345572844 -34.6562344033932,-58.4076723994795 -34.6563979663974,-58.4088408457366 -34.6571901306887,-58.4093028293946 -34.6575033710594,-58.4094750859579 -34.6576168299157,-58.409932121433 -34.6567352425944,-58.4102743796734 -34.6560750894322,-58.4106061372611 -34.655435001756,-58.411109054083 -34.6544649759972,-58.411257179374 -34.6541792555613,-58.4102185429708 -34.6537986609539)))";;"2451";4_9_3;COMUNA 4;"9";"3";"536";"262";"274";"95,62%";"176";"176";"100,00%";"0";"0,00%";"186";"5";"2.69";"181";"97,31%";"2.69";2.690
"MULTIPOLYGON (((-58.404933592192 -34.6499915814986,-58.4047470775343 -34.6503150942364,-58.4046638024306 -34.6504595659938,-58.4044265180883 -34.6508710848357,-58.4043176126576 -34.6511055467724,-58.404166935671 -34.6514794293232,-58.4039990755349 -34.651927530946,-58.4039280276058 -34.6521312351525,-58.4038336664005 -34.6524019722939,-58.40358053746 -34.6532705374183,-58.4049785517068 -34.6537322771,-58.4051368609463 -34.6537835506223,-58.4047546141531 -34.6549152336615,-58.4053109194276 -34.6550963470996,-58.4061747353849 -34.6553775334222,-58.4065488722306 -34.6542407012783,-58.4066187283106 -34.6540282624144,-58.4069221450104 -34.6531062618106,-58.4069715894804 -34.6529559278734,-58.4073018613718 -34.652006472826,-58.4074055181482 -34.651708342013,-58.4072172723449 -34.6515689565933,-58.4068074139907 -34.6512337594542,-58.4062370929189 -34.6507672856291,-58.4056893488124 -34.6503192709178,-58.4054891471594 -34.6501011424596,-58.4053357098212 -34.6500388149898,-58.4052228583979 -34.6499456604685,-58.4050450225269 -34.6497982481554,-58.404933592192 -34.6499915814986)))";;"2452";4_9_4;COMUNA 4;"9";"4";"503";"222";"281";"79,00%";"187";"187";"100,00%";"0";"0,00%";"176";"46";"26.14";"130";"73,86%";"26.14";26.140
"MULTIPOLYGON (((-58.4051368609463 -34.6537835506223,-58.4049785517068 -34.6537322771,-58.40358053746 -34.6532705374183,-58.4032391653005 -34.6544218840646,-58.4027454410952 -34.655872952145,-58.4034413256176 -34.6562050624986,-58.403625947228 -34.6562931827998,-58.4042450454299 -34.6552965508464,-58.405984631168 -34.6559554196757,-58.4061747353849 -34.6553775334222,-58.4047546141531 -34.6549152336615,-58.4051368609463 -34.6537835506223)))";;"2453";4_9_5;COMUNA 4;"9";"5";"537";"249";"288";"86,46%";"233";"233";"100,00%";"0";"0,00%";"189";"5";"2.65";"184";"97,35%";"2.65";2.650
"MULTIPOLYGON (((-58.4044407748249 -34.6566819663511,-58.4054742297494 -34.6571751460187,-58.4055682888884 -34.6572205435453,-58.405984631168 -34.6559554196757,-58.4045532251929 -34.6554086732855,-58.4042450454299 -34.6552965508464,-58.403625947228 -34.6562931827998,-58.4044407748249 -34.6566819663511)))";;"2454";4_9_6;COMUNA 4;"9";"6";"839";"373";"466";"80,04%";"318";"318";"100,00%";"0";"0,00%";"279";"22";"7.89";"257";"92,11%";"7.89";7.890
"MULTIPOLYGON (((-58.4055682888884 -34.6572205435453,-58.4054742297494 -34.6571751460187,-58.4044407748249 -34.6566819663511,-58.403625947228 -34.6562931827998,-58.4034413256176 -34.6562050624986,-58.4027454410952 -34.655872952145,-58.4022337212554 -34.6570831569507,-58.4020088465649 -34.657615102769,-58.4012125400132 -34.6595029098639,-58.401134544667 -34.6595863472202,-58.4008353451129 -34.660196768278,-58.4009161994604 -34.6601514933505,-58.4009682104343 -34.6600775831838,-58.4010533695395 -34.6600657010267,-58.4010960608323 -34.660037601356,-58.4011572981764 -34.6599801658666,-58.4012042105344 -34.659931314914,-58.4013386328755 -34.6599104665533,-58.4014821484922 -34.6598739206367,-58.4016366011812 -34.6598358373061,-58.4017900198985 -34.6596617421699,-58.4018460765453 -34.6595509286889,-58.4018908066555 -34.659564068775,-58.4019903903061 -34.6595617333512,-58.402068343082 -34.6595355366015,-58.4022430258667 -34.6594616868231,-58.4023916924944 -34.6594402950069,-58.4024869463418 -34.6594379570357,-58.4026441084799 -34.6594168771977,-58.4027493622092 -34.6594225629584,-58.4029239038847 -34.6594327897874,-58.4029724177761 -34.6594068973332,-58.4029949238664 -34.6594853115582,-58.4030843997662 -34.659490125438,-58.4032662482438 -34.6594854441183,-58.4033031937104 -34.6594038193909,-58.4033926935054 -34.6593906935697,-58.4035272474936 -34.6594224499858,-58.4036544866246 -34.6594334274732,-58.4037964830145 -34.6594265945506,-58.4039655719124 -34.6594343523954,-58.4041198979874 -34.6594680191428,-58.4042691166718 -34.6594928097558,-58.4043890442971 -34.6595217619954,-58.4044929408 -34.6595432770805,-58.4046809737841 -34.6595718114885,-58.4047816853259 -34.6596139732421,-58.4048276624126 -34.6596936945022,-58.4049488547053 -34.659748608092,-58.4050527549398 -34.6597653526033,-58.4051191331467 -34.6597796942628,-58.4051941706976 -34.6597940399705,-58.4052718749678 -34.659808224698,-58.4054789652776 -34.6598331819227,-58.4055866954977 -34.6598395404004,-58.405716564162 -34.6598706068009,-58.4058204907781 -34.6598491898874,-58.4059301219117 -34.659927947596,-58.4059675790552 -34.6600257520348,-58.4061176549203 -34.6600544423593,-58.4068797647087 -34.6578465210801,-58.4055682888884 -34.6572205435453)))";;"2455";4_9_7;COMUNA 4;"9";"7";"782";"372";"410";"90,73%";"293";"293";"100,00%";"0";"0,00%";"263";"32";"12.17";"231";"87,83%";"12.17";12.170
"MULTIPOLYGON (((-58.428079791493 -34.5990658582842,-58.4267410746479 -34.599197800151,-58.4266257591738 -34.5991948786795,-58.4267551666413 -34.6000948809456,-58.4280355543162 -34.599970880443,-58.4282075157413 -34.5999545905194,-58.4297344689337 -34.5998099366155,-58.4301501897177 -34.599770539662,-58.4296465989643 -34.599320668726,-58.4294289030137 -34.5991261654736,-58.429220123503 -34.5989992725074,-58.4291618000751 -34.5989591141025,-58.4285480320993 -34.5986725243934,-58.427987566853 -34.5984239059692,-58.428079791493 -34.5990658582842)))";;"2456";5_1_1;COMUNA 5;"1";"1";"553";"228";"325";"70,15%";"321";"319";"99,38%";"2";"0,63%";"253";"5";"1.98";"248";"98,02%";"1.98";1.980
"MULTIPOLYGON (((-58.4205127011655 -34.6000246403354,-58.4190845336776 -34.600149847241,-58.4191757319551 -34.6008356806248,-58.4197474133875 -34.6007846840675,-58.4206097083661 -34.6006989249381,-58.4205127011655 -34.6000246403354)))";;"2457";5_1_10;COMUNA 5;"1";"10";"673";"283";"390";"72,56%";"382";"381";"99,74%";"1";"0,26%";"312";"3";"0.96";"309";"99,04%";"0.96";0.960
"MULTIPOLYGON (((-58.4265648222198 -34.5979157973043,-58.4264393795074 -34.5978996327093,-58.4266257591738 -34.5991948786795,-58.4267410746479 -34.599197800151,-58.428079791493 -34.5990658582842,-58.427987566853 -34.5984239059692,-58.4278525175348 -34.5983640060146,-58.4277732421143 -34.598328911575,-58.4267852199686 -34.597944243749,-58.4265648222198 -34.5979157973043)))";;"2458";5_1_2;COMUNA 5;"1";"2";"879";"388";"491";"79,02%";"475";"475";"100,00%";"0";"0,00%";"411";"12";"2.92";"399";"97,08%";"2.92";2.920
"MULTIPOLYGON (((-58.4264393795074 -34.5978996327093,-58.4263027807292 -34.5978819857279,-58.424954103811 -34.5978517861145,-58.4251376455081 -34.5991565408895,-58.4252708484906 -34.6001032378255,-58.4252899515026 -34.6002367699169,-58.4267551666413 -34.6000948809456,-58.4266257591738 -34.5991948786795,-58.4264393795074 -34.5978996327093)))";;"2459";5_1_3;COMUNA 5;"1";"3";"775";"366";"409";"89,49%";"448";"447";"99,78%";"1";"0,22%";"361";"48";"13.3";"313";"86,70%";"13.3";13.300
"MULTIPOLYGON (((-58.424954103811 -34.5978517861145,-58.4237468970472 -34.5978247502171,-58.4233671610307 -34.5977486809503,-58.4233649713673 -34.5977504902107,-58.4234213571528 -34.5980596202667,-58.4235584548962 -34.5990099826011,-58.423573053861 -34.5991161885462,-58.4237474788619 -34.6003884057572,-58.4251112601726 -34.6002540396079,-58.4252899515026 -34.6002367699169,-58.4252708484906 -34.6001032378255,-58.4251376455081 -34.5991565408895,-58.424954103811 -34.5978517861145)))";;"2460";5_1_4;COMUNA 5;"1";"4";"683";"307";"376";"81,65%";"396";"396";"100,00%";"0";"0,00%";"314";"5";"1.59";"309";"98,41%";"1.59";1.590
"MULTIPOLYGON (((-58.4220386429746 -34.5993637950028,-58.4222113884656 -34.6005396720852,-58.4237474788619 -34.6003884057572,-58.423573053861 -34.5991161885462,-58.4235584548962 -34.5990099826011,-58.4234213571528 -34.5980596202667,-58.4233649713673 -34.5977504902107,-58.4230157976127 -34.5978734548513,-58.4225813655385 -34.5978751145287,-58.4218627408038 -34.5982091143946,-58.4220183552526 -34.5992256843497,-58.4220386429746 -34.5993637950028)))";;"2461";5_1_5;COMUNA 5;"1";"5";"1103";"483";"620";"77,90%";"646";"645";"99,85%";"1";"0,16%";"472";"4";"0.85";"468";"99,15%";"0.85";0.850
"MULTIPOLYGON (((-58.4189677086252 -34.598475304581,-58.418970024714 -34.5986061555168,-58.4190034319432 -34.5995402174318,-58.4203377310406 -34.5989182696995,-58.4206122893995 -34.5987902611918,-58.4218627408038 -34.5982091143946,-58.4225813655385 -34.5978751145287,-58.4230157976127 -34.5978734548513,-58.4233649713673 -34.5977504902107,-58.4233671610307 -34.5977486809503,-58.422933791295 -34.5977177710671,-58.4228373554465 -34.5977115356876,-58.4217775514282 -34.597734912628,-58.4204326843225 -34.5977574128364,-58.4201627052187 -34.5977631643184,-58.4189408150578 -34.5977892825791,-58.4189677086252 -34.598475304581)))";;"2462";5_1_6;COMUNA 5;"1";"6";"498";"185";"313";"59,11%";"307";"305";"99,35%";"2";"0,66%";"209";"13";"6.22";"196";"93,78%";"6.22";6.220
"MULTIPOLYGON (((-58.4218627408038 -34.5982091143946,-58.4206122893995 -34.5987902611918,-58.4203377310406 -34.5989182696995,-58.4204364773989 -34.5995165663375,-58.4220386429746 -34.5993637950028,-58.4220183552526 -34.5992256843497,-58.4218627408038 -34.5982091143946)))";;"2463";5_1_7;COMUNA 5;"1";"7";"625";"283";"342";"82,75%";"376";"376";"100,00%";"0";"0,00%";"302";"3";"0.99";"299";"99,01%";"0.99";0.990
"MULTIPOLYGON (((-58.4220386429746 -34.5993637950028,-58.4204364773989 -34.5995165663375,-58.4204607606864 -34.5996641156104,-58.4205127011655 -34.6000246403354,-58.4206097083661 -34.6006989249381,-58.4220443643612 -34.600556166477,-58.4222113884656 -34.6005396720852,-58.4220386429746 -34.5993637950028)))";;"2464";5_1_8;COMUNA 5;"1";"8";"742";"347";"395";"87,85%";"374";"373";"99,73%";"1";"0,27%";"323";"7";"2.17";"316";"97,83%";"2.17";2.170
"MULTIPOLYGON (((-58.4204364773989 -34.5995165663375,-58.4203377310406 -34.5989182696995,-58.4190034319432 -34.5995402174318,-58.4190845336776 -34.600149847241,-58.4205127011655 -34.6000246403354,-58.4204607606864 -34.5996641156104,-58.4204364773989 -34.5995165663375)))";;"2465";5_1_9;COMUNA 5;"1";"9";"691";"308";"383";"80,42%";"428";"428";"100,00%";"0";"0,00%";"349";"5";"1.43";"344";"98,57%";"1.43";1.430
"MULTIPOLYGON (((-58.4246767448998 -34.6086307687408,-58.4230359082726 -34.6085996818422,-58.423042991386 -34.6087506051973,-58.4227989168694 -34.6099062722959,-58.423347103136 -34.6099525787945,-58.4245631235673 -34.6101102946657,-58.4246718863933 -34.6088250701586,-58.4246767448998 -34.6086307687408)))";;"2466";5_10_1;COMUNA 5;"10";"1";"1160";"508";"652";"77,91%";"636";"636";"100,00%";"0";"0,00%";"538";"24";"4.46";"514";"95,54%";"4.46";4.460
"MULTIPOLYGON (((-58.4205629655706 -34.6097744594188,-58.419914109685 -34.6097119777969,-58.4197462317097 -34.6110190792566,-58.4197178132516 -34.6111232279722,-58.4206850738731 -34.6113702640267,-58.42100938386 -34.6114803088562,-58.4211336439393 -34.6108318769312,-58.4212655525021 -34.6100435127094,-58.4212792230706 -34.6099589367898,-58.4212785057525 -34.6099587328041,-58.4211478113517 -34.6099215667945,-58.4206770988758 -34.6097854851014,-58.4205629655706 -34.6097744594188)))";;"2467";5_10_10;COMUNA 5;"10";"10";"540";"245";"295";"83,05%";"329";"329";"100,00%";"0";"0,00%";"256";"44";"17.19";"212";"82,81%";"17.19";17.190
"MULTIPOLYGON (((-58.4216383289147 -34.6098221843848,-58.4227989168694 -34.6099062722959,-58.423042991386 -34.6087506051973,-58.4230359082726 -34.6085996818422,-58.421537828237 -34.6085712972775,-58.4213212403504 -34.6097085576498,-58.4213076560864 -34.6098044851032,-58.4216383289147 -34.6098221843848)))";;"2468";5_10_2;COMUNA 5;"10";"2";"1082";"477";"605";"78,84%";"694";"694";"100,00%";"0";"0,00%";"548";"28";"5.11";"520";"94,89%";"5.11";5.110
"MULTIPOLYGON (((-58.4199643140236 -34.6093124032679,-58.4199400795914 -34.6095027329346,-58.4199403667277 -34.6095026131268,-58.419914109685 -34.6097119777969,-58.4205629655706 -34.6097744594188,-58.4206770988758 -34.6097854851014,-58.4211478113517 -34.6099215667945,-58.4212785057525 -34.6099587328041,-58.4213076560864 -34.6098044851032,-58.4213212403504 -34.6097085576498,-58.421537828237 -34.6085712972775,-58.4200608729517 -34.6085432538289,-58.4199643140236 -34.6093124032679)))";;"2469";5_10_3;COMUNA 5;"10";"3";"416";"187";"229";"81,66%";"190";"189";"99,47%";"1";"0,53%";"164";"22";"13.41";"142";"86,59%";"13.41";13.410
"MULTIPOLYGON (((-58.4199400795914 -34.6095027329346,-58.4199643140236 -34.6093124032679,-58.4200608729517 -34.6085432538289,-58.4198765517362 -34.6085397384422,-58.4187886720198 -34.6085381545325,-58.4187089459065 -34.6091758609018,-58.4187565594627 -34.6091864062557,-58.4187601206728 -34.6092172537417,-58.4189715069807 -34.6092643736689,-58.4192503451823 -34.6093290531245,-58.4193941921379 -34.6093643872525,-58.4199400795914 -34.6095027329346)))";;"2470";5_10_4;COMUNA 5;"10";"4";"557";"255";"302";"84,44%";"290";"290";"100,00%";"0";"0,00%";"254";"0";"0";"254";"100,00%";"0";0.000
"MULTIPOLYGON (((-58.4187089459065 -34.6091758609018,-58.4187886720198 -34.6085381545325,-58.4185054587663 -34.6085377001484,-58.4175068277919 -34.6085370793211,-58.4162344680204 -34.6085410114848,-58.4160650536564 -34.6085362283639,-58.4160480344263 -34.608659606682,-58.4160262045503 -34.6088556618845,-58.415951163563 -34.6094631202536,-58.4174059526295 -34.609555292084,-58.4175195762061 -34.609562517575,-58.4186512981761 -34.6096356101364,-58.419914109685 -34.6097119777969,-58.4199403667277 -34.6095026131268,-58.4199400795914 -34.6095027329346,-58.4193941921379 -34.6093643872525,-58.4192503451823 -34.6093290531245,-58.4189715069807 -34.6092643736689,-58.4187601206728 -34.6092172537417,-58.4187565594627 -34.6091864062557,-58.4187089459065 -34.6091758609018)))";;"2471";5_10_5;COMUNA 5;"10";"5";"749";"330";"419";"78,76%";"360";"359";"99,72%";"1";"0,28%";"269";"1";"0.37";"268";"99,63%";"0.37";0.370
"MULTIPOLYGON (((-58.4145830004472 -34.6093763880048,-58.4144670534897 -34.6107363919603,-58.415823307158 -34.6108347410661,-58.415793797466 -34.6107502196011,-58.415951163563 -34.6094631202536,-58.4160262045503 -34.6088556618845,-58.4160480344263 -34.608659606682,-58.4160650536564 -34.6085362283639,-58.4159021978199 -34.608531658799,-58.4154337495797 -34.6084872512397,-58.4150718838863 -34.6083977410263,-58.4146600031146 -34.608190036685,-58.4146524549141 -34.6082814455338,-58.4146166101315 -34.6088470860407,-58.4145830004472 -34.6093763880048)))";;"2472";5_10_6;COMUNA 5;"10";"6";"791";"365";"426";"85,68%";"352";"350";"99,43%";"2";"0,57%";"314";"33";"10.51";"281";"89,49%";"10.51";10.510
"MULTIPOLYGON (((-58.4174059526295 -34.609555292084,-58.415951163563 -34.6094631202536,-58.415793797466 -34.6107502196011,-58.415823307158 -34.6108347410661,-58.4159855670899 -34.6108467051441,-58.4169726720774 -34.6109168703803,-58.4173398666527 -34.610942430914,-58.4173049900067 -34.6108562176174,-58.4174059526295 -34.609555292084)))";;"2473";5_10_7;COMUNA 5;"10";"7";"1225";"566";"659";"85,89%";"654";"654";"100,00%";"0";"0,00%";"548";"3";"0.55";"545";"99,45%";"0.55";0.550
"MULTIPOLYGON (((-58.4186512981761 -34.6096356101364,-58.4175195762061 -34.609562517575,-58.4174059526295 -34.609555292084,-58.4173049900067 -34.6108562176174,-58.4173398666527 -34.610942430914,-58.4175319390555 -34.6109558125177,-58.4181670137788 -34.6109994982675,-58.418472881369 -34.6110221455615,-58.4185208842534 -34.610933779451,-58.4186512981761 -34.6096356101364)))";;"2474";5_10_8;COMUNA 5;"10";"8";"660";"279";"381";"73,23%";"393";"392";"99,75%";"1";"0,26%";"309";"15";"4.85";"294";"95,15%";"4.85";4.850
"MULTIPOLYGON (((-58.419914109685 -34.6097119777969,-58.4186512981761 -34.6096356101364,-58.4185208842534 -34.610933779451,-58.418472881369 -34.6110221455615,-58.4197178132516 -34.6111232279722,-58.4197462317097 -34.6110190792566,-58.419914109685 -34.6097119777969)))";;"2475";5_10_9;COMUNA 5;"10";"9";"785";"323";"462";"69,91%";"427";"426";"99,77%";"1";"0,23%";"344";"21";"6.1";"323";"93,90%";"6.1";6.100
"MULTIPOLYGON (((-58.4290986885005 -34.6059440092391,-58.4275762811885 -34.6059465383388,-58.4275928379286 -34.6060707026638,-58.427662259924 -34.6072759082796,-58.4277390013748 -34.6087028140307,-58.4279148040209 -34.608710047643,-58.4291903223201 -34.6087344900279,-58.4292044523243 -34.6085458249801,-58.4291489618125 -34.6071637163464,-58.4290986885005 -34.6059440092391)))";;"2476";5_11_1;COMUNA 5;"11";"1";"1144";"511";"633";"80,73%";"679";"679";"100,00%";"0";"0,00%";"536";"49";"9.14";"487";"90,86%";"9.14";9.140
"MULTIPOLYGON (((-58.4287764749004 -34.6115960297423,-58.4287527336264 -34.6117463807197,-58.4287801604961 -34.6117492757771,-58.4287582967655 -34.611890753712,-58.4287294295947 -34.6120777947244,-58.4287006478767 -34.6122638497967,-58.4286779298827 -34.6124106797738,-58.4286481110035 -34.612407138679,-58.4285946563058 -34.6127455982324,-58.4286619377044 -34.6127745617318,-58.4286855480657 -34.6127374542975,-58.4286836955938 -34.6126847053927,-58.4287736949261 -34.6127762126375,-58.4292864824759 -34.6129988269922,-58.4300213876301 -34.6133215024933,-58.4300476054468 -34.6133679900642,-58.4301216975994 -34.6133980688608,-58.4301272661105 -34.6133281507648,-58.4302328524247 -34.6118973524365,-58.4287764749004 -34.6115960297423)))";;"2477";5_11_10;COMUNA 5;"11";"10";"855";"371";"484";"76,65%";"395";"394";"99,75%";"1";"0,25%";"354";"21";"5.93";"333";"94,07%";"5.93";5.930
"MULTIPOLYGON (((-58.4306691341148 -34.6059413329139,-58.4290986885005 -34.6059440092391,-58.4291489618125 -34.6071637163464,-58.4306058500099 -34.6070470616714,-58.4306691341148 -34.6059413329139)))";;"2478";5_11_2;COMUNA 5;"11";"2";"894";"417";"477";"87,42%";"463";"463";"100,00%";"0";"0,00%";"389";"21";"5.4";"368";"94,60%";"5.4";5.400
"MULTIPOLYGON (((-58.4306058500099 -34.6070470616714,-58.4291489618125 -34.6071637163464,-58.4292044523243 -34.6085458249801,-58.4291903223201 -34.6087344900279,-58.4304739462198 -34.6087252580068,-58.4305128686542 -34.6085137111839,-58.4305494685221 -34.6079188397023,-58.4305599237008 -34.6077536250754,-58.4306058500099 -34.6070470616714)))";;"2479";5_11_3;COMUNA 5;"11";"3";"694";"324";"370";"87,57%";"323";"323";"100,00%";"0";"0,00%";"281";"0";"0";"281";"100,00%";"0";0.000
"MULTIPOLYGON (((-58.4304739462198 -34.6087252580068,-58.4291903223201 -34.6087344900279,-58.4291701122692 -34.6090037197437,-58.4289143115657 -34.6107173739862,-58.4303302540484 -34.6109154411486,-58.430370661783 -34.6101719035516,-58.4304139505004 -34.6094654102272,-58.4304739462198 -34.6087252580068)))";;"2480";5_11_4;COMUNA 5;"11";"4";"682";"296";"386";"76,68%";"442";"442";"100,00%";"0";"0,00%";"331";"2";"0.6";"329";"99,40%";"0.6";0.600
"MULTIPOLYGON (((-58.4291903223201 -34.6087344900279,-58.4279148040209 -34.608710047643,-58.4277390013748 -34.6087028140307,-58.4274592809795 -34.6105137859439,-58.4275445401428 -34.6105257123844,-58.4289143115657 -34.6107173739862,-58.4291701122692 -34.6090037197437,-58.4291903223201 -34.6087344900279)))";;"2481";5_11_5;COMUNA 5;"11";"5";"764";"358";"406";"88,18%";"438";"437";"99,77%";"1";"0,23%";"321";"6";"1.87";"315";"98,13%";"1.87";1.870
"MULTIPOLYGON (((-58.4270282894567 -34.6086880303067,-58.4262469679621 -34.6086686437332,-58.4262370078295 -34.6088506897167,-58.4260242732895 -34.6103130035695,-58.4259244831085 -34.6109963787744,-58.4270196246493 -34.6112219938684,-58.4273449818188 -34.6112913868854,-58.4275445401428 -34.6105257123844,-58.4274592809795 -34.6105137859439,-58.4277390013748 -34.6087028140307,-58.4270282894567 -34.6086880303067)))";;"2482";5_11_6;COMUNA 5;"11";"6";"747";"349";"398";"87,69%";"430";"428";"99,53%";"2";"0,47%";"315";"4";"1.27";"311";"98,73%";"1.27";1.270
"MULTIPOLYGON (((-58.4262469679621 -34.6086686437332,-58.424877846251 -34.6086346342043,-58.4246767448998 -34.6086307687408,-58.4246718863933 -34.6088250701586,-58.4245631235673 -34.6101102946657,-58.4247384959553 -34.6101330262444,-58.4260242732895 -34.6103130035695,-58.4262370078295 -34.6088506897167,-58.4262469679621 -34.6086686437332)))";;"2483";5_11_7;COMUNA 5;"11";"7";"1059";"460";"599";"76,79%";"560";"560";"100,00%";"0";"0,00%";"470";"26";"5.53";"444";"94,47%";"5.53";5.530
"MULTIPOLYGON (((-58.4286481110035 -34.612407138679,-58.4286779298827 -34.6124106797738,-58.4287006478767 -34.6122638497967,-58.4287294295947 -34.6120777947244,-58.4287582967655 -34.611890753712,-58.4287801604961 -34.6117492757771,-58.4287527336264 -34.6117463807197,-58.4287764749004 -34.6115960297423,-58.4280051519371 -34.6114321449067,-58.4278932354311 -34.6114083093455,-58.4273449818188 -34.6112913868854,-58.4270196246493 -34.6112219938684,-58.4259244831085 -34.6109963787744,-58.4260242732895 -34.6103130035695,-58.4247384959553 -34.6101330262444,-58.4245631235673 -34.6101102946657,-58.4245504485854 -34.6102601553425,-58.4244846975469 -34.6109885416517,-58.4245543634445 -34.6110124375631,-58.4257729694612 -34.6115267748665,-58.4257858244455 -34.6115430469542,-58.425839358324 -34.6115657214187,-58.4258394778236 -34.6115658104825,-58.4258623017596 -34.6115756064645,-58.4258952961627 -34.6115900611447,-58.4259131124212 -34.611588727462,-58.4263832547999 -34.6117905591908,-58.4270724102918 -34.6120799278177,-58.4271229129842 -34.6121019856088,-58.4271939406709 -34.6121324299397,-58.427616279009 -34.6123049527407,-58.4276572439456 -34.6123217256851,-58.4276991457108 -34.612338921435,-58.4284325965512 -34.6126476619537,-58.4284202369715 -34.6126678704809,-58.4284620536556 -34.6126856293447,-58.4284845360367 -34.612698945993,-58.4285946379753 -34.6127455584518,-58.4285946563058 -34.6127455982324,-58.4286481110035 -34.612407138679)))";;"2484";5_11_8;COMUNA 5;"11";"8";"791";"369";"422";"87,44%";"421";"420";"99,76%";"1";"0,24%";"321";"32";"9.97";"289";"90,03%";"9.97";9.970
"MULTIPOLYGON (((-58.4303302540484 -34.6109154411486,-58.4289143115657 -34.6107173739862,-58.4275445401428 -34.6105257123844,-58.4273449818188 -34.6112913868854,-58.4278932354311 -34.6114083093455,-58.4280051519371 -34.6114321449067,-58.4287764749004 -34.6115960297423,-58.4302328524247 -34.6118973524365,-58.4302546269411 -34.6117598180184,-58.4303186720573 -34.6111286148663,-58.4303302540484 -34.6109154411486)))";;"2485";5_11_9;COMUNA 5;"11";"9";"1026";"461";"565";"81,59%";"569";"569";"100,00%";"0";"0,00%";"459";"53";"11.55";"406";"88,45%";"11.55";11.550
"MULTIPOLYGON (((-58.4268319494424 -34.6126647377158,-58.4282750975676 -34.6132641892034,-58.4300858545243 -34.6140152771461,-58.4301125135935 -34.6135652539065,-58.4301216975994 -34.6133980688608,-58.4300476054468 -34.6133679900642,-58.4300213876301 -34.6133215024933,-58.4292864824759 -34.6129988269922,-58.4287736949261 -34.6127762126375,-58.4286836955938 -34.6126847053927,-58.4286855480657 -34.6127374542975,-58.4286619377044 -34.6127745617318,-58.4285946563058 -34.6127455982324,-58.4285946379753 -34.6127455584518,-58.4284845360367 -34.612698945993,-58.4284620536556 -34.6126856293447,-58.4284202369715 -34.6126678704809,-58.4284325965512 -34.6126476619537,-58.4276991457108 -34.612338921435,-58.4276572439456 -34.6123217256851,-58.427616279009 -34.6123049527407,-58.4271939406709 -34.6121324299397,-58.4271229129842 -34.6121019856088,-58.4270724102918 -34.6120799278177,-58.4263832547999 -34.6117905591908,-58.4259131124212 -34.611588727462,-58.4258952961627 -34.6115900611447,-58.4258623017596 -34.6115756064645,-58.4258394778236 -34.6115658104825,-58.425839358324 -34.6115657214187,-58.4257858244455 -34.6115430469542,-58.4257729694612 -34.6115267748665,-58.4245543634445 -34.6110124375631,-58.4244846975469 -34.6109885416517,-58.4244671466777 -34.6111828390097,-58.4244650920011 -34.6112054448232,-58.4244081510541 -34.6112945147169,-58.4242367308003 -34.6115626395685,-58.4255741457134 -34.6121311731067,-58.4267246403645 -34.6126201270415,-58.4268319494424 -34.6126647377158)))";;"2486";5_12_1;COMUNA 5;"12";"1";"606";"300";"306";"98,04%";"323";"323";"100,00%";"0";"0,00%";"293";"71";"24.23";"222";"75,77%";"24.23";24.230
"MULTIPOLYGON (((-58.4300858545243 -34.6140152771461,-58.4282750975676 -34.6132641892034,-58.4276778025632 -34.6142784923648,-58.4275987125946 -34.614374177299,-58.4286083739251 -34.6148208176659,-58.4292525018146 -34.6151056540497,-58.4300285611138 -34.6154491864935,-58.4300858545243 -34.6140152771461)))";;"2487";5_12_2;COMUNA 5;"12";"2";"1821";"786";"1035";"75,94%";"1038";"1038";"100,00%";"0";"0,00%";"840";"6";"0.71";"834";"99,29%";"0.71";0.710
"MULTIPOLYGON (((-58.4282750975676 -34.6132641892034,-58.4268319494424 -34.6126647377158,-58.4261773097237 -34.6136877494627,-58.4261034457172 -34.6137127986537,-58.4275987125946 -34.614374177299,-58.4276778025632 -34.6142784923648,-58.4282750975676 -34.6132641892034)))";;"2488";5_12_3;COMUNA 5;"12";"3";"949";"414";"535";"77,38%";"526";"524";"99,62%";"2";"0,38%";"426";"24";"5.63";"402";"94,37%";"5.63";5.630
"MULTIPOLYGON (((-58.4268319494424 -34.6126647377158,-58.4267246403645 -34.6126201270415,-58.4255741457134 -34.6121311731067,-58.4249471168774 -34.6131028468551,-58.4249383854899 -34.6131974954583,-58.4261034457172 -34.6137127986537,-58.4261773097237 -34.6136877494627,-58.4268319494424 -34.6126647377158)))";;"2489";5_12_4;COMUNA 5;"12";"4";"735";"331";"404";"81,93%";"407";"407";"100,00%";"0";"0,00%";"328";"8";"2.44";"320";"97,56%";"2.44";2.440
"MULTIPOLYGON (((-58.4255741457134 -34.6121311731067,-58.4242367308003 -34.6115626395685,-58.423582573328 -34.6125977508361,-58.4249383854899 -34.6131974954583,-58.4249471168774 -34.6131028468551,-58.4255741457134 -34.6121311731067)))";;"2490";5_12_5;COMUNA 5;"12";"5";"435";"165";"270";"61,11%";"278";"277";"99,64%";"1";"0,36%";"198";"1";"0.51";"197";"99,49%";"0.51";0.510
"MULTIPOLYGON (((-58.4229223745773 -34.6110846655242,-58.4211336439393 -34.6108318769312,-58.42100938386 -34.6114803088562,-58.4212119077337 -34.6115489719375,-58.4224026409007 -34.6120757281891,-58.423582573328 -34.6125977508361,-58.4242367308003 -34.6115626395685,-58.4244081510541 -34.6112945147169,-58.4232332755114 -34.611129920873,-58.4232307892727 -34.6111282179759,-58.4229223745773 -34.6110846655242)))";;"2491";5_12_6;COMUNA 5;"12";"6";"1575";"680";"895";"75,98%";"908";"907";"99,89%";"1";"0,11%";"769";"42";"5.46";"727";"94,54%";"5.46";5.460
"MULTIPOLYGON (((-58.4216383289147 -34.6098221843848,-58.4213076560864 -34.6098044851032,-58.4212785057525 -34.6099587328041,-58.4212792230706 -34.6099589367898,-58.4212655525021 -34.6100435127094,-58.4211336439393 -34.6108318769312,-58.4229223745773 -34.6110846655242,-58.4232332755114 -34.611129920873,-58.4244081510541 -34.6112945147169,-58.4244650920011 -34.6112054448232,-58.4244671466777 -34.6111828390097,-58.4244846975469 -34.6109885416517,-58.4245504485854 -34.6102601553425,-58.4245631235673 -34.6101102946657,-58.423347103136 -34.6099525787945,-58.4227989168694 -34.6099062722959,-58.4216383289147 -34.6098221843848)))";;"2492";5_12_7;COMUNA 5;"12";"7";"897";"437";"460";"95,00%";"388";"384";"98,97%";"4";"1,04%";"336";"14";"4.17";"322";"95,83%";"4.17";4.170
"MULTIPOLYGON (((-58.4275987125946 -34.614374177299,-58.4261034457172 -34.6137127986537,-58.4259774387872 -34.6147306846987,-58.4259679084592 -34.6149008991983,-58.4261696177903 -34.6149127207484,-58.4274398478186 -34.614975138962,-58.4275468090648 -34.6150446793612,-58.4284287849996 -34.6150823260162,-58.4288940487202 -34.6151058369482,-58.4290705246509 -34.6151670850967,-58.4292190488984 -34.6152573404444,-58.4292525018146 -34.6151056540497,-58.4286083739251 -34.6148208176659,-58.4275987125946 -34.614374177299)))";;"2493";5_13_1;COMUNA 5;"13";"1";"856";"365";"491";"74,34%";"518";"518";"100,00%";"0";"0,00%";"396";"1";"0.25";"395";"99,75%";"0.25";0.250
"MULTIPOLYGON (((-58.4261034457172 -34.6137127986537,-58.4249383854899 -34.6131974954583,-58.4247912383418 -34.6138438111545,-58.4245662457267 -34.6148317342664,-58.4257386004597 -34.6148874491799,-58.4259679084592 -34.6149008991983,-58.4259774387872 -34.6147306846987,-58.4261034457172 -34.6137127986537)))";;"2494";5_13_2;COMUNA 5;"13";"2";"710";"327";"383";"85,38%";"432";"430";"99,54%";"2";"0,47%";"321";"7";"2.18";"314";"97,82%";"2.18";2.180
"MULTIPOLYGON (((-58.4249383854899 -34.6131974954583,-58.423582573328 -34.6125977508361,-58.4233290229512 -34.6136085508532,-58.4247912383418 -34.6138438111545,-58.4249383854899 -34.6131974954583)))";;"2495";5_13_3;COMUNA 5;"13";"3";"759";"329";"430";"76,51%";"444";"444";"100,00%";"0";"0,00%";"365";"20";"5.48";"345";"94,52%";"5.48";5.480
"MULTIPOLYGON (((-58.4247912383418 -34.6138438111545,-58.4233290229512 -34.6136085508532,-58.4231927295345 -34.6141520474795,-58.4230764052046 -34.6146156179481,-58.4230556375884 -34.6147588557735,-58.4230352119075 -34.6148994175509,-58.4229156020324 -34.6156392642141,-58.4228894556337 -34.615806867299,-58.4230260909144 -34.6158079681857,-58.4244884116858 -34.6158955507585,-58.4245342166591 -34.6150180689536,-58.4245662457267 -34.6148317342664,-58.4247912383418 -34.6138438111545)))";;"2496";5_13_4;COMUNA 5;"13";"4";"731";"320";"411";"77,86%";"365";"364";"99,73%";"1";"0,27%";"330";"54";"16.36";"276";"83,64%";"16.36";16.360
"MULTIPOLYGON (((-58.4227298431179 -34.6168249499291,-58.422706943429 -34.6169708630955,-58.4226078247961 -34.6176016979796,-58.422582098212 -34.6177794422857,-58.4241978497286 -34.6179196157522,-58.4243820155376 -34.6179360827679,-58.424434526983 -34.6169284579388,-58.4244884116858 -34.6158955507585,-58.4230260909144 -34.6158079681857,-58.4228894556337 -34.615806867299,-58.4228670689921 -34.6159498932606,-58.4227298431179 -34.6168249499291)))";;"2497";5_13_5;COMUNA 5;"13";"5";"795";"354";"441";"80,27%";"384";"383";"99,74%";"1";"0,26%";"332";"35";"10.54";"297";"89,46%";"10.54";10.540
"MULTIPOLYGON (((-58.4259679084592 -34.6149008991983,-58.4257386004597 -34.6148874491799,-58.4245662457267 -34.6148317342664,-58.4245342166591 -34.6150180689536,-58.4244884116858 -34.6158955507585,-58.424434526983 -34.6169284579388,-58.4243820155376 -34.6179360827679,-58.4245533187589 -34.6179514186838,-58.4250352033646 -34.6179869217764,-58.4258067972462 -34.6180473709562,-58.4258658619482 -34.617014605768,-58.4259150441671 -34.6159809218707,-58.4259574336552 -34.6150879449964,-58.4259679084592 -34.6149008991983)))";;"2498";5_13_6;COMUNA 5;"13";"6";"850";"378";"472";"80,08%";"454";"454";"100,00%";"0";"0,00%";"377";"32";"8.49";"345";"91,51%";"8.49";8.490
"MULTIPOLYGON (((-58.4274398478186 -34.614975138962,-58.4261696177903 -34.6149127207484,-58.4259679084592 -34.6149008991983,-58.4259574336552 -34.6150879449964,-58.4259150441671 -34.6159809218707,-58.4258658619482 -34.617014605768,-58.4271419954815 -34.6170913251359,-58.4273553804859 -34.6171037115259,-58.427386505396 -34.6162233371333,-58.4273931298151 -34.6160693899035,-58.4274398478186 -34.614975138962)))";;"2499";5_13_7;COMUNA 5;"13";"7";"739";"326";"413";"78,93%";"419";"418";"99,76%";"1";"0,24%";"323";"32";"9.91";"291";"90,09%";"9.91";9.910
"MULTIPOLYGON (((-58.4284287849996 -34.6150823260162,-58.4275468090648 -34.6150446793612,-58.4274398478186 -34.614975138962,-58.4273931298151 -34.6160693899035,-58.427386505396 -34.6162233371333,-58.4273553804859 -34.6171037115259,-58.4287930264039 -34.6171870098378,-58.4292190488984 -34.6152573404444,-58.4290705246509 -34.6151670850967,-58.4288940487202 -34.6151058369482,-58.4284287849996 -34.6150823260162)))";;"2500";5_13_8;COMUNA 5;"13";"8";"940";"409";"531";"77,02%";"521";"521";"100,00%";"0";"0,00%";"421";"4";"0.95";"417";"99,05%";"0.95";0.950
"MULTIPOLYGON (((-58.4287930264039 -34.6171870098378,-58.4273553804859 -34.6171037115259,-58.4271419954815 -34.6170913251359,-58.4258658619482 -34.617014605768,-58.4258067972462 -34.6180473709562,-58.4259900275338 -34.6180617225106,-58.4265602450297 -34.6181134438829,-58.4273172705732 -34.6181825414695,-58.4285509856805 -34.6182947984147,-58.4285882862832 -34.6181141686716,-58.4287930264039 -34.6171870098378)))";;"2501";5_13_9;COMUNA 5;"13";"9";"1022";"465";"557";"83,48%";"538";"536";"99,63%";"2";"0,37%";"422";"2";"0.47";"420";"99,53%";"0.47";0.470
"MULTIPOLYGON (((-58.423582573328 -34.6125977508361,-58.4224026409007 -34.6120757281891,-58.4219866575354 -34.6133922574201,-58.4221206380972 -34.6134141338309,-58.4233290229512 -34.6136085508532,-58.423582573328 -34.6125977508361)))";;"2502";5_14_1;COMUNA 5;"14";"1";"659";"289";"370";"78,11%";"324";"323";"99,69%";"1";"0,31%";"274";"2";"0.73";"272";"99,27%";"0.73";0.730
"MULTIPOLYGON (((-58.4224026409007 -34.6120757281891,-58.4212119077337 -34.6115489719375,-58.42100938386 -34.6114803088562,-58.4206325463307 -34.6131713675325,-58.4219866575354 -34.6133922574201,-58.4224026409007 -34.6120757281891)))";;"2503";5_14_2;COMUNA 5;"14";"2";"672";"274";"398";"68,84%";"485";"484";"99,79%";"1";"0,21%";"347";"32";"9.22";"315";"90,78%";"9.22";9.220
"MULTIPOLYGON (((-58.42100938386 -34.6114803088562,-58.4206850738731 -34.6113702640267,-58.4197178132516 -34.6111232279722,-58.4191445215842 -34.6128168889242,-58.4204794874221 -34.6131463841826,-58.4206325463307 -34.6131713675325,-58.42100938386 -34.6114803088562)))";;"2504";5_14_3;COMUNA 5;"14";"3";"1153";"494";"659";"74,96%";"696";"696";"100,00%";"0";"0,00%";"540";"5";"0.93";"535";"99,07%";"0.93";0.930
"MULTIPOLYGON (((-58.4197178132516 -34.6111232279722,-58.418472881369 -34.6110221455615,-58.4178350320593 -34.6124936562485,-58.4191445215842 -34.6128168889242,-58.4197178132516 -34.6111232279722)))";;"2505";5_14_4;COMUNA 5;"14";"4";"931";"399";"532";"75,00%";"506";"506";"100,00%";"0";"0,00%";"421";"2";"0.48";"419";"99,52%";"0.48";0.480
"MULTIPOLYGON (((-58.4191445215842 -34.6128168889242,-58.4178350320593 -34.6124936562485,-58.4173204036641 -34.6136809031321,-58.417243805109 -34.6138733463289,-58.4174955621642 -34.6139512595712,-58.4183950344852 -34.6142152609815,-58.418650465144 -34.6142768345564,-58.4191445215842 -34.6128168889242)))";;"2506";5_14_5;COMUNA 5;"14";"5";"1592";"691";"901";"76,69%";"886";"886";"100,00%";"0";"0,00%";"787";"46";"5.84";"741";"94,16%";"5.84";5.840
"MULTIPOLYGON (((-58.4206325463307 -34.6131713675325,-58.4204794874221 -34.6131463841826,-58.4191445215842 -34.6128168889242,-58.418650465144 -34.6142768345564,-58.4188494270661 -34.6143247952752,-58.4203344437397 -34.6146145557306,-58.420382824536 -34.614285264932,-58.4205854192937 -34.6133826969253,-58.4206325463307 -34.6131713675325)))";;"2507";5_14_6;COMUNA 5;"14";"6";"1229";"531";"698";"76,07%";"651";"648";"99,54%";"3";"0,46%";"538";"16";"2.97";"522";"97,03%";"2.97";2.970
"MULTIPOLYGON (((-58.4219866575354 -34.6133922574201,-58.4206325463307 -34.6131713675325,-58.4205854192937 -34.6133826969253,-58.420382824536 -34.614285264932,-58.4203344437397 -34.6146145557306,-58.420303927824 -34.6148220877782,-58.4200802251466 -34.6158436660581,-58.4213541807108 -34.6157991732857,-58.4215830729142 -34.6157957293923,-58.4216942393754 -34.6157940766073,-58.4227595499245 -34.6158057684627,-58.4228894556337 -34.615806867299,-58.4229156020324 -34.6156392642141,-58.4230352119075 -34.6148994175509,-58.4230556375884 -34.6147588557735,-58.4230764052046 -34.6146156179481,-58.4231927295345 -34.6141520474795,-58.4233290229512 -34.6136085508532,-58.4221206380972 -34.6134141338309,-58.4219866575354 -34.6133922574201)))";;"2508";5_14_7;COMUNA 5;"14";"7";"454";"196";"258";"75,97%";"208";"203";"97,60%";"5";"2,46%";"168";"23";"13.69";"145";"86,31%";"13.69";13.690
"MULTIPOLYGON (((-58.4203344437397 -34.6146145557306,-58.4188494270661 -34.6143247952752,-58.418650465144 -34.6142768345564,-58.4186498135713 -34.6145427593548,-58.4186231383908 -34.6147282493263,-58.4184713775801 -34.6157848518828,-58.4200802251466 -34.6158436660581,-58.420303927824 -34.6148220877782,-58.4203344437397 -34.6146145557306)))";;"2509";5_14_8;COMUNA 5;"14";"8";"650";"289";"361";"80,06%";"309";"309";"100,00%";"0";"0,00%";"275";"23";"8.36";"252";"91,64%";"8.36";8.360
"MULTIPOLYGON (((-58.41715859265 -34.6145522121631,-58.4170174985096 -34.6156969890742,-58.4184713775801 -34.6157848518828,-58.4186231383908 -34.6147282493263,-58.4186498135713 -34.6145427593548,-58.418650465144 -34.6142768345564,-58.4183950344852 -34.6142152609815,-58.4174955621642 -34.6139512595712,-58.417243805109 -34.6138733463289,-58.41715859265 -34.6145522121631)))";;"2510";5_14_9;COMUNA 5;"14";"9";"907";"404";"503";"80,32%";"470";"470";"100,00%";"0";"0,00%";"426";"51";"11.97";"375";"88,03%";"11.97";11.970
"MULTIPOLYGON (((-58.415823307158 -34.6108347410661,-58.4144670534897 -34.6107363919603,-58.4140142765254 -34.6115504671036,-58.4153348082762 -34.6118764916922,-58.415823307158 -34.6108347410661)))";;"2511";5_15_1;COMUNA 5;"15";"1";"1104";"500";"604";"82,78%";"595";"595";"100,00%";"0";"0,00%";"521";"47";"9.02";"474";"90,98%";"9.02";9.020
"MULTIPOLYGON (((-58.4173398666527 -34.610942430914,-58.4169726720774 -34.6109168703803,-58.4159855670899 -34.6108467051441,-58.415823307158 -34.6108347410661,-58.4153348082762 -34.6118764916922,-58.4167750982024 -34.6122320552248,-58.4173398666527 -34.610942430914)))";;"2512";5_15_2;COMUNA 5;"15";"2";"1099";"449";"650";"69,08%";"631";"631";"100,00%";"0";"0,00%";"530";"22";"4.15";"508";"95,85%";"4.15";4.150
"MULTIPOLYGON (((-58.418472881369 -34.6110221455615,-58.4181670137788 -34.6109994982675,-58.4175319390555 -34.6109558125177,-58.4173398666527 -34.610942430914,-58.4167750982024 -34.6122320552248,-58.4162866472215 -34.6133474036449,-58.4162214631856 -34.6135359067475,-58.4170231347949 -34.6138050924435,-58.417243805109 -34.6138733463289,-58.4173204036641 -34.6136809031321,-58.4178350320593 -34.6124936562485,-58.418472881369 -34.6110221455615)))";;"2513";5_15_3;COMUNA 5;"15";"3";"586";"264";"322";"81,99%";"284";"284";"100,00%";"0";"0,00%";"267";"14";"5.24";"253";"94,76%";"5.24";5.240
"MULTIPOLYGON (((-58.4167750982024 -34.6122320552248,-58.4153348082762 -34.6118764916922,-58.4147840371517 -34.61305322061,-58.4156266641927 -34.6133361644675,-58.4162214631856 -34.6135359067475,-58.4162866472215 -34.6133474036449,-58.4167750982024 -34.6122320552248)))";;"2514";5_15_4;COMUNA 5;"15";"4";"1186";"537";"649";"82,74%";"648";"647";"99,85%";"1";"0,15%";"568";"49";"8.63";"519";"91,37%";"8.63";8.630
"MULTIPOLYGON (((-58.4153348082762 -34.6118764916922,-58.4140142765254 -34.6115504671036,-58.4135612348391 -34.612365103748,-58.4134353605483 -34.6126144282007,-58.4144100774601 -34.6129276461024,-58.4147840371517 -34.61305322061,-58.4153348082762 -34.6118764916922)))";;"2515";5_15_5;COMUNA 5;"15";"5";"922";"388";"534";"72,66%";"548";"547";"99,82%";"1";"0,18%";"454";"7";"1.54";"447";"98,46%";"1.54";1.540
"MULTIPOLYGON (((-58.4147840371517 -34.61305322061,-58.4144100774601 -34.6129276461024,-58.4134353605483 -34.6126144282007,-58.413314005456 -34.6128547399326,-58.4131163061818 -34.6134164405642,-58.4128700528592 -34.614116224551,-58.4145297376016 -34.6142891508539,-58.4152935269232 -34.614369030358,-58.4156266641927 -34.6133361644675,-58.4147840371517 -34.61305322061)))";;"2516";5_15_6;COMUNA 5;"15";"6";"863";"393";"470";"83,62%";"343";"341";"99,42%";"2";"0,59%";"330";"56";"16.97";"274";"83,03%";"16.97";16.970
"MULTIPOLYGON (((-58.4162214631856 -34.6135359067475,-58.4156266641927 -34.6133361644675,-58.4152935269232 -34.614369030358,-58.4159702657306 -34.6144398573599,-58.4169257087395 -34.6145398710462,-58.41715859265 -34.6145522121631,-58.417243805109 -34.6138733463289,-58.4170231347949 -34.6138050924435,-58.4162214631856 -34.6135359067475)))";;"2517";5_15_7;COMUNA 5;"15";"7";"723";"321";"402";"79,85%";"360";"359";"99,72%";"1";"0,28%";"313";"33";"10.54";"280";"89,46%";"10.54";10.540
"MULTIPOLYGON (((-58.41715859265 -34.6145522121631,-58.4169257087395 -34.6145398710462,-58.4159702657306 -34.6144398573599,-58.4152935269232 -34.614369030358,-58.4145297376016 -34.6142891508539,-58.4143694667643 -34.6155371602836,-58.4157784497671 -34.6156221499634,-58.4166760912091 -34.6156763670659,-58.4170174985096 -34.6156969890742,-58.41715859265 -34.6145522121631)))";;"2518";5_15_8;COMUNA 5;"15";"8";"775";"356";"419";"84,96%";"286";"285";"99,65%";"1";"0,35%";"331";"98";"29.61";"233";"70,39%";"29.61";29.610
"MULTIPOLYGON (((-58.4145297376016 -34.6142891508539,-58.4128700528592 -34.614116224551,-58.412816360458 -34.6154434332046,-58.4143694667643 -34.6155371602836,-58.4145297376016 -34.6142891508539)))";;"2519";5_15_9;COMUNA 5;"15";"9";"406";"192";"214";"89,72%";"214";"214";"100,00%";"0";"0,00%";"168";"29";"17.26";"139";"82,74%";"17.26";17.260
"MULTIPOLYGON (((-58.4184713775801 -34.6157848518828,-58.4170174985096 -34.6156969890742,-58.4169215683653 -34.6166509307187,-58.4183457764982 -34.6166594148648,-58.41857407235 -34.6166607653041,-58.4196186951549 -34.6166692375526,-58.4198984413769 -34.6166737023734,-58.4200802251466 -34.6158436660581,-58.4184713775801 -34.6157848518828)))";;"2520";5_16_1;COMUNA 5;"16";"1";"833";"408";"425";"96,00%";"428";"428";"100,00%";"0";"0,00%";"404";"12";"2.97";"392";"97,03%";"2.97";2.970
"MULTIPOLYGON (((-58.4153417595874 -34.6183848960314,-58.4140919807929 -34.6182381317016,-58.4129133324096 -34.6180996233433,-58.4126876053489 -34.6180698820806,-58.4126822844973 -34.618277351997,-58.4126420869941 -34.6193945578449,-58.4126353291159 -34.6195830827993,-58.4125438811881 -34.6206423075662,-58.4138235314332 -34.6207518448672,-58.413938917879 -34.6196640361739,-58.4152103156302 -34.6197315119161,-58.4153417595874 -34.6183848960314)))";;"2521";5_16_10;COMUNA 5;"16";"10";"923";"430";"493";"87,22%";"486";"486";"100,00%";"0";"0,00%";"388";"44";"11.34";"344";"88,66%";"11.34";11.340
"MULTIPOLYGON (((-58.4152103156302 -34.6197315119161,-58.413938917879 -34.6196640361739,-58.4138235314332 -34.6207518448672,-58.4150932183614 -34.6208605197565,-58.416104711005 -34.6209471104868,-58.4165096860088 -34.6209771951195,-58.418065443679 -34.6210925670047,-58.4181453711438 -34.6200998151363,-58.4181562924649 -34.6199082631327,-58.4168212663702 -34.6198179060559,-58.4166180127335 -34.6198067727211,-58.4163482289912 -34.6197919516869,-58.4152103156302 -34.6197315119161)))";;"2522";5_16_11;COMUNA 5;"16";"11";"1063";"487";"576";"84,55%";"488";"486";"99,59%";"2";"0,41%";"424";"23";"5.42";"401";"94,58%";"5.42";5.420
"MULTIPOLYGON (((-58.4170174985096 -34.6156969890742,-58.4166760912091 -34.6156763670659,-58.4157784497671 -34.6156221499634,-58.4155218079545 -34.6172459819229,-58.4165882070106 -34.6173237867701,-58.4168518460907 -34.6173446615195,-58.4169215683653 -34.6166509307187,-58.4170174985096 -34.6156969890742)))";;"2523";5_16_2;COMUNA 5;"16";"2";"628";"278";"350";"79,43%";"328";"328";"100,00%";"0";"0,00%";"286";"20";"6.99";"266";"93,01%";"6.99";6.990
"MULTIPOLYGON (((-58.4157784497671 -34.6156221499634,-58.4143694667643 -34.6155371602836,-58.4143441230052 -34.6157600455115,-58.4142554508301 -34.6166315906232,-58.4142027605546 -34.6171496866461,-58.4155218079545 -34.6172459819229,-58.4157784497671 -34.6156221499634)))";;"2524";5_16_3;COMUNA 5;"16";"3";"632";"296";"336";"88,10%";"247";"244";"98,79%";"3";"1,23%";"214";"28";"13.08";"186";"86,92%";"13.08";13.080
"MULTIPOLYGON (((-58.4143694667643 -34.6155371602836,-58.412816360458 -34.6154434332046,-58.4127540619096 -34.61662957668,-58.4126876053489 -34.6180698820806,-58.4129133324096 -34.6180996233433,-58.4140919807929 -34.6182381317016,-58.4142027605546 -34.6171496866461,-58.4142554508301 -34.6166315906232,-58.4143441230052 -34.6157600455115,-58.4143694667643 -34.6155371602836)))";;"2525";5_16_4;COMUNA 5;"16";"4";"1025";"449";"576";"77,95%";"452";"451";"99,78%";"1";"0,22%";"389";"44";"11.31";"345";"88,69%";"11.31";11.310
"MULTIPOLYGON (((-58.4168518460907 -34.6173446615195,-58.4165882070106 -34.6173237867701,-58.4155218079545 -34.6172459819229,-58.4142027605546 -34.6171496866461,-58.4140919807929 -34.6182381317016,-58.4153417595874 -34.6183848960314,-58.4164073800395 -34.618510098183,-58.4167318351332 -34.6185515603559,-58.4167474316996 -34.6183837434228,-58.4168518460907 -34.6173446615195)))";;"2526";5_16_5;COMUNA 5;"16";"5";"846";"380";"466";"81,55%";"466";"466";"100,00%";"0";"0,00%";"376";"24";"6.38";"352";"93,62%";"6.38";6.380
"MULTIPOLYGON (((-58.4182745591794 -34.6174633611064,-58.4170855011067 -34.6173632004656,-58.4168518460907 -34.6173446615195,-58.4167474316996 -34.6183837434228,-58.4167318351332 -34.6185515603559,-58.4168772395443 -34.6185700664129,-58.4182268931679 -34.6186693721974,-58.4189794091412 -34.6187246461463,-58.4189956277327 -34.6175241166578,-58.4182745591794 -34.6174633611064)))";;"2527";5_16_6;COMUNA 5;"16";"6";"715";"315";"400";"78,75%";"360";"360";"100,00%";"0";"0,00%";"309";"9";"2.91";"300";"97,09%";"2.91";2.910
"MULTIPOLYGON (((-58.4198984413769 -34.6166737023734,-58.4196186951549 -34.6166692375526,-58.41857407235 -34.6166607653041,-58.4183457764982 -34.6166594148648,-58.4169215683653 -34.6166509307187,-58.4168518460907 -34.6173446615195,-58.4170855011067 -34.6173632004656,-58.4182745591794 -34.6174633611064,-58.4189956277327 -34.6175241166578,-58.4189794091412 -34.6187246461463,-58.4196288531743 -34.6187724140543,-58.4196316084329 -34.6185508579359,-58.4196401188245 -34.617577305464,-58.4196995763648 -34.6175820449128,-58.4198984413769 -34.6166737023734)))";;"2528";5_16_7;COMUNA 5;"16";"7";"604";"296";"308";"96,10%";"273";"273";"100,00%";"0";"0,00%";"249";"58";"23.29";"191";"76,71%";"23.29";23.290
"MULTIPOLYGON (((-58.4189794091412 -34.6187246461463,-58.4182268931679 -34.6186693721974,-58.4181562924649 -34.6199082631327,-58.4181453711438 -34.6200998151363,-58.418065443679 -34.6210925670047,-58.4194257874622 -34.6211934831867,-58.4195688232475 -34.6202018091412,-58.4195918406555 -34.6200053315372,-58.4196161415319 -34.6197977272258,-58.4196288531743 -34.6187724140543,-58.4189794091412 -34.6187246461463)))";;"2529";5_16_8;COMUNA 5;"16";"8";"1030";"485";"545";"88,99%";"432";"432";"100,00%";"0";"0,00%";"376";"39";"10.37";"337";"89,63%";"10.37";10.370
"MULTIPOLYGON (((-58.4167318351332 -34.6185515603559,-58.4164073800395 -34.618510098183,-58.4153417595874 -34.6183848960314,-58.4152103156302 -34.6197315119161,-58.4163482289912 -34.6197919516869,-58.4166180127335 -34.6198067727211,-58.4168212663702 -34.6198179060559,-58.4181562924649 -34.6199082631327,-58.4182268931679 -34.6186693721974,-58.4168772395443 -34.6185700664129,-58.4167318351332 -34.6185515603559)))";;"2530";5_16_9;COMUNA 5;"16";"9";"918";"409";"509";"80,35%";"455";"454";"99,78%";"1";"0,22%";"394";"35";"8.88";"359";"91,12%";"8.88";8.880
"MULTIPOLYGON (((-58.4215830729142 -34.6157957293923,-58.4213541807108 -34.6157991732857,-58.4200802251466 -34.6158436660581,-58.4198984413769 -34.6166737023734,-58.4201680506159 -34.616678092594,-58.4215670966723 -34.6167539271183,-58.4215514692081 -34.6176950819531,-58.4217323145989 -34.617705706572,-58.422582098212 -34.6177794422857,-58.4226078247961 -34.6176016979796,-58.422706943429 -34.6169708630955,-58.4227298431179 -34.6168249499291,-58.4228670689921 -34.6159498932606,-58.4228894556337 -34.615806867299,-58.4227595499245 -34.6158057684627,-58.4216942393754 -34.6157940766073,-58.4215830729142 -34.6157957293923)))";;"2531";5_17_1;COMUNA 5;"17";"1";"706";"324";"382";"84,82%";"356";"356";"100,00%";"0";"0,00%";"290";"30";"10.34";"260";"89,66%";"10.34";10.340
"MULTIPOLYGON (((-58.4241569454765 -34.620346941622,-58.4224795574908 -34.6202024514218,-58.4223288636915 -34.62019134492,-58.4222297416165 -34.621166416496,-58.4222125932364 -34.6213937426529,-58.4235208143956 -34.6214864969848,-58.4237189571035 -34.6215073358316,-58.4240407049876 -34.6215411013627,-58.4242883411105 -34.6215671664082,-58.4251634440826 -34.6216937812384,-58.4253488020761 -34.6205895039257,-58.4253735686456 -34.6204517602194,-58.4248028236126 -34.6204025684509,-58.4241569454765 -34.620346941622)))";;"2532";5_17_10;COMUNA 5;"17";"10";"757";"369";"388";"95,10%";"351";"350";"99,72%";"1";"0,29%";"280";"1";"0.36";"279";"99,64%";"0.36";0.360
"MULTIPOLYGON (((-58.4280687721697 -34.6206839012314,-58.4268748868912 -34.620581088095,-58.4261197123409 -34.620516002563,-58.4253735686456 -34.6204517602194,-58.4253488020761 -34.6205895039257,-58.4251634440826 -34.6216937812384,-58.4266150833682 -34.6219037335957,-58.4277953282905 -34.6220745054584,-58.4278429654122 -34.6218338065068,-58.4279416552112 -34.6213313524218,-58.4280687721697 -34.6206839012314)))";;"2533";5_17_11;COMUNA 5;"17";"11";"879";"417";"462";"90,26%";"502";"502";"100,00%";"0";"0,00%";"428";"2";"0.47";"426";"99,53%";"0.47";0.470
"MULTIPOLYGON (((-58.4196995763648 -34.6175820449128,-58.4196401188245 -34.617577305464,-58.4196316084329 -34.6185508579359,-58.4196288531743 -34.6187724140543,-58.4205317213391 -34.6188387881457,-58.4205493669805 -34.6176358645069,-58.4215514692081 -34.6176950819531,-58.4215670966723 -34.6167539271183,-58.4201680506159 -34.616678092594,-58.4198984413769 -34.6166737023734,-58.4196995763648 -34.6175820449128)))";;"2534";5_17_2;COMUNA 5;"17";"2";"815";"382";"433";"88,22%";"428";"428";"100,00%";"0";"0,00%";"353";"29";"8.22";"324";"91,78%";"8.22";8.220
"MULTIPOLYGON (((-58.422582098212 -34.6177794422857,-58.4217323145989 -34.617705706572,-58.4215514692081 -34.6176950819531,-58.4205493669805 -34.6176358645069,-58.4205317213391 -34.6188387881457,-58.4215311901723 -34.6189122306942,-58.4224522908899 -34.6189799347978,-58.4225569700618 -34.6179525387267,-58.422582098212 -34.6177794422857)))";;"2535";5_17_3;COMUNA 5;"17";"3";"754";"339";"415";"81,69%";"331";"331";"100,00%";"0";"0,00%";"317";"28";"8.83";"289";"91,17%";"8.83";8.830
"MULTIPOLYGON (((-58.4250352033646 -34.6179869217764,-58.4245533187589 -34.6179514186838,-58.4243820155376 -34.6179360827679,-58.4241978497286 -34.6179196157522,-58.422582098212 -34.6177794422857,-58.4225569700618 -34.6179525387267,-58.4224522908899 -34.6189799347978,-58.4242769487338 -34.6191140489656,-58.4243975705915 -34.6191228900238,-58.4249219679151 -34.6191643930254,-58.4252732701267 -34.6191921783387,-58.4255960359142 -34.6192170665387,-58.4261476941071 -34.6192596289348,-58.4263472828355 -34.6192748299511,-58.4265602450297 -34.6181134438829,-58.4259900275338 -34.6180617225106,-58.4258067972462 -34.6180473709562,-58.4250352033646 -34.6179869217764)))";;"2536";5_17_4;COMUNA 5;"17";"4";"842";"404";"438";"92,24%";"342";"342";"100,00%";"0";"0,00%";"298";"25";"8.39";"273";"91,61%";"8.39";8.390
"MULTIPOLYGON (((-58.4273172705732 -34.6181825414695,-58.4265602450297 -34.6181134438829,-58.4263472828355 -34.6192748299511,-58.4271052605946 -34.6193327315512,-58.4283175331573 -34.6194252655811,-58.4285509856805 -34.6182947984147,-58.4273172705732 -34.6181825414695)))";;"2537";5_17_5;COMUNA 5;"17";"5";"747";"317";"430";"73,72%";"389";"389";"100,00%";"0";"0,00%";"309";"2";"0.65";"307";"99,35%";"0.65";0.650
"MULTIPOLYGON (((-58.4283175331573 -34.6194252655811,-58.4271052605946 -34.6193327315512,-58.4263472828355 -34.6192748299511,-58.4261197123409 -34.620516002563,-58.4268748868912 -34.620581088095,-58.4280687721697 -34.6206839012314,-58.4282839871933 -34.6195876561853,-58.4283175331573 -34.6194252655811)))";;"2538";5_17_6;COMUNA 5;"17";"6";"775";"345";"430";"80,23%";"435";"435";"100,00%";"0";"0,00%";"341";"2";"0.59";"339";"99,41%";"0.59";0.590
"MULTIPOLYGON (((-58.4242769487338 -34.6191140489656,-58.4224522908899 -34.6189799347978,-58.4223479519933 -34.6200029643677,-58.4223288636915 -34.62019134492,-58.4224795574908 -34.6202024514218,-58.4241569454765 -34.620346941622,-58.4248028236126 -34.6204025684509,-58.4253735686456 -34.6204517602194,-58.4261197123409 -34.620516002563,-58.4263472828355 -34.6192748299511,-58.4261476941071 -34.6192596289348,-58.4255960359142 -34.6192170665387,-58.4252732701267 -34.6191921783387,-58.4249219679151 -34.6191643930254,-58.4243975705915 -34.6191228900238,-58.4242769487338 -34.6191140489656)))";;"2539";5_17_7;COMUNA 5;"17";"7";"906";"415";"491";"84,52%";"379";"378";"99,74%";"1";"0,26%";"329";"12";"3.65";"317";"96,35%";"3.65";3.650
"MULTIPOLYGON (((-58.4224522908899 -34.6189799347978,-58.4215311901723 -34.6189122306942,-58.4205317213391 -34.6188387881457,-58.4196288531743 -34.6187724140543,-58.4196161415319 -34.6197977272258,-58.4195918406555 -34.6200053315372,-58.4195688232475 -34.6202018091412,-58.4194257874622 -34.6211934831867,-58.4202381278614 -34.6212537003138,-58.4204972664687 -34.6212721007357,-58.4204999552452 -34.621009205198,-58.4205137212655 -34.6200676982458,-58.4210127420944 -34.6200976595692,-58.4215108224841 -34.6201351540084,-58.422176210657 -34.6201800967312,-58.4223288636915 -34.62019134492,-58.4223479519933 -34.6200029643677,-58.4224522908899 -34.6189799347978)))";;"2540";5_17_8;COMUNA 5;"17";"8";"938";"441";"497";"88,73%";"427";"427";"100,00%";"0";"0,00%";"385";"11";"2.86";"374";"97,14%";"2.86";2.860
"MULTIPOLYGON (((-58.4215108224841 -34.6201351540084,-58.4210127420944 -34.6200976595692,-58.4205137212655 -34.6200676982458,-58.4204999552452 -34.621009205198,-58.4204972664687 -34.6212721007357,-58.4209729510613 -34.6213048007175,-58.4214488053985 -34.6213395412262,-58.4222125932364 -34.6213937426529,-58.4222297416165 -34.621166416496,-58.4223288636915 -34.62019134492,-58.422176210657 -34.6201800967312,-58.4215108224841 -34.6201351540084)))";;"2541";5_17_9;COMUNA 5;"17";"9";"558";"268";"290";"92,41%";"309";"309";"100,00%";"0";"0,00%";"253";"18";"7.11";"235";"92,89%";"7.11";7.110
"MULTIPOLYGON (((-58.4266150833682 -34.6219037335957,-58.4251634440826 -34.6216937812384,-58.4251466650071 -34.6218752612443,-58.4248575602595 -34.6233056438778,-58.4263003862735 -34.6234710886249,-58.4274914866589 -34.6236075696746,-58.4277953282905 -34.6220745054584,-58.4266150833682 -34.6219037335957)))";;"2542";5_18_1;COMUNA 5;"18";"1";"943";"431";"512";"84,18%";"527";"527";"100,00%";"0";"0,00%";"423";"32";"7.57";"391";"92,43%";"7.57";7.570
"MULTIPOLYGON (((-58.4271761351053 -34.6251348545483,-58.4259816657934 -34.6250552727852,-58.4245225949099 -34.624958131413,-58.424493052858 -34.6250999579946,-58.424334449141 -34.6257809173469,-58.4257523348434 -34.625991573482,-58.4257799920534 -34.6258694650259,-58.4269716191785 -34.6260475724023,-58.4270405917933 -34.6257316663412,-58.4271761351053 -34.6251348545483)))";;"2543";5_18_10;COMUNA 5;"18";"10";"818";"349";"469";"74,41%";"406";"406";"100,00%";"0";"0,00%";"344";"15";"4.36";"329";"95,64%";"4.36";4.360
"MULTIPOLYGON (((-58.4257523348434 -34.625991573482,-58.424334449141 -34.6257809173469,-58.424188818185 -34.6264063152469,-58.4241387119452 -34.6266151797411,-58.4243806503802 -34.6266514543951,-58.4253442333168 -34.6267928144132,-58.4255614679015 -34.6268249240862,-58.425776913669 -34.626856751131,-58.4267558364569 -34.6269984567619,-58.4268193420074 -34.6267200857482,-58.4269716191785 -34.6260475724023,-58.4257799920534 -34.6258694650259,-58.4257523348434 -34.625991573482)))";;"2544";5_18_11;COMUNA 5;"18";"11";"718";"291";"427";"68,15%";"405";"404";"99,75%";"1";"0,25%";"315";"6";"1.9";"309";"98,10%";"1.9";1.900
"MULTIPOLYGON (((-58.4263003862735 -34.6234710886249,-58.4248575602595 -34.6233056438778,-58.4245577722718 -34.6247887000051,-58.4245225949099 -34.624958131413,-58.4259816657934 -34.6250552727852,-58.4271761351053 -34.6251348545483,-58.4272374244697 -34.6248525387885,-58.4274620323837 -34.6237563691046,-58.4274914866589 -34.6236075696746,-58.4263003862735 -34.6234710886249)))";;"2545";5_18_2;COMUNA 5;"18";"2";"900";"407";"493";"82,56%";"382";"382";"100,00%";"0";"0,00%";"375";"38";"10.13";"337";"89,87%";"10.13";10.130
"MULTIPOLYGON (((-58.4240407049876 -34.6215411013627,-58.4237189571035 -34.6215073358316,-58.4235857240096 -34.6224057046062,-58.4234758192984 -34.6231471737909,-58.4232302786725 -34.6248034894802,-58.4232201937068 -34.6248713054366,-58.4245225949099 -34.624958131413,-58.4245577722718 -34.6247887000051,-58.4248575602595 -34.6233056438778,-58.4251466650071 -34.6218752612443,-58.4251634440826 -34.6216937812384,-58.4242883411105 -34.6215671664082,-58.4240407049876 -34.6215411013627)))";;"2546";5_18_3;COMUNA 5;"18";"3";"852";"410";"442";"92,76%";"412";"412";"100,00%";"0";"0,00%";"343";"6";"1.75";"337";"98,25%";"1.75";1.750
"MULTIPOLYGON (((-58.422707425796 -34.6230688230108,-58.4220549794298 -34.6229910694781,-58.4212997091011 -34.6229109535774,-58.4211269694027 -34.6247318024381,-58.4218605469766 -34.62478071388,-58.4225283586544 -34.6248239652742,-58.4230805658072 -34.6248617527986,-58.4232302786725 -34.6248034894802,-58.4234758192984 -34.6231471737909,-58.422707425796 -34.6230688230108)))";;"2547";5_18_4;COMUNA 5;"18";"4";"788";"375";"413";"90,80%";"295";"293";"99,32%";"2";"0,68%";"277";"31";"11.19";"246";"88,81%";"11.19";11.190
"MULTIPOLYGON (((-58.4222125932364 -34.6213937426529,-58.4214488053985 -34.6213395412262,-58.4212997091011 -34.6229109535774,-58.4220549794298 -34.6229910694781,-58.422707425796 -34.6230688230108,-58.4234758192984 -34.6231471737909,-58.4235857240096 -34.6224057046062,-58.4237189571035 -34.6215073358316,-58.4235208143956 -34.6214864969848,-58.4222125932364 -34.6213937426529)))";;"2548";5_18_5;COMUNA 5;"18";"5";"828";"379";"449";"84,41%";"417";"417";"100,00%";"0";"0,00%";"336";"34";"10.12";"302";"89,88%";"10.12";10.120
"MULTIPOLYGON (((-58.4209729510613 -34.6213048007175,-58.4204972664687 -34.6212721007357,-58.4204949292384 -34.6215136576147,-58.4205223768219 -34.6228284309251,-58.4205613885577 -34.6246941423005,-58.4211269694027 -34.6247318024381,-58.4212997091011 -34.6229109535774,-58.4214488053985 -34.6213395412262,-58.4209729510613 -34.6213048007175)))";;"2549";5_18_6;COMUNA 5;"18";"6";"684";"303";"381";"79,53%";"273";"272";"99,63%";"1";"0,37%";"242";"22";"9.09";"220";"90,91%";"9.09";9.090
"MULTIPOLYGON (((-58.4211269694027 -34.6247318024381,-58.4205613885577 -34.6246941423005,-58.4202479562894 -34.6260429528428,-58.4204651867689 -34.6260754237176,-58.421312217919 -34.6261999436269,-58.4215153932232 -34.6262300134136,-58.4215720784544 -34.6259955175304,-58.4217193331594 -34.6253982932392,-58.4218358549129 -34.6249257809916,-58.4218605469766 -34.62478071388,-58.4211269694027 -34.6247318024381)))";;"2550";5_18_7;COMUNA 5;"18";"7";"724";"328";"396";"82,83%";"370";"370";"100,00%";"0";"0,00%";"309";"0";"0";"309";"100,00%";"0";0.000
"MULTIPOLYGON (((-58.4217193331594 -34.6253982932392,-58.4215720784544 -34.6259955175304,-58.4215153932232 -34.6262300134136,-58.4217514515894 -34.6262649532249,-58.4226364811579 -34.6263946881306,-58.4228421273045 -34.6264263762917,-58.4228871936212 -34.6262521597437,-58.4230432431049 -34.6255945825781,-58.4232201937068 -34.6248713054366,-58.4232302786725 -34.6248034894802,-58.4230805658072 -34.6248617527986,-58.4225283586544 -34.6248239652742,-58.4218605469766 -34.62478071388,-58.4218358549129 -34.6249257809916,-58.4217193331594 -34.6253982932392)))";;"2551";5_18_8;COMUNA 5;"18";"8";"408";"198";"210";"94,29%";"181";"181";"100,00%";"0";"0,00%";"149";"4";"2.68";"145";"97,32%";"2.68";2.680
"MULTIPOLYGON (((-58.4245225949099 -34.624958131413,-58.4232201937068 -34.6248713054366,-58.4230432431049 -34.6255945825781,-58.4228871936212 -34.6262521597437,-58.4228421273045 -34.6264263762917,-58.4230699227418 -34.6264615221252,-58.4238930253856 -34.6265783400152,-58.4241387119452 -34.6266151797411,-58.424188818185 -34.6264063152469,-58.424334449141 -34.6257809173469,-58.424493052858 -34.6250999579946,-58.4245225949099 -34.624958131413)))";;"2552";5_18_9;COMUNA 5;"18";"9";"689";"331";"358";"92,46%";"311";"311";"100,00%";"0";"0,00%";"267";"16";"5.99";"251";"94,01%";"5.99";5.990
"MULTIPOLYGON (((-58.4194257874622 -34.6211934831867,-58.418065443679 -34.6210925670047,-58.4179606435315 -34.6223935596373,-58.4179433281851 -34.6225923629708,-58.4182032341564 -34.6226164025423,-58.4192755777976 -34.6227034821219,-58.4195704982701 -34.6227273903896,-58.4205223768219 -34.6228284309251,-58.4204949292384 -34.6215136576147,-58.4204972664687 -34.6212721007357,-58.4202381278614 -34.6212537003138,-58.4194257874622 -34.6211934831867)))";;"2553";5_19_1;COMUNA 5;"19";"1";"856";"400";"456";"87,72%";"405";"405";"100,00%";"0";"0,00%";"344";"5";"1.45";"339";"98,55%";"1.45";1.450
"MULTIPOLYGON (((-58.4191078678027 -34.6245972197767,-58.4177763428606 -34.6245084237909,-58.4175406215 -34.6244927024142,-58.417063048758 -34.6244546360562,-58.416211164421 -34.624062751663,-58.4161643596133 -34.6245813431222,-58.4160992192486 -34.6254374038065,-58.4173620412931 -34.625616829463,-58.4176816653939 -34.6256639212718,-58.4179966045358 -34.6257103062767,-58.4186436063163 -34.6258062491541,-58.418825227301 -34.6258327943896,-58.4191078678027 -34.6245972197767)))";;"2554";5_19_10;COMUNA 5;"19";"10";"798";"363";"435";"83,45%";"473";"473";"100,00%";"0";"0,00%";"364";"21";"5.77";"343";"94,23%";"5.77";5.770
"MULTIPOLYGON (((-58.4205223768219 -34.6228284309251,-58.4195704982701 -34.6227273903896,-58.4192755777976 -34.6227034821219,-58.4191078678027 -34.6245972197767,-58.418825227301 -34.6258327943896,-58.4190827510682 -34.6258704232331,-58.4200581566242 -34.6260145758193,-58.4202479562894 -34.6260429528428,-58.4205613885577 -34.6246941423005,-58.4205223768219 -34.6228284309251)))";;"2555";5_19_11;COMUNA 5;"19";"11";"1046";"498";"548";"90,88%";"402";"402";"100,00%";"0";"0,00%";"437";"51";"11.67";"386";"88,33%";"11.67";11.670
"MULTIPOLYGON (((-58.4192755777976 -34.6227034821219,-58.4182032341564 -34.6226164025423,-58.4179433281851 -34.6225923629708,-58.4178661798465 -34.6234776468371,-58.4177763428606 -34.6245084237909,-58.4191078678027 -34.6245972197767,-58.4192755777976 -34.6227034821219)))";;"2556";5_19_2;COMUNA 5;"19";"2";"692";"309";"383";"80,68%";"345";"345";"100,00%";"0";"0,00%";"282";"2";"0.71";"280";"99,29%";"0.71";0.710
"MULTIPOLYGON (((-58.4163675397123 -34.6224464879276,-58.4162785990132 -34.6233663449788,-58.4162202696279 -34.6239286660275,-58.416211164421 -34.624062751663,-58.417063048758 -34.6244546360562,-58.4175406215 -34.6244927024142,-58.4177763428606 -34.6245084237909,-58.4178661798465 -34.6234776468371,-58.4179433281851 -34.6225923629708,-58.4179606435315 -34.6223935596373,-58.418065443679 -34.6210925670047,-58.4165096860088 -34.6209771951195,-58.4163675397123 -34.6224464879276)))";;"2557";5_19_3;COMUNA 5;"19";"3";"929";"415";"514";"80,74%";"502";"502";"100,00%";"0";"0,00%";"407";"41";"10.07";"366";"89,93%";"10.07";10.070
"MULTIPOLYGON (((-58.4150932183614 -34.6208605197565,-58.4138235314332 -34.6207518448672,-58.4136827807889 -34.6220858487715,-58.4147234621061 -34.6222509865103,-58.4149460505612 -34.6222782578884,-58.4163675397123 -34.6224464879276,-58.4165096860088 -34.6209771951195,-58.416104711005 -34.6209471104868,-58.4150932183614 -34.6208605197565)))";;"2558";5_19_4;COMUNA 5;"19";"4";"994";"435";"559";"77,82%";"477";"476";"99,79%";"1";"0,21%";"397";"17";"4.28";"380";"95,72%";"4.28";4.280
"MULTIPOLYGON (((-58.4149460505612 -34.6222782578884,-58.4147234621061 -34.6222509865103,-58.4136827807889 -34.6220858487715,-58.4137299246595 -34.6233342910463,-58.4148097569268 -34.6235919821235,-58.4162202696279 -34.6239286660275,-58.4162785990132 -34.6233663449788,-58.4163675397123 -34.6224464879276,-58.4149460505612 -34.6222782578884)))";;"2559";5_19_5;COMUNA 5;"19";"5";"768";"346";"422";"81,99%";"415";"415";"100,00%";"0";"0,00%";"334";"6";"1.8";"328";"98,20%";"1.8";1.800
"MULTIPOLYGON (((-58.4123334674259 -34.6230328670315,-58.4122197515561 -34.6239925713041,-58.4136541009306 -34.6242077412622,-58.4137299246595 -34.6233342910463,-58.4136827807889 -34.6220858487715,-58.4138235314332 -34.6207518448672,-58.4125438811881 -34.6206423075662,-58.4124368166296 -34.6218833629295,-58.4123564056345 -34.6218685405263,-58.4120418912046 -34.6229747865517,-58.4123334674259 -34.6230328670315)))";;"2560";5_19_6;COMUNA 5;"19";"6";"808";"371";"437";"84,90%";"382";"381";"99,74%";"1";"0,26%";"330";"12";"3.64";"318";"96,36%";"3.64";3.640
"MULTIPOLYGON (((-58.4136541009306 -34.6242077412622,-58.4122197515561 -34.6239925713041,-58.4121266704108 -34.6247781230019,-58.4120940956267 -34.6249692427754,-58.4132704546165 -34.6251072650339,-58.4135721916801 -34.6251408387755,-58.4136541009306 -34.6242077412622)))";;"2561";5_19_7;COMUNA 5;"19";"7";"446";"212";"234";"90,60%";"280";"280";"100,00%";"0";"0,00%";"199";"17";"8.54";"182";"91,46%";"8.54";8.540
"MULTIPOLYGON (((-58.4147512071062 -34.6243719154431,-58.4145085125577 -34.6243359735066,-58.4136541009306 -34.6242077412622,-58.4135721916801 -34.6251408387755,-58.4138553579413 -34.6251722915878,-58.4146907152301 -34.6252676264642,-58.4157774662676 -34.62539171553,-58.4160992192486 -34.6254374038065,-58.4161643596133 -34.6245813431222,-58.4147512071062 -34.6243719154431)))";;"2562";5_19_8;COMUNA 5;"19";"8";"922";"417";"505";"82,57%";"485";"484";"99,79%";"1";"0,21%";"429";"4";"0.93";"425";"99,07%";"0.93";0.930
"MULTIPOLYGON (((-58.4162202696279 -34.6239286660275,-58.4148097569268 -34.6235919821235,-58.4137299246595 -34.6233342910463,-58.4136541009306 -34.6242077412622,-58.4145085125577 -34.6243359735066,-58.4147512071062 -34.6243719154431,-58.4161643596133 -34.6245813431222,-58.416211164421 -34.624062751663,-58.4162202696279 -34.6239286660275)))";;"2563";5_19_9;COMUNA 5;"19";"9";"605";"271";"334";"81,14%";"372";"372";"100,00%";"0";"0,00%";"294";"7";"2.38";"287";"97,62%";"2.38";2.380
"MULTIPOLYGON (((-58.417507733165 -34.5988776754239,-58.4175436032879 -34.5990077641219,-58.4179133455357 -34.5999016670395,-58.4188620187438 -34.5996061551532,-58.4190034319432 -34.5995402174318,-58.418970024714 -34.5986061555168,-58.4189677086252 -34.598475304581,-58.4189408150578 -34.5977892825791,-58.4174656374451 -34.5978207177188,-58.4172629395686 -34.5978256426042,-58.4161590873864 -34.597852481157,-58.4160005068785 -34.5978547446042,-58.4160728697126 -34.5992770805046,-58.417507733165 -34.5988776754239)))";;"2564";5_2_1;COMUNA 5;"2";"1";"875";"371";"504";"73,61%";"438";"432";"98,63%";"6";"1,39%";"336";"10";"2.98";"326";"97,02%";"2.98";2.980
"MULTIPOLYGON (((-58.4161433284763 -34.6004529270319,-58.415136455235 -34.6007665647663,-58.4153125313611 -34.6017604034483,-58.4163322840069 -34.6014333884218,-58.4177940520583 -34.6009589170704,-58.4177065224657 -34.599966100462,-58.4161433284763 -34.6004529270319)))";;"2565";5_2_10;COMUNA 5;"2";"10";"675";"326";"349";"93,41%";"359";"359";"100,00%";"0";"0,00%";"301";"48";"15.95";"253";"84,05%";"15.95";15.950
"MULTIPOLYGON (((-58.4190034319432 -34.5995402174318,-58.4188620187438 -34.5996061551532,-58.4179133455357 -34.5999016670395,-58.4177065224657 -34.599966100462,-58.4177940520583 -34.6009589170704,-58.4191757319551 -34.6008356806248,-58.4190845336776 -34.600149847241,-58.4190034319432 -34.5995402174318)))";;"2566";5_2_11;COMUNA 5;"2";"11";"841";"375";"466";"80,47%";"486";"486";"100,00%";"0";"0,00%";"394";"57";"14.47";"337";"85,53%";"14.47";14.470
"MULTIPOLYGON (((-58.4160728697126 -34.5992770805046,-58.415910515033 -34.5993223017846,-58.4149301621818 -34.5996003128795,-58.4149664953626 -34.5998077294017,-58.415136455235 -34.6007665647663,-58.4161433284763 -34.6004529270319,-58.4177065224657 -34.599966100462,-58.4179133455357 -34.5999016670395,-58.4175436032879 -34.5990077641219,-58.417507733165 -34.5988776754239,-58.4160728697126 -34.5992770805046)))";;"2567";5_2_2;COMUNA 5;"2";"2";"616";"288";"328";"87,80%";"334";"333";"99,70%";"1";"0,30%";"270";"24";"8.89";"246";"91,11%";"8.89";8.890
"MULTIPOLYGON (((-58.4160005068785 -34.5978547446042,-58.4156625650391 -34.5978597558484,-58.4146278602449 -34.5978979456493,-58.414903761237 -34.599449733394,-58.4149301621818 -34.5996003128795,-58.415910515033 -34.5993223017846,-58.4160728697126 -34.5992770805046,-58.4160005068785 -34.5978547446042)))";;"2568";5_2_3;COMUNA 5;"2";"3";"723";"334";"389";"85,86%";"412";"409";"99,27%";"3";"0,73%";"325";"1";"0.31";"324";"99,69%";"0.31";0.310
"MULTIPOLYGON (((-58.4146278602449 -34.5978979456493,-58.4132525675508 -34.5979487361076,-58.413541661175 -34.5991824918959,-58.414903761237 -34.599449733394,-58.4146278602449 -34.5978979456493)))";;"2569";5_2_4;COMUNA 5;"2";"4";"941";"422";"519";"81,31%";"565";"565";"100,00%";"0";"0,00%";"461";"17";"3.69";"444";"96,31%";"3.69";3.690
"MULTIPOLYGON (((-58.4132525675508 -34.5979487361076,-58.4129838623689 -34.5979586273118,-58.4120909588458 -34.5979936137291,-58.411918832168 -34.5980030496281,-58.4121240654761 -34.5992961422995,-58.413541661175 -34.5991824918959,-58.4132525675508 -34.5979487361076)))";;"2570";5_2_5;COMUNA 5;"2";"5";"568";"215";"353";"60,91%";"287";"286";"99,65%";"1";"0,35%";"222";"1";"0.45";"221";"99,55%";"0.45";0.450
"MULTIPOLYGON (((-58.4121240654761 -34.5992961422995,-58.4123093634233 -34.6002382071366,-58.413435394686 -34.6000098750799,-58.4137189612952 -34.5999393527337,-58.4138428991147 -34.5999084857459,-58.4149301621818 -34.5996003128795,-58.414903761237 -34.599449733394,-58.413541661175 -34.5991824918959,-58.4121240654761 -34.5992961422995)))";;"2571";5_2_6;COMUNA 5;"2";"6";"610";"287";"323";"88,85%";"300";"300";"100,00%";"0";"0,00%";"258";"65";"25.19";"193";"74,81%";"25.19";25.190
"MULTIPOLYGON (((-58.4123093634233 -34.6002382071366,-58.4125916132526 -34.6016018456514,-58.4139887609948 -34.6011289427107,-58.4139305024176 -34.600842147963,-58.4137189612952 -34.5999393527337,-58.413435394686 -34.6000098750799,-58.4123093634233 -34.6002382071366)))";;"2572";5_2_7;COMUNA 5;"2";"7";"572";"250";"322";"77,64%";"299";"298";"99,67%";"1";"0,34%";"246";"110";"44.72";"136";"55,28%";"44.72";44.720
"MULTIPOLYGON (((-58.4139887609948 -34.6011289427107,-58.4125916132526 -34.6016018456514,-58.4128039938622 -34.6025116854483,-58.4140293745221 -34.6021719562424,-58.4141724024483 -34.6021260959777,-58.4140109265045 -34.6012381106375,-58.4139887609948 -34.6011289427107)))";;"2573";5_2_8;COMUNA 5;"2";"8";"1067";"523";"544";"96,14%";"613";"613";"100,00%";"0";"0,00%";"433";"2";"0.46";"431";"99,54%";"0.46";0.460
"MULTIPOLYGON (((-58.4139887609948 -34.6011289427107,-58.4140109265045 -34.6012381106375,-58.4141724024483 -34.6021260959777,-58.4153125313611 -34.6017604034483,-58.415136455235 -34.6007665647663,-58.4149664953626 -34.5998077294017,-58.4149301621818 -34.5996003128795,-58.4138428991147 -34.5999084857459,-58.4137189612952 -34.5999393527337,-58.4139305024176 -34.600842147963,-58.4139887609948 -34.6011289427107)))";;"2574";5_2_9;COMUNA 5;"2";"9";"837";"399";"438";"91,10%";"401";"401";"100,00%";"0";"0,00%";"339";"67";"19.76";"272";"80,24%";"19.76";19.760
"MULTIPOLYGON (((-58.4145734001336 -34.6277809047956,-58.414550635072 -34.6288436075489,-58.4159061558544 -34.6289511809402,-58.4159242621148 -34.628113202027,-58.4159358124235 -34.6278745364563,-58.4159751189221 -34.6270597353102,-58.4159835296971 -34.6269498756637,-58.4160992192486 -34.6254374038065,-58.4157774662676 -34.62539171553,-58.4146907152301 -34.6252676264642,-58.4146765375415 -34.6254770646364,-58.4145945867338 -34.6267950348153,-58.4145734001336 -34.6277809047956)))";;"2575";5_20_1;COMUNA 5;"20";"1";"764";"351";"413";"84,99%";"419";"418";"99,76%";"1";"0,24%";"316";"29";"9.18";"287";"90,82%";"9.18";9.180
"MULTIPOLYGON (((-58.4161635331895 -34.6375044470792,-58.4161504966433 -34.6376568413568,-58.4158438221148 -34.6388963409886,-58.4161358013451 -34.6389475812043,-58.4170868058096 -34.6391082978067,-58.4171499029773 -34.638873666031,-58.4173022101083 -34.6383303252038,-58.4176156113402 -34.6372128000178,-58.4179165807404 -34.6362230198598,-58.4179090275115 -34.635533135613,-58.4167746794554 -34.6354139775126,-58.4161758293384 -34.6353208602129,-58.4161889457371 -34.6360931437356,-58.4162046997877 -34.6370252220372,-58.4161926927863 -34.6371652219593,-58.4161635331895 -34.6375044470792)))";;"2576";5_20_10;COMUNA 5;"20";"10";"962";"446";"516";"86,43%";"457";"457";"100,00%";"0";"0,00%";"380";"35";"9.21";"345";"90,79%";"9.21";9.210
"MULTIPOLYGON (((-58.4145533072027 -34.6386698452381,-58.4158438221148 -34.6388963409886,-58.4161504966433 -34.6376568413568,-58.4161635331895 -34.6375044470792,-58.4158613330221 -34.6373037615791,-58.4156081041308 -34.6371450674225,-58.4146388928212 -34.636537768405,-58.4145584861763 -34.6364902703748,-58.4138143884656 -34.6360505235956,-58.413540005201 -34.6371000950109,-58.4131919992311 -34.6384309123483,-58.4145533072027 -34.6386698452381)))";;"2577";5_20_11;COMUNA 5;"20";"11";"830";"398";"432";"92,13%";"320";"320";"100,00%";"0";"0,00%";"302";"20";"6.62";"282";"93,38%";"6.62";6.620
"MULTIPOLYGON (((-58.4116257957169 -34.6381590606751,-58.4118797732766 -34.6382005061188,-58.4131919992311 -34.6384309123483,-58.413540005201 -34.6371000950109,-58.4138143884656 -34.6360505235956,-58.4135804967615 -34.6359122561444,-58.4126778932431 -34.6353901118449,-58.4124089217806 -34.6352176012793,-58.4122424121198 -34.6351108389055,-58.4112969642215 -34.634457113017,-58.4109869624709 -34.6342333127167,-58.4108802872865 -34.6345084876698,-58.4105653491697 -34.6350945696848,-58.4104885758959 -34.6352374992263,-58.4105119670987 -34.6357094259257,-58.4107060144903 -34.6363341768605,-58.4109273635771 -34.6370431670748,-58.4110021971106 -34.6372814459036,-58.4112604638686 -34.6380993277679,-58.4116257957169 -34.6381590606751)))";;"2578";5_20_12;COMUNA 5;"20";"12";"905";"455";"450";"101,11%";"324";"322";"99,38%";"2";"0,62%";"297";"54";"18.18";"243";"81,82%";"18.18";18.180
"MULTIPOLYGON (((-58.4135721916801 -34.6251408387755,-58.4132704546165 -34.6251072650339,-58.4120940956267 -34.6249692427754,-58.4120651975512 -34.6251381097809,-58.4119903327197 -34.6265045335513,-58.4134383025247 -34.6266660478516,-58.4145945867338 -34.6267950348153,-58.4146765375415 -34.6254770646364,-58.4146907152301 -34.6252676264642,-58.4138553579413 -34.6251722915878,-58.4135721916801 -34.6251408387755)))";;"2579";5_20_2;COMUNA 5;"20";"2";"930";"439";"491";"89,41%";"498";"497";"99,80%";"1";"0,20%";"410";"14";"3.41";"396";"96,59%";"3.41";3.410
"MULTIPOLYGON (((-58.4118741969917 -34.6286239228038,-58.4118423189936 -34.6292055486976,-58.4124174928343 -34.62934438334,-58.412636080134 -34.6293966580948,-58.413178460626 -34.6295263908712,-58.4132509196059 -34.6287404784978,-58.414550635072 -34.6288436075489,-58.4145734001336 -34.6277809047956,-58.4145945867338 -34.6267950348153,-58.4134383025247 -34.6266660478516,-58.4119903327197 -34.6265045335513,-58.4119310594474 -34.6275862355657,-58.4118741969917 -34.6286239228038)))";;"2580";5_20_3;COMUNA 5;"20";"3";"1065";"487";"578";"84,26%";"399";"399";"100,00%";"0";"0,00%";"385";"75";"19.48";"310";"80,52%";"19.48";19.480
"MULTIPOLYGON (((-58.4159061558544 -34.6289511809402,-58.414550635072 -34.6288436075489,-58.4132509196059 -34.6287404784978,-58.413178460626 -34.6295263908712,-58.4145290950462 -34.6298494777166,-58.4145172732275 -34.6304029421697,-58.4159226911374 -34.630760402512,-58.4159055758043 -34.630439469797,-58.4158941366609 -34.6301760059423,-58.4158843797671 -34.6299513468306,-58.4159061558544 -34.6289511809402)))";;"2581";5_20_4;COMUNA 5;"20";"4";"804";"375";"429";"87,41%";"373";"373";"100,00%";"0";"0,00%";"314";"14";"4.46";"300";"95,54%";"4.46";4.460
"MULTIPOLYGON (((-58.4144785548369 -34.6323825697996,-58.4160294331524 -34.6327617066607,-58.4159899737494 -34.6320213150744,-58.4159558265596 -34.6313809287306,-58.4159226911374 -34.630760402512,-58.4145172732275 -34.6304029421697,-58.414503878224 -34.6310245772226,-58.4130715353766 -34.6306730052854,-58.413051986774 -34.6308796239006,-58.4130086142315 -34.6313180714602,-58.4129600129659 -34.6318084903865,-58.4129628701553 -34.6320176533786,-58.4144785548369 -34.6323825697996)))";;"2582";5_20_5;COMUNA 5;"20";"5";"901";"441";"460";"95,87%";"392";"392";"100,00%";"0";"0,00%";"332";"27";"8.13";"305";"91,87%";"8.13";8.130
"MULTIPOLYGON (((-58.4120863654273 -34.6318066520609,-58.4129628701553 -34.6320176533786,-58.4129600129659 -34.6318084903865,-58.4130086142315 -34.6313180714602,-58.413051986774 -34.6308796239006,-58.4130715353766 -34.6306730052854,-58.414503878224 -34.6310245772226,-58.4145172732275 -34.6304029421697,-58.4145290950462 -34.6298494777166,-58.413178460626 -34.6295263908712,-58.412636080134 -34.6293966580948,-58.4124174928343 -34.62934438334,-58.4118423189936 -34.6292055486976,-58.4117793363578 -34.6303558424391,-58.4117664119792 -34.6305922533439,-58.4116509028005 -34.6315309685304,-58.4116345272361 -34.6316978685949,-58.4120863654273 -34.6318066520609)))";;"2583";5_20_6;COMUNA 5;"20";"6";"846";"406";"440";"92,27%";"321";"321";"100,00%";"0";"0,00%";"288";"19";"6.6";"269";"93,40%";"6.6";6.600
"MULTIPOLYGON (((-58.4144785548369 -34.6323825697996,-58.4129628701553 -34.6320176533786,-58.4120863654273 -34.6318066520609,-58.4116345272361 -34.6316978685949,-58.4115205838471 -34.6328567322147,-58.4114776591965 -34.6329675629023,-58.4130310128664 -34.6333344849688,-58.4144602569306 -34.6336719710555,-58.4161065812053 -34.6340607223558,-58.4160426716954 -34.6330084099662,-58.4160294331524 -34.6327617066607,-58.4144785548369 -34.6323825697996)))";;"2584";5_20_7;COMUNA 5;"20";"7";"912";"443";"469";"94,46%";"341";"341";"100,00%";"0";"0,00%";"315";"21";"6.67";"294";"93,33%";"6.67";6.670
"MULTIPOLYGON (((-58.4161065812053 -34.6340607223558,-58.4144602569306 -34.6336719710555,-58.4130310128664 -34.6333344849688,-58.4114776591965 -34.6329675629023,-58.4109869624709 -34.6342333127167,-58.4112969642215 -34.634457113017,-58.4122424121198 -34.6351108389055,-58.4124089217806 -34.6352176012793,-58.4127346211402 -34.6342838315427,-58.4141665519922 -34.6347154096936,-58.4152056887424 -34.6350285049844,-58.4161758293384 -34.6353208602129,-58.4161730253149 -34.6351544452929,-58.4161065812053 -34.6340607223558)))";;"2585";5_20_8;COMUNA 5;"20";"8";"907";"439";"468";"93,80%";"333";"333";"100,00%";"0";"0,00%";"317";"26";"8.2";"291";"91,80%";"8.2";8.200
"MULTIPOLYGON (((-58.4141665519922 -34.6347154096936,-58.4127346211402 -34.6342838315427,-58.4124089217806 -34.6352176012793,-58.4126778932431 -34.6353901118449,-58.4135804967615 -34.6359122561444,-58.4138143884656 -34.6360505235956,-58.4145584861763 -34.6364902703748,-58.4146388928212 -34.636537768405,-58.4156081041308 -34.6371450674225,-58.4158613330221 -34.6373037615791,-58.4161635331895 -34.6375044470792,-58.4161926927863 -34.6371652219593,-58.4162046997877 -34.6370252220372,-58.4161889457371 -34.6360931437356,-58.4161758293384 -34.6353208602129,-58.4152056887424 -34.6350285049844,-58.4141665519922 -34.6347154096936)))";;"2586";5_20_9;COMUNA 5;"20";"9";"861";"408";"453";"90,07%";"356";"355";"99,72%";"1";"0,28%";"326";"17";"5.21";"309";"94,79%";"5.21";5.210
"MULTIPOLYGON (((-58.423980359859 -34.627292194746,-58.4238331842071 -34.6279301272075,-58.4252615845839 -34.6281404402104,-58.4264557999563 -34.6283162997674,-58.4265020660238 -34.6281109544838,-58.4267558364569 -34.6269984567619,-58.425776913669 -34.626856751131,-58.4255614679015 -34.6268249240862,-58.4253442333168 -34.6267928144132,-58.4243806503802 -34.6266514543951,-58.4241387119452 -34.6266151797411,-58.4240824595543 -34.6268495360828,-58.423980359859 -34.627292194746)))";;"2587";5_21_1;COMUNA 5;"21";"1";"860";"390";"470";"82,98%";"512";"512";"100,00%";"0";"0,00%";"378";"12";"3.17";"366";"96,83%";"3.17";3.170
"MULTIPOLYGON (((-58.425014958252 -34.6292288515014,-58.4249720179334 -34.6294180699106,-58.4247900138999 -34.6302121244913,-58.4259797142156 -34.6304519330461,-58.4260154079062 -34.6302694024981,-58.4262127713714 -34.6293947846133,-58.4262507582548 -34.6292264100538,-58.4264557999563 -34.6283162997674,-58.4252615845839 -34.6281404402104,-58.4238331842071 -34.6279301272075,-58.4237833283276 -34.6281463157727,-58.4235840634577 -34.6290305774988,-58.425014958252 -34.6292288515014)))";;"2588";5_21_10;COMUNA 5;"21";"10";"599";"262";"337";"77,74%";"287";"286";"99,65%";"1";"0,35%";"253";"6";"2.37";"247";"97,63%";"2.37";2.370
"MULTIPOLYGON (((-58.4259797142156 -34.6304519330461,-58.4247900138999 -34.6302121244913,-58.4249720179334 -34.6294180699106,-58.425014958252 -34.6292288515014,-58.4235840634577 -34.6290305774988,-58.4233817208801 -34.6299282185055,-58.4231773247649 -34.6308350840357,-58.4231162826988 -34.6310966222156,-58.4244320195754 -34.6312982459685,-58.4245372345151 -34.6313143358037,-58.4257528821022 -34.6314835185075,-58.425802727457 -34.6312840903703,-58.4259325777455 -34.6306931240514,-58.4259797142156 -34.6304519330461)))";;"2589";5_21_11;COMUNA 5;"21";"11";"694";"326";"368";"88,59%";"299";"299";"100,00%";"0";"0,00%";"245";"9";"3.67";"236";"96,33%";"3.67";3.670
"MULTIPOLYGON (((-58.422526951541 -34.6277435005392,-58.4236123693124 -34.6278976611899,-58.4238331842071 -34.6279301272075,-58.423980359859 -34.627292194746,-58.4240824595543 -34.6268495360828,-58.4241387119452 -34.6266151797411,-58.4238930253856 -34.6265783400152,-58.4230699227418 -34.6264615221252,-58.4228421273045 -34.6264263762917,-58.4226364811579 -34.6263946881306,-58.4217514515894 -34.6262649532249,-58.4215153932232 -34.6262300134136,-58.4214621223133 -34.6264507071306,-58.4213548177048 -34.6268823755732,-58.4212219873022 -34.6274165738865,-58.4211892868428 -34.6275576942853,-58.4213560918065 -34.6275771177876,-58.422526951541 -34.6277435005392)))";;"2590";5_21_2;COMUNA 5;"21";"2";"857";"396";"461";"85,90%";"407";"407";"100,00%";"0";"0,00%";"350";"48";"13.71";"302";"86,29%";"13.71";13.710
"MULTIPOLYGON (((-58.4199538421316 -34.6274137416213,-58.4197727920288 -34.6282563824779,-58.4197216498594 -34.6284679208714,-58.4209363028304 -34.6286493347967,-58.4211892868428 -34.6275576942853,-58.4212219873022 -34.6274165738865,-58.4213548177048 -34.6268823755732,-58.4214621223133 -34.6264507071306,-58.4215153932232 -34.6262300134136,-58.421312217919 -34.6261999436269,-58.4204651867689 -34.6260754237176,-58.4202479562894 -34.6260429528428,-58.4201887748768 -34.626320124742,-58.4199538421316 -34.6274137416213)))";;"2591";5_21_3;COMUNA 5;"21";"3";"531";"228";"303";"75,25%";"272";"271";"99,63%";"1";"0,37%";"209";"14";"6.7";"195";"93,30%";"6.7";6.700
"MULTIPOLYGON (((-58.418825227301 -34.6258327943896,-58.4186436063163 -34.6258062491541,-58.4179966045358 -34.6257103062767,-58.4176816653939 -34.6256639212718,-58.4176711875514 -34.6258196269259,-58.4174585982182 -34.6269712070291,-58.4174249512712 -34.6271181009186,-58.4182355400803 -34.6272134727275,-58.4184960535552 -34.6272438501264,-58.4199538421316 -34.6274137416213,-58.4201887748768 -34.626320124742,-58.4202479562894 -34.6260429528428,-58.4200581566242 -34.6260145758193,-58.4190827510682 -34.6258704232331,-58.418825227301 -34.6258327943896)))";;"2592";5_21_4;COMUNA 5;"21";"4";"914";"429";"485";"88,45%";"453";"453";"100,00%";"0";"0,00%";"370";"37";"10";"333";"90,00%";"10";10.000
"MULTIPOLYGON (((-58.4176816653939 -34.6256639212718,-58.4173620412931 -34.625616829463,-58.4160992192486 -34.6254374038065,-58.4159835296971 -34.6269498756637,-58.4161795530864 -34.626971641455,-58.4174249512712 -34.6271181009186,-58.4174585982182 -34.6269712070291,-58.4176711875514 -34.6258196269259,-58.4176816653939 -34.6256639212718)))";;"2593";5_21_5;COMUNA 5;"21";"5";"640";"285";"355";"80,28%";"337";"337";"100,00%";"0";"0,00%";"266";"1";"0.38";"265";"99,62%";"0.38";0.380
"MULTIPOLYGON (((-58.4164415058855 -34.6302390337518,-58.4174681797536 -34.630351887327,-58.417763292226 -34.63038495525,-58.4180571378243 -34.629125302822,-58.4178807873012 -34.6291078432022,-58.4168619487745 -34.6290270393538,-58.4171301485959 -34.6282538744797,-58.4171941454075 -34.6280726246729,-58.4172283622462 -34.6279757327654,-58.4172578253052 -34.6278470774432,-58.4174249512712 -34.6271181009186,-58.4161795530864 -34.626971641455,-58.4159835296971 -34.6269498756637,-58.4159751189221 -34.6270597353102,-58.4159358124235 -34.6278745364563,-58.4159242621148 -34.628113202027,-58.4159061558544 -34.6289511809402,-58.4158843797671 -34.6299513468306,-58.4158941366609 -34.6301760059423,-58.4164415058855 -34.6302390337518)))";;"2594";5_21_6;COMUNA 5;"21";"6";"717";"319";"398";"80,15%";"467";"467";"100,00%";"0";"0,00%";"337";"13";"3.86";"324";"96,14%";"3.86";3.860
"MULTIPOLYGON (((-58.4199538421316 -34.6274137416213,-58.4184960535552 -34.6272438501264,-58.4182355400803 -34.6272134727275,-58.4174249512712 -34.6271181009186,-58.4172578253052 -34.6278470774432,-58.4172283622462 -34.6279757327654,-58.4171941454075 -34.6280726246729,-58.4171301485959 -34.6282538744797,-58.4168619487745 -34.6290270393538,-58.4178807873012 -34.6291078432022,-58.4180571378243 -34.629125302822,-58.417763292226 -34.63038495525,-58.4183490877712 -34.6304505943692,-58.4190088329922 -34.6305245673214,-58.4191382428067 -34.6305401775053,-58.4194967321633 -34.6292832912733,-58.4196789599823 -34.6286446018931,-58.4197216498594 -34.6284679208714,-58.4197727920288 -34.6282563824779,-58.4199538421316 -34.6274137416213)))";;"2595";5_21_7;COMUNA 5;"21";"7";"719";"366";"353";"103,68%";"308";"308";"100,00%";"0";"0,00%";"257";"25";"9.73";"232";"90,27%";"9.73";9.730
"MULTIPOLYGON (((-58.4233817208801 -34.6299282185055,-58.4223129205294 -34.629712791697,-58.422088869349 -34.6296692651505,-58.4218022885957 -34.6296136745866,-58.4207566569838 -34.6294247216577,-58.4194967321633 -34.6292832912733,-58.4191382428067 -34.6305401775053,-58.4204612245109 -34.6306998030409,-58.4207696284662 -34.6307370233588,-58.4218193799469 -34.6308978779989,-58.4231162826988 -34.6310966222156,-58.4231773247649 -34.6308350840357,-58.4233817208801 -34.6299282185055)))";;"2596";5_21_8;COMUNA 5;"21";"8";"728";"360";"368";"97,83%";"289";"286";"98,96%";"3";"1,05%";"248";"36";"14.52";"212";"85,48%";"14.52";14.520
"MULTIPOLYGON (((-58.4209363028304 -34.6286493347967,-58.4197216498594 -34.6284679208714,-58.4196789599823 -34.6286446018931,-58.4194967321633 -34.6292832912733,-58.4207566569838 -34.6294247216577,-58.4218022885957 -34.6296136745866,-58.422088869349 -34.6296692651505,-58.4223129205294 -34.629712791697,-58.4233817208801 -34.6299282185055,-58.4235840634577 -34.6290305774988,-58.4237833283276 -34.6281463157727,-58.4238331842071 -34.6279301272075,-58.4236123693124 -34.6278976611899,-58.422526951541 -34.6277435005392,-58.4213560918065 -34.6275771177876,-58.4211892868428 -34.6275576942853,-58.4209363028304 -34.6286493347967)))";;"2597";5_21_9;COMUNA 5;"21";"9";"726";"355";"371";"95,69%";"279";"277";"99,28%";"2";"0,72%";"236";"17";"7.2";"219";"92,80%";"7.2";7.200
"MULTIPOLYGON (((-58.4244320195754 -34.6312982459685,-58.4231162826988 -34.6310966222156,-58.4230632656237 -34.631323373077,-58.4228639469775 -34.6321099538645,-58.4225266758937 -34.6334408729258,-58.4227987995264 -34.6334679349678,-58.4238162409663 -34.6335674217521,-58.4239068923882 -34.6335762537235,-58.4244663925962 -34.6336310096468,-58.4251830856037 -34.6337010936469,-58.4252227733989 -34.6335487064905,-58.4254564608418 -34.6326473400172,-58.4255287524562 -34.6323652401014,-58.4256863073124 -34.6317501972873,-58.4257528821022 -34.6314835185075,-58.4245372345151 -34.6313143358037,-58.4244320195754 -34.6312982459685)))";;"2598";5_22_1;COMUNA 5;"22";"1";"738";"347";"391";"88,75%";"310";"309";"99,68%";"1";"0,32%";"260";"0";"0";"260";"100,00%";"0";0.000
"MULTIPOLYGON (((-58.4184984255673 -34.6343371849957,-58.4178727274927 -34.6342714615406,-58.4176155985424 -34.6342445349045,-58.4167048347085 -34.6341376420743,-58.4161065812053 -34.6340607223558,-58.4161730253149 -34.6351544452929,-58.4161758293384 -34.6353208602129,-58.4167746794554 -34.6354139775126,-58.4179090275115 -34.635533135613,-58.4179165807404 -34.6362230198598,-58.4187983435459 -34.6362736237568,-58.4190984276855 -34.6362909150582,-58.4193173943998 -34.636312120584,-58.419336353459 -34.6362286035022,-58.4193493377182 -34.6358375391358,-58.4193441350124 -34.6356837999146,-58.4193374214033 -34.6354863263399,-58.419294438867 -34.6344171213622,-58.4187017095014 -34.6343585267967,-58.4184984255673 -34.6343371849957)))";;"2599";5_22_10;COMUNA 5;"22";"10";"858";"393";"465";"84,52%";"305";"305";"100,00%";"0";"0,00%";"296";"33";"11.15";"263";"88,85%";"11.15";11.150
"MULTIPOLYGON (((-58.4203229225205 -34.6374464542795,-58.4206683028236 -34.6365261920643,-58.4195499933573 -34.6363347390366,-58.4193173943998 -34.636312120584,-58.4190984276855 -34.6362909150582,-58.4187983435459 -34.6362736237568,-58.4179165807404 -34.6362230198598,-58.4176156113402 -34.6372128000178,-58.4181467778988 -34.6372305309858,-58.4183474396263 -34.6372289139279,-58.4191110619449 -34.6372224988785,-58.4188662926847 -34.6383020936403,-58.4199240493687 -34.6384838130416,-58.4201916629498 -34.638529823569,-58.4209053853155 -34.6386535248878,-58.4211848416595 -34.638703974054,-58.4214125292622 -34.6378194455952,-58.4214573504929 -34.6376424832548,-58.4203229225205 -34.6374464542795)))";;"2600";5_22_11;COMUNA 5;"22";"11";"894";"424";"470";"90,21%";"341";"341";"100,00%";"0";"0,00%";"320";"36";"11.25";"284";"88,75%";"11.25";11.250
"MULTIPOLYGON (((-58.4191110619449 -34.6372224988785,-58.4183474396263 -34.6372289139279,-58.4181467778988 -34.6372305309858,-58.4176156113402 -34.6372128000178,-58.4173022101083 -34.6383303252038,-58.4171499029773 -34.638873666031,-58.4170868058096 -34.6391082978067,-58.4172579733651 -34.6391372358618,-58.4184799245802 -34.6393363533288,-58.4186226377428 -34.6393571802987,-58.4192953075563 -34.6394554528383,-58.4195341259133 -34.6394965952413,-58.4197565006879 -34.6395349143968,-58.4209177911051 -34.6397418032042,-58.4211848416595 -34.638703974054,-58.4209053853155 -34.6386535248878,-58.4201916629498 -34.638529823569,-58.4199240493687 -34.6384838130416,-58.4188662926847 -34.6383020936403,-58.4191110619449 -34.6372224988785)))";;"2601";5_22_12;COMUNA 5;"22";"12";"909";"424";"485";"87,42%";"323";"323";"100,00%";"0";"0,00%";"326";"20";"6.13";"306";"93,87%";"6.13";6.130
"MULTIPOLYGON (((-58.423759604867 -34.6391685705002,-58.4240434301461 -34.6380744005023,-58.4242774850141 -34.6371706426394,-58.4230852949102 -34.6369582121533,-58.4228458457606 -34.6378910514319,-58.4227927479134 -34.6380979421041,-58.422574630868 -34.6389547288903,-58.4218184761361 -34.6388182762429,-58.4211848416595 -34.638703974054,-58.4209177911051 -34.6397418032042,-58.4223060647256 -34.6399891097316,-58.4234919060627 -34.6402003484821,-58.423759604867 -34.6391685705002)))";;"2602";5_22_13;COMUNA 5;"22";"13";"678";"295";"383";"77,02%";"264";"263";"99,62%";"1";"0,38%";"218";"20";"9.17";"198";"90,83%";"9.17";9.170
"MULTIPOLYGON (((-58.4191870299967 -34.6317438967751,-58.4192417848716 -34.6331068484935,-58.4205390892322 -34.6332411814622,-58.4204885727728 -34.6318788656386,-58.4216150441205 -34.6319887609411,-58.4225123383823 -34.6320762458634,-58.4228639469775 -34.6321099538645,-58.4230632656237 -34.631323373077,-58.4231162826988 -34.6310966222156,-58.4218193799469 -34.6308978779989,-58.4207696284662 -34.6307370233588,-58.4204612245109 -34.6306998030409,-58.4191382428067 -34.6305401775053,-58.4191870299967 -34.6317438967751)))";;"2603";5_22_2;COMUNA 5;"22";"2";"827";"390";"437";"89,24%";"358";"358";"100,00%";"0";"0,00%";"292";"26";"8.9";"266";"91,10%";"8.9";8.900
"MULTIPOLYGON (((-58.4183490877712 -34.6304505943692,-58.417763292226 -34.63038495525,-58.4177830877198 -34.6315952843566,-58.4178287030061 -34.6329580925175,-58.4182636336081 -34.6330055772461,-58.4184476598162 -34.6330245884363,-58.4192417848716 -34.6331068484935,-58.4191870299967 -34.6317438967751,-58.4191382428067 -34.6305401775053,-58.4190088329922 -34.6305245673214,-58.4183490877712 -34.6304505943692)))";;"2604";5_22_3;COMUNA 5;"22";"3";"629";"276";"353";"78,19%";"311";"311";"100,00%";"0";"0,00%";"260";"15";"5.77";"245";"94,23%";"5.77";5.770
"MULTIPOLYGON (((-58.416633136287 -34.6328275721272,-58.4178287030061 -34.6329580925175,-58.4177830877198 -34.6315952843566,-58.417763292226 -34.63038495525,-58.4174681797536 -34.630351887327,-58.4164415058855 -34.6302390337518,-58.4158941366609 -34.6301760059423,-58.4159055758043 -34.630439469797,-58.4159226911374 -34.630760402512,-58.4159558265596 -34.6313809287306,-58.4159899737494 -34.6320213150744,-58.4160294331524 -34.6327617066607,-58.4160426716954 -34.6330084099662,-58.4161065812053 -34.6340607223558,-58.4167048347085 -34.6341376420743,-58.416633136287 -34.6328275721272)))";;"2605";5_22_4;COMUNA 5;"22";"4";"936";"437";"499";"87,58%";"435";"435";"100,00%";"0";"0,00%";"362";"7";"1.93";"355";"98,07%";"1.93";1.930
"MULTIPOLYGON (((-58.4178287030061 -34.6329580925175,-58.416633136287 -34.6328275721272,-58.4167048347085 -34.6341376420743,-58.4176155985424 -34.6342445349045,-58.4178727274927 -34.6342714615406,-58.4184984255673 -34.6343371849957,-58.4187017095014 -34.6343585267967,-58.419294438867 -34.6344171213622,-58.4205875068067 -34.6345449732029,-58.4205390892322 -34.6332411814622,-58.4192417848716 -34.6331068484935,-58.4184476598162 -34.6330245884363,-58.4182636336081 -34.6330055772461,-58.4178287030061 -34.6329580925175)))";;"2606";5_22_5;COMUNA 5;"22";"5";"801";"378";"423";"89,36%";"322";"322";"100,00%";"0";"0,00%";"277";"31";"11.19";"246";"88,81%";"11.19";11.190
"MULTIPOLYGON (((-58.4228639469775 -34.6321099538645,-58.4225123383823 -34.6320762458634,-58.4216150441205 -34.6319887609411,-58.4204885727728 -34.6318788656386,-58.4205390892322 -34.6332411814622,-58.4205875068067 -34.6345449732029,-58.4211401099346 -34.6345995307216,-58.4222118348463 -34.6347054580198,-58.4222417970886 -34.634590675491,-58.4225266758937 -34.6334408729258,-58.4228639469775 -34.6321099538645)))";;"2607";5_22_6;COMUNA 5;"22";"6";"938";"457";"481";"95,01%";"306";"306";"100,00%";"0";"0,00%";"332";"44";"13.25";"288";"86,75%";"13.25";13.250
"MULTIPOLYGON (((-58.4251830856037 -34.6337010936469,-58.4244663925962 -34.6336310096468,-58.4239068923882 -34.6335762537235,-58.4238162409663 -34.6335674217521,-58.4227987995264 -34.6334679349678,-58.4225266758937 -34.6334408729258,-58.4222417970886 -34.634590675491,-58.4222118348463 -34.6347054580198,-58.4218864283577 -34.6359505308266,-58.423014315858 -34.6360688646048,-58.423305106593 -34.6360992415474,-58.4245256133552 -34.6362239294624,-58.4246737895358 -34.635654661547,-58.424859804032 -34.6348763842592,-58.4250920248777 -34.6340322031961,-58.4251830856037 -34.6337010936469)))";;"2608";5_22_7;COMUNA 5;"22";"7";"1596";"722";"874";"82,61%";"891";"891";"100,00%";"0";"0,00%";"724";"24";"3.31";"700";"96,69%";"3.31";3.310
"MULTIPOLYGON (((-58.4245256133552 -34.6362239294624,-58.423305106593 -34.6360992415474,-58.423014315858 -34.6360688646048,-58.4218864283577 -34.6359505308266,-58.421694088473 -34.6367084485364,-58.4214573504929 -34.6376424832548,-58.4214125292622 -34.6378194455952,-58.4211848416595 -34.638703974054,-58.4218184761361 -34.6388182762429,-58.422574630868 -34.6389547288903,-58.4227927479134 -34.6380979421041,-58.4228458457606 -34.6378910514319,-58.4230852949102 -34.6369582121533,-58.4242774850141 -34.6371706426394,-58.4243858777479 -34.6367774950642,-58.4245256133552 -34.6362239294624)))";;"2609";5_22_8;COMUNA 5;"22";"8";"713";"332";"381";"87,14%";"242";"242";"100,00%";"0";"0,00%";"246";"26";"10.57";"220";"89,43%";"10.57";10.570
"MULTIPOLYGON (((-58.4206683028236 -34.6365261920643,-58.4203229225205 -34.6374464542795,-58.4214573504929 -34.6376424832548,-58.421694088473 -34.6367084485364,-58.4218864283577 -34.6359505308266,-58.4222118348463 -34.6347054580198,-58.4211401099346 -34.6345995307216,-58.4205875068067 -34.6345449732029,-58.419294438867 -34.6344171213622,-58.4193374214033 -34.6354863263399,-58.4193441350124 -34.6356837999146,-58.4193493377182 -34.6358375391358,-58.419336353459 -34.6362286035022,-58.4193173943998 -34.636312120584,-58.4195499933573 -34.6363347390366,-58.4206683028236 -34.6365261920643)))";;"2610";5_22_9;COMUNA 5;"22";"9";"901";"417";"484";"86,16%";"319";"318";"99,69%";"1";"0,31%";"278";"10";"3.6";"268";"96,40%";"3.6";3.600
"MULTIPOLYGON (((-58.4163322840069 -34.6014333884218,-58.4153125313611 -34.6017604034483,-58.415448369384 -34.6025268231802,-58.4154692504387 -34.6026521881158,-58.4156607463138 -34.6038046998994,-58.4167465494632 -34.6035983453211,-58.4167172649896 -34.6034172007071,-58.4165215024405 -34.6024084971476,-58.4163322840069 -34.6014333884218)))";;"2611";5_3_1;COMUNA 5;"3";"1";"757";"348";"409";"85,09%";"400";"398";"99,50%";"2";"0,50%";"320";"29";"9.06";"291";"90,94%";"9.06";9.060
"MULTIPOLYGON (((-58.4160283277746 -34.605670051754,-58.4149448914068 -34.6058578085428,-58.4147633264133 -34.6069973571656,-58.4147439066504 -34.607145101489,-58.4161006754019 -34.606979846428,-58.4162873888877 -34.6069636493873,-58.4160283277746 -34.605670051754)))";;"2612";5_3_10;COMUNA 5;"3";"10";"535";"240";"295";"81,36%";"284";"284";"100,00%";"0";"0,00%";"241";"32";"13.28";"209";"86,72%";"13.28";13.280
"MULTIPOLYGON (((-58.4162873888877 -34.6069636493873,-58.4161006754019 -34.606979846428,-58.4147439066504 -34.607145101489,-58.4147246573319 -34.6072925641722,-58.4146600031146 -34.608190036685,-58.4150718838863 -34.6083977410263,-58.4154337495797 -34.6084872512397,-58.4159021978199 -34.608531658799,-58.4160650536564 -34.6085362283639,-58.4162873888877 -34.6069636493873)))";;"2613";5_3_11;COMUNA 5;"3";"11";"839";"399";"440";"90,68%";"507";"507";"100,00%";"0";"0,00%";"386";"35";"9.07";"351";"90,93%";"9.07";9.070
"MULTIPOLYGON (((-58.4141724024483 -34.6021260959777,-58.4140293745221 -34.6021719562424,-58.4128039938622 -34.6025116854483,-58.4129727122721 -34.6032345280815,-58.4143169015895 -34.6029209017161,-58.4143365134332 -34.6030290825867,-58.4145140370536 -34.6040153871295,-58.4156607463138 -34.6038046998994,-58.4154692504387 -34.6026521881158,-58.415448369384 -34.6025268231802,-58.4153125313611 -34.6017604034483,-58.4141724024483 -34.6021260959777)))";;"2614";5_3_2;COMUNA 5;"3";"2";"1145";"559";"586";"95,39%";"672";"671";"99,85%";"1";"0,15%";"507";"113";"22.29";"394";"77,71%";"22.29";22.290
"MULTIPOLYGON (((-58.4143169015895 -34.6029209017161,-58.4129727122721 -34.6032345280815,-58.4131834869508 -34.6041375350811,-58.413345311069 -34.6041436572109,-58.414356366176 -34.6040444103603,-58.4145140370536 -34.6040153871295,-58.4143365134332 -34.6030290825867,-58.4143169015895 -34.6029209017161)))";;"2615";5_3_3;COMUNA 5;"3";"3";"369";"176";"193";"91,19%";"156";"156";"100,00%";"0";"0,00%";"177";"61";"34.46";"116";"65,54%";"34.46";34.460
"MULTIPOLYGON (((-58.4145140370536 -34.6040153871295,-58.414356366176 -34.6040444103603,-58.413345311069 -34.6041436572109,-58.4131834869508 -34.6041375350811,-58.4132219723806 -34.6043022751838,-58.413412361718 -34.6051190729599,-58.413549064526 -34.6051201844821,-58.4147333165688 -34.6049725516586,-58.4145426482956 -34.6041744889059,-58.4145140370536 -34.6040153871295)))";;"2616";5_3_4;COMUNA 5;"3";"4";"582";"242";"340";"71,18%";"293";"292";"99,66%";"1";"0,34%";"235";"25";"10.64";"210";"89,36%";"10.64";10.640
"MULTIPOLYGON (((-58.4156607463138 -34.6038046998994,-58.4145140370536 -34.6040153871295,-58.4145426482956 -34.6041744889059,-58.4147333165688 -34.6049725516586,-58.4158605795823 -34.6048319984138,-58.4156896920264 -34.6039785908303,-58.4156607463138 -34.6038046998994)))";;"2617";5_3_5;COMUNA 5;"3";"5";"727";"344";"383";"89,82%";"401";"399";"99,50%";"2";"0,50%";"336";"8";"2.38";"328";"97,62%";"2.38";2.380
"MULTIPOLYGON (((-58.4167465494632 -34.6035983453211,-58.4156607463138 -34.6038046998994,-58.4156896920264 -34.6039785908303,-58.4158605795823 -34.6048319984138,-58.4160283277746 -34.605670051754,-58.416870438731 -34.6055240979036,-58.4170524720699 -34.6054936016203,-58.4169242101778 -34.6046993689382,-58.4167465494632 -34.6035983453211)))";;"2618";5_3_6;COMUNA 5;"3";"6";"669";"300";"369";"81,30%";"367";"365";"99,46%";"2";"0,55%";"303";"6";"1.98";"297";"98,02%";"1.98";1.980
"MULTIPOLYGON (((-58.4158605795823 -34.6048319984138,-58.4147333165688 -34.6049725516586,-58.4149448914068 -34.6058578085428,-58.4160283277746 -34.605670051754,-58.4158605795823 -34.6048319984138)))";;"2619";5_3_7;COMUNA 5;"3";"7";"563";"234";"329";"71,12%";"414";"414";"100,00%";"0";"0,00%";"297";"5";"1.68";"292";"98,32%";"1.68";1.680
"MULTIPOLYGON (((-58.4147333165688 -34.6049725516586,-58.413549064526 -34.6051201844821,-58.413412361718 -34.6051190729599,-58.4136448948344 -34.6061168095105,-58.4147918180211 -34.6058843692448,-58.4149448914068 -34.6058578085428,-58.4147333165688 -34.6049725516586)))";;"2620";5_3_8;COMUNA 5;"3";"8";"357";"165";"192";"85,94%";"221";"221";"100,00%";"0";"0,00%";"163";"0";"0";"163";"100,00%";"0";0.000
"MULTIPOLYGON (((-58.4149448914068 -34.6058578085428,-58.4147918180211 -34.6058843692448,-58.4136448948344 -34.6061168095105,-58.4139082751344 -34.6072463232406,-58.413937006205 -34.6073460567284,-58.4140989392073 -34.6079069871436,-58.4146600031146 -34.608190036685,-58.4147246573319 -34.6072925641722,-58.4147439066504 -34.607145101489,-58.4147633264133 -34.6069973571656,-58.4149448914068 -34.6058578085428)))";;"2621";5_3_9;COMUNA 5;"3";"9";"610";"285";"325";"87,69%";"401";"401";"100,00%";"0";"0,00%";"309";"50";"16.18";"259";"83,82%";"16.18";16.180
"MULTIPOLYGON (((-58.4237474788619 -34.6003884057572,-58.4222113884656 -34.6005396720852,-58.4220443643612 -34.600556166477,-58.4206097083661 -34.6006989249381,-58.4207593382904 -34.6017392977358,-58.4207823345175 -34.6019081852867,-58.4222121552288 -34.6017676768343,-58.4223811406711 -34.6017511124399,-58.4239210856487 -34.6015999860884,-58.4237649640539 -34.600516021845,-58.4237474788619 -34.6003884057572)))";;"2622";5_4_1;COMUNA 5;"4";"1";"1030";"428";"602";"71,10%";"498";"494";"99,20%";"4";"0,81%";"420";"6";"1.43";"414";"98,57%";"1.43";1.430
"MULTIPOLYGON (((-58.4206097083661 -34.6006989249381,-58.4197474133875 -34.6007846840675,-58.4191757319551 -34.6008356806248,-58.4191900695253 -34.600943084196,-58.4193396476261 -34.6020499400615,-58.4207823345175 -34.6019081852867,-58.4207593382904 -34.6017392977358,-58.4206097083661 -34.6006989249381)))";;"2623";5_4_2;COMUNA 5;"4";"2";"726";"317";"409";"77,51%";"457";"457";"100,00%";"0";"0,00%";"347";"7";"2.02";"340";"97,98%";"2.02";2.020
"MULTIPOLYGON (((-58.4191757319551 -34.6008356806248,-58.4177940520583 -34.6009589170704,-58.417891741777 -34.6020678683494,-58.4179029180879 -34.6021911165592,-58.4193396476261 -34.6020499400615,-58.4191900695253 -34.600943084196,-58.4191757319551 -34.6008356806248)))";;"2624";5_4_3;COMUNA 5;"4";"3";"703";"318";"385";"82,60%";"369";"368";"99,73%";"1";"0,27%";"319";"10";"3.13";"309";"96,87%";"3.13";3.130
"MULTIPOLYGON (((-58.4177940520583 -34.6009589170704,-58.4163322840069 -34.6014333884218,-58.4165215024405 -34.6024084971476,-58.4166691222104 -34.6023742558535,-58.4179029180879 -34.6021911165592,-58.417891741777 -34.6020678683494,-58.4177940520583 -34.6009589170704)))";;"2625";5_4_4;COMUNA 5;"4";"4";"699";"317";"382";"82,98%";"372";"371";"99,73%";"1";"0,27%";"341";"18";"5.28";"323";"94,72%";"5.28";5.280
"MULTIPOLYGON (((-58.4179029180879 -34.6021911165592,-58.4166691222104 -34.6023742558535,-58.4165215024405 -34.6024084971476,-58.4167172649896 -34.6034172007071,-58.4167465494632 -34.6035983453211,-58.4180316930673 -34.6034689585152,-58.4179985940315 -34.6032487972518,-58.4179029180879 -34.6021911165592)))";;"2626";5_4_5;COMUNA 5;"4";"5";"723";"327";"396";"82,58%";"409";"408";"99,76%";"1";"0,25%";"331";"12";"3.63";"319";"96,37%";"3.63";3.630
"MULTIPOLYGON (((-58.4193396476261 -34.6020499400615,-58.4179029180879 -34.6021911165592,-58.4179985940315 -34.6032487972518,-58.4180316930673 -34.6034689585152,-58.4195102676556 -34.6033201190127,-58.419489993743 -34.6031615847293,-58.4193396476261 -34.6020499400615)))";;"2627";5_4_6;COMUNA 5;"4";"6";"1027";"477";"550";"86,73%";"658";"658";"100,00%";"0";"0,00%";"504";"30";"5.95";"474";"94,05%";"5.95";5.950
"MULTIPOLYGON (((-58.4207823345175 -34.6019081852867,-58.4193396476261 -34.6020499400615,-58.419489993743 -34.6031615847293,-58.4195102676556 -34.6033201190127,-58.4207454896241 -34.6031958269725,-58.4209545109705 -34.6031750528068,-58.4207823345175 -34.6019081852867)))";;"2628";5_4_7;COMUNA 5;"4";"7";"553";"242";"311";"77,81%";"322";"322";"100,00%";"0";"0,00%";"253";"5";"1.98";"248";"98,02%";"1.98";1.980
"MULTIPOLYGON (((-58.4223811406711 -34.6017511124399,-58.4222121552288 -34.6017676768343,-58.4207823345175 -34.6019081852867,-58.4209545109705 -34.6031750528068,-58.4225584524148 -34.6030157962541,-58.4225347676984 -34.6028535992343,-58.4223811406711 -34.6017511124399)))";;"2629";5_4_8;COMUNA 5;"4";"8";"1094";"492";"602";"81,73%";"597";"597";"100,00%";"0";"0,00%";"516";"1";"0.19";"515";"99,81%";"0.19";0.190
"MULTIPOLYGON (((-58.4239210856487 -34.6015999860884,-58.4223811406711 -34.6017511124399,-58.4225347676984 -34.6028535992343,-58.4225584524148 -34.6030157962541,-58.4241029355034 -34.602862485959,-58.4239210856487 -34.6015999860884)))";;"2630";5_4_9;COMUNA 5;"4";"9";"778";"341";"437";"78,03%";"440";"439";"99,77%";"1";"0,23%";"337";"43";"12.76";"294";"87,24%";"12.76";12.760
"MULTIPOLYGON (((-58.4301879911524 -34.5998043538522,-58.4301501897177 -34.599770539662,-58.4297344689337 -34.5998099366155,-58.4299262738053 -34.6008778460106,-58.4299492207129 -34.6010020822613,-58.4311543268513 -34.6008811979602,-58.4310382061634 -34.6007492614427,-58.4302750878436 -34.5998821969106,-58.4301879911524 -34.5998043538522)))";;"2631";5_5_1;COMUNA 5;"5";"1";"784";"336";"448";"75,00%";"414";"414";"100,00%";"0";"0,00%";"348";"3";"0.86";"345";"99,14%";"0.86";0.860
"MULTIPOLYGON (((-58.4311543268513 -34.6008811979602,-58.4299492207129 -34.6010020822613,-58.4301463964112 -34.6020709784975,-58.4301707680643 -34.6022562737162,-58.4310693524738 -34.602164534644,-58.431894941135 -34.6020802356176,-58.4321984913017 -34.6020724242515,-58.4318726827822 -34.6016973985528,-58.4311543268513 -34.6008811979602)))";;"2632";5_5_2;COMUNA 5;"5";"2";"1353";"608";"745";"81,61%";"716";"716";"100,00%";"0";"0,00%";"592";"27";"4.56";"565";"95,44%";"4.56";4.560
"MULTIPOLYGON (((-58.4299492207129 -34.6010020822613,-58.4283848515891 -34.6011591231395,-58.4285418943337 -34.6022230104522,-58.428571368072 -34.6024196458706,-58.4301707680643 -34.6022562737162,-58.4301463964112 -34.6020709784975,-58.4299492207129 -34.6010020822613)))";;"2633";5_5_3;COMUNA 5;"5";"3";"743";"323";"420";"76,90%";"441";"439";"99,55%";"2";"0,46%";"370";"17";"4.59";"353";"95,41%";"4.59";4.590
"MULTIPOLYGON (((-58.4297344689337 -34.5998099366155,-58.4282075157413 -34.5999545905194,-58.4280355543162 -34.599970880443,-58.4267551666413 -34.6000948809456,-58.4267771595691 -34.6002474284679,-58.4269261768194 -34.6013051182302,-58.4271038139033 -34.6025654292882,-58.4283513627795 -34.6024421202016,-58.428571368072 -34.6024196458706,-58.4285418943337 -34.6022230104522,-58.4283848515891 -34.6011591231395,-58.4299492207129 -34.6010020822613,-58.4299262738053 -34.6008778460106,-58.4297344689337 -34.5998099366155)))";;"2634";5_5_4;COMUNA 5;"5";"4";"727";"322";"405";"79,51%";"386";"385";"99,74%";"1";"0,26%";"288";"8";"2.78";"280";"97,22%";"2.78";2.780
"MULTIPOLYGON (((-58.4269261768194 -34.6013051182302,-58.4254636654221 -34.6014486298248,-58.4254801371712 -34.6015633575225,-58.4256446020396 -34.6027097186544,-58.4271038139033 -34.6025654292882,-58.4269261768194 -34.6013051182302)))";;"2635";5_5_5;COMUNA 5;"5";"5";"593";"257";"336";"76,49%";"307";"307";"100,00%";"0";"0,00%";"244";"3";"1.23";"241";"98,77%";"1.23";1.230
"MULTIPOLYGON (((-58.4267551666413 -34.6000948809456,-58.4252899515026 -34.6002367699169,-58.4254636654221 -34.6014486298248,-58.4269261768194 -34.6013051182302,-58.4267771595691 -34.6002474284679,-58.4267551666413 -34.6000948809456)))";;"2636";5_5_6;COMUNA 5;"5";"6";"716";"317";"399";"79,45%";"393";"392";"99,75%";"1";"0,26%";"315";"13";"4.13";"302";"95,87%";"4.13";4.130
"MULTIPOLYGON (((-58.4252899515026 -34.6002367699169,-58.4251112601726 -34.6002540396079,-58.4237474788619 -34.6003884057572,-58.4237649640539 -34.600516021845,-58.4239210856487 -34.6015999860884,-58.4254636654221 -34.6014486298248,-58.4252899515026 -34.6002367699169)))";;"2637";5_5_7;COMUNA 5;"5";"7";"890";"386";"504";"76,59%";"507";"506";"99,80%";"1";"0,20%";"422";"6";"1.42";"416";"98,58%";"1.42";1.420
"MULTIPOLYGON (((-58.4254636654221 -34.6014486298248,-58.4239210856487 -34.6015999860884,-58.4241029355034 -34.602862485959,-58.4248402957914 -34.6027892634947,-58.4256446020396 -34.6027097186544,-58.4254801371712 -34.6015633575225,-58.4254636654221 -34.6014486298248)))";;"2638";5_5_8;COMUNA 5;"5";"8";"710";"322";"388";"82,99%";"427";"427";"100,00%";"0";"0,00%";"324";"12";"3.7";"312";"96,30%";"3.7";3.700
"MULTIPOLYGON (((-58.4321984913017 -34.6020724242515,-58.431894941135 -34.6020802356176,-58.4321452577216 -34.6039384673912,-58.4323301705341 -34.6039281610538,-58.4333341121189 -34.602673429842,-58.4331418295864 -34.602578591092,-58.4322406282471 -34.6021337751335,-58.4321984913017 -34.6020724242515)))";;"2639";5_6_1;COMUNA 5;"6";"1";"740";"330";"410";"80,49%";"361";"361";"100,00%";"0";"0,00%";"304";"0";"0";"304";"100,00%";"0";0.000
"MULTIPOLYGON (((-58.431894941135 -34.6020802356176,-58.4310693524738 -34.602164534644,-58.4313148956282 -34.603984596402,-58.4321452577216 -34.6039384673912,-58.431894941135 -34.6020802356176)))";;"2640";5_6_2;COMUNA 5;"6";"2";"991";"452";"539";"83,86%";"507";"507";"100,00%";"0";"0,00%";"437";"4";"0.92";"433";"99,08%";"0.92";0.920
"MULTIPOLYGON (((-58.4310693524738 -34.602164534644,-58.4301707680643 -34.6022562737162,-58.4301973475977 -34.602458682837,-58.4304106865562 -34.6040348553272,-58.4313148956282 -34.603984596402,-58.4310693524738 -34.602164534644)))";;"2641";5_6_3;COMUNA 5;"6";"3";"877";"369";"508";"72,64%";"553";"553";"100,00%";"0";"0,00%";"438";"3";"0.68";"435";"99,32%";"0.68";0.680
"MULTIPOLYGON (((-58.4301707680643 -34.6022562737162,-58.428571368072 -34.6024196458706,-58.4288261887529 -34.6041228093353,-58.4304106865562 -34.6040348553272,-58.4301973475977 -34.602458682837,-58.4301707680643 -34.6022562737162)))";;"2642";5_6_4;COMUNA 5;"6";"4";"1481";"677";"804";"84,20%";"824";"824";"100,00%";"0";"0,00%";"660";"6";"0.91";"654";"99,09%";"0.91";0.910
"MULTIPOLYGON (((-58.428571368072 -34.6024196458706,-58.4283513627795 -34.6024421202016,-58.4271038139033 -34.6025654292882,-58.4272242228295 -34.6034200036887,-58.4272431591695 -34.6035540283308,-58.4273369111208 -34.6042094323207,-58.4286445117211 -34.6041328999895,-58.4288261887529 -34.6041228093353,-58.428571368072 -34.6024196458706)))";;"2643";5_6_5;COMUNA 5;"6";"5";"1134";"494";"640";"77,19%";"692";"692";"100,00%";"0";"0,00%";"558";"7";"1.25";"551";"98,75%";"1.25";1.250
"MULTIPOLYGON (((-58.4288261887529 -34.6041228093353,-58.4286445117211 -34.6041328999895,-58.4273369111208 -34.6042094323207,-58.4274524045522 -34.6050171016773,-58.4274643762502 -34.6051064746791,-58.4287364717103 -34.6050342974803,-58.4289590393654 -34.6050107667977,-58.4290626998028 -34.6049998090921,-58.4305310333958 -34.6049228782113,-58.4304294558754 -34.6041738796067,-58.4304106865562 -34.6040348553272,-58.4288261887529 -34.6041228093353)))";;"2644";5_6_6;COMUNA 5;"6";"6";"907";"428";"479";"89,35%";"473";"473";"100,00%";"0";"0,00%";"407";"6";"1.47";"401";"98,53%";"1.47";1.470
"MULTIPOLYGON (((-58.4289590393654 -34.6050107667977,-58.4287364717103 -34.6050342974803,-58.4274643762502 -34.6051064746791,-58.4275762811885 -34.6059465383388,-58.4290986885005 -34.6059440092391,-58.4306691341148 -34.6059413329139,-58.4305310333958 -34.6049228782113,-58.4290626998028 -34.6049998090921,-58.4289590393654 -34.6050107667977)))";;"2645";5_6_7;COMUNA 5;"6";"7";"894";"418";"476";"87,82%";"535";"535";"100,00%";"0";"0,00%";"418";"25";"5.98";"393";"94,02%";"5.98";5.980
"MULTIPOLYGON (((-58.4323301705341 -34.6039281610538,-58.4321452577216 -34.6039384673912,-58.4313148956282 -34.603984596402,-58.4304106865562 -34.6040348553272,-58.4304294558754 -34.6041738796067,-58.4305310333958 -34.6049228782113,-58.4306691341148 -34.6059413329139,-58.4315295122246 -34.6049437719506,-58.4323301705341 -34.6039281610538)))";;"2646";5_6_8;COMUNA 5;"6";"8";"922";"424";"498";"85,14%";"491";"491";"100,00%";"0";"0,00%";"385";"1";"0.26";"384";"99,74%";"0.26";0.260
"MULTIPOLYGON (((-58.4256446020396 -34.6027097186544,-58.4248402957914 -34.6027892634947,-58.4241029355034 -34.602862485959,-58.4241299332977 -34.6030498959425,-58.4243395565514 -34.6044958615306,-58.4256862990386 -34.6043283838747,-58.4258742830164 -34.6043106231847,-58.425856536486 -34.604187092059,-58.425766871003 -34.6035620414268,-58.4256446020396 -34.6027097186544)))";;"2647";5_7_1;COMUNA 5;"7";"1";"1206";"531";"675";"78,67%";"659";"657";"99,70%";"2";"0,30%";"529";"3";"0.57";"526";"99,43%";"0.57";0.570
"MULTIPOLYGON (((-58.4271038139033 -34.6025654292882,-58.4256446020396 -34.6027097186544,-58.425766871003 -34.6035620414268,-58.4272242228295 -34.6034200036887,-58.4271038139033 -34.6025654292882)))";;"2648";5_7_2;COMUNA 5;"7";"2";"538";"227";"311";"72,99%";"237";"237";"100,00%";"0";"0,00%";"222";"25";"11.26";"197";"88,74%";"11.26";11.260
"MULTIPOLYGON (((-58.4272242228295 -34.6034200036887,-58.425766871003 -34.6035620414268,-58.425856536486 -34.604187092059,-58.4258742830164 -34.6043106231847,-58.4260308369074 -34.6042958106211,-58.4271911772377 -34.6042179114434,-58.4273369111208 -34.6042094323207,-58.4272431591695 -34.6035540283308,-58.4272242228295 -34.6034200036887)))";;"2649";5_7_3;COMUNA 5;"7";"3";"640";"274";"366";"74,86%";"343";"343";"100,00%";"0";"0,00%";"276";"17";"6.16";"259";"93,84%";"6.16";6.160
"MULTIPOLYGON (((-58.4273369111208 -34.6042094323207,-58.4271911772377 -34.6042179114434,-58.4260308369074 -34.6042958106211,-58.4258742830164 -34.6043106231847,-58.4261112785254 -34.605955403935,-58.4274372765512 -34.605946779945,-58.4275762811885 -34.6059465383388,-58.4274643762502 -34.6051064746791,-58.4274524045522 -34.6050171016773,-58.4273369111208 -34.6042094323207)))";;"2650";5_7_4;COMUNA 5;"7";"4";"1364";"602";"762";"79,00%";"739";"736";"99,59%";"3";"0,41%";"605";"23";"3.8";"582";"96,20%";"3.8";3.800
"MULTIPOLYGON (((-58.4258742830164 -34.6043106231847,-58.4256862990386 -34.6043283838747,-58.4243395565514 -34.6044958615306,-58.4245520740863 -34.6059612646676,-58.4254280078253 -34.6059599156106,-58.4261112785254 -34.605955403935,-58.4258742830164 -34.6043106231847)))";;"2651";5_7_5;COMUNA 5;"7";"5";"1295";"556";"739";"75,24%";"824";"822";"99,76%";"2";"0,24%";"618";"28";"4.53";"590";"95,47%";"4.53";4.530
"MULTIPOLYGON (((-58.4243395565514 -34.6044958615306,-58.422802094855 -34.6046871362351,-58.4228124539009 -34.6060010619806,-58.4229691752787 -34.6060000567369,-58.4243496144961 -34.6059615533253,-58.4245520740863 -34.6059612646676,-58.4243395565514 -34.6044958615306)))";;"2652";5_7_6;COMUNA 5;"7";"6";"627";"268";"359";"74,65%";"362";"360";"99,45%";"2";"0,56%";"300";"40";"13.33";"260";"86,67%";"13.33";13.330
"MULTIPOLYGON (((-58.4229138880771 -34.6072689591295,-58.4229218507958 -34.6073607961151,-58.4230277283027 -34.6084268559101,-58.4230359082726 -34.6085996818422,-58.4246767448998 -34.6086307687408,-58.4246822093158 -34.6084151991152,-58.4246276214295 -34.6072726046282,-58.4261801162253 -34.6072787836317,-58.427034171613 -34.607282134983,-58.4275516131947 -34.6072841866223,-58.427662259924 -34.6072759082796,-58.4275928379286 -34.6060707026638,-58.4275762811885 -34.6059465383388,-58.4274372765512 -34.605946779945,-58.4261112785254 -34.605955403935,-58.4254280078253 -34.6059599156106,-58.4245520740863 -34.6059612646676,-58.4243496144961 -34.6059615533253,-58.4229691752787 -34.6060000567369,-58.4228124539009 -34.6060010619806,-58.4228146964303 -34.6061206446348,-58.4229138880771 -34.6072689591295)))";;"2653";5_7_7;COMUNA 5;"7";"7";"894";"417";"477";"87,42%";"262";"260";"99,24%";"2";"0,77%";"196";"20";"10.2";"176";"89,80%";"10.2";10.200
"MULTIPOLYGON (((-58.427662259924 -34.6072759082796,-58.4275516131947 -34.6072841866223,-58.427034171613 -34.607282134983,-58.4261801162253 -34.6072787836317,-58.4246276214295 -34.6072726046282,-58.4246822093158 -34.6084151991152,-58.4246767448998 -34.6086307687408,-58.424877846251 -34.6086346342043,-58.4262469679621 -34.6086686437332,-58.4270282894567 -34.6086880303067,-58.4277390013748 -34.6087028140307,-58.427662259924 -34.6072759082796)))";;"2654";5_7_8;COMUNA 5;"7";"8";"909";"393";"516";"76,16%";"475";"473";"99,58%";"2";"0,42%";"394";"42";"10.66";"352";"89,34%";"10.66";10.660
"MULTIPOLYGON (((-58.4241029355034 -34.602862485959,-58.4225584524148 -34.6030157962541,-58.422802094855 -34.6046871362351,-58.4243395565514 -34.6044958615306,-58.4241299332977 -34.6030498959425,-58.4241029355034 -34.602862485959)))";;"2655";5_8_1;COMUNA 5;"8";"1";"1171";"525";"646";"81,27%";"656";"656";"100,00%";"0";"0,00%";"547";"68";"12.43";"479";"87,57%";"12.43";12.430
"MULTIPOLYGON (((-58.4225584524148 -34.6030157962541,-58.4209545109705 -34.6031750528068,-58.4211877936264 -34.6048909011202,-58.4213692253219 -34.604865398375,-58.422802094855 -34.6046871362351,-58.4225584524148 -34.6030157962541)))";;"2656";5_8_2;COMUNA 5;"8";"2";"703";"307";"396";"77,53%";"436";"436";"100,00%";"0";"0,00%";"320";"9";"2.81";"311";"97,19%";"2.81";2.810
"MULTIPOLYGON (((-58.4209545109705 -34.6031750528068,-58.4207454896241 -34.6031958269725,-58.4195102676556 -34.6033201190127,-58.4196433651007 -34.6043603460245,-58.4197373582696 -34.6050947024469,-58.4211877936264 -34.6048909011202,-58.4209545109705 -34.6031750528068)))";;"2657";5_8_3;COMUNA 5;"8";"3";"1180";"524";"656";"79,88%";"634";"634";"100,00%";"0";"0,00%";"504";"5";"0.99";"499";"99,01%";"0.99";0.990
"MULTIPOLYGON (((-58.4211877936264 -34.6048909011202,-58.4197373582696 -34.6050947024469,-58.4198543427653 -34.6060092143452,-58.4212954929606 -34.6060108387084,-58.4212080757716 -34.6050402093833,-58.4211877936264 -34.6048909011202)))";;"2658";5_8_4;COMUNA 5;"8";"4";"990";"418";"572";"73,08%";"552";"549";"99,46%";"3";"0,55%";"454";"22";"4.85";"432";"95,15%";"4.85";4.850
"MULTIPOLYGON (((-58.422802094855 -34.6046871362351,-58.4213692253219 -34.604865398375,-58.4211877936264 -34.6048909011202,-58.4212080757716 -34.6050402093833,-58.4212954929606 -34.6060108387084,-58.4228124539009 -34.6060010619806,-58.422802094855 -34.6046871362351)))";;"2659";5_8_5;COMUNA 5;"8";"5";"401";"192";"209";"91,87%";"220";"220";"100,00%";"0";"0,00%";"175";"5";"2.86";"170";"97,14%";"2.86";2.860
"MULTIPOLYGON (((-58.4228124539009 -34.6060010619806,-58.4212954929606 -34.6060108387084,-58.4213418281392 -34.6065255918945,-58.4213576737875 -34.6066911667991,-58.4214129225219 -34.607267826624,-58.4216057609564 -34.6072664832233,-58.4229138880771 -34.6072689591295,-58.4228146964303 -34.6061206446348,-58.4228124539009 -34.6060010619806)))";;"2660";5_8_6;COMUNA 5;"8";"6";"896";"364";"532";"68,42%";"474";"472";"99,58%";"2";"0,42%";"394";"15";"3.81";"379";"96,19%";"3.81";3.810
"MULTIPOLYGON (((-58.4199176136218 -34.6067002481713,-58.4199624604665 -34.6072778909526,-58.4214129225219 -34.607267826624,-58.4213576737875 -34.6066911667991,-58.4213418281392 -34.6065255918945,-58.4212954929606 -34.6060108387084,-58.4198543427653 -34.6060092143452,-58.4198786052448 -34.606198948239,-58.4199176136218 -34.6067002481713)))";;"2661";5_8_7;COMUNA 5;"8";"7";"855";"362";"493";"73,43%";"496";"495";"99,80%";"1";"0,20%";"399";"1";"0.25";"398";"99,75%";"0.25";0.250
"MULTIPOLYGON (((-58.4214129225219 -34.607267826624,-58.4199624604665 -34.6072778909526,-58.4200608729517 -34.6085432538289,-58.421537828237 -34.6085712972775,-58.4214129225219 -34.607267826624)))";;"2662";5_8_8;COMUNA 5;"8";"8";"834";"375";"459";"81,70%";"449";"448";"99,78%";"1";"0,22%";"353";"12";"3.4";"341";"96,60%";"3.4";3.400
"MULTIPOLYGON (((-58.4229138880771 -34.6072689591295,-58.4216057609564 -34.6072664832233,-58.4214129225219 -34.607267826624,-58.421537828237 -34.6085712972775,-58.4230359082726 -34.6085996818422,-58.4230277283027 -34.6084268559101,-58.4229218507958 -34.6073607961151,-58.4229138880771 -34.6072689591295)))";;"2663";5_8_9;COMUNA 5;"8";"9";"767";"326";"441";"73,92%";"401";"400";"99,75%";"1";"0,25%";"333";"17";"5.11";"316";"94,89%";"5.11";5.110
"MULTIPOLYGON (((-58.4195102676556 -34.6033201190127,-58.4180316930673 -34.6034689585152,-58.4180885563081 -34.6038464583151,-58.4182162012059 -34.6045382914588,-58.4196433651007 -34.6043603460245,-58.4195102676556 -34.6033201190127)))";;"2664";5_9_1;COMUNA 5;"9";"1";"1082";"475";"607";"78,25%";"569";"568";"99,82%";"1";"0,18%";"472";"0";"0";"472";"100,00%";"0";0.000
"MULTIPOLYGON (((-58.4199624604665 -34.6072778909526,-58.4186647187009 -34.60728686645,-58.4187886720198 -34.6085381545325,-58.4198765517362 -34.6085397384422,-58.4200608729517 -34.6085432538289,-58.4199624604665 -34.6072778909526)))";;"2665";5_9_10;COMUNA 5;"9";"10";"806";"361";"445";"81,12%";"390";"390";"100,00%";"0";"0,00%";"341";"5";"1.47";"336";"98,53%";"1.47";1.470
"MULTIPOLYGON (((-58.4180316930673 -34.6034689585152,-58.4167465494632 -34.6035983453211,-58.4169242101778 -34.6046993689382,-58.4182162012059 -34.6045382914588,-58.4180885563081 -34.6038464583151,-58.4180316930673 -34.6034689585152)))";;"2666";5_9_2;COMUNA 5;"9";"2";"601";"255";"346";"73,70%";"366";"366";"100,00%";"0";"0,00%";"287";"2";"0.7";"285";"99,30%";"0.7";0.700
"MULTIPOLYGON (((-58.4182162012059 -34.6045382914588,-58.4169242101778 -34.6046993689382,-58.4170524720699 -34.6054936016203,-58.4181913485859 -34.6053029589062,-58.4183533604762 -34.6052812565214,-58.4182162012059 -34.6045382914588)))";;"2667";5_9_3;COMUNA 5;"9";"3";"575";"259";"316";"81,96%";"341";"341";"100,00%";"0";"0,00%";"268";"2";"0.75";"266";"99,25%";"0.75";0.750
"MULTIPOLYGON (((-58.4196433651007 -34.6043603460245,-58.4182162012059 -34.6045382914588,-58.4183533604762 -34.6052812565214,-58.4195619733335 -34.6051193598002,-58.4197373582696 -34.6050947024469,-58.4196433651007 -34.6043603460245)))";;"2668";5_9_4;COMUNA 5;"9";"4";"526";"216";"310";"69,68%";"297";"297";"100,00%";"0";"0,00%";"232";"1";"0.43";"231";"99,57%";"0.43";0.430
"MULTIPOLYGON (((-58.4199176136218 -34.6067002481713,-58.4198786052448 -34.606198948239,-58.4198543427653 -34.6060092143452,-58.4197373582696 -34.6050947024469,-58.4195619733335 -34.6051193598002,-58.4183533604762 -34.6052812565214,-58.4185966013585 -34.6065985768738,-58.4186144775859 -34.6067796463976,-58.4186647187009 -34.60728686645,-58.4199624604665 -34.6072778909526,-58.4199176136218 -34.6067002481713)))";;"2669";5_9_5;COMUNA 5;"9";"5";"576";"268";"308";"87,01%";"335";"335";"100,00%";"0";"0,00%";"260";"24";"9.23";"236";"90,77%";"9.23";9.230
"MULTIPOLYGON (((-58.4183533604762 -34.6052812565214,-58.4181913485859 -34.6053029589062,-58.4170524720699 -34.6054936016203,-58.4172577296237 -34.60676548615,-58.4172750385852 -34.6068881027798,-58.4186144775859 -34.6067796463976,-58.4185966013585 -34.6065985768738,-58.4183533604762 -34.6052812565214)))";;"2670";5_9_6;COMUNA 5;"9";"6";"572";"266";"306";"86,93%";"311";"311";"100,00%";"0";"0,00%";"245";"9";"3.67";"236";"96,33%";"3.67";3.670
"MULTIPOLYGON (((-58.4170524720699 -34.6054936016203,-58.416870438731 -34.6055240979036,-58.4160283277746 -34.605670051754,-58.4162873888877 -34.6069636493873,-58.4164244426904 -34.6069517291702,-58.4172750385852 -34.6068881027798,-58.4172577296237 -34.60676548615,-58.4170524720699 -34.6054936016203)))";;"2671";5_9_7;COMUNA 5;"9";"7";"485";"215";"270";"79,63%";"307";"307";"100,00%";"0";"0,00%";"220";"4";"1.82";"216";"98,18%";"1.82";1.820
"MULTIPOLYGON (((-58.4172750385852 -34.6068881027798,-58.4164244426904 -34.6069517291702,-58.4162873888877 -34.6069636493873,-58.4160650536564 -34.6085362283639,-58.4162344680204 -34.6085410114848,-58.4175068277919 -34.6085370793211,-58.4172750385852 -34.6068881027798)))";;"2672";5_9_8;COMUNA 5;"9";"8";"941";"416";"525";"79,24%";"549";"549";"100,00%";"0";"0,00%";"454";"3";"0.66";"451";"99,34%";"0.66";0.660
"MULTIPOLYGON (((-58.4186144775859 -34.6067796463976,-58.4172750385852 -34.6068881027798,-58.4175068277919 -34.6085370793211,-58.4185054587663 -34.6085377001484,-58.4187886720198 -34.6085381545325,-58.4186647187009 -34.60728686645,-58.4186144775859 -34.6067796463976)))";;"2673";5_9_9;COMUNA 5;"9";"9";"924";"439";"485";"90,52%";"524";"524";"100,00%";"0";"0,00%";"438";"49";"11.19";"389";"88,81%";"11.19";11.190
"MULTIPOLYGON (((-58.4627046538459 -34.6073729848495,-58.4625100274186 -34.6072419939201,-58.4621505024981 -34.6069978288233,-58.4615404818497 -34.6065835837754,-58.460861358678 -34.607620937946,-58.4614865457568 -34.6079800435835,-58.4607712948075 -34.6090381720641,-58.4599359180097 -34.6102739056531,-58.4608640190255 -34.6105868219367,-58.4610748357344 -34.6106660531792,-58.4616406103216 -34.6095229188694,-58.4621929112938 -34.6084069657696,-58.4627046538459 -34.6073729848495)))";;"2674";6_1_1;COMUNA 6;"1";"1";"677";"322";"355";"90,70%";"253";"253";"100,00%";"0";"0,00%";"242";"14";"5.79";"228";"94,21%";"5.79";5.790
"MULTIPOLYGON (((-58.4574629260466 -34.6102207944499,-58.4567656676002 -34.6112135453295,-58.4579153914546 -34.6117742500797,-58.4570746687521 -34.6129346788938,-58.4573283326463 -34.6130368771255,-58.459195822296 -34.6137895074708,-58.4594483842544 -34.6138856446923,-58.4595438792337 -34.6137419096196,-58.4600362644989 -34.6127561814814,-58.4604853642341 -34.6118569324401,-58.4605526602413 -34.6117210132009,-58.4610748357344 -34.6106660531792,-58.4608640190255 -34.6105868219367,-58.4599359180097 -34.6102739056531,-58.4591804781949 -34.6100199332221,-58.4581357911563 -34.6095188238641,-58.4579993394877 -34.6094569149973,-58.4574629260466 -34.6102207944499)))";;"2675";6_1_10;COMUNA 6;"1";"10";"620";"272";"348";"78,16%";"180";"178";"98,89%";"2";"1,12%";"145";"1";"0.69";"144";"99,31%";"0.69";0.690
"MULTIPOLYGON (((-58.4556621244149 -34.6106752979775,-58.4555771904736 -34.6107958608395,-58.4547542470952 -34.6119639512209,-58.4553557687988 -34.6122248434688,-58.455536430473 -34.6123031669148,-58.4558964778313 -34.612451150644,-58.4567656676002 -34.6112135453295,-58.4574629260466 -34.6102207944499,-58.4579993394877 -34.6094569149973,-58.457845597368 -34.6093871881015,-58.4570385628544 -34.6090074914494,-58.456886781496 -34.60893705918,-58.4563533429503 -34.6096943139991,-58.4556621244149 -34.6106752979775)))";;"2676";6_1_11;COMUNA 6;"1";"11";"675";"309";"366";"84,43%";"316";"316";"100,00%";"0";"0,00%";"253";"2";"0.79";"251";"99,21%";"0.79";0.790
"MULTIPOLYGON (((-58.4579153914546 -34.6117742500797,-58.4567656676002 -34.6112135453295,-58.4558964778313 -34.612451150644,-58.4569474111481 -34.6128833330717,-58.4570746687521 -34.6129346788938,-58.4579153914546 -34.6117742500797)))";;"2677";6_1_12;COMUNA 6;"1";"12";"622";"273";"349";"78,22%";"325";"325";"100,00%";"0";"0,00%";"292";"15";"5.14";"277";"94,86%";"5.14";5.140
"MULTIPOLYGON (((-58.4596535615486 -34.6053039963914,-58.4595130285781 -34.6052089892405,-58.4585643834251 -34.6065557012578,-58.4596751313905 -34.6070765278873,-58.4606951817667 -34.6075548765397,-58.460861358678 -34.607620937946,-58.4615404818497 -34.6065835837754,-58.4605130340719 -34.6058858675878,-58.4603105787193 -34.6057483938619,-58.4596535615486 -34.6053039963914)))";;"2678";6_1_2;COMUNA 6;"1";"2";"824";"384";"440";"87,27%";"386";"386";"100,00%";"0";"0,00%";"345";"2";"0.58";"343";"99,42%";"0.58";0.580
"MULTIPOLYGON (((-58.4595130285781 -34.6052089892405,-58.4587824326416 -34.6047148649183,-58.4584739469889 -34.6044918180705,-58.4574542531614 -34.6059138740627,-58.4573885779986 -34.6060043675608,-58.4585643834251 -34.6065557012578,-58.4595130285781 -34.6052089892405)))";;"2679";6_1_3;COMUNA 6;"1";"3";"888";"400";"488";"81,97%";"429";"428";"99,77%";"1";"0,23%";"347";"2";"0.58";"345";"99,42%";"0.58";0.580
"MULTIPOLYGON (((-58.4562144917685 -34.6054507689697,-58.4554423013769 -34.6064790737651,-58.4565141906038 -34.6069759823059,-58.4566405014254 -34.6070352161995,-58.4573885779986 -34.6060043675608,-58.4574542531614 -34.6059138740627,-58.4584739469889 -34.6044918180705,-58.4580801020557 -34.6045927935066,-58.4565633128438 -34.6049862625556,-58.4558033797138 -34.6051834124635,-58.4562144917685 -34.6054507689697)))";;"2680";6_1_4;COMUNA 6;"1";"4";"698";"316";"382";"82,72%";"332";"331";"99,70%";"1";"0,30%";"274";"7";"2.55";"267";"97,45%";"2.55";2.550
"MULTIPOLYGON (((-58.452958836664 -34.6059231053721,-58.452428268855 -34.6060604613586,-58.4520150738248 -34.6061672608486,-58.4522633379091 -34.6063255981041,-58.4524100817348 -34.6064249100461,-58.4525534191949 -34.6065218974965,-58.4532244611107 -34.6069747147932,-58.4533350104407 -34.6070490218665,-58.454466934261 -34.605913709057,-58.4554423013769 -34.6064790737651,-58.4562144917685 -34.6054507689697,-58.4558033797138 -34.6051834124635,-58.4555246003864 -34.6052557230425,-58.4549823718974 -34.6053967515738,-58.4540018246167 -34.6056517655838,-58.4530692259189 -34.605894310242,-58.452958836664 -34.6059231053721)))";;"2681";6_1_5;COMUNA 6;"1";"5";"1124";"499";"625";"79,84%";"550";"549";"99,82%";"1";"0,18%";"431";"23";"5.34";"408";"94,66%";"5.34";5.340
"MULTIPOLYGON (((-58.4566405014254 -34.6070352161995,-58.4565141906038 -34.6069759823059,-58.4554423013769 -34.6064790737651,-58.454466934261 -34.605913709057,-58.4533350104407 -34.6070490218665,-58.4544515015711 -34.6077995528509,-58.4556703253847 -34.6083721151432,-58.4566405014254 -34.6070352161995)))";;"2682";6_1_6;COMUNA 6;"1";"6";"938";"439";"499";"87,98%";"428";"427";"99,77%";"1";"0,23%";"348";"3";"0.86";"345";"99,14%";"0.86";0.860
"MULTIPOLYGON (((-58.4585643834251 -34.6065557012578,-58.4573885779986 -34.6060043675608,-58.4566405014254 -34.6070352161995,-58.4556703253847 -34.6083721151432,-58.456886781496 -34.60893705918,-58.4578327549581 -34.6075943044363,-58.4585643834251 -34.6065557012578)))";;"2683";6_1_7;COMUNA 6;"1";"7";"692";"316";"376";"84,04%";"301";"301";"100,00%";"0";"0,00%";"260";"5";"1.92";"255";"98,08%";"1.92";1.920
"MULTIPOLYGON (((-58.4614865457568 -34.6079800435835,-58.460861358678 -34.607620937946,-58.4606951817667 -34.6075548765397,-58.4596751313905 -34.6070765278873,-58.4585643834251 -34.6065557012578,-58.4578327549581 -34.6075943044363,-58.4579876008887 -34.6076669188424,-58.4588154096805 -34.6080495678193,-58.4589443641215 -34.6081113347068,-58.459070082106 -34.6081716224331,-58.4601416737674 -34.6086757527496,-58.4607712948075 -34.6090381720641,-58.4614865457568 -34.6079800435835)))";;"2684";6_1_8;COMUNA 6;"1";"8";"871";"379";"492";"77,03%";"369";"368";"99,73%";"1";"0,27%";"310";"18";"5.81";"292";"94,19%";"5.81";5.810
"MULTIPOLYGON (((-58.4601416737674 -34.6086757527496,-58.459070082106 -34.6081716224331,-58.4589443641215 -34.6081113347068,-58.4588154096805 -34.6080495678193,-58.4579876008887 -34.6076669188424,-58.4578327549581 -34.6075943044363,-58.456886781496 -34.60893705918,-58.4570385628544 -34.6090074914494,-58.457845597368 -34.6093871881015,-58.4579993394877 -34.6094569149973,-58.4581357911563 -34.6095188238641,-58.4591804781949 -34.6100199332221,-58.4599359180097 -34.6102739056531,-58.4607712948075 -34.6090381720641,-58.4601416737674 -34.6086757527496)))";;"2685";6_1_9;COMUNA 6;"1";"9";"715";"353";"362";"97,51%";"230";"229";"99,57%";"1";"0,44%";"227";"7";"3.08";"220";"96,92%";"3.08";3.080
"MULTIPOLYGON (((-58.4450556535738 -34.6198159411088,-58.4450880403641 -34.6196694817616,-58.4451430379218 -34.6194270163842,-58.4446930034347 -34.6193605400001,-58.4441495367826 -34.6192116505193,-58.4441923259489 -34.6190997516726,-58.4441987195648 -34.6190793293883,-58.4442121894602 -34.6190332030461,-58.4437534995738 -34.6188308720243,-58.4436640618225 -34.6187908566913,-58.443532034815 -34.6187318198532,-58.4425686685741 -34.6183036918324,-58.4424024010454 -34.618232042033,-58.4422785522792 -34.6185268205051,-58.4422782155669 -34.6185266863959,-58.4422033991905 -34.6187041264024,-58.4421927157701 -34.6187294639201,-58.4421926637431 -34.6187295453399,-58.4421926085149 -34.6187296317692,-58.4420076697979 -34.6191616563819,-58.4419573782015 -34.6192853141622,-58.4420822496971 -34.6193422387395,-58.4431894930038 -34.6198377199314,-58.4433204139367 -34.6198973203541,-58.4438247637303 -34.6201266328189,-58.4439644606446 -34.6201834873302,-58.4441269011123 -34.620249711671,-58.4446873989221 -34.6204605777431,-58.4448852766558 -34.6205388489731,-58.4450065248686 -34.6200248345425,-58.4450556535738 -34.6198159411088)))";;"2686";6_10_1;COMUNA 6;"10";"1";"604";"256";"348";"73,56%";"391";"391";"100,00%";"0";"0,00%";"303";"2";"0.66";"301";"99,34%";"0.66";0.660
"MULTIPOLYGON (((-58.4448852766558 -34.6205388489731,-58.4446873989221 -34.6204605777431,-58.4441269011123 -34.620249711671,-58.4439644606446 -34.6201834873302,-58.4435349173873 -34.62138592738,-58.4443522411359 -34.621728881878,-58.4447943840337 -34.6209153981144,-58.4448469060655 -34.62070427168,-58.4448852766558 -34.6205388489731)))";;"2687";6_10_10;COMUNA 6;"10";"10";"943";"399";"544";"73,35%";"616";"616";"100,00%";"0";"0,00%";"463";"2";"0.43";"461";"99,57%";"0.43";0.430
"MULTIPOLYGON (((-58.4421926085149 -34.6187296317692,-58.442192639665 -34.618729644416,-58.4421926876852 -34.6187294468232,-58.4421926085149 -34.6187296317692)),((-58.4421244054156 -34.6187019416261,-58.4416805369999 -34.6185312965583,-58.4414030279838 -34.6184103286669,-58.4412014979472 -34.618322684591,-58.4410365096897 -34.6182497655054,-58.4409562719 -34.6182179895449,-58.4407456387798 -34.6187357165708,-58.4408956366254 -34.618801450014,-58.4419573782015 -34.6192853141622,-58.4420076697979 -34.6191616563819,-58.4421926085149 -34.6187296317692,-58.4421244054156 -34.6187019416261)))";;"2688";6_10_2;COMUNA 6;"10";"2";"564";"222";"342";"64,91%";"382";"382";"100,00%";"0";"0,00%";"288";"3";"1.04";"285";"98,96%";"1.04";1.040
"MULTIPOLYGON (((-58.4404250604619 -34.6159335872191,-58.439056654468 -34.6159384002954,-58.4389982601911 -34.6160891689935,-58.4387529387657 -34.6166456902118,-58.4386134042959 -34.6169439832096,-58.4385872382299 -34.6169927121665,-58.4385910656524 -34.6169944268181,-58.4385009800375 -34.617203584607,-58.4385780828354 -34.617185586881,-58.4386917769724 -34.6172330934317,-58.4389674044831 -34.6173525177955,-58.4389599028017 -34.6173711789697,-58.4394351843302 -34.6175735312252,-58.4395345845787 -34.6176170023846,-58.4396077509995 -34.6176480032694,-58.4396733401702 -34.6176635091737,-58.4397219764511 -34.6176820401271,-58.4397914812428 -34.6177084625848,-58.4401974311012 -34.6178876289872,-58.4405105401184 -34.6180256489674,-58.4408602762279 -34.6181800133093,-58.4409562719 -34.6182179895449,-58.4410365096897 -34.6182497655054,-58.4412014979472 -34.618322684591,-58.4414030279838 -34.6184103286669,-58.4416805369999 -34.6185312965583,-58.4421244054156 -34.6187019416261,-58.4421927157701 -34.6187294639201,-58.4422033991905 -34.6187041264024,-58.4422782155669 -34.6185266863959,-58.4422785522792 -34.6185268205051,-58.4424024010454 -34.618232042033,-58.4419019809426 -34.6180198375705,-58.4413806006515 -34.6171681680966,-58.4406305238562 -34.6159401740906,-58.4405642508341 -34.6159380493322,-58.4404250604619 -34.6159335872191)))";;"2689";6_10_3;COMUNA 6;"10";"3";"791";"352";"439";"80,18%";"465";"465";"100,00%";"0";"0,00%";"383";"5";"1.31";"378";"98,69%";"1.31";1.310
"MULTIPOLYGON (((-58.4395160257867 -34.6181872303018,-58.4406226424255 -34.6186818192351,-58.4407456387798 -34.6187357165708,-58.4409562719 -34.6182179895449,-58.4408602762279 -34.6181800133093,-58.4405105401184 -34.6180256489674,-58.4401974311012 -34.6178876289872,-58.4397914812428 -34.6177084625848,-58.4397219764511 -34.6176820401271,-58.4396733401702 -34.6176635091737,-58.4396077509995 -34.6176480032694,-58.4395345845787 -34.6176170023846,-58.4394351843302 -34.6175735312252,-58.4389599028017 -34.6173711789697,-58.4389674044831 -34.6173525177955,-58.4386917769724 -34.6172330934317,-58.4385780828354 -34.617185586881,-58.4385009800375 -34.617203584607,-58.4384857089028 -34.617207149266,-58.4384975592723 -34.6172120683952,-58.4383027835282 -34.6176428899449,-58.4384314826535 -34.6177025656151,-58.4395160257867 -34.6181872303018)))";;"2690";6_10_4;COMUNA 6;"10";"4";"712";"305";"407";"74,94%";"414";"414";"100,00%";"0";"0,00%";"337";"20";"5.93";"317";"94,07%";"5.93";5.930
"MULTIPOLYGON (((-58.4395160257867 -34.6181872303018,-58.4384314826535 -34.6177025656151,-58.4383027835282 -34.6176428899449,-58.4377465747139 -34.6188732434345,-58.4390138353137 -34.619435839794,-58.4390641275128 -34.6193257752583,-58.4395160257867 -34.6181872303018)))";;"2691";6_10_5;COMUNA 6;"10";"5";"959";"421";"538";"78,25%";"565";"565";"100,00%";"0";"0,00%";"461";"4";"0.87";"457";"99,13%";"0.87";0.870
"MULTIPOLYGON (((-58.4407456387798 -34.6187357165708,-58.4406226424255 -34.6186818192351,-58.4395160257867 -34.6181872303018,-58.4390641275128 -34.6193257752583,-58.4390138353137 -34.619435839794,-58.4402507042969 -34.6199848957511,-58.4407456387798 -34.6187357165708)))";;"2692";6_10_6;COMUNA 6;"10";"6";"956";"400";"556";"71,94%";"591";"591";"100,00%";"0";"0,00%";"455";"3";"0.66";"452";"99,34%";"0.66";0.660
"MULTIPOLYGON (((-58.4419573782015 -34.6192853141622,-58.4408956366254 -34.618801450014,-58.4407456387798 -34.6187357165708,-58.4402507042969 -34.6199848957511,-58.4412098193167 -34.6204102242114,-58.4414626336296 -34.6205162581078,-58.4416453112495 -34.6200526115756,-58.4419573782015 -34.6192853141622)))";;"2693";6_10_7;COMUNA 6;"10";"7";"592";"243";"349";"69,63%";"478";"478";"100,00%";"0";"0,00%";"335";"2";"0.6";"333";"99,40%";"0.6";0.600
"MULTIPOLYGON (((-58.4433204139367 -34.6198973203541,-58.4431894930038 -34.6198377199314,-58.4420822496971 -34.6193422387395,-58.4419573782015 -34.6192853141622,-58.4416453112495 -34.6200526115756,-58.4414626336296 -34.6205162581078,-58.4428890702833 -34.6211148992718,-58.4433204139367 -34.6198973203541)))";;"2694";6_10_8;COMUNA 6;"10";"8";"1243";"540";"703";"76,81%";"728";"728";"100,00%";"0";"0,00%";"568";"8";"1.41";"560";"98,59%";"1.41";1.410
"MULTIPOLYGON (((-58.4439644606446 -34.6201834873302,-58.4438247637303 -34.6201266328189,-58.4433204139367 -34.6198973203541,-58.4428890702833 -34.6211148992718,-58.4428935742635 -34.6211167893737,-58.4435349173873 -34.62138592738,-58.4439644606446 -34.6201834873302)))";;"2695";6_10_9;COMUNA 6;"10";"9";"501";"236";"265";"89,06%";"323";"323";"100,00%";"0";"0,00%";"246";"0";"0";"246";"100,00%";"0";0.000
"MULTIPOLYGON (((-58.4520358278215 -34.6157169778629,-58.4513701090813 -34.6157404398216,-58.4507192971527 -34.6157644630127,-58.4502719913553 -34.6157820245282,-58.4500110881764 -34.6162325067169,-58.4494252812486 -34.6172439592545,-58.4493782427833 -34.6173431830018,-58.4489622055264 -34.6183096499606,-58.4492096559919 -34.6184191180611,-58.4502298746714 -34.6188679044154,-58.4507010865744 -34.6180010900742,-58.4507838204792 -34.6178775726845,-58.4508408222031 -34.6177937020293,-58.4514370957634 -34.6167664685416,-58.4520358278215 -34.6157169778629)))";;"2696";6_11_1;COMUNA 6;"11";"1";"1053";"478";"575";"83,13%";"478";"477";"99,79%";"1";"0,21%";"429";"2";"0.47";"427";"99,53%";"0.47";0.470
"MULTIPOLYGON (((-58.4453807602582 -34.6183782810237,-58.4441823729013 -34.6178863974785,-58.4437534995738 -34.6188308720243,-58.4442121894602 -34.6190332030461,-58.4441987195648 -34.6190793293883,-58.4441923259489 -34.6190997516726,-58.4441495367826 -34.6192116505193,-58.4446930034347 -34.6193605400001,-58.4451430379218 -34.6194270163842,-58.4453807602582 -34.6183782810237)))";;"2697";6_11_10;COMUNA 6;"11";"10";"536";"238";"298";"79,87%";"297";"297";"100,00%";"0";"0,00%";"240";"6";"2.5";"234";"97,50%";"2.5";2.500
"MULTIPOLYGON (((-58.4502719913553 -34.6157820245282,-58.4494892270595 -34.6158127180234,-58.4491460156231 -34.6158334557654,-58.4491620183738 -34.6159069108713,-58.448515788475 -34.6170265252343,-58.4480107388292 -34.6179017077797,-58.4481773531575 -34.617962504527,-58.4489622055264 -34.6183096499606,-58.4493782427833 -34.6173431830018,-58.4494252812486 -34.6172439592545,-58.4500110881764 -34.6162325067169,-58.4502719913553 -34.6157820245282)))";;"2698";6_11_2;COMUNA 6;"11";"2";"550";"263";"287";"91,64%";"295";"295";"100,00%";"0";"0,00%";"242";"1";"0.41";"241";"99,59%";"0.41";0.410
"MULTIPOLYGON (((-58.4491620183738 -34.6159069108713,-58.4490097091158 -34.6159028092214,-58.4488768204245 -34.6159078648401,-58.4486532096115 -34.6159163607295,-58.448585240651 -34.6158673370488,-58.4476965859736 -34.6159236414627,-58.4468385969153 -34.6159780419173,-58.4466960815729 -34.6159859109105,-58.4467303002644 -34.616119159588,-58.4466815680634 -34.6165965645846,-58.4482707234836 -34.6169445921746,-58.448515788475 -34.6170265252343,-58.4491620183738 -34.6159069108713)))";;"2699";6_11_3;COMUNA 6;"11";"3";"876";"413";"463";"89,20%";"449";"449";"100,00%";"0";"0,00%";"368";"24";"6.52";"344";"93,48%";"6.52";6.520
"MULTIPOLYGON (((-58.448515788475 -34.6170265252343,-58.4482707234836 -34.6169445921746,-58.4466815680634 -34.6165965645846,-58.4466048258181 -34.6174291897111,-58.4465912570264 -34.6175544740533,-58.4467387075546 -34.6175899876504,-58.4478115004401 -34.6178290049972,-58.4480107388292 -34.6179017077797,-58.448515788475 -34.6170265252343)))";;"2700";6_11_4;COMUNA 6;"11";"4";"782";"359";"423";"84,87%";"408";"408";"100,00%";"0";"0,00%";"343";"0";"0";"343";"100,00%";"0";0.000
"MULTIPOLYGON (((-58.4456206081623 -34.6173202492116,-58.4446217193124 -34.6169189642668,-58.4441823729013 -34.6178863974785,-58.4453807602582 -34.6183782810237,-58.4451430379218 -34.6194270163842,-58.4450880403641 -34.6196694817616,-58.4451731369243 -34.6197009739957,-58.4456046631572 -34.6198873093724,-58.4460102171442 -34.6200316663648,-58.4460768329953 -34.6200404081609,-58.4461700952915 -34.6197085077847,-58.4462334404908 -34.6194542820709,-58.4462634580269 -34.6192954777194,-58.4464070985549 -34.6187900566575,-58.4464519475954 -34.6185825905335,-58.4464906617815 -34.6183811096979,-58.4465207729066 -34.6181744866758,-58.4465301581141 -34.618098921868,-58.4465472220579 -34.617961665752,-58.4465912570264 -34.6175544740533,-58.4466048258181 -34.6174291897111,-58.4466815680634 -34.6165965645846,-58.4467303002644 -34.616119159588,-58.4466960815729 -34.6159859109105,-58.4461819043064 -34.6160009837611,-58.445920984726 -34.6159964409508,-58.4456206081623 -34.6173202492116)))";;"2701";6_11_5;COMUNA 6;"11";"5";"581";"280";"301";"93,02%";"315";"315";"100,00%";"0";"0,00%";"249";"2";"0.8";"247";"99,20%";"0.8";0.800
"MULTIPOLYGON (((-58.4450627538826 -34.6159767417297,-58.4433575395296 -34.6159297914782,-58.4431893756708 -34.6163347087257,-58.4433372423673 -34.6163967063241,-58.44445664422 -34.6168525993058,-58.4446217193124 -34.6169189642668,-58.4456206081623 -34.6173202492116,-58.445920984726 -34.6159964409508,-58.4455253888002 -34.6159894842455,-58.4450627538826 -34.6159767417297)))";;"2702";6_11_6;COMUNA 6;"11";"6";"727";"337";"390";"86,41%";"384";"384";"100,00%";"0";"0,00%";"309";"1";"0.32";"308";"99,68%";"0.32";0.320
"MULTIPOLYGON (((-58.4446217193124 -34.6169189642668,-58.44445664422 -34.6168525993058,-58.4433372423673 -34.6163967063241,-58.4431893756708 -34.6163347087257,-58.4427827243022 -34.6173139736175,-58.442884680882 -34.6173603298931,-58.4440095453007 -34.6178154531189,-58.4441823729013 -34.6178863974785,-58.4446217193124 -34.6169189642668)))";;"2703";6_11_7;COMUNA 6;"11";"7";"755";"354";"401";"88,28%";"405";"405";"100,00%";"0";"0,00%";"357";"20";"5.6";"337";"94,40%";"5.6";5.600
"MULTIPOLYGON (((-58.4433575395296 -34.6159297914782,-58.442264617613 -34.6159467970128,-58.4418520668977 -34.6159542626901,-58.4408635868411 -34.615947681085,-58.4406305238562 -34.6159401740906,-58.4413806006515 -34.6171681680966,-58.4415397441085 -34.6167680407381,-58.4426626252169 -34.6172593745488,-58.4427827243022 -34.6173139736175,-58.4431893756708 -34.6163347087257,-58.4433575395296 -34.6159297914782)))";;"2704";6_11_8;COMUNA 6;"11";"8";"779";"351";"428";"82,01%";"460";"460";"100,00%";"0";"0,00%";"369";"2";"0.54";"367";"99,46%";"0.54";0.540
"MULTIPOLYGON (((-58.4441823729013 -34.6178863974785,-58.4440095453007 -34.6178154531189,-58.442884680882 -34.6173603298931,-58.4427827243022 -34.6173139736175,-58.4426626252169 -34.6172593745488,-58.4415397441085 -34.6167680407381,-58.4413806006515 -34.6171681680966,-58.4419019809426 -34.6180198375705,-58.4424024010454 -34.618232042033,-58.4425686685741 -34.6183036918324,-58.443532034815 -34.6187318198532,-58.4436640618225 -34.6187908566913,-58.4437534995738 -34.6188308720243,-58.4441823729013 -34.6178863974785)))";;"2705";6_11_9;COMUNA 6;"11";"9";"723";"324";"399";"81,20%";"330";"329";"99,70%";"1";"0,30%";"288";"5";"1.74";"283";"98,26%";"1.74";1.740
"MULTIPOLYGON (((-58.4480107388292 -34.6179017077797,-58.4478115004401 -34.6178290049972,-58.4467387075546 -34.6175899876504,-58.4465912570264 -34.6175544740533,-58.4465472220579 -34.617961665752,-58.4465301581141 -34.618098921868,-58.4471782592659 -34.61809759755,-58.44765973413 -34.6181016016616,-58.4478920373643 -34.6181076866328,-58.4480107388292 -34.6179017077797)))";;"2706";6_12_1;COMUNA 6;"12";"1";"522";"235";"287";"81,88%";"326";"326";"100,00%";"0";"0,00%";"256";"3";"1.17";"253";"98,83%";"1.17";1.170
"MULTIPOLYGON (((-58.451205021808 -34.6231547694931,-58.4501315819941 -34.6227321842213,-58.4499585687394 -34.6226623046995,-58.4494077907469 -34.6238274974236,-58.4498925927068 -34.6240177671012,-58.4504348988335 -34.6242306470525,-58.4506646514804 -34.6243203913295,-58.451205021808 -34.6231547694931)))";;"2707";6_12_10;COMUNA 6;"12";"10";"536";"247";"289";"85,47%";"311";"311";"100,00%";"0";"0,00%";"236";"3";"1.27";"233";"98,73%";"1.27";1.270
"MULTIPOLYGON (((-58.4535375611948 -34.6240726746819,-58.4533551712836 -34.6240011090888,-58.451205021808 -34.6231547694931,-58.4506646514804 -34.6243203913295,-58.4519861860461 -34.6248365886025,-58.4521818662259 -34.6249129462759,-58.4530023299744 -34.6252314054423,-58.4535375611948 -34.6240726746819)))";;"2708";6_12_11;COMUNA 6;"12";"11";"814";"363";"451";"80,49%";"502";"502";"100,00%";"0";"0,00%";"372";"7";"1.88";"365";"98,12%";"1.88";1.880
"MULTIPOLYGON (((-58.4545749150793 -34.624479874854,-58.4535375611948 -34.6240726746819,-58.4530023299744 -34.6252314054423,-58.4540312622009 -34.625631003598,-58.4545749150793 -34.624479874854)))";;"2709";6_12_12;COMUNA 6;"12";"12";"519";"225";"294";"76,53%";"255";"254";"99,61%";"1";"0,39%";"208";"2";"0.96";"206";"99,04%";"0.96";0.960
"MULTIPOLYGON (((-58.4560760254784 -34.6212043593208,-58.4551721042202 -34.6208811970233,-58.4550221752709 -34.620829495733,-58.4547810115343 -34.6207463788215,-58.4539750633369 -34.6204656098008,-58.4536553604126 -34.6203542445915,-58.4533618970772 -34.6202380916537,-58.453079267978 -34.6214732536696,-58.4534427605306 -34.6216001171963,-58.4545058995164 -34.6219714033316,-58.4555578030921 -34.6223386652984,-58.4560760254784 -34.6212043593208)))";;"2710";6_12_2;COMUNA 6;"12";"2";"556";"257";"299";"85,95%";"256";"255";"99,61%";"1";"0,39%";"228";"23";"10.09";"205";"89,91%";"10.09";10.090
"MULTIPOLYGON (((-58.4534427605306 -34.6216001171963,-58.453079267978 -34.6214732536696,-58.4533618970772 -34.6202380916537,-58.4532045601765 -34.6201758238066,-58.4526981389438 -34.6199532403253,-58.4514996904604 -34.6194264275452,-58.4513191876577 -34.6193471122765,-58.4502298746714 -34.6188679044154,-58.4492096559919 -34.6184191180611,-58.4489622055264 -34.6183096499606,-58.4481773531575 -34.617962504527,-58.4480107388292 -34.6179017077797,-58.4478920373643 -34.6181076866328,-58.44765973413 -34.6181016016616,-58.4471782592659 -34.61809759755,-58.4465301581141 -34.618098921868,-58.4465207729066 -34.6181744866758,-58.4464906617815 -34.6183811096979,-58.4464519475954 -34.6185825905335,-58.4464070985549 -34.6187900566575,-58.4462634580269 -34.6192954777194,-58.4462334404908 -34.6194542820709,-58.4461700952915 -34.6197085077847,-58.4460768329953 -34.6200404081609,-58.4460070128322 -34.6202930131079,-58.4459646556041 -34.6203841372541,-58.4457319835162 -34.6209041937093,-58.445844423047 -34.6209575210169,-58.4464913006757 -34.6212293082987,-58.4476301188024 -34.62170778081,-58.4486888761671 -34.6221526407697,-58.4499585687394 -34.6226623046995,-58.4501315819941 -34.6227321842213,-58.451205021808 -34.6231547694931,-58.4533551712836 -34.6240011090888,-58.4535375611948 -34.6240726746819,-58.4545749150793 -34.624479874854,-58.4547625494278 -34.6240731126674,-58.4546797458207 -34.6240329650254,-58.4547625602595 -34.6240731171022,-58.4548301211898 -34.6239267739823,-58.4550485988027 -34.6234531095886,-58.4555578030921 -34.6223386652984,-58.4545058995164 -34.6219714033316,-58.4534427605306 -34.6216001171963)))";;"2711";6_12_3;COMUNA 6;"12";"3";"629";"286";"343";"83,38%";"373";"372";"99,73%";"1";"0,27%";"288";"1";"0.35";"287";"99,65%";"0.35";0.350
"MULTIPOLYGON (((-58.4450065248686 -34.6200248345425,-58.4448852766558 -34.6205388489731,-58.4450466116085 -34.6206026070493,-58.4455666465564 -34.6208257875818,-58.4457319835162 -34.6209041937093,-58.4459646556041 -34.6203841372541,-58.4460070128322 -34.6202930131079,-58.4460768329953 -34.6200404081609,-58.4460102171442 -34.6200316663648,-58.4456046631572 -34.6198873093724,-58.4451731369243 -34.6197009739957,-58.4450880403641 -34.6196694817616,-58.4450556535738 -34.6198159411088,-58.4450065248686 -34.6200248345425)))";;"2712";6_12_4;COMUNA 6;"12";"4";"360";"153";"207";"73,91%";"267";"267";"100,00%";"0";"0,00%";"193";"1";"0.52";"192";"99,48%";"0.52";0.520
"MULTIPOLYGON (((-58.4457319835162 -34.6209041937093,-58.4455666465564 -34.6208257875818,-58.4450466116085 -34.6206026070493,-58.4448852766558 -34.6205388489731,-58.4448469060655 -34.62070427168,-58.4447943840337 -34.6209153981144,-58.4443522411359 -34.621728881878,-58.4444870852959 -34.6217854533464,-58.4444261550957 -34.6218719965375,-58.4451684448768 -34.6221633831934,-58.4457319835162 -34.6209041937093)))";;"2713";6_12_5;COMUNA 6;"12";"5";"841";"359";"482";"74,48%";"502";"502";"100,00%";"0";"0,00%";"384";"7";"1.82";"377";"98,18%";"1.82";1.820
"MULTIPOLYGON (((-58.4464913006757 -34.6212293082987,-58.445844423047 -34.6209575210169,-58.4457319835162 -34.6209041937093,-58.4451684448768 -34.6221633831934,-58.4457874779647 -34.6224064367598,-58.4464913006757 -34.6212293082987)))";;"2714";6_12_6;COMUNA 6;"12";"6";"571";"251";"320";"78,44%";"301";"301";"100,00%";"0";"0,00%";"243";"4";"1.65";"239";"98,35%";"1.65";1.650
"MULTIPOLYGON (((-58.4476301188024 -34.62170778081,-58.4464913006757 -34.6212293082987,-58.4457874779647 -34.6224064367598,-58.4470126068209 -34.6228873213301,-58.4470901594088 -34.6227368331152,-58.4476301188024 -34.62170778081)))";;"2715";6_12_7;COMUNA 6;"12";"7";"685";"296";"389";"76,09%";"494";"494";"100,00%";"0";"0,00%";"349";"2";"0.57";"347";"99,43%";"0.57";0.570
"MULTIPOLYGON (((-58.4486888761671 -34.6221526407697,-58.4476301188024 -34.62170778081,-58.4470901594088 -34.6227368331152,-58.4470126068209 -34.6228873213301,-58.4472638187563 -34.6229859483353,-58.4481220668107 -34.6233228261143,-58.4486888761671 -34.6221526407697)))";;"2716";6_12_8;COMUNA 6;"12";"8";"741";"335";"406";"82,51%";"409";"409";"100,00%";"0";"0,00%";"303";"8";"2.64";"295";"97,36%";"2.64";2.640
"MULTIPOLYGON (((-58.4499585687394 -34.6226623046995,-58.4486888761671 -34.6221526407697,-58.4481220668107 -34.6233228261143,-58.4486478376751 -34.6235292329598,-58.4494077907469 -34.6238274974236,-58.4499585687394 -34.6226623046995)))";;"2717";6_12_9;COMUNA 6;"12";"9";"773";"346";"427";"81,03%";"461";"461";"100,00%";"0";"0,00%";"362";"3";"0.83";"359";"99,17%";"0.83";0.830
"MULTIPOLYGON (((-58.4530023299744 -34.6252314054423,-58.4521818662259 -34.6249129462759,-58.4519861860461 -34.6248365886025,-58.4514708769709 -34.6258986208072,-58.4534370734072 -34.6267810694993,-58.4539380454384 -34.6257643817714,-58.4540312622009 -34.625631003598,-58.4530023299744 -34.6252314054423)))";;"2718";6_13_1;COMUNA 6;"13";"1";"689";"291";"398";"73,12%";"418";"418";"100,00%";"0";"0,00%";"307";"3";"0.98";"304";"99,02%";"0.98";0.980
"MULTIPOLYGON (((-58.4506646514804 -34.6243203913295,-58.4504348988335 -34.6242306470525,-58.4498925927068 -34.6240177671012,-58.4494989293831 -34.6250136748032,-58.4497056803598 -34.6251063762313,-58.4514708769709 -34.6258986208072,-58.4519861860461 -34.6248365886025,-58.4506646514804 -34.6243203913295)))";;"2719";6_13_2;COMUNA 6;"13";"2";"1302";"557";"745";"74,77%";"703";"702";"99,86%";"1";"0,14%";"586";"2";"0.34";"584";"99,66%";"0.34";0.340
"MULTIPOLYGON (((-58.4514708769709 -34.6258986208072,-58.4497056803598 -34.6251063762313,-58.4494989293831 -34.6250136748032,-58.4491110522753 -34.6259950037543,-58.4493518790635 -34.6261136963592,-58.4500521277261 -34.6264687126307,-58.4509725974722 -34.6269354401643,-58.45107239184 -34.6267197381718,-58.4514708769709 -34.6258986208072)))";;"2720";6_13_3;COMUNA 6;"13";"3";"764";"338";"426";"79,34%";"366";"364";"99,45%";"2";"0,55%";"302";"2";"0.66";"300";"99,34%";"0.66";0.660
"MULTIPOLYGON (((-58.4534370734072 -34.6267810694993,-58.4514708769709 -34.6258986208072,-58.45107239184 -34.6267197381718,-58.4509725974722 -34.6269354401643,-58.4528705579412 -34.6279246554289,-58.4534370734072 -34.6267810694993)))";;"2721";6_13_4;COMUNA 6;"13";"4";"1240";"540";"700";"77,14%";"577";"576";"99,83%";"1";"0,17%";"497";"5";"1.01";"492";"98,99%";"1.01";1.010
"MULTIPOLYGON (((-58.4528705579412 -34.6279246554289,-58.4509725974722 -34.6269354401643,-58.4508608714843 -34.6271769164312,-58.4503951321187 -34.6281454946268,-58.4511836106646 -34.6282901539577,-58.4515081188048 -34.6283491298124,-58.452568801026 -34.6285418346427,-58.452669188958 -34.6283312020432,-58.4528705579412 -34.6279246554289)))";;"2722";6_13_5;COMUNA 6;"13";"5";"873";"378";"495";"76,36%";"526";"525";"99,81%";"1";"0,19%";"361";"19";"5.26";"342";"94,74%";"5.26";5.260
"MULTIPOLYGON (((-58.4509725974722 -34.6269354401643,-58.4500521277261 -34.6264687126307,-58.4493123949433 -34.627946852772,-58.4503951321187 -34.6281454946268,-58.4508608714843 -34.6271769164312,-58.4509725974722 -34.6269354401643)))";;"2723";6_13_6;COMUNA 6;"13";"6";"535";"212";"323";"65,63%";"364";"364";"100,00%";"0";"0,00%";"267";"1";"0.37";"266";"99,63%";"0.37";0.370
"MULTIPOLYGON (((-58.4479946720669 -34.6288191952006,-58.4475135091176 -34.6300365009756,-58.4482222607585 -34.6301432808645,-58.4483455041416 -34.6298789908252,-58.4488075207542 -34.6289557739473,-58.4493123949433 -34.627946852772,-58.4500521277261 -34.6264687126307,-58.4493518790635 -34.6261136963592,-58.4491110522753 -34.6259950037543,-58.4487840215604 -34.6268223893853,-58.4484086569701 -34.6277719556001,-58.4479946720669 -34.6288191952006)))";;"2724";6_13_7;COMUNA 6;"13";"7";"862";"392";"470";"83,40%";"463";"463";"100,00%";"0";"0,00%";"369";"12";"3.25";"357";"96,75%";"3.25";3.250
"MULTIPOLYGON (((-58.4510395665488 -34.6293342598749,-58.4501582134873 -34.6291826884825,-58.4499160015472 -34.6291420281709,-58.4503951321187 -34.6281454946268,-58.4493123949433 -34.627946852772,-58.4488075207542 -34.6289557739473,-58.4483455041416 -34.6298789908252,-58.4482222607585 -34.6301432808645,-58.4490540388145 -34.6302685217793,-58.4493589595847 -34.6303133457385,-58.4504979638399 -34.6304806536754,-58.4515763969476 -34.6306390719281,-58.4519952676798 -34.6297454175993,-58.4521029023144 -34.6295195743664,-58.4510395665488 -34.6293342598749)))";;"2725";6_13_8;COMUNA 6;"13";"8";"1221";"572";"649";"88,14%";"638";"638";"100,00%";"0";"0,00%";"497";"16";"3.22";"481";"96,78%";"3.22";3.220
"MULTIPOLYGON (((-58.452568801026 -34.6285418346427,-58.4515081188048 -34.6283491298124,-58.4511836106646 -34.6282901539577,-58.4503951321187 -34.6281454946268,-58.4499160015472 -34.6291420281709,-58.4501582134873 -34.6291826884825,-58.4510395665488 -34.6293342598749,-58.4521029023144 -34.6295195743664,-58.452568801026 -34.6285418346427)))";;"2726";6_13_9;COMUNA 6;"13";"9";"896";"420";"476";"88,24%";"552";"552";"100,00%";"0";"0,00%";"426";"2";"0.47";"424";"99,53%";"0.47";0.470
"MULTIPOLYGON (((-58.4494077907469 -34.6238274974236,-58.4486478376751 -34.6235292329598,-58.4481220668107 -34.6233228261143,-58.4477850518221 -34.6242473242498,-58.4480689781792 -34.6243730671782,-58.4482663554603 -34.6244614740084,-58.4494989293831 -34.6250136748032,-58.4498925927068 -34.6240177671012,-58.4494077907469 -34.6238274974236)))";;"2727";6_14_1;COMUNA 6;"14";"1";"896";"383";"513";"74,66%";"475";"473";"99,58%";"2";"0,42%";"382";"2";"0.52";"380";"99,48%";"0.52";0.520
"MULTIPOLYGON (((-58.446570038411 -34.628598937306,-58.4449957242387 -34.6283619504291,-58.444477543156 -34.6295830418786,-58.4460609103067 -34.6298184168624,-58.4464236760184 -34.6298723408503,-58.4475135091176 -34.6300365009756,-58.4479946720669 -34.6288191952006,-58.4476630073983 -34.6287634486667,-58.446570038411 -34.628598937306)))";;"2728";6_14_10;COMUNA 6;"14";"10";"912";"423";"489";"86,50%";"576";"576";"100,00%";"0";"0,00%";"392";"8";"2.04";"384";"97,96%";"2.04";2.040
"MULTIPOLYGON (((-58.4482663554603 -34.6244614740084,-58.4480689781792 -34.6243730671782,-58.4477850518221 -34.6242473242498,-58.4474452175789 -34.6251738632837,-58.447885887503 -34.6253911081207,-58.4491110522753 -34.6259950037543,-58.4494989293831 -34.6250136748032,-58.4482663554603 -34.6244614740084)))";;"2729";6_14_2;COMUNA 6;"14";"2";"625";"269";"356";"75,56%";"320";"320";"100,00%";"0";"0,00%";"250";"6";"2.4";"244";"97,60%";"2.4";2.400
"MULTIPOLYGON (((-58.4481220668107 -34.6233228261143,-58.4472638187563 -34.6229859483353,-58.4468975851308 -34.6238544525256,-58.4465311734152 -34.6247233075927,-58.4474452175789 -34.6251738632837,-58.4477850518221 -34.6242473242498,-58.4481220668107 -34.6233228261143)))";;"2730";6_14_3;COMUNA 6;"14";"3";"850";"394";"456";"86,40%";"495";"493";"99,60%";"2";"0,41%";"384";"47";"12.24";"337";"87,76%";"12.24";12.240
"MULTIPOLYGON (((-58.4470126068209 -34.6228873213301,-58.4457874779647 -34.6224064367598,-58.4449776913871 -34.623818131125,-58.4456720127799 -34.6242271877488,-58.4465311734152 -34.6247233075927,-58.4468975851308 -34.6238544525256,-58.4472638187563 -34.6229859483353,-58.4470126068209 -34.6228873213301)))";;"2731";6_14_4;COMUNA 6;"14";"4";"1059";"471";"588";"80,10%";"699";"699";"100,00%";"0";"0,00%";"531";"2";"0.38";"529";"99,62%";"0.38";0.380
"MULTIPOLYGON (((-58.4445952717764 -34.6253410145214,-58.4445182043908 -34.6259693343562,-58.4444188769075 -34.6267021613342,-58.4443691479444 -34.6269747687535,-58.4449530574752 -34.6270814784376,-58.4453276332385 -34.6255942282571,-58.4460473844017 -34.625877155188,-58.4461427635456 -34.6256442729048,-58.4465311734152 -34.6247233075927,-58.4456720127799 -34.6242271877488,-58.4449776913871 -34.623818131125,-58.4448095434838 -34.6241111448288,-58.4446989214222 -34.6243040929307,-58.4445952717764 -34.6253410145214)))";;"2732";6_14_5;COMUNA 6;"14";"5";"1031";"468";"563";"83,13%";"517";"516";"99,81%";"1";"0,19%";"407";"3";"0.74";"404";"99,26%";"0.74";0.740
"MULTIPOLYGON (((-58.4474818014512 -34.6263784864019,-58.447885887503 -34.6253911081207,-58.4474452175789 -34.6251738632837,-58.4465311734152 -34.6247233075927,-58.4461427635456 -34.6256442729048,-58.4460473844017 -34.625877155188,-58.4453276332385 -34.6255942282571,-58.4449530574752 -34.6270814784376,-58.4455028913607 -34.6271819831325,-58.4466559792908 -34.6273927107594,-58.4470321054892 -34.6274741004322,-58.4473817372823 -34.6266232005041,-58.4474818014512 -34.6263784864019)))";;"2733";6_14_6;COMUNA 6;"14";"6";"1161";"544";"617";"88,17%";"618";"618";"100,00%";"0";"0,00%";"484";"13";"2.69";"471";"97,31%";"2.69";2.690
"MULTIPOLYGON (((-58.4491110522753 -34.6259950037543,-58.447885887503 -34.6253911081207,-58.4474818014512 -34.6263784864019,-58.4487840215604 -34.6268223893853,-58.4491110522753 -34.6259950037543)))";;"2734";6_14_7;COMUNA 6;"14";"7";"539";"243";"296";"82,09%";"277";"277";"100,00%";"0";"0,00%";"237";"2";"0.84";"235";"99,16%";"0.84";0.840
"MULTIPOLYGON (((-58.4487840215604 -34.6268223893853,-58.4474818014512 -34.6263784864019,-58.4473817372823 -34.6266232005041,-58.4470321054892 -34.6274741004322,-58.4484086569701 -34.6277719556001,-58.4487840215604 -34.6268223893853)))";;"2735";6_14_8;COMUNA 6;"14";"8";"540";"253";"287";"88,15%";"276";"275";"99,64%";"1";"0,36%";"218";"1";"0.46";"217";"99,54%";"0.46";0.460
"MULTIPOLYGON (((-58.4470321054892 -34.6274741004322,-58.4466559792908 -34.6273927107594,-58.4455028913607 -34.6271819831325,-58.4453833059588 -34.6274483836828,-58.4449957242387 -34.6283619504291,-58.446570038411 -34.628598937306,-58.4476630073983 -34.6287634486667,-58.4479946720669 -34.6288191952006,-58.4484086569701 -34.6277719556001,-58.4470321054892 -34.6274741004322)))";;"2736";6_14_9;COMUNA 6;"14";"9";"794";"376";"418";"89,95%";"411";"411";"100,00%";"0";"0,00%";"309";"3";"0.97";"306";"99,03%";"0.97";0.970
"MULTIPOLYGON (((-58.4436202450113 -34.6230184621677,-58.4435405655038 -34.6231280309288,-58.4434540002251 -34.6239106499114,-58.4434423887186 -34.6240201588877,-58.4436935334021 -34.6240365368675,-58.4448095434838 -34.6241111448288,-58.4449776913871 -34.623818131125,-58.4457874779647 -34.6224064367598,-58.4451684448768 -34.6221633831934,-58.4444261550957 -34.6218719965375,-58.4436202450113 -34.6230184621677)))";;"2737";6_15_1;COMUNA 6;"15";"1";"671";"304";"367";"82,83%";"385";"384";"99,74%";"1";"0,26%";"284";"7";"2.46";"277";"97,54%";"2.46";2.460
"MULTIPOLYGON (((-58.4440819292449 -34.628224344954,-58.4431723975161 -34.6280850431154,-58.4429251960712 -34.6293520881348,-58.444477543156 -34.6295830418786,-58.4449957242387 -34.6283619504291,-58.4440819292449 -34.628224344954)))";;"2738";6_15_10;COMUNA 6;"15";"10";"716";"349";"367";"95,10%";"375";"375";"100,00%";"0";"0,00%";"305";"0";"0";"305";"100,00%";"0";0.000
"MULTIPOLYGON (((-58.4428032776191 -34.6212929858269,-58.4427992380603 -34.6212913696731,-58.4418776049765 -34.6228453542788,-58.442758832639 -34.6228219091525,-58.4435475003986 -34.6229785198107,-58.4436202450113 -34.6230184621677,-58.4444261550957 -34.6218719965375,-58.4444870852959 -34.6217854533464,-58.4443522411359 -34.621728881878,-58.4435349173873 -34.62138592738,-58.4428935742635 -34.6211167893737,-58.4428032776191 -34.6212929858269)))";;"2739";6_15_2;COMUNA 6;"15";"2";"1667";"708";"959";"73,83%";"983";"983";"100,00%";"0";"0,00%";"770";"0";"0";"770";"100,00%";"0";0.000
"MULTIPOLYGON (((-58.4436202450113 -34.6230184621677,-58.4435475003986 -34.6229785198107,-58.442758832639 -34.6228219091525,-58.4418776049765 -34.6228453542788,-58.4417735739339 -34.6239115704316,-58.4434423887186 -34.6240201588877,-58.4434540002251 -34.6239106499114,-58.4435405655038 -34.6231280309288,-58.4436202450113 -34.6230184621677)))";;"2740";6_15_3;COMUNA 6;"15";"3";"816";"367";"449";"81,74%";"451";"451";"100,00%";"0";"0,00%";"358";"2";"0.56";"356";"99,44%";"0.56";0.560
"MULTIPOLYGON (((-58.4434423887186 -34.6240201588877,-58.4417735739339 -34.6239115704316,-58.4416439533378 -34.625091588605,-58.4425478394664 -34.6251794907614,-58.4433235984964 -34.6252549007191,-58.4433301869483 -34.6251322215143,-58.4434423887186 -34.6240201588877)))";;"2741";6_15_4;COMUNA 6;"15";"4";"682";"318";"364";"87,36%";"347";"347";"100,00%";"0";"0,00%";"270";"3";"1.11";"267";"98,89%";"1.11";1.110
"MULTIPOLYGON (((-58.4448095434838 -34.6241111448288,-58.4436935334021 -34.6240365368675,-58.4434423887186 -34.6240201588877,-58.4433301869483 -34.6251322215143,-58.4433235984964 -34.6252549007191,-58.4445952717764 -34.6253410145214,-58.4446989214222 -34.6243040929307,-58.4448095434838 -34.6241111448288)))";;"2742";6_15_5;COMUNA 6;"15";"5";"760";"338";"422";"80,09%";"418";"417";"99,76%";"1";"0,24%";"320";"0";"0";"320";"100,00%";"0";0.000
"MULTIPOLYGON (((-58.4422809062637 -34.626653862804,-58.442928969462 -34.6267340427076,-58.4432422229098 -34.6267800101303,-58.4435538580503 -34.6268256947946,-58.4443691479444 -34.6269747687535,-58.4444188769075 -34.6267021613342,-58.4445182043908 -34.6259693343562,-58.4445952717764 -34.6253410145214,-58.4433235984964 -34.6252549007191,-58.4425478394664 -34.6251794907614,-58.4416439533378 -34.625091588605,-58.441565393631 -34.62580666986,-58.4414832458523 -34.6265552021968,-58.4422809062637 -34.626653862804)))";;"2743";6_15_6;COMUNA 6;"15";"6";"803";"361";"442";"81,67%";"352";"351";"99,72%";"1";"0,28%";"283";"3";"1.06";"280";"98,94%";"1.06";1.060
"MULTIPOLYGON (((-58.4422809062637 -34.626653862804,-58.4414832458523 -34.6265552021968,-58.4414041710162 -34.6272749311307,-58.4413440527815 -34.6278219109405,-58.4402853543888 -34.6276694623255,-58.4397699448434 -34.6284910843667,-58.4395276274238 -34.6288552761687,-58.4417593858374 -34.6291816765868,-58.4429251960712 -34.6293520881348,-58.4431723975161 -34.6280850431154,-58.4432040588365 -34.6274931972092,-58.4432422229098 -34.6267800101303,-58.442928969462 -34.6267340427076,-58.4422809062637 -34.626653862804)))";;"2744";6_15_7;COMUNA 6;"15";"7";"859";"402";"457";"87,96%";"420";"419";"99,76%";"1";"0,24%";"335";"18";"5.37";"317";"94,63%";"5.37";5.370
"MULTIPOLYGON (((-58.4443691479444 -34.6269747687535,-58.4435538580503 -34.6268256947946,-58.4432422229098 -34.6267800101303,-58.4432040588365 -34.6274931972092,-58.4431723975161 -34.6280850431154,-58.4440819292449 -34.628224344954,-58.4443288015905 -34.6271958265123,-58.4443691479444 -34.6269747687535)))";;"2745";6_15_8;COMUNA 6;"15";"8";"959";"438";"521";"84,07%";"560";"560";"100,00%";"0";"0,00%";"445";"1";"0.22";"444";"99,78%";"0.22";0.220
"MULTIPOLYGON (((-58.4449530574752 -34.6270814784376,-58.4443691479444 -34.6269747687535,-58.4443288015905 -34.6271958265123,-58.4440819292449 -34.628224344954,-58.4449957242387 -34.6283619504291,-58.4453833059588 -34.6274483836828,-58.4455028913607 -34.6271819831325,-58.4449530574752 -34.6270814784376)))";;"2746";6_15_9;COMUNA 6;"15";"9";"517";"250";"267";"93,63%";"295";"295";"100,00%";"0";"0,00%";"227";"1";"0.44";"226";"99,56%";"0.44";0.440
"MULTIPOLYGON (((-58.4418776049765 -34.6228453542788,-58.4412056068385 -34.6228712949595,-58.4408454090863 -34.6228998939217,-58.4407442083914 -34.6238436406901,-58.4415847048227 -34.623899283942,-58.4417735739339 -34.6239115704316,-58.4418776049765 -34.6228453542788)))";;"2747";6_16_1;COMUNA 6;"16";"1";"672";"292";"380";"76,84%";"321";"321";"100,00%";"0";"0,00%";"283";"2";"0.71";"281";"99,29%";"0.71";0.710
"MULTIPOLYGON (((-58.4374446867775 -34.6272538227915,-58.4359345714303 -34.6270325778061,-58.4350371615622 -34.6269010351108,-58.4348045510511 -34.6279972163736,-58.4347631765583 -34.6281583390948,-58.4356474798731 -34.6282876977037,-58.4371695443988 -34.6285103572028,-58.4374104762966 -34.6274081871228,-58.4374446867775 -34.6272538227915)))";;"2748";6_16_10;COMUNA 6;"16";"10";"1155";"531";"624";"85,10%";"612";"612";"100,00%";"0";"0,00%";"499";"42";"8.42";"457";"91,58%";"8.42";8.420
"MULTIPOLYGON (((-58.4352602671928 -34.6259328835979,-58.4346583785482 -34.6258960553268,-58.4343067041343 -34.6258683674008,-58.4341084040908 -34.6267649712722,-58.4338183040698 -34.6280200862079,-58.4347631765583 -34.6281583390948,-58.4348045510511 -34.6279972163736,-58.4350371615622 -34.6269010351108,-58.4359345714303 -34.6270325778061,-58.4360510266104 -34.6265234311058,-58.4361990952664 -34.6259903466467,-58.4352602671928 -34.6259328835979)))";;"2749";6_16_11;COMUNA 6;"16";"11";"886";"391";"495";"78,99%";"499";"499";"100,00%";"0";"0,00%";"390";"6";"1.54";"384";"98,46%";"1.54";1.540
"MULTIPOLYGON (((-58.4406210564185 -34.6249921085757,-58.4405442809536 -34.6256927523939,-58.4404709880902 -34.6264275528082,-58.4410201385426 -34.6264978653001,-58.4414832458523 -34.6265552021968,-58.441565393631 -34.62580666986,-58.4416439533378 -34.625091588605,-58.4417735739339 -34.6239115704316,-58.4415847048227 -34.623899283942,-58.4407442083914 -34.6238436406901,-58.4406210564185 -34.6249921085757)))";;"2750";6_16_2;COMUNA 6;"16";"2";"678";"299";"379";"78,89%";"347";"347";"100,00%";"0";"0,00%";"284";"2";"0.7";"282";"99,30%";"0.7";0.700
"MULTIPOLYGON (((-58.4393696585108 -34.6237247899106,-58.439261911774 -34.6248592448236,-58.4395433838631 -34.6248873277105,-58.4406210564185 -34.6249921085757,-58.4407442083914 -34.6238436406901,-58.4408454090863 -34.6228998939217,-58.4394345959055 -34.6230401308175,-58.4393696585108 -34.6237247899106)))";;"2751";6_16_3;COMUNA 6;"16";"3";"945";"432";"513";"84,21%";"520";"520";"100,00%";"0";"0,00%";"393";"9";"2.29";"384";"97,71%";"2.29";2.290
"MULTIPOLYGON (((-58.4384524080966 -34.6236651019401,-58.4383468738232 -34.6247658933683,-58.4382139058402 -34.6261506323317,-58.4391142149713 -34.6262620811265,-58.4391475821741 -34.6260641935166,-58.439261911774 -34.6248592448236,-58.4393696585108 -34.6237247899106,-58.4394345959055 -34.6230401308175,-58.4389179780972 -34.6230915118434,-58.4385029975295 -34.6231293892905,-58.4384524080966 -34.6236651019401)))";;"2752";6_16_4;COMUNA 6;"16";"4";"696";"317";"379";"83,64%";"393";"393";"100,00%";"0";"0,00%";"310";"3";"0.97";"307";"99,03%";"0.97";0.970
"MULTIPOLYGON (((-58.4385029975295 -34.6231293892905,-58.4377296897222 -34.6231991654366,-58.4372039564681 -34.623243565264,-58.4369349206532 -34.6232416776871,-58.4365617804133 -34.6232391334296,-58.4362622537292 -34.6232125186692,-58.4362266415189 -34.6245599516503,-58.4374025303877 -34.6246757685216,-58.4377098996109 -34.6247053399317,-58.4379516719095 -34.624728559031,-58.4383468738232 -34.6247658933683,-58.4384524080966 -34.6236651019401,-58.4385029975295 -34.6231293892905)))";;"2753";6_16_5;COMUNA 6;"16";"5";"976";"440";"536";"82,09%";"463";"463";"100,00%";"0";"0,00%";"393";"1";"0.25";"392";"99,75%";"0.25";0.250
"MULTIPOLYGON (((-58.4377098996109 -34.6247053399317,-58.4374025303877 -34.6246757685216,-58.4362266415189 -34.6245599516503,-58.4361990952664 -34.6259903466467,-58.4373693948274 -34.6260620061683,-58.4376770246505 -34.6260918594095,-58.4379639529053 -34.6261197357805,-58.4382139058402 -34.6261506323317,-58.4383468738232 -34.6247658933683,-58.4379516719095 -34.624728559031,-58.4377098996109 -34.6247053399317)))";;"2754";6_16_6;COMUNA 6;"16";"6";"979";"449";"530";"84,72%";"513";"513";"100,00%";"0";"0,00%";"415";"0";"0";"415";"100,00%";"0";0.000
"MULTIPOLYGON (((-58.4382139058402 -34.6261506323317,-58.4379639529053 -34.6261197357805,-58.4376770246505 -34.6260918594095,-58.4373693948274 -34.6260620061683,-58.4361990952664 -34.6259903466467,-58.4360510266104 -34.6265234311058,-58.4359345714303 -34.6270325778061,-58.4374446867775 -34.6272538227915,-58.4388645909948 -34.6274618620214,-58.4390787995896 -34.6264717292871,-58.4391142149713 -34.6262620811265,-58.4382139058402 -34.6261506323317)))";;"2755";6_16_7;COMUNA 6;"16";"7";"1040";"489";"551";"88,75%";"497";"497";"100,00%";"0";"0,00%";"388";"13";"3.35";"375";"96,65%";"3.35";3.350
"MULTIPOLYGON (((-58.4414832458523 -34.6265552021968,-58.4410201385426 -34.6264978653001,-58.4404709880902 -34.6264275528082,-58.4405442809536 -34.6256927523939,-58.4406210564185 -34.6249921085757,-58.4395433838631 -34.6248873277105,-58.439261911774 -34.6248592448236,-58.4391475821741 -34.6260641935166,-58.4391142149713 -34.6262620811265,-58.4390787995896 -34.6264717292871,-58.4388645909948 -34.6274618620214,-58.4400746715665 -34.6276391407153,-58.4402853543888 -34.6276694623255,-58.4413440527815 -34.6278219109405,-58.4414041710162 -34.6272749311307,-58.4414832458523 -34.6265552021968)))";;"2756";6_16_8;COMUNA 6;"16";"8";"1406";"674";"732";"92,08%";"653";"653";"100,00%";"0";"0,00%";"560";"4";"0.71";"556";"99,29%";"0.71";0.710
"MULTIPOLYGON (((-58.4388645909948 -34.6274618620214,-58.4374446867775 -34.6272538227915,-58.4374104762966 -34.6274081871228,-58.4371695443988 -34.6285103572028,-58.4385927919983 -34.6287185411079,-58.4395276274238 -34.6288552761687,-58.4397699448434 -34.6284910843667,-58.4402853543888 -34.6276694623255,-58.4400746715665 -34.6276391407153,-58.4388645909948 -34.6274618620214)))";;"2757";6_16_9;COMUNA 6;"16";"9";"1087";"520";"567";"91,71%";"525";"525";"100,00%";"0";"0,00%";"418";"6";"1.44";"412";"98,56%";"1.44";1.440
"MULTIPOLYGON (((-58.4409234641244 -34.6221731221536,-58.4408454090863 -34.6228998939217,-58.4412056068385 -34.6228712949595,-58.4418776049765 -34.6228453542788,-58.4427992380603 -34.6212913696731,-58.4411004142234 -34.6208249376893,-58.4409481463924 -34.6219351605527,-58.4409234641244 -34.6221731221536)))";;"2758";6_17_1;COMUNA 6;"17";"1";"838";"351";"487";"72,07%";"590";"590";"100,00%";"0";"0,00%";"416";"2";"0.48";"414";"99,52%";"0.48";0.480
"MULTIPOLYGON (((-58.4402507042969 -34.6199848957511,-58.4390138353137 -34.619435839794,-58.4387307950896 -34.6201858812346,-58.4389179390715 -34.6202420465872,-58.4408855806197 -34.6207697566912,-58.4411004142234 -34.6208249376893,-58.4427992380603 -34.6212913696731,-58.4428032776191 -34.6212929858269,-58.4428935742635 -34.6211167893737,-58.4428890702833 -34.6211148992718,-58.4414626336296 -34.6205162581078,-58.4412098193167 -34.6204102242114,-58.4402507042969 -34.6199848957511)))";;"2759";6_17_2;COMUNA 6;"17";"2";"899";"365";"534";"68,35%";"586";"586";"100,00%";"0";"0,00%";"419";"3";"0.72";"416";"99,28%";"0.72";0.720
"MULTIPOLYGON (((-58.4390138353137 -34.619435839794,-58.4377465747139 -34.6188732434345,-58.4373310128584 -34.6197688934269,-58.4375541022431 -34.6198326038205,-58.4381886156312 -34.6200230917466,-58.4387307950896 -34.6201858812346,-58.4390138353137 -34.619435839794)))";;"2760";6_17_3;COMUNA 6;"17";"3";"708";"311";"397";"78,34%";"462";"462";"100,00%";"0";"0,00%";"309";"2";"0.65";"307";"99,35%";"0.65";0.650
"MULTIPOLYGON (((-58.4387307950896 -34.6201858812346,-58.4381886156312 -34.6200230917466,-58.4376751282187 -34.6213413433868,-58.4382617607452 -34.6215853440443,-58.4386701794871 -34.6203465087332,-58.4387307950896 -34.6201858812346)))";;"2761";6_17_4;COMUNA 6;"17";"4";"747";"313";"434";"72,12%";"439";"439";"100,00%";"0";"0,00%";"360";"3";"0.83";"357";"99,17%";"0.83";0.830
"MULTIPOLYGON (((-58.4411004142234 -34.6208249376893,-58.4408855806197 -34.6207697566912,-58.4389179390715 -34.6202420465872,-58.4387307950896 -34.6201858812346,-58.4386701794871 -34.6203465087332,-58.4382617607452 -34.6215853440443,-58.4391580089517 -34.6217241870933,-58.4409481463924 -34.6219351605527,-58.4411004142234 -34.6208249376893)))";;"2762";6_17_5;COMUNA 6;"17";"5";"1730";"750";"980";"76,53%";"1062";"1062";"100,00%";"0";"0,00%";"839";"56";"6.67";"783";"93,33%";"6.67";6.670
"MULTIPOLYGON (((-58.4409481463924 -34.6219351605527,-58.4391580089517 -34.6217241870933,-58.4387883350348 -34.6230254278803,-58.4389179780972 -34.6230915118434,-58.4394345959055 -34.6230401308175,-58.4408454090863 -34.6228998939217,-58.4409234641244 -34.6221731221536,-58.4409481463924 -34.6219351605527)))";;"2763";6_17_6;COMUNA 6;"17";"6";"1047";"433";"614";"70,52%";"649";"649";"100,00%";"0";"0,00%";"507";"2";"0.39";"505";"99,61%";"0.39";0.390
"MULTIPOLYGON (((-58.4379309241921 -34.6225886219828,-58.4377296897222 -34.6231991654366,-58.4385029975295 -34.6231293892905,-58.4389179780972 -34.6230915118434,-58.4387883350348 -34.6230254278803,-58.4391580089517 -34.6217241870933,-58.4382617607452 -34.6215853440443,-58.4379309241921 -34.6225886219828)))";;"2764";6_17_7;COMUNA 6;"17";"7";"606";"263";"343";"76,68%";"359";"359";"100,00%";"0";"0,00%";"277";"0";"0";"277";"100,00%";"0";0.000
"MULTIPOLYGON (((-58.4377465747139 -34.6188732434345,-58.4364568449873 -34.6183006991031,-58.4360097627904 -34.6191645762112,-58.4359137773576 -34.6193635058276,-58.4360918890924 -34.6194151663381,-58.4373310128584 -34.6197688934269,-58.4377465747139 -34.6188732434345)))";;"2765";6_18_1;COMUNA 6;"18";"1";"623";"250";"373";"67,02%";"346";"346";"100,00%";"0";"0,00%";"263";"0";"0";"263";"100,00%";"0";0.000
"MULTIPOLYGON (((-58.4373310128584 -34.6197688934269,-58.4360918890924 -34.6194151663381,-58.4359137773576 -34.6193635058276,-58.435824270087 -34.6195490560378,-58.4355003599403 -34.6204073241732,-58.4356841637957 -34.6205130729369,-58.4369402879012 -34.6210356164018,-58.4376751282187 -34.6213413433868,-58.4381886156312 -34.6200230917466,-58.4375541022431 -34.6198326038205,-58.4373310128584 -34.6197688934269)))";;"2766";6_18_2;COMUNA 6;"18";"2";"611";"259";"352";"73,58%";"309";"308";"99,68%";"1";"0,32%";"256";"2";"0.78";"254";"99,22%";"0.78";0.780
"MULTIPOLYGON (((-58.4359137773576 -34.6193635058276,-58.4356710993933 -34.6192931681404,-58.4346836665907 -34.6190958961833,-58.4345362143567 -34.6190727628265,-58.4341334826194 -34.6202108781269,-58.4355003599403 -34.6204073241732,-58.435824270087 -34.6195490560378,-58.4359137773576 -34.6193635058276)))";;"2767";6_18_3;COMUNA 6;"18";"3";"648";"292";"356";"82,02%";"356";"356";"100,00%";"0";"0,00%";"313";"2";"0.64";"311";"99,36%";"0.64";0.640
"MULTIPOLYGON (((-58.4364568449873 -34.6183006991031,-58.4352835657606 -34.6177798592834,-58.4347368354355 -34.6175371209638,-58.4341311685815 -34.6172682387102,-58.433118723123 -34.6168186856863,-58.4328609927907 -34.6167045343571,-58.4322112191591 -34.6164165465554,-58.4317666981792 -34.6176331679893,-58.4314929332333 -34.6175696453142,-58.4313057038389 -34.6186744954558,-58.4315425123832 -34.6187073742254,-58.4316915826149 -34.6187280467374,-58.4317370706967 -34.6187334105924,-58.4325860972601 -34.6188340492021,-58.4333989224557 -34.6189309406862,-58.4343692552681 -34.6190465260623,-58.4345362143567 -34.6190727628265,-58.4346836665907 -34.6190958961833,-58.4356710993933 -34.6192931681404,-58.4359137773576 -34.6193635058276,-58.4360097627904 -34.6191645762112,-58.4364568449873 -34.6183006991031)))";;"2768";6_18_4;COMUNA 6;"18";"4";"722";"320";"402";"79,60%";"428";"428";"100,00%";"0";"0,00%";"309";"4";"1.29";"305";"98,71%";"1.29";1.290
"MULTIPOLYGON (((-58.4316345264817 -34.6161608990079,-58.4313591699306 -34.6160389228248,-58.4309066993326 -34.6172999069254,-58.4308716399528 -34.6174255360393,-58.4314929332333 -34.6175696453142,-58.4317666981792 -34.6176331679893,-58.4322112191591 -34.6164165465554,-58.4316345264817 -34.6161608990079)))";;"2769";6_18_5;COMUNA 6;"18";"5";"812";"336";"476";"70,59%";"506";"506";"100,00%";"0";"0,00%";"390";"13";"3.33";"377";"96,67%";"3.33";3.330
"MULTIPOLYGON (((-58.4313591699306 -34.6160389228248,-58.4308688448227 -34.6158216050275,-58.4307760095446 -34.6157804525409,-58.4302529824051 -34.6155486161375,-58.4295768025254 -34.6172340578084,-58.4302082707941 -34.6172716233188,-58.4303396156548 -34.617302081844,-58.4308716399528 -34.6174255360393,-58.4309066993326 -34.6172999069254,-58.4313591699306 -34.6160389228248)))";;"2770";6_18_6;COMUNA 6;"18";"6";"1083";"503";"580";"86,72%";"526";"526";"100,00%";"0";"0,00%";"454";"13";"2.86";"441";"97,14%";"2.86";2.860
"MULTIPOLYGON (((-58.4292525018146 -34.6151056540497,-58.4292190488984 -34.6152573404444,-58.4287930264039 -34.6171870098378,-58.4290868250835 -34.6172049791003,-58.4295768025254 -34.6172340578084,-58.4302529824051 -34.6155486161375,-58.4300285611138 -34.6154491864935,-58.4292525018146 -34.6151056540497)))";;"2771";6_18_7;COMUNA 6;"18";"7";"1153";"495";"658";"75,23%";"622";"622";"100,00%";"0";"0,00%";"526";"12";"2.28";"514";"97,72%";"2.28";2.280
"MULTIPOLYGON (((-58.4295768025254 -34.6172340578084,-58.4290868250835 -34.6172049791003,-58.4287930264039 -34.6171870098378,-58.4285882862832 -34.6181141686716,-58.4285509856805 -34.6182947984147,-58.4287914569003 -34.618323246775,-58.4299591368395 -34.6184844869183,-58.4302082707941 -34.6172716233188,-58.4295768025254 -34.6172340578084)))";;"2772";6_18_8;COMUNA 6;"18";"8";"1071";"470";"601";"78,20%";"684";"684";"100,00%";"0";"0,00%";"512";"4";"0.78";"508";"99,22%";"0.78";0.780
"MULTIPOLYGON (((-58.4314929332333 -34.6175696453142,-58.4308716399528 -34.6174255360393,-58.4303396156548 -34.617302081844,-58.4302082707941 -34.6172716233188,-58.4299591368395 -34.6184844869183,-58.4301554826549 -34.6185115826633,-58.43062594576 -34.6185783997556,-58.4311686445718 -34.6186555157776,-58.4313057038389 -34.6186744954558,-58.4314929332333 -34.6175696453142)))";;"2773";6_18_9;COMUNA 6;"18";"9";"819";"362";"457";"79,21%";"487";"487";"100,00%";"0";"0,00%";"395";"32";"8.1";"363";"91,90%";"8.1";8.100
"MULTIPOLYGON (((-58.4345362143567 -34.6190727628265,-58.4343692552681 -34.6190465260623,-58.4333989224557 -34.6189309406862,-58.4329853650165 -34.6200463023429,-58.4341334826194 -34.6202108781269,-58.4345362143567 -34.6190727628265)))";;"2774";6_19_1;COMUNA 6;"19";"1";"887";"377";"510";"73,92%";"474";"474";"100,00%";"0";"0,00%";"385";"13";"3.38";"372";"96,62%";"3.38";3.380
"MULTIPOLYGON (((-58.4317370706967 -34.6187334105924,-58.4316915826149 -34.6187280467374,-58.4315425123832 -34.6187073742254,-58.4313478443699 -34.6196529913906,-58.4313087547385 -34.6198478473237,-58.4329853650165 -34.6200463023429,-58.4333989224557 -34.6189309406862,-58.4325860972601 -34.6188340492021,-58.4317370706967 -34.6187334105924)))";;"2775";6_19_2;COMUNA 6;"19";"2";"1468";"630";"838";"75,18%";"806";"806";"100,00%";"0";"0,00%";"641";"4";"0.62";"637";"99,38%";"0.62";0.620
"MULTIPOLYGON (((-58.43062594576 -34.6185783997556,-58.4301554826549 -34.6185115826633,-58.4299591368395 -34.6184844869183,-58.4297616338131 -34.6194462281475,-58.4297277439117 -34.6196237604322,-58.4313087547385 -34.6198478473237,-58.4313478443699 -34.6196529913906,-58.4315425123832 -34.6187073742254,-58.4313057038389 -34.6186744954558,-58.4311686445718 -34.6186555157776,-58.43062594576 -34.6185783997556)))";;"2776";6_19_3;COMUNA 6;"19";"3";"1420";"606";"814";"74,45%";"770";"768";"99,74%";"2";"0,26%";"603";"4";"0.66";"599";"99,34%";"0.66";0.660
"MULTIPOLYGON (((-58.4299591368395 -34.6184844869183,-58.4287914569003 -34.618323246775,-58.4285509856805 -34.6182947984147,-58.4283175331573 -34.6194252655811,-58.4285984708844 -34.6194562610163,-58.429581483781 -34.6196030862861,-58.4297277439117 -34.6196237604322,-58.4297616338131 -34.6194462281475,-58.4299591368395 -34.6184844869183)))";;"2777";6_19_4;COMUNA 6;"19";"4";"1010";"443";"567";"78,13%";"557";"557";"100,00%";"0";"0,00%";"453";"4";"0.88";"449";"99,12%";"0.88";0.880
"MULTIPOLYGON (((-58.4297277439117 -34.6196237604322,-58.429581483781 -34.6196030862861,-58.4285984708844 -34.6194562610163,-58.4283175331573 -34.6194252655811,-58.4282839871933 -34.6195876561853,-58.4280687721697 -34.6206839012314,-58.4283371951762 -34.6207052454858,-58.4294913035723 -34.6208004275889,-58.4296967563519 -34.6197859408369,-58.4297277439117 -34.6196237604322)))";;"2778";6_19_5;COMUNA 6;"19";"5";"748";"315";"433";"72,75%";"387";"386";"99,74%";"1";"0,26%";"305";"0";"0";"305";"100,00%";"0";0.000
"MULTIPOLYGON (((-58.4313087547385 -34.6198478473237,-58.4297277439117 -34.6196237604322,-58.4296967563519 -34.6197859408369,-58.4294913035723 -34.6208004275889,-58.4310911979582 -34.6209323360909,-58.4311240580424 -34.6207684656467,-58.4313087547385 -34.6198478473237)))";;"2779";6_19_6;COMUNA 6;"19";"6";"1017";"447";"570";"78,42%";"546";"546";"100,00%";"0";"0,00%";"439";"2";"0.46";"437";"99,54%";"0.46";0.460
"MULTIPOLYGON (((-58.4329853650165 -34.6200463023429,-58.4313087547385 -34.6198478473237,-58.4311240580424 -34.6207684656467,-58.4310911979582 -34.6209323360909,-58.4326211586687 -34.6210585019609,-58.4326530613994 -34.6209426607151,-58.4329853650165 -34.6200463023429)))";;"2780";6_19_7;COMUNA 6;"19";"7";"966";"412";"554";"74,37%";"513";"513";"100,00%";"0";"0,00%";"444";"7";"1.58";"437";"98,42%";"1.58";1.580
"MULTIPOLYGON (((-58.4341334826194 -34.6202108781269,-58.4329853650165 -34.6200463023429,-58.4326530613994 -34.6209426607151,-58.4326211586687 -34.6210585019609,-58.4331913172535 -34.621105544256,-58.4337897587162 -34.6211549146167,-58.4338356465374 -34.620994145233,-58.4341334826194 -34.6202108781269)))";;"2781";6_19_8;COMUNA 6;"19";"8";"907";"403";"504";"79,96%";"543";"543";"100,00%";"0";"0,00%";"431";"3";"0.7";"428";"99,30%";"0.7";0.700
"MULTIPOLYGON (((-58.4479462572988 -34.6154680218155,-58.4476965859736 -34.6159236414627,-58.448585240651 -34.6158673370488,-58.4486532096115 -34.6159163607295,-58.4488768204245 -34.6159078648401,-58.4490097091158 -34.6159028092214,-58.4491620183738 -34.6159069108713,-58.4491460156231 -34.6158334557654,-58.4494892270595 -34.6158127180234,-58.4502719913553 -34.6157820245282,-58.4507192971527 -34.6157644630127,-58.4513701090813 -34.6157404398216,-58.4521648575562 -34.6145626519077,-58.4516092386377 -34.6143311858874,-58.4514533626607 -34.6142662397027,-58.4503673485016 -34.6138120338827,-58.4502375386731 -34.6137576525328,-58.4491270901089 -34.6133062501407,-58.4486312630322 -34.6142177761553,-58.4485581535468 -34.6143512936352,-58.4479462572988 -34.6154680218155)))";;"2782";6_2_1;COMUNA 6;"2";"1";"1081";"527";"554";"95,13%";"450";"449";"99,78%";"1";"0,22%";"387";"9";"2.33";"378";"97,67%";"2.33";2.330
"MULTIPOLYGON (((-58.4507838204792 -34.6178775726845,-58.4507010865744 -34.6180010900742,-58.4502298746714 -34.6188679044154,-58.4513191876577 -34.6193471122765,-58.4514996904604 -34.6194264275452,-58.4526981389438 -34.6199532403253,-58.4531748000292 -34.6189403555454,-58.4532233687101 -34.6188371162528,-58.4532875267979 -34.6187318358173,-58.4538047328286 -34.617621694525,-58.4538608832698 -34.617502046476,-58.4525868005157 -34.6171180606407,-58.4516702382522 -34.6168417742122,-58.4514370957634 -34.6167664685416,-58.4508408222031 -34.6177937020293,-58.4507838204792 -34.6178775726845)))";;"2783";6_2_10;COMUNA 6;"2";"10";"917";"458";"459";"99,78%";"364";"364";"100,00%";"0";"0,00%";"334";"5";"1.5";"329";"98,50%";"1.5";1.500
"MULTIPOLYGON (((-58.4539750633369 -34.6204656098008,-58.4547810115343 -34.6207463788215,-58.4550221752709 -34.620829495733,-58.4551721042202 -34.6208811970233,-58.4560760254784 -34.6212043593208,-58.4566230321572 -34.6200070924132,-58.4555587155228 -34.6196431487422,-58.4545268637011 -34.6192903955209,-58.4545848865331 -34.6191895507755,-58.455173055112 -34.6178975006175,-58.4538608832698 -34.617502046476,-58.4538047328286 -34.617621694525,-58.4532875267979 -34.6187318358173,-58.4532233687101 -34.6188371162528,-58.4531748000292 -34.6189403555454,-58.4526981389438 -34.6199532403253,-58.4532045601765 -34.6201758238066,-58.4533618970772 -34.6202380916537,-58.4536553604126 -34.6203542445915,-58.4539750633369 -34.6204656098008)))";;"2784";6_2_11;COMUNA 6;"2";"11";"1327";"622";"705";"88,23%";"572";"570";"99,65%";"2";"0,35%";"508";"14";"2.76";"494";"97,24%";"2.76";2.760
"MULTIPOLYGON (((-58.4541413717558 -34.6128100672517,-58.453527667976 -34.612556069785,-58.4529055354454 -34.6122985472898,-58.4516051507569 -34.6117634165066,-58.4510027862498 -34.6127603682914,-58.4506894998803 -34.6132789481766,-58.4503673485016 -34.6138120338827,-58.4514533626607 -34.6142662397027,-58.4516092386377 -34.6143311858874,-58.4521648575562 -34.6145626519077,-58.452250397317 -34.6144359645674,-58.4527799880864 -34.6136533749411,-58.4528522351197 -34.6135474614765,-58.4532459277165 -34.6137163015317,-58.4534282942866 -34.6137946282125,-58.4541413717558 -34.6128100672517)))";;"2785";6_2_2;COMUNA 6;"2";"2";"899";"437";"462";"94,59%";"377";"377";"100,00%";"0";"0,00%";"334";"0";"0";"334";"100,00%";"0";0.000
"MULTIPOLYGON (((-58.4553557687988 -34.6122248434688,-58.4547542470952 -34.6119639512209,-58.4541187437506 -34.6116884051901,-58.4535104239271 -34.6113500386947,-58.4533727818181 -34.6112734761606,-58.4529712696387 -34.6110560425007,-58.452278721425 -34.6106809011758,-58.452177682294 -34.6108125874615,-58.4516051507569 -34.6117634165066,-58.4529055354454 -34.6122985472898,-58.453527667976 -34.612556069785,-58.4541413717558 -34.6128100672517,-58.4547986053814 -34.6130820228446,-58.454158530616 -34.6141081435292,-58.4547765909855 -34.6143735469031,-58.4551947289869 -34.6137065070482,-58.4552546457324 -34.6123760400152,-58.4553557687988 -34.6122248434688)))";;"2786";6_2_3;COMUNA 6;"2";"3";"591";"275";"316";"87,03%";"281";"280";"99,64%";"1";"0,36%";"243";"10";"4.12";"233";"95,88%";"4.12";4.120
"MULTIPOLYGON (((-58.4534282942866 -34.6137946282125,-58.4532459277165 -34.6137163015317,-58.4528522351197 -34.6135474614765,-58.4527799880864 -34.6136533749411,-58.452250397317 -34.6144359645674,-58.4521648575562 -34.6145626519077,-58.4513701090813 -34.6157404398216,-58.4520358278215 -34.6157169778629,-58.4529959443663 -34.6156831131359,-58.4531845424791 -34.6156824237413,-58.4534277032539 -34.6152796111412,-58.4535222740384 -34.6151281339886,-58.454158530616 -34.6141081435292,-58.4547986053814 -34.6130820228446,-58.4541413717558 -34.6128100672517,-58.4534282942866 -34.6137946282125)))";;"2787";6_2_4;COMUNA 6;"2";"4";"667";"309";"358";"86,31%";"283";"283";"100,00%";"0";"0,00%";"247";"12";"4.86";"235";"95,14%";"4.86";4.860
"MULTIPOLYGON (((-58.4553557687988 -34.6122248434688,-58.4552546457324 -34.6123760400152,-58.4551947289869 -34.6137065070482,-58.4547765909855 -34.6143735469031,-58.454158530616 -34.6141081435292,-58.4535222740384 -34.6151281339886,-58.4534277032539 -34.6152796111412,-58.4531845424791 -34.6156824237413,-58.4532568639782 -34.6156821476606,-58.4539678975521 -34.615679735749,-58.4541366477021 -34.6156791138853,-58.4547210965617 -34.6156851396394,-58.4548412063038 -34.6156864150867,-58.4550843210618 -34.6156999521159,-58.4552767514745 -34.6157106685848,-58.4561623238544 -34.6157600167935,-58.457106418767 -34.6158126008233,-58.4573060050701 -34.6158252158956,-58.458499179768 -34.6159004767722,-58.4590330824291 -34.6147344662902,-58.4594483842544 -34.6138856446923,-58.459195822296 -34.6137895074708,-58.4573283326463 -34.6130368771255,-58.4570746687521 -34.6129346788938,-58.4569474111481 -34.6128833330717,-58.4558964778313 -34.612451150644,-58.455536430473 -34.6123031669148,-58.4553557687988 -34.6122248434688)))";;"2788";6_2_5;COMUNA 6;"2";"5";"634";"299";"335";"89,25%";"259";"258";"99,61%";"1";"0,39%";"226";"0";"0";"226";"100,00%";"0";0.000
"MULTIPOLYGON (((-58.4573060050701 -34.6158252158956,-58.457106418767 -34.6158126008233,-58.4561623238544 -34.6157600167935,-58.4552767514745 -34.6157106685848,-58.4550843210618 -34.6156999521159,-58.4548412063038 -34.6156864150867,-58.4547210965617 -34.6156851396394,-58.4541366477021 -34.6156791138853,-58.4539678975521 -34.615679735749,-58.4532568639782 -34.6156821476606,-58.4530984672777 -34.6160216544742,-58.4543707450702 -34.6164224664965,-58.4556596458274 -34.6168284072133,-58.4566924109993 -34.6171536852746,-58.4567592068021 -34.6170114299682,-58.4573060050701 -34.6158252158956)))";;"2789";6_2_6;COMUNA 6;"2";"6";"905";"395";"510";"77,45%";"391";"390";"99,74%";"1";"0,26%";"342";"8";"2.34";"334";"97,66%";"2.34";2.340
"MULTIPOLYGON (((-58.458499179768 -34.6159004767722,-58.4573060050701 -34.6158252158956,-58.4567592068021 -34.6170114299682,-58.4566924109993 -34.6171536852746,-58.4575915297695 -34.6174368348823,-58.4577657312247 -34.6175060698609,-58.4581986131446 -34.6165606304541,-58.458499179768 -34.6159004767722)))";;"2790";6_2_7;COMUNA 6;"2";"7";"737";"305";"432";"70,60%";"417";"417";"100,00%";"0";"0,00%";"346";"4";"1.16";"342";"98,84%";"1.16";1.160
"MULTIPOLYGON (((-58.455173055112 -34.6178975006175,-58.4545848865331 -34.6191895507755,-58.4545268637011 -34.6192903955209,-58.4555587155228 -34.6196431487422,-58.4566230321572 -34.6200070924132,-58.4572246361539 -34.6186903140222,-58.4572947553077 -34.6185368610292,-58.4577657312247 -34.6175060698609,-58.4575915297695 -34.6174368348823,-58.4566924109993 -34.6171536852746,-58.4556596458274 -34.6168284072133,-58.455173055112 -34.6178975006175)))";;"2791";6_2_8;COMUNA 6;"2";"8";"1089";"497";"592";"83,95%";"446";"445";"99,78%";"1";"0,22%";"368";"6";"1.63";"362";"98,37%";"1.63";1.630
"MULTIPOLYGON (((-58.4543707450702 -34.6164224664965,-58.4530984672777 -34.6160216544742,-58.4532568639782 -34.6156821476606,-58.4531845424791 -34.6156824237413,-58.4529959443663 -34.6156831131359,-58.4520358278215 -34.6157169778629,-58.4514370957634 -34.6167664685416,-58.4516702382522 -34.6168417742122,-58.4525868005157 -34.6171180606407,-58.4538608832698 -34.617502046476,-58.455173055112 -34.6178975006175,-58.4556596458274 -34.6168284072133,-58.4543707450702 -34.6164224664965)))";;"2792";6_2_9;COMUNA 6;"2";"9";"660";"291";"369";"78,86%";"296";"295";"99,66%";"1";"0,34%";"252";"3";"1.19";"249";"98,81%";"1.19";1.190
"MULTIPOLYGON (((-58.4382617607452 -34.6215853440443,-58.4376751282187 -34.6213413433868,-58.4369402879012 -34.6210356164018,-58.4368030807647 -34.6214760252239,-58.436658453154 -34.6219402359188,-58.4373121050688 -34.6222732725785,-58.4379309241921 -34.6225886219828,-58.4382617607452 -34.6215853440443)))";;"2793";6_20_1;COMUNA 6;"20";"1";"491";"226";"265";"85,28%";"273";"273";"100,00%";"0";"0,00%";"214";"4";"1.87";"210";"98,13%";"1.87";1.870
"MULTIPOLYGON (((-58.4294913035723 -34.6208004275889,-58.4283371951762 -34.6207052454858,-58.4280687721697 -34.6206839012314,-58.4279416552112 -34.6213313524218,-58.4278429654122 -34.6218338065068,-58.4277953282905 -34.6220745054584,-58.4291977349274 -34.6222981458461,-58.4292313006489 -34.6220848378104,-58.4294913035723 -34.6208004275889)))";;"2794";6_20_10;COMUNA 6;"20";"10";"864";"356";"508";"70,08%";"485";"485";"100,00%";"0";"0,00%";"385";"1";"0.26";"384";"99,74%";"0.26";0.260
"MULTIPOLYGON (((-58.4373121050688 -34.6222732725785,-58.436658453154 -34.6219402359188,-58.4362622537292 -34.6232125186692,-58.4365617804133 -34.6232391334296,-58.4369349206532 -34.6232416776871,-58.4372039564681 -34.623243565264,-58.4377296897222 -34.6231991654366,-58.4379309241921 -34.6225886219828,-58.4373121050688 -34.6222732725785)))";;"2795";6_20_2;COMUNA 6;"20";"2";"558";"242";"316";"76,58%";"344";"344";"100,00%";"0";"0,00%";"258";"1";"0.39";"257";"99,61%";"0.39";0.390
"MULTIPOLYGON (((-58.4368030807647 -34.6214760252239,-58.4354215249085 -34.6212956474194,-58.4351739704468 -34.6212721402904,-58.435099960618 -34.6214681867289,-58.4347043127039 -34.6228098332324,-58.4346576331021 -34.6230470842272,-58.4359818096704 -34.6231876679786,-58.4362622537292 -34.6232125186692,-58.436658453154 -34.6219402359188,-58.4368030807647 -34.6214760252239)))";;"2796";6_20_3;COMUNA 6;"20";"3";"970";"430";"540";"79,63%";"650";"650";"100,00%";"0";"0,00%";"447";"5";"1.12";"442";"98,88%";"1.12";1.120
"MULTIPOLYGON (((-58.4369402879012 -34.6210356164018,-58.4356841637957 -34.6205130729369,-58.4355003599403 -34.6204073241732,-58.4351739704468 -34.6212721402904,-58.4354215249085 -34.6212956474194,-58.4368030807647 -34.6214760252239,-58.4369402879012 -34.6210356164018)))";;"2797";6_20_4;COMUNA 6;"20";"4";"532";"243";"289";"84,08%";"343";"343";"100,00%";"0";"0,00%";"256";"2";"0.78";"254";"99,22%";"0.78";0.780
"MULTIPOLYGON (((-58.4355003599403 -34.6204073241732,-58.4341334826194 -34.6202108781269,-58.4338356465374 -34.620994145233,-58.4337897587162 -34.6211549146167,-58.4349181529321 -34.6212479265275,-58.4351739704468 -34.6212721402904,-58.4355003599403 -34.6204073241732)))";;"2798";6_20_5;COMUNA 6;"20";"5";"836";"352";"484";"72,73%";"528";"528";"100,00%";"0";"0,00%";"384";"2";"0.52";"382";"99,48%";"0.52";0.520
"MULTIPOLYGON (((-58.4351739704468 -34.6212721402904,-58.4349181529321 -34.6212479265275,-58.4337897587162 -34.6211549146167,-58.4337434443518 -34.6213168811023,-58.4334150723761 -34.6229129143923,-58.4346576331021 -34.6230470842272,-58.4347043127039 -34.6228098332324,-58.435099960618 -34.6214681867289,-58.4351739704468 -34.6212721402904)))";;"2799";6_20_6;COMUNA 6;"20";"6";"824";"368";"456";"80,70%";"484";"484";"100,00%";"0";"0,00%";"380";"2";"0.53";"378";"99,47%";"0.53";0.530
"MULTIPOLYGON (((-58.4331913172535 -34.621105544256,-58.4326211586687 -34.6210585019609,-58.4322093146086 -34.6225561981969,-58.4321543745072 -34.6227660508639,-58.4328330652441 -34.6228503063353,-58.4334150723761 -34.6229129143923,-58.4337434443518 -34.6213168811023,-58.4337897587162 -34.6211549146167,-58.4331913172535 -34.621105544256)))";;"2800";6_20_7;COMUNA 6;"20";"7";"603";"273";"330";"82,73%";"315";"315";"100,00%";"0";"0,00%";"254";"1";"0.39";"253";"99,61%";"0.39";0.390
"MULTIPOLYGON (((-58.4326211586687 -34.6210585019609,-58.4310911979582 -34.6209323360909,-58.4308156804672 -34.6223057628156,-58.4307591922207 -34.6225452633702,-58.4321543745072 -34.6227660508639,-58.4322093146086 -34.6225561981969,-58.4326211586687 -34.6210585019609)))";;"2801";6_20_8;COMUNA 6;"20";"8";"1194";"525";"669";"78,48%";"575";"575";"100,00%";"0";"0,00%";"483";"4";"0.83";"479";"99,17%";"0.83";0.830
"MULTIPOLYGON (((-58.4310911979582 -34.6209323360909,-58.4294913035723 -34.6208004275889,-58.4292313006489 -34.6220848378104,-58.4291977349274 -34.6222981458461,-58.4307591922207 -34.6225452633702,-58.4308156804672 -34.6223057628156,-58.4310911979582 -34.6209323360909)))";;"2802";6_20_9;COMUNA 6;"20";"9";"770";"351";"419";"83,77%";"371";"371";"100,00%";"0";"0,00%";"317";"3";"0.95";"314";"99,05%";"0.95";0.950
"MULTIPOLYGON (((-58.4362266415189 -34.6245599516503,-58.4344814895255 -34.6244592752961,-58.4343532175121 -34.6256264685664,-58.4343067041343 -34.6258683674008,-58.4346583785482 -34.6258960553268,-58.4352602671928 -34.6259328835979,-58.4361990952664 -34.6259903466467,-58.4362266415189 -34.6245599516503)))";;"2803";6_21_1;COMUNA 6;"21";"1";"620";"266";"354";"75,14%";"385";"385";"100,00%";"0";"0,00%";"293";"19";"6.48";"274";"93,52%";"6.48";6.480
"MULTIPOLYGON (((-58.4312201771618 -34.6263410767102,-58.4310509889826 -34.6263161729303,-58.429918469035 -34.6261522062943,-58.4296338436171 -34.6274128764268,-58.4309337820061 -34.6276008338618,-58.4323337418832 -34.6278032394872,-58.432624630487 -34.6265474944135,-58.4324643012744 -34.626524003277,-58.4312201771618 -34.6263410767102)))";;"2804";6_21_10;COMUNA 6;"21";"10";"825";"389";"436";"89,22%";"470";"470";"100,00%";"0";"0,00%";"368";"2";"0.54";"366";"99,46%";"0.54";0.540
"MULTIPOLYGON (((-58.4270405917933 -34.6257316663412,-58.4269716191785 -34.6260475724023,-58.4268193420074 -34.6267200857482,-58.4267558364569 -34.6269984567619,-58.4270800716138 -34.6270458774205,-58.4281601213502 -34.6272001369027,-58.4283671355998 -34.6272297033861,-58.4296338436171 -34.6274128764268,-58.429918469035 -34.6261522062943,-58.4299559348126 -34.6259862952212,-58.4300838578865 -34.6254341980058,-58.4285839068567 -34.6252772330792,-58.4271761351053 -34.6251348545483,-58.4270405917933 -34.6257316663412)))";;"2805";6_21_11;COMUNA 6;"21";"11";"1008";"453";"555";"81,62%";"474";"471";"99,37%";"3";"0,64%";"387";"1";"0.26";"386";"99,74%";"0.26";0.260
"MULTIPOLYGON (((-58.4362622537292 -34.6232125186692,-58.4359818096704 -34.6231876679786,-58.4346576331021 -34.6230470842272,-58.4346102706774 -34.6232873633111,-58.4344814895255 -34.6244592752961,-58.4362266415189 -34.6245599516503,-58.4362622537292 -34.6232125186692)))";;"2806";6_21_2;COMUNA 6;"21";"2";"992";"431";"561";"76,83%";"556";"556";"100,00%";"0";"0,00%";"452";"21";"4.65";"431";"95,35%";"4.65";4.650
"MULTIPOLYGON (((-58.4328330652441 -34.6228503063353,-58.4321543745072 -34.6227660508639,-58.4319698454234 -34.6234708175678,-58.4317899199807 -34.6241584718133,-58.431994286702 -34.6241888061576,-58.433119301848 -34.6243111306015,-58.4344814895255 -34.6244592752961,-58.4346102706774 -34.6232873633111,-58.4346576331021 -34.6230470842272,-58.4334150723761 -34.6229129143923,-58.4328330652441 -34.6228503063353)))";;"2807";6_21_3;COMUNA 6;"21";"3";"1027";"465";"562";"82,74%";"564";"564";"100,00%";"0";"0,00%";"454";"51";"11.23";"403";"88,77%";"11.23";11.230
"MULTIPOLYGON (((-58.4305944184154 -34.6232447513148,-58.4304213644833 -34.6239795196674,-58.431622354752 -34.6241334988045,-58.4317899199807 -34.6241584718133,-58.4319698454234 -34.6234708175678,-58.4321543745072 -34.6227660508639,-58.4307591922207 -34.6225452633702,-58.4305944184154 -34.6232447513148)))";;"2808";6_21_4;COMUNA 6;"21";"4";"614";"278";"336";"82,74%";"353";"353";"100,00%";"0";"0,00%";"262";"5";"1.91";"257";"98,09%";"1.91";1.910
"MULTIPOLYGON (((-58.4307591922207 -34.6225452633702,-58.4291977349274 -34.6222981458461,-58.4291599839231 -34.6225381437785,-58.4289196307615 -34.6236596654417,-58.4288941931501 -34.6237836063196,-58.4304213644833 -34.6239795196674,-58.4305944184154 -34.6232447513148,-58.4307591922207 -34.6225452633702)))";;"2809";6_21_5;COMUNA 6;"21";"5";"784";"362";"422";"85,78%";"411";"411";"100,00%";"0";"0,00%";"330";"4";"1.21";"326";"98,79%";"1.21";1.210
"MULTIPOLYGON (((-58.4291977349274 -34.6222981458461,-58.4277953282905 -34.6220745054584,-58.4274914866589 -34.6236075696746,-58.4277036911176 -34.6236308709752,-58.4288941931501 -34.6237836063196,-58.4289196307615 -34.6236596654417,-58.4291599839231 -34.6225381437785,-58.4291977349274 -34.6222981458461)))";;"2810";6_21_6;COMUNA 6;"21";"6";"523";"221";"302";"73,18%";"293";"292";"99,66%";"1";"0,34%";"231";"2";"0.87";"229";"99,13%";"0.87";0.870
"MULTIPOLYGON (((-58.4304213644833 -34.6239795196674,-58.4288941931501 -34.6237836063196,-58.4277036911176 -34.6236308709752,-58.4274914866589 -34.6236075696746,-58.4274620323837 -34.6237563691046,-58.4272374244697 -34.6248525387885,-58.4271761351053 -34.6251348545483,-58.4285839068567 -34.6252772330792,-58.4300838578865 -34.6254341980058,-58.4302568373173 -34.6246873876235,-58.4303837324447 -34.6241395151986,-58.4304213644833 -34.6239795196674)))";;"2811";6_21_7;COMUNA 6;"21";"7";"963";"427";"536";"79,66%";"445";"443";"99,55%";"2";"0,45%";"378";"41";"10.85";"337";"89,15%";"10.85";10.850
"MULTIPOLYGON (((-58.4300838578865 -34.6254341980058,-58.4299559348126 -34.6259862952212,-58.429918469035 -34.6261522062943,-58.4310509889826 -34.6263161729303,-58.4312201771618 -34.6263410767102,-58.4324643012744 -34.626524003277,-58.432624630487 -34.6265474944135,-58.4328162760073 -34.625720048583,-58.4328603044621 -34.6255299120334,-58.433119301848 -34.6243111306015,-58.431994286702 -34.6241888061576,-58.4317899199807 -34.6241584718133,-58.431622354752 -34.6241334988045,-58.4304213644833 -34.6239795196674,-58.4303837324447 -34.6241395151986,-58.4302568373173 -34.6246873876235,-58.4300838578865 -34.6254341980058)))";;"2812";6_21_8;COMUNA 6;"21";"8";"1223";"572";"651";"87,86%";"574";"573";"99,83%";"1";"0,17%";"465";"26";"5.59";"439";"94,41%";"5.59";5.590
"MULTIPOLYGON (((-58.432624630487 -34.6265474944135,-58.4323337418832 -34.6278032394872,-58.4325451037918 -34.6278337859089,-58.4338183040698 -34.6280200862079,-58.4341084040908 -34.6267649712722,-58.4343067041343 -34.6258683674008,-58.4343532175121 -34.6256264685664,-58.4344814895255 -34.6244592752961,-58.433119301848 -34.6243111306015,-58.4328603044621 -34.6255299120334,-58.4328162760073 -34.625720048583,-58.432624630487 -34.6265474944135)))";;"2813";6_21_9;COMUNA 6;"21";"9";"740";"345";"395";"87,34%";"364";"364";"100,00%";"0";"0,00%";"294";"4";"1.36";"290";"98,64%";"1.36";1.360
"MULTIPOLYGON (((-58.4543711993554 -34.610168367127,-58.4543035578823 -34.61026385895,-58.4535104239271 -34.6113500386947,-58.4541187437506 -34.6116884051901,-58.4547542470952 -34.6119639512209,-58.4555771904736 -34.6107958608395,-58.4556621244149 -34.6106752979775,-58.4563533429503 -34.6096943139991,-58.456886781496 -34.60893705918,-58.4556703253847 -34.6083721151432,-58.4555955313463 -34.6084752132133,-58.4551665265651 -34.6090701390125,-58.4550853421634 -34.6091818986542,-58.4544488931588 -34.6100585796461,-58.4543711993554 -34.610168367127)))";;"2814";6_3_1;COMUNA 6;"3";"1";"962";"427";"535";"79,81%";"446";"445";"99,78%";"1";"0,22%";"367";"14";"3.81";"353";"96,19%";"3.81";3.810
"MULTIPOLYGON (((-58.4458644454421 -34.6074420371976,-58.4456777571815 -34.6073574306904,-58.4453604763227 -34.6077721197046,-58.4451021507966 -34.608109771279,-58.444901589199 -34.6083720758306,-58.4444300003318 -34.6089889303005,-58.445229839541 -34.6092863823454,-58.4456260563204 -34.6094337678009,-58.4461617858871 -34.6096330038485,-58.4465721445453 -34.6097855995988,-58.4465407569321 -34.6086835126159,-58.4465136003391 -34.6077288258184,-58.446247447132 -34.607615617009,-58.4458644454421 -34.6074420371976)))";;"2815";6_3_10;COMUNA 6;"3";"10";"864";"407";"457";"89,06%";"476";"475";"99,79%";"1";"0,21%";"393";"3";"0.76";"390";"99,24%";"0.76";0.760
"MULTIPOLYGON (((-58.4533350104407 -34.6070490218665,-58.4532244611107 -34.6069747147932,-58.4525534191949 -34.6065218974965,-58.4524100817348 -34.6064249100461,-58.451687285953 -34.6070857870491,-58.4525669113419 -34.6076401092068,-58.4526765246309 -34.6077094166055,-58.452020215821 -34.6085819988478,-58.4519484847585 -34.6086750241521,-58.4520579281076 -34.6087477124864,-58.4525289189731 -34.6090685391377,-58.4531707669726 -34.6095057197271,-58.4532926452171 -34.6096072822158,-58.4538411620418 -34.6098905026954,-58.4543711993554 -34.610168367127,-58.4544488931588 -34.6100585796461,-58.4550853421634 -34.6091818986542,-58.4551665265651 -34.6090701390125,-58.4555955313463 -34.6084752132133,-58.4556703253847 -34.6083721151432,-58.4544515015711 -34.6077995528509,-58.4533350104407 -34.6070490218665)))";;"2816";6_3_2;COMUNA 6;"3";"2";"874";"393";"481";"81,70%";"388";"386";"99,48%";"2";"0,52%";"303";"27";"8.91";"276";"91,09%";"8.91";8.910
"MULTIPOLYGON (((-58.4538411620418 -34.6098905026954,-58.4532926452171 -34.6096072822158,-58.4531707669726 -34.6095057197271,-58.4525289189731 -34.6090685391377,-58.4520579281076 -34.6087477124864,-58.4519484847585 -34.6086750241521,-58.4509547119559 -34.6099637123675,-58.4515934191152 -34.6103097003635,-58.452278721425 -34.6106809011758,-58.4529712696387 -34.6110560425007,-58.4533727818181 -34.6112734761606,-58.4535104239271 -34.6113500386947,-58.4543035578823 -34.61026385895,-58.4543711993554 -34.610168367127,-58.4538411620418 -34.6098905026954)))";;"2817";6_3_3;COMUNA 6;"3";"3";"909";"445";"464";"95,91%";"447";"447";"100,00%";"0";"0,00%";"349";"5";"1.43";"344";"98,57%";"1.43";1.430
"MULTIPOLYGON (((-58.4515934191152 -34.6103097003635,-58.4509547119559 -34.6099637123675,-58.4499204758143 -34.6094035174144,-58.4491726421398 -34.6108055304727,-58.4502585294332 -34.6112331264438,-58.4516051507569 -34.6117634165066,-58.452177682294 -34.6108125874615,-58.452278721425 -34.6106809011758,-58.4515934191152 -34.6103097003635)))";;"2818";6_3_4;COMUNA 6;"3";"4";"635";"281";"354";"79,38%";"294";"293";"99,66%";"1";"0,34%";"243";"1";"0.41";"242";"99,59%";"0.41";0.410
"MULTIPOLYGON (((-58.4499204758143 -34.6094035174144,-58.4488934929976 -34.6088471878477,-58.4480329366746 -34.6103566499655,-58.4491726421398 -34.6108055304727,-58.4499204758143 -34.6094035174144)))";;"2819";6_3_5;COMUNA 6;"3";"5";"720";"346";"374";"92,51%";"309";"309";"100,00%";"0";"0,00%";"260";"5";"1.92";"255";"98,08%";"1.92";1.920
"MULTIPOLYGON (((-58.4509851384103 -34.6080180801875,-58.4501578193548 -34.6074517797739,-58.4500195932668 -34.6073571845105,-58.4488934929976 -34.6088471878477,-58.4499204758143 -34.6094035174144,-58.4509547119559 -34.6099637123675,-58.4519484847585 -34.6086750241521,-58.451838871246 -34.6086023357037,-58.4509851384103 -34.6080180801875)))";;"2820";6_3_6;COMUNA 6;"3";"6";"880";"399";"481";"82,95%";"433";"433";"100,00%";"0";"0,00%";"356";"4";"1.12";"352";"98,88%";"1.12";1.120
"MULTIPOLYGON (((-58.4507387710852 -34.6064940560066,-58.4506559780317 -34.6065151049849,-58.4500195932668 -34.6073571845105,-58.4501578193548 -34.6074517797739,-58.4509851384103 -34.6080180801875,-58.451838871246 -34.6086023357037,-58.4519484847585 -34.6086750241521,-58.452020215821 -34.6085819988478,-58.4526765246309 -34.6077094166055,-58.4525669113419 -34.6076401092068,-58.451687285953 -34.6070857870491,-58.4524100817348 -34.6064249100461,-58.4522633379091 -34.6063255981041,-58.4520150738248 -34.6061672608486,-58.4515075860897 -34.6062984174304,-58.4510499260992 -34.6064148578077,-58.4507387710852 -34.6064940560066)))";;"2821";6_3_7;COMUNA 6;"3";"7";"876";"396";"480";"82,50%";"440";"439";"99,77%";"1";"0,23%";"370";"2";"0.54";"368";"99,46%";"0.54";0.540
"MULTIPOLYGON (((-58.4490619887586 -34.6069141819997,-58.4490616083139 -34.6069145999531,-58.4487697440631 -34.6072351422773,-58.448341910679 -34.6077067299012,-58.4478085178285 -34.6082947159057,-58.4479592689486 -34.6083610746928,-58.4482539565448 -34.6085007629881,-58.4488934929976 -34.6088471878477,-58.4500195932668 -34.6073571845105,-58.4506559780317 -34.6065151049849,-58.4502369866001 -34.6066217570223,-58.4492899725587 -34.6068576513151,-58.4492900781285 -34.606857723594,-58.4490619887586 -34.6069141819997)))";;"2822";6_3_8;COMUNA 6;"3";"8";"732";"313";"419";"74,70%";"367";"367";"100,00%";"0";"0,00%";"305";"8";"2.62";"297";"97,38%";"2.62";2.620
"MULTIPOLYGON (((-58.4490616083139 -34.6069145999531,-58.4470400474061 -34.6074181787735,-58.4466272653969 -34.6075210162368,-58.446247447132 -34.607615617009,-58.4465136003391 -34.6077288258184,-58.4465407569321 -34.6086835126159,-58.4465721445453 -34.6097855995988,-58.4467625896331 -34.6098564018719,-58.4480329366746 -34.6103566499655,-58.4488934929976 -34.6088471878477,-58.4482539565448 -34.6085007629881,-58.4479592689486 -34.6083610746928,-58.4478085178285 -34.6082947159057,-58.448341910679 -34.6077067299012,-58.4487697440631 -34.6072351422773,-58.4490616083139 -34.6069145999531)))";;"2823";6_3_9;COMUNA 6;"3";"9";"1142";"530";"612";"86,60%";"510";"510";"100,00%";"0";"0,00%";"451";"7";"1.55";"444";"98,45%";"1.55";1.550
"MULTIPOLYGON (((-58.4497008692723 -34.6122512039648,-58.4491270901089 -34.6133062501407,-58.4502375386731 -34.6137576525328,-58.4503673485016 -34.6138120338827,-58.4506894998803 -34.6132789481766,-58.4510027862498 -34.6127603682914,-58.4516051507569 -34.6117634165066,-58.4502585294332 -34.6112331264438,-58.4497784058878 -34.6121086013853,-58.4497008692723 -34.6122512039648)))";;"2824";6_4_1;COMUNA 6;"4";"1";"554";"257";"297";"86,53%";"245";"245";"100,00%";"0";"0,00%";"208";"1";"0.48";"207";"99,52%";"0.48";0.480
"MULTIPOLYGON (((-58.4433575395296 -34.6159297914782,-58.4450627538826 -34.6159767417297,-58.4455253888002 -34.6159894842455,-58.445920984726 -34.6159964409508,-58.4461819043064 -34.6160009837611,-58.4452285969712 -34.6156242177825,-58.4437319593152 -34.6150327054849,-58.4424050111651 -34.6145082477835,-58.4421503230982 -34.6151614680316,-58.4419431090927 -34.6156928604238,-58.4419050073497 -34.6157905334826,-58.4418520668977 -34.6159542626901,-58.442264617613 -34.6159467970128,-58.4433575395296 -34.6159297914782)))";;"2825";6_4_10;COMUNA 6;"4";"10";"804";"391";"413";"94,67%";"426";"426";"100,00%";"0";"0,00%";"339";"10";"2.95";"329";"97,05%";"2.95";2.950
"MULTIPOLYGON (((-58.4406897839249 -34.6147568325703,-58.4406292236908 -34.6150592972693,-58.4405642508341 -34.6159380493322,-58.4406305238562 -34.6159401740906,-58.4408635868411 -34.615947681085,-58.4418520668977 -34.6159542626901,-58.4419050073497 -34.6157905334826,-58.4419431090927 -34.6156928604238,-58.4421503230982 -34.6151614680316,-58.4424050111651 -34.6145082477835,-58.4409933317953 -34.6139502382263,-58.4407337963749 -34.6145372551511,-58.4406897839249 -34.6147568325703)))";;"2826";6_4_11;COMUNA 6;"4";"11";"762";"343";"419";"81,86%";"419";"419";"100,00%";"0";"0,00%";"345";"1";"0.29";"344";"99,71%";"0.29";0.290
"MULTIPOLYGON (((-58.4474575360061 -34.6113845043316,-58.4466083556635 -34.6110563551446,-58.4466380527079 -34.6120999182052,-58.4466272779939 -34.612317600751,-58.4468818649662 -34.6124157361781,-58.4480589000349 -34.6128748434125,-58.4475228630971 -34.6137571337471,-58.4474404672756 -34.613891071962,-58.4485581535468 -34.6143512936352,-58.4486312630322 -34.6142177761553,-58.4491270901089 -34.6133062501407,-58.4497008692723 -34.6122512039648,-58.4497784058878 -34.6121086013853,-58.4502585294332 -34.6112331264438,-58.4491726421398 -34.6108055304727,-58.4486234876951 -34.611835012948,-58.4474575360061 -34.6113845043316)))";;"2827";6_4_2;COMUNA 6;"4";"2";"658";"308";"350";"88,00%";"272";"272";"100,00%";"0";"0,00%";"227";"2";"0.88";"225";"99,12%";"0.88";0.880
"MULTIPOLYGON (((-58.4480329366746 -34.6103566499655,-58.4467625896331 -34.6098564018719,-58.4465721445453 -34.6097855995988,-58.4466083556635 -34.6110563551446,-58.4474575360061 -34.6113845043316,-58.4486234876951 -34.611835012948,-58.4491726421398 -34.6108055304727,-58.4480329366746 -34.6103566499655)))";;"2828";6_4_3;COMUNA 6;"4";"3";"831";"391";"440";"88,86%";"394";"394";"100,00%";"0";"0,00%";"339";"18";"5.31";"321";"94,69%";"5.31";5.310
"MULTIPOLYGON (((-58.445229839541 -34.6092863823454,-58.4444300003318 -34.6089889303005,-58.4436845604252 -34.6099640635277,-58.4441007927144 -34.6101201897527,-58.4447924725541 -34.6103795280879,-58.4450530992472 -34.6104772456967,-58.4451911636337 -34.6105283942205,-58.4457254514019 -34.6107263642902,-58.4464287254882 -34.6109869625894,-58.4466083556635 -34.6110563551446,-58.4465721445453 -34.6097855995988,-58.4461617858871 -34.6096330038485,-58.4456260563204 -34.6094337678009,-58.445229839541 -34.6092863823454)))";;"2829";6_4_4;COMUNA 6;"4";"4";"773";"344";"429";"80,19%";"417";"417";"100,00%";"0";"0,00%";"319";"2";"0.63";"317";"99,37%";"0.63";0.630
"MULTIPOLYGON (((-58.4451911636337 -34.6105283942205,-58.4450530992472 -34.6104772456967,-58.4447924725541 -34.6103795280879,-58.4441007927144 -34.6101201897527,-58.4436979093652 -34.6111912936129,-58.4442221464623 -34.6113899025046,-58.4443691545223 -34.6114466168884,-58.4447656343846 -34.6115995687099,-58.4452865540747 -34.611800496556,-58.4466272779939 -34.612317600751,-58.4466380527079 -34.6120999182052,-58.4466083556635 -34.6110563551446,-58.4464287254882 -34.6109869625894,-58.4457254514019 -34.6107263642902,-58.4451911636337 -34.6105283942205)))";;"2830";6_4_5;COMUNA 6;"4";"5";"731";"343";"388";"88,40%";"341";"341";"100,00%";"0";"0,00%";"288";"2";"0.69";"286";"99,31%";"0.69";0.690
"MULTIPOLYGON (((-58.4432797588518 -34.6123029583766,-58.4446185191158 -34.6128205772661,-58.4447490918921 -34.6128682743314,-58.4457619093129 -34.613236812764,-58.4461897462234 -34.6133946940193,-58.4464558357241 -34.6134919163485,-58.4466272779939 -34.612317600751,-58.4452865540747 -34.611800496556,-58.4447656343846 -34.6115995687099,-58.4443691545223 -34.6114466168884,-58.4442221464623 -34.6113899025046,-58.4436979093652 -34.6111912936129,-58.4441007927144 -34.6101201897527,-58.4436845604252 -34.6099640635277,-58.4429600637287 -34.6109117296394,-58.4423948034268 -34.6116511004635,-58.4422227647388 -34.6118950946747,-58.4424668691403 -34.6119886599293,-58.4432797588518 -34.6123029583766)))";;"2831";6_4_6;COMUNA 6;"4";"6";"774";"365";"409";"89,24%";"400";"400";"100,00%";"0";"0,00%";"322";"2";"0.62";"320";"99,38%";"0.62";0.620
"MULTIPOLYGON (((-58.4465931995225 -34.6149954393855,-58.4466193911153 -34.6152285497899,-58.4466576511893 -34.6156061739809,-58.4466960815729 -34.6159859109105,-58.4468385969153 -34.6159780419173,-58.4476965859736 -34.6159236414627,-58.4479462572988 -34.6154680218155,-58.4485581535468 -34.6143512936352,-58.4474404672756 -34.613891071962,-58.4475228630971 -34.6137571337471,-58.4480589000349 -34.6128748434125,-58.4468818649662 -34.6124157361781,-58.4466272779939 -34.612317600751,-58.4464558357241 -34.6134919163485,-58.4465687089229 -34.6147769071797,-58.4465931995225 -34.6149954393855)))";;"2832";6_4_7;COMUNA 6;"4";"7";"673";"333";"340";"97,94%";"304";"304";"100,00%";"0";"0,00%";"242";"1";"0.41";"241";"99,59%";"0.41";0.410
"MULTIPOLYGON (((-58.4464558357241 -34.6134919163485,-58.4461897462234 -34.6133946940193,-58.4457619093129 -34.613236812764,-58.4447490918921 -34.6128682743314,-58.4446185191158 -34.6128205772661,-58.4432797588518 -34.6123029583766,-58.4424668691403 -34.6119886599293,-58.4422227647388 -34.6118950946747,-58.4414638736939 -34.6129717645732,-58.4428260537594 -34.6135091965965,-58.444164402352 -34.6140371727882,-58.4450601931429 -34.6143906281766,-58.4456603440066 -34.6146274121265,-58.4465931995225 -34.6149954393855,-58.4465687089229 -34.6147769071797,-58.4464558357241 -34.6134919163485)))";;"2833";6_4_8;COMUNA 6;"4";"8";"883";"391";"492";"79,47%";"479";"479";"100,00%";"0";"0,00%";"370";"10";"2.7";"360";"97,30%";"2.7";2.700
"MULTIPOLYGON (((-58.4452285969712 -34.6156242177825,-58.4461819043064 -34.6160009837611,-58.4466960815729 -34.6159859109105,-58.4466576511893 -34.6156061739809,-58.4466193911153 -34.6152285497899,-58.4465931995225 -34.6149954393855,-58.4456603440066 -34.6146274121265,-58.4450601931429 -34.6143906281766,-58.444164402352 -34.6140371727882,-58.4428260537594 -34.6135091965965,-58.4414638736939 -34.6129717645732,-58.4413622152336 -34.6131159774063,-58.4409933317953 -34.6139502382263,-58.4424050111651 -34.6145082477835,-58.4437319593152 -34.6150327054849,-58.4452285969712 -34.6156242177825)))";;"2834";6_4_9;COMUNA 6;"4";"9";"1080";"433";"647";"66,92%";"388";"379";"97,68%";"9";"2,37%";"322";"8";"2.48";"314";"97,52%";"2.48";2.480
"MULTIPOLYGON (((-58.4453604763227 -34.6077721197046,-58.4451080053811 -34.6078130709974,-58.443741131531 -34.6080349871582,-58.4433503840182 -34.608587411025,-58.4444300003318 -34.6089889303005,-58.444901589199 -34.6083720758306,-58.4451021507966 -34.608109771279,-58.4453604763227 -34.6077721197046)))";;"2835";6_5_1;COMUNA 6;"5";"1";"741";"300";"441";"68,03%";"475";"475";"100,00%";"0";"0,00%";"383";"1";"0.26";"382";"99,74%";"0.26";0.260
"MULTIPOLYGON (((-58.4411093816116 -34.6102104750289,-58.4408453690185 -34.6113527232971,-58.4410266098887 -34.6114369840507,-58.4411342666973 -34.6114782018124,-58.4422227647388 -34.6118950946747,-58.4423948034268 -34.6116511004635,-58.4429600637287 -34.6109117296394,-58.4418817942349 -34.6105031551987,-58.442605276559 -34.6095593686427,-58.4424333177599 -34.609494901211,-58.4413706557186 -34.6090899868601,-58.4413290454915 -34.609260056263,-58.4411093816116 -34.6102104750289)))";;"2836";6_5_10;COMUNA 6;"5";"10";"978";"463";"515";"89,90%";"495";"495";"100,00%";"0";"0,00%";"407";"2";"0.49";"405";"99,51%";"0.49";0.490
"MULTIPOLYGON (((-58.4414501130632 -34.6088079480766,-58.4401196467537 -34.6087979904294,-58.4393007021121 -34.6107993884661,-58.4394818601167 -34.6108654114027,-58.4406205217802 -34.6112483832348,-58.4408453690185 -34.6113527232971,-58.4411093816116 -34.6102104750289,-58.4413290454915 -34.609260056263,-58.4413706557186 -34.6090899868601,-58.4414501130632 -34.6088079480766)))";;"2837";6_5_11;COMUNA 6;"5";"11";"936";"407";"529";"76,94%";"485";"485";"100,00%";"0";"0,00%";"416";"3";"0.72";"413";"99,28%";"0.72";0.720
"MULTIPOLYGON (((-58.4401196467537 -34.6087979904294,-58.4388588527594 -34.6087985252528,-58.4383553174875 -34.6104373592684,-58.4390698048497 -34.6107152563833,-58.4393007021121 -34.6107993884661,-58.4401196467537 -34.6087979904294)))";;"2838";6_5_12;COMUNA 6;"5";"12";"369";"156";"213";"73,24%";"180";"180";"100,00%";"0";"0,00%";"159";"23";"14.47";"136";"85,53%";"14.47";14.470
"MULTIPOLYGON (((-58.4456777571815 -34.6073574306904,-58.4452634910376 -34.6072191276205,-58.4451314780528 -34.6071750929634,-58.4441672610476 -34.6069228986913,-58.4429800752824 -34.606612348926,-58.4426295892454 -34.6076359917846,-58.4425882529539 -34.6077433833246,-58.4425259499357 -34.6079055621451,-58.4424037227207 -34.6082521039921,-58.4433503840182 -34.608587411025,-58.443741131531 -34.6080349871582,-58.4451080053811 -34.6078130709974,-58.4453604763227 -34.6077721197046,-58.4456777571815 -34.6073574306904)))";;"2839";6_5_2;COMUNA 6;"5";"2";"1015";"446";"569";"78,38%";"689";"689";"100,00%";"0";"0,00%";"453";"1";"0.22";"452";"99,78%";"0.22";0.220
"MULTIPOLYGON (((-58.4415946728915 -34.607742792949,-58.4415925516424 -34.6083837317898,-58.4424037227207 -34.6082521039921,-58.4425259499357 -34.6079055621451,-58.4425882529539 -34.6077433833246,-58.4426295892454 -34.6076359917846,-58.4429800752824 -34.606612348926,-58.4428240443641 -34.6065714770162,-58.4415997379745 -34.6062390759511,-58.4415989050046 -34.6065015503803,-58.4415946728915 -34.607742792949)))";;"2840";6_5_3;COMUNA 6;"5";"3";"774";"344";"430";"80,00%";"476";"476";"100,00%";"0";"0,00%";"372";"12";"3.23";"360";"96,77%";"3.23";3.230
"MULTIPOLYGON (((-58.4415989050046 -34.6065015503803,-58.4401321096829 -34.6064943862255,-58.4401235175759 -34.6070847587138,-58.4401152709119 -34.6076571727961,-58.4401145665815 -34.6077418236899,-58.4415946728915 -34.607742792949,-58.4415989050046 -34.6065015503803)))";;"2841";6_5_4;COMUNA 6;"5";"4";"637";"308";"329";"93,62%";"348";"348";"100,00%";"0";"0,00%";"293";"5";"1.71";"288";"98,29%";"1.71";1.710
"MULTIPOLYGON (((-58.4387286846666 -34.6064874986046,-58.4387207647601 -34.6070753358193,-58.438713627587 -34.6076066217388,-58.4387127372038 -34.6077409223152,-58.4401145665815 -34.6077418236899,-58.4401152709119 -34.6076571727961,-58.4401235175759 -34.6070847587138,-58.4401321096829 -34.6064943862255,-58.4415989050046 -34.6065015503803,-58.4415997379745 -34.6062390759511,-58.4414652562619 -34.6062034879134,-58.4403350722207 -34.6058936265379,-58.4401415705689 -34.6058405607655,-58.439285379801 -34.6056058132306,-58.4388116154466 -34.6062475785026,-58.438730426231 -34.6063550292219,-58.4387286846666 -34.6064874986046)))";;"2842";6_5_5;COMUNA 6;"5";"5";"939";"436";"503";"86,68%";"472";"471";"99,79%";"1";"0,21%";"392";"17";"4.34";"375";"95,66%";"4.34";4.340
"MULTIPOLYGON (((-58.4401145665815 -34.6077418236899,-58.4387127372038 -34.6077409223152,-58.4387051931274 -34.608798002154,-58.4388588527594 -34.6087985252528,-58.4401196467537 -34.6087979904294,-58.4401145665815 -34.6077418236899)))";;"2843";6_5_6;COMUNA 6;"5";"6";"689";"327";"362";"90,33%";"379";"379";"100,00%";"0";"0,00%";"304";"4";"1.32";"300";"98,68%";"1.32";1.320
"MULTIPOLYGON (((-58.4424037227207 -34.6082521039921,-58.4415925516424 -34.6083837317898,-58.4415946728915 -34.607742792949,-58.4401145665815 -34.6077418236899,-58.4401196467537 -34.6087979904294,-58.4414501130632 -34.6088079480766,-58.4413706557186 -34.6090899868601,-58.4424333177599 -34.609494901211,-58.442605276559 -34.6095593686427,-58.4433503840182 -34.608587411025,-58.4424037227207 -34.6082521039921)))";;"2844";6_5_7;COMUNA 6;"5";"7";"749";"324";"425";"76,24%";"403";"403";"100,00%";"0";"0,00%";"334";"3";"0.9";"331";"99,10%";"0.9";0.900
"MULTIPOLYGON (((-58.4444300003318 -34.6089889303005,-58.4433503840182 -34.608587411025,-58.442605276559 -34.6095593686427,-58.4436845604252 -34.6099640635277,-58.4444300003318 -34.6089889303005)))";;"2845";6_5_8;COMUNA 6;"5";"8";"466";"212";"254";"83,46%";"279";"279";"100,00%";"0";"0,00%";"205";"0";"0";"205";"100,00%";"0";0.000
"MULTIPOLYGON (((-58.4436845604252 -34.6099640635277,-58.442605276559 -34.6095593686427,-58.4418817942349 -34.6105031551987,-58.4429600637287 -34.6109117296394,-58.4436845604252 -34.6099640635277)))";;"2846";6_5_9;COMUNA 6;"5";"9";"569";"255";"314";"81,21%";"300";"300";"100,00%";"0";"0,00%";"237";"1";"0.42";"236";"99,58%";"0.42";0.420
"MULTIPOLYGON (((-58.4411342666973 -34.6114782018124,-58.4410266098887 -34.6114369840507,-58.4408453690185 -34.6113527232971,-58.4408087001 -34.6115111027772,-58.4405379986075 -34.6124702437036,-58.4404881325466 -34.6126022816772,-58.4414638736939 -34.6129717645732,-58.4422227647388 -34.6118950946747,-58.4411342666973 -34.6114782018124)))";;"2847";6_6_1;COMUNA 6;"6";"1";"1118";"508";"610";"83,28%";"672";"672";"100,00%";"0";"0,00%";"546";"5";"0.92";"541";"99,08%";"0.92";0.920
"MULTIPOLYGON (((-58.4408453690185 -34.6113527232971,-58.4406205217802 -34.6112483832348,-58.4394818601167 -34.6108654114027,-58.4393007021121 -34.6107993884661,-58.4392360917591 -34.6109573395747,-58.4389053024982 -34.6116854710721,-58.4384772538491 -34.612627533733,-58.4384009682547 -34.6127937921928,-58.4400601709262 -34.6135860414144,-58.4401213703599 -34.6134433011234,-58.4404242867406 -34.612771219821,-58.4404881325466 -34.6126022816772,-58.4405379986075 -34.6124702437036,-58.4408087001 -34.6115111027772,-58.4408453690185 -34.6113527232971)))";;"2848";6_6_2;COMUNA 6;"6";"2";"1836";"831";"1005";"82,69%";"939";"939";"100,00%";"0";"0,00%";"792";"4";"0.51";"788";"99,49%";"0.51";0.510
"MULTIPOLYGON (((-58.4393007021121 -34.6107993884661,-58.4390698048497 -34.6107152563833,-58.4383553174875 -34.6104373592684,-58.4380925436151 -34.6112927603384,-58.4380441148685 -34.6114504323646,-58.4377298352344 -34.6124732929545,-58.4384009682547 -34.6127937921928,-58.4384772538491 -34.612627533733,-58.4389053024982 -34.6116854710721,-58.4392360917591 -34.6109573395747,-58.4393007021121 -34.6107993884661)))";;"2849";6_6_3;COMUNA 6;"6";"3";"1107";"489";"618";"79,13%";"629";"629";"100,00%";"0";"0,00%";"509";"4";"0.79";"505";"99,21%";"0.79";0.790
"MULTIPOLYGON (((-58.4384009682547 -34.6127937921928,-58.4377298352344 -34.6124732929545,-58.4376710028666 -34.6126647667139,-58.4372909871838 -34.6138562100913,-58.437012503294 -34.6142058826767,-58.4369536043544 -34.6143277760545,-58.4377431614637 -34.6146233732784,-58.437812152896 -34.6140759028965,-58.4384009682547 -34.6127937921928)))";;"2850";6_6_4;COMUNA 6;"6";"4";"482";"208";"274";"75,91%";"301";"301";"100,00%";"0";"0,00%";"226";"1";"0.44";"225";"99,56%";"0.44";0.440
"MULTIPOLYGON (((-58.4400601709262 -34.6135860414144,-58.4384009682547 -34.6127937921928,-58.437812152896 -34.6140759028965,-58.4395770460595 -34.6147127519277,-58.4396502656036 -34.6145424075517,-58.4400601709262 -34.6135860414144)))";;"2851";6_6_5;COMUNA 6;"6";"5";"677";"293";"384";"76,30%";"258";"257";"99,61%";"1";"0,39%";"201";"2";"1";"199";"99,00%";"1";1.000
"MULTIPOLYGON (((-58.4400601709262 -34.6135860414144,-58.4396502656036 -34.6145424075517,-58.4395770460595 -34.6147127519277,-58.4406897839249 -34.6147568325703,-58.4407337963749 -34.6145372551511,-58.4409933317953 -34.6139502382263,-58.4413622152336 -34.6131159774063,-58.4414638736939 -34.6129717645732,-58.4404881325466 -34.6126022816772,-58.4404242867406 -34.612771219821,-58.4401213703599 -34.6134433011234,-58.4400601709262 -34.6135860414144)))";;"2852";6_6_6;COMUNA 6;"6";"6";"786";"360";"426";"84,51%";"438";"437";"99,77%";"1";"0,23%";"333";"7";"2.1";"326";"97,90%";"2.1";2.100
"MULTIPOLYGON (((-58.4406897839249 -34.6147568325703,-58.4395770460595 -34.6147127519277,-58.439115474814 -34.615786363997,-58.439056654468 -34.6159384002954,-58.4404250604619 -34.6159335872191,-58.4405642508341 -34.6159380493322,-58.4406292236908 -34.6150592972693,-58.4406897839249 -34.6147568325703)))";;"2853";6_6_7;COMUNA 6;"6";"7";"741";"322";"419";"76,85%";"438";"438";"100,00%";"0";"0,00%";"350";"4";"1.14";"346";"98,86%";"1.14";1.140
"MULTIPOLYGON (((-58.437812152896 -34.6140759028965,-58.4377431614637 -34.6146233732784,-58.4375841699176 -34.615886343625,-58.4375769971691 -34.6159435977134,-58.439056654468 -34.6159384002954,-58.439115474814 -34.615786363997,-58.4395770460595 -34.6147127519277,-58.437812152896 -34.6140759028965)))";;"2854";6_6_8;COMUNA 6;"6";"8";"1009";"450";"559";"80,50%";"507";"505";"99,61%";"2";"0,40%";"408";"9";"2.21";"399";"97,79%";"2.21";2.210
"MULTIPOLYGON (((-58.4377431614637 -34.6146233732784,-58.4369536043544 -34.6143277760545,-58.4363667366433 -34.6155417788364,-58.4375841699176 -34.615886343625,-58.4377431614637 -34.6146233732784)))";;"2855";6_6_9;COMUNA 6;"6";"9";"761";"326";"435";"74,94%";"439";"439";"100,00%";"0";"0,00%";"356";"0";"0";"356";"100,00%";"0";0.000
"MULTIPOLYGON (((-58.4338657440282 -34.6029358200767,-58.4333341121189 -34.602673429842,-58.4323301705341 -34.6039281610538,-58.433219322885 -34.6043002945266,-58.4339139427525 -34.6029596351743,-58.4338657440282 -34.6029358200767)))";;"2856";6_7_1;COMUNA 6;"7";"1";"593";"264";"329";"80,24%";"332";"332";"100,00%";"0";"0,00%";"280";"3";"1.07";"277";"98,93%";"1.07";1.070
"MULTIPOLYGON (((-58.4327802496165 -34.6090721961612,-58.4327106886856 -34.6092281003134,-58.4323140378815 -34.6101035976964,-58.4322586272021 -34.6102257714578,-58.4319813157526 -34.6108368510603,-58.431933235533 -34.610942758305,-58.4316767191762 -34.6115110239241,-58.4324104335605 -34.6118182617132,-58.4327174884265 -34.6111638771084,-58.4329469664621 -34.6106751830495,-58.4330002546305 -34.6105314583837,-58.4330503026881 -34.610396536043,-58.4332642418842 -34.6092753495297,-58.4342770308225 -34.6097003940166,-58.434733229149 -34.6087320835288,-58.4341967276224 -34.6087357562454,-58.4329245705555 -34.6087490505484,-58.4327802496165 -34.6090721961612)))";;"2857";6_7_10;COMUNA 6;"7";"10";"778";"352";"426";"82,63%";"393";"392";"99,75%";"1";"0,26%";"326";"1";"0.31";"325";"99,69%";"0.31";0.310
"MULTIPOLYGON (((-58.4321080647271 -34.6087411017878,-58.4318161634979 -34.6087382816681,-58.4311857979936 -34.609783511031,-58.4322586272021 -34.6102257714578,-58.4323140378815 -34.6101035976964,-58.4327106886856 -34.6092281003134,-58.4327802496165 -34.6090721961612,-58.4329245705555 -34.6087490505484,-58.4321080647271 -34.6087411017878)))";;"2858";6_7_11;COMUNA 6;"7";"11";"613";"296";"317";"93,38%";"311";"311";"100,00%";"0";"0,00%";"293";"31";"10.58";"262";"89,42%";"10.58";10.580
"MULTIPOLYGON (((-58.4304139505004 -34.6094654102272,-58.430370661783 -34.6101719035516,-58.4319813157526 -34.6108368510603,-58.4322586272021 -34.6102257714578,-58.4311857979936 -34.609783511031,-58.4318161634979 -34.6087382816681,-58.4304739462198 -34.6087252580068,-58.4304139505004 -34.6094654102272)))";;"2859";6_7_12;COMUNA 6;"7";"12";"652";"296";"356";"83,15%";"332";"332";"100,00%";"0";"0,00%";"286";"2";"0.7";"284";"99,30%";"0.7";0.700
"MULTIPOLYGON (((-58.4319813157526 -34.6108368510603,-58.430370661783 -34.6101719035516,-58.4303302540484 -34.6109154411486,-58.4316767191762 -34.6115110239241,-58.431933235533 -34.610942758305,-58.4319813157526 -34.6108368510603)))";;"2860";6_7_13;COMUNA 6;"7";"13";"491";"212";"279";"75,99%";"289";"289";"100,00%";"0";"0,00%";"236";"1";"0.42";"235";"99,58%";"0.42";0.420
"MULTIPOLYGON (((-58.4315295122246 -34.6049437719506,-58.4306691341148 -34.6059413329139,-58.432075324627 -34.6065085460807,-58.432631648439 -34.6054347007075,-58.433219322885 -34.6043002945266,-58.4323301705341 -34.6039281610538,-58.4315295122246 -34.6049437719506)))";;"2861";6_7_2;COMUNA 6;"7";"2";"803";"359";"444";"80,86%";"431";"430";"99,77%";"1";"0,23%";"343";"3";"0.87";"340";"99,13%";"0.87";0.870
"MULTIPOLYGON (((-58.4329043171384 -34.6063537274017,-58.4329430226638 -34.606210651088,-58.432986074 -34.6061035449097,-58.4330257957829 -34.6060179175793,-58.4330523034737 -34.605966020678,-58.4330831570716 -34.605908349962,-58.4331307986905 -34.6058260344995,-58.4331699157712 -34.6057635768513,-58.4332027252037 -34.6057144280215,-58.4332669787086 -34.6056231020967,-58.4333315701649 -34.6055391708606,-58.4333656541739 -34.6054981211864,-58.4334008451867 -34.6054577055948,-58.4334690951254 -34.6053844093628,-58.433518427909 -34.6053353348276,-58.4335634144161 -34.6052930200507,-58.4336153014887 -34.6052462701162,-58.4336686360372 -34.6052007177316,-58.4337350901863 -34.6051467174178,-58.4337786255293 -34.605113064512,-58.4338230975501 -34.6050799752136,-58.4338945756151 -34.6050292155587,-58.4339474807043 -34.6049932407729,-58.4340013222911 -34.6049583225619,-58.4340491148355 -34.604928332669,-58.4341183749433 -34.604886868484,-58.4341885713341 -34.6048470242574,-58.4342734808767 -34.6047971928063,-58.4344022002044 -34.6047452518246,-58.4344979915393 -34.6047056771247,-58.4345788158246 -34.6046710485106,-58.4346462756596 -34.6046431086114,-58.4347793714336 -34.6046092244453,-58.4352343534294 -34.6044954866818,-58.4353570791043 -34.6044633417807,-58.435419283578 -34.6044511640014,-58.4354649380013 -34.6044456810363,-58.4355632312743 -34.6044338715063,-58.435752829611 -34.6044225046472,-58.4358529929907 -34.6044219633259,-58.4359208753179 -34.6044231754713,-58.4360137976362 -34.6044269283646,-58.4360814235076 -34.6044310982222,-58.4361743445431 -34.6044389356535,-58.4362580665976 -34.6044478273986,-58.4363676796965 -34.6044615135889,-58.4364162240368 -34.6044747639899,-58.4366161845485 -34.6042833912541,-58.4353380277268 -34.6036751306822,-58.4351483827033 -34.6035749433856,-58.4349717671532 -34.6034815899979,-58.4339139427525 -34.6029596351743,-58.433219322885 -34.6043002945266,-58.432631648439 -34.6054347007075,-58.432075324627 -34.6065085460807,-58.4323648967797 -34.6064657576582,-58.4326761863569 -34.6064182439128,-58.4326761398074 -34.6064191730895,-58.4326774362104 -34.6064188012575,-58.4329043171384 -34.6063537274017)))";;"2862";6_7_3;COMUNA 6;"7";"3";"954";"438";"516";"84,88%";"336";"335";"99,70%";"1";"0,30%";"278";"5";"1.8";"273";"98,20%";"1.8";1.800
"MULTIPOLYGON (((-58.4326761398074 -34.6064191730895,-58.4326761863569 -34.6064182439128,-58.4323648967797 -34.6064657576582,-58.432075324627 -34.6065085460807,-58.4306691341148 -34.6059413329139,-58.4306058500099 -34.6070470616714,-58.4315838521912 -34.6074570485218,-58.4323536405493 -34.6077773246927,-58.4332339925879 -34.6081334860133,-58.433122694506 -34.6078533240124,-58.4331181582618 -34.6078350551071,-58.4330951932736 -34.6077425676343,-58.4330951962126 -34.6077342872829,-58.4331100505362 -34.6076223003453,-58.4331058038154 -34.6076159541739,-58.4330033924192 -34.6074603601444,-58.4329645832709 -34.6073732347858,-58.4329406706562 -34.6073121703527,-58.4329125919379 -34.6072301886281,-58.4328834989721 -34.6071263748516,-58.4328630920337 -34.6070279859275,-58.4328506043336 -34.6069355146489,-58.4328444223273 -34.6068355094193,-58.4328455653228 -34.6067357172557,-58.4328547207417 -34.6066192362888,-58.4328751091617 -34.6065069489205,-58.4329042169724 -34.6063540976683,-58.4329043171384 -34.6063537274017,-58.4326774362104 -34.6064188012575,-58.4326761398074 -34.6064191730895)))";;"2863";6_7_4;COMUNA 6;"7";"4";"869";"390";"479";"81,42%";"419";"419";"100,00%";"0";"0,00%";"372";"10";"2.69";"362";"97,31%";"2.69";2.690
"MULTIPOLYGON (((-58.4315838521912 -34.6074570485218,-58.4306058500099 -34.6070470616714,-58.4305599237008 -34.6077536250754,-58.4305494685221 -34.6079188397023,-58.4305128686542 -34.6085137111839,-58.4304739462198 -34.6087252580068,-58.4318161634979 -34.6087382816681,-58.4321080647271 -34.6087411017878,-58.4329245705555 -34.6087490505484,-58.4341967276224 -34.6087357562454,-58.434733229149 -34.6087320835288,-58.4343944479292 -34.6085739714049,-58.4342386656817 -34.608500429588,-58.433870379896 -34.6083226871692,-58.4337811047399 -34.608280366031,-58.4336854721497 -34.6082203411094,-58.433613345296 -34.608169336136,-58.4335266595955 -34.608100439654,-58.4334505358464 -34.6080317569176,-58.4333736486313 -34.6079545525075,-58.4333068114452 -34.6078799561998,-58.4332310371685 -34.6077875401352,-58.4331946825667 -34.6077433043595,-58.4331642036852 -34.6077032250785,-58.4331100505362 -34.6076223003453,-58.4330951962126 -34.6077342872829,-58.4330951932736 -34.6077425676343,-58.4331181582618 -34.6078350551071,-58.433122694506 -34.6078533240124,-58.4332339925879 -34.6081334860133,-58.4323536405493 -34.6077773246927,-58.4315838521912 -34.6074570485218)))";;"2864";6_7_5;COMUNA 6;"7";"5";"784";"356";"428";"83,18%";"442";"442";"100,00%";"0";"0,00%";"359";"3";"0.84";"356";"99,16%";"0.84";0.840
"MULTIPOLYGON (((-58.4338945756151 -34.6050292155587,-58.4338230975501 -34.6050799752136,-58.4337786255293 -34.605113064512,-58.4337350901863 -34.6051467174178,-58.4336686360372 -34.6052007177316,-58.4336153014887 -34.6052462701162,-58.4335634144161 -34.6052930200507,-58.433518427909 -34.6053353348276,-58.4334690951254 -34.6053844093628,-58.4334008451867 -34.6054577055948,-58.4333656541739 -34.6054981211864,-58.4333315701649 -34.6055391708606,-58.4332669787086 -34.6056231020967,-58.4332027252037 -34.6057144280215,-58.4331699157712 -34.6057635768513,-58.4331307986905 -34.6058260344995,-58.4330831570716 -34.605908349962,-58.4330523034737 -34.605966020678,-58.4330257957829 -34.6060179175793,-58.432986074 -34.6061035449097,-58.4329430226638 -34.606210651088,-58.4329043171384 -34.6063537274017,-58.4329042169724 -34.6063540976683,-58.4328751091617 -34.6065069489205,-58.4328547207417 -34.6066192362888,-58.4328455653228 -34.6067357172557,-58.4328444223273 -34.6068355094193,-58.4328506043336 -34.6069355146489,-58.4328630920337 -34.6070279859275,-58.4328834989721 -34.6071263748516,-58.4329125919379 -34.6072301886281,-58.4329406706562 -34.6073121703527,-58.4329645832709 -34.6073732347858,-58.4330033924192 -34.6074603601444,-58.4331058038154 -34.6076159541739,-58.4331100505362 -34.6076223003453,-58.4331642036852 -34.6077032250785,-58.4331946825667 -34.6077433043595,-58.4332310371685 -34.6077875401352,-58.4333068114452 -34.6078799561998,-58.4333736486313 -34.6079545525075,-58.4334505358464 -34.6080317569176,-58.4335266595955 -34.608100439654,-58.433613345296 -34.608169336136,-58.4336854721497 -34.6082203411094,-58.4337811047399 -34.608280366031,-58.433870379896 -34.6083226871692,-58.4342386656817 -34.608500429588,-58.4343944479292 -34.6085739714049,-58.434733229149 -34.6087320835288,-58.4348085992083 -34.6087672429227,-58.4361233057147 -34.6087799312084,-58.4368996939721 -34.6087874220706,-58.4373901431434 -34.608792172856,-58.4375610082206 -34.6087938279594,-58.4387051931274 -34.608798002154,-58.4387127372038 -34.6077409223152,-58.438713627587 -34.6076066217388,-58.4387207647601 -34.6070753358193,-58.4387286846666 -34.6064874986046,-58.438730426231 -34.6063550292219,-58.4388116154466 -34.6062475785026,-58.439285379801 -34.6056058132306,-58.4392016602282 -34.6055828385307,-58.4385162809844 -34.605234663414,-58.4379749989363 -34.6049596854722,-58.4371745791229 -34.6045530265198,-58.4370533118273 -34.6044913790571,-58.4366161845485 -34.6042833912541,-58.4364162240368 -34.6044747639899,-58.4363676796965 -34.6044615135889,-58.4362580665976 -34.6044478273986,-58.4361743445431 -34.6044389356535,-58.4360814235076 -34.6044310982222,-58.4360137976362 -34.6044269283646,-58.4359208753179 -34.6044231754713,-58.4358529929907 -34.6044219633259,-58.435752829611 -34.6044225046472,-58.4355632312743 -34.6044338715063,-58.4354649380013 -34.6044456810363,-58.435419283578 -34.6044511640014,-58.4353570791043 -34.6044633417807,-58.4352343534294 -34.6044954866818,-58.4347793714336 -34.6046092244453,-58.4346462756596 -34.6046431086114,-58.4345788158246 -34.6046710485106,-58.4344979915393 -34.6047056771247,-58.4344022002044 -34.6047452518246,-58.4342734808767 -34.6047971928063,-58.4341885713341 -34.6048470242574,-58.4341183749433 -34.604886868484,-58.4340491148355 -34.604928332669,-58.4340013222911 -34.6049583225619,-58.4339474807043 -34.6049932407729,-58.4338945756151 -34.6050292155587)))";;"2865";6_7_6;COMUNA 6;"7";"6";"682";"323";"359";"89,97%";"327";"326";"99,69%";"1";"0,31%";"260";"30";"11.54";"230";"88,46%";"11.54";11.540
"MULTIPOLYGON (((-58.4387051931274 -34.608798002154,-58.4375610082206 -34.6087938279594,-58.4373901431434 -34.608792172856,-58.4368996939721 -34.6087874220706,-58.4361233057147 -34.6087799312084,-58.4348085992083 -34.6087672429227,-58.434733229149 -34.6087320835288,-58.4342770308225 -34.6097003940166,-58.4356986318806 -34.6102970768094,-58.4365009103505 -34.6106337429124,-58.4366724389663 -34.6107047681363,-58.4380925436151 -34.6112927603384,-58.4383553174875 -34.6104373592684,-58.4388588527594 -34.6087985252528,-58.4387051931274 -34.608798002154)))";;"2866";6_7_7;COMUNA 6;"7";"7";"1151";"515";"636";"80,97%";"495";"491";"99,19%";"4";"0,81%";"399";"16";"4.01";"383";"95,99%";"4.01";4.010
"MULTIPOLYGON (((-58.4366724389663 -34.6107047681363,-58.4365009103505 -34.6106337429124,-58.4356986318806 -34.6102970768094,-58.4353607577421 -34.6115043696001,-58.4367496954807 -34.6120768064229,-58.4377298352344 -34.6124732929545,-58.4380441148685 -34.6114504323646,-58.4380925436151 -34.6112927603384,-58.4366724389663 -34.6107047681363)))";;"2867";6_7_8;COMUNA 6;"7";"8";"740";"331";"409";"80,93%";"348";"348";"100,00%";"0";"0,00%";"307";"26";"8.47";"281";"91,53%";"8.47";8.470
"MULTIPOLYGON (((-58.4356986318806 -34.6102970768094,-58.4342770308225 -34.6097003940166,-58.4332642418842 -34.6092753495297,-58.4330503026881 -34.610396536043,-58.4330002546305 -34.6105314583837,-58.4337489563805 -34.610840029896,-58.4346036976108 -34.6111923552549,-58.4353607577421 -34.6115043696001,-58.4356986318806 -34.6102970768094)))";;"2868";6_7_9;COMUNA 6;"7";"9";"769";"354";"415";"85,30%";"406";"405";"99,75%";"1";"0,25%";"320";"1";"0.31";"319";"99,69%";"0.31";0.310
"MULTIPOLYGON (((-58.4337489563805 -34.610840029896,-58.4330002546305 -34.6105314583837,-58.4329469664621 -34.6106751830495,-58.4327174884265 -34.6111638771084,-58.4324104335605 -34.6118182617132,-58.4331553103722 -34.6121301458355,-58.4341074083493 -34.6125287674201,-58.4346036976108 -34.6111923552549,-58.4337489563805 -34.610840029896)))";;"2869";6_8_1;COMUNA 6;"8";"1";"832";"399";"433";"92,15%";"443";"443";"100,00%";"0";"0,00%";"355";"15";"4.23";"340";"95,77%";"4.23";4.230
"MULTIPOLYGON (((-58.4313211128821 -34.6123625132197,-58.4302328524247 -34.6118973524365,-58.4301272661105 -34.6133281507648,-58.4308841544601 -34.6136507564954,-58.43125785051 -34.6125167278756,-58.4313211128821 -34.6123625132197)))";;"2870";6_8_10;COMUNA 6;"8";"10";"677";"297";"380";"78,16%";"409";"409";"100,00%";"0";"0,00%";"334";"2";"0.6";"332";"99,40%";"0.6";0.600
"MULTIPOLYGON (((-58.4341074083493 -34.6125287674201,-58.4331553103722 -34.6121301458355,-58.4328321262175 -34.6128679812155,-58.4327901730639 -34.6129903697317,-58.4344276611717 -34.6133651399172,-58.4347077653569 -34.6127801129275,-58.435903294843 -34.613280610735,-58.4361132403127 -34.6133677020654,-58.4367496954807 -34.6120768064229,-58.4353607577421 -34.6115043696001,-58.4346036976108 -34.6111923552549,-58.4341074083493 -34.6125287674201)))";;"2871";6_8_2;COMUNA 6;"8";"2";"1023";"476";"547";"87,02%";"542";"542";"100,00%";"0";"0,00%";"457";"39";"8.53";"418";"91,47%";"8.53";8.530
"MULTIPOLYGON (((-58.4377298352344 -34.6124732929545,-58.4367496954807 -34.6120768064229,-58.4361132403127 -34.6133677020654,-58.4372909871838 -34.6138562100913,-58.4376710028666 -34.6126647667139,-58.4377298352344 -34.6124732929545)))";;"2872";6_8_3;COMUNA 6;"8";"3";"640";"290";"350";"82,86%";"291";"291";"100,00%";"0";"0,00%";"260";"0";"0";"260";"100,00%";"0";0.000
"MULTIPOLYGON (((-58.4347077653569 -34.6127801129275,-58.4344276611717 -34.6133651399172,-58.4356873465515 -34.6138445975483,-58.4358584558891 -34.6139133701855,-58.4360199411426 -34.6139781966737,-58.4369536043544 -34.6143277760545,-58.437012503294 -34.6142058826767,-58.4372909871838 -34.6138562100913,-58.4361132403127 -34.6133677020654,-58.435903294843 -34.613280610735,-58.4347077653569 -34.6127801129275)))";;"2873";6_8_4;COMUNA 6;"8";"4";"626";"271";"355";"76,34%";"351";"351";"100,00%";"0";"0,00%";"300";"1";"0.33";"299";"99,67%";"0.33";0.330
"MULTIPOLYGON (((-58.4369536043544 -34.6143277760545,-58.4360199411426 -34.6139781966737,-58.4358584558891 -34.6139133701855,-58.4352706233111 -34.6151724395987,-58.4352500795106 -34.6152165210639,-58.4362728721309 -34.6155152082942,-58.4363667366433 -34.6155417788364,-58.4369536043544 -34.6143277760545)))";;"2874";6_8_5;COMUNA 6;"8";"5";"511";"219";"292";"75,00%";"310";"310";"100,00%";"0";"0,00%";"251";"28";"11.16";"223";"88,84%";"11.16";11.160
"MULTIPOLYGON (((-58.4358584558891 -34.6139133701855,-58.4356873465515 -34.6138445975483,-58.4344276611717 -34.6133651399172,-58.4343611721275 -34.6135038618936,-58.4339922326793 -34.6142923955938,-58.4338043504925 -34.6146939149598,-58.4352706233111 -34.6151724395987,-58.4358584558891 -34.6139133701855)))";;"2875";6_8_6;COMUNA 6;"8";"6";"1320";"597";"723";"82,57%";"607";"607";"100,00%";"0";"0,00%";"533";"25";"4.69";"508";"95,31%";"4.69";4.690
"MULTIPOLYGON (((-58.4344276611717 -34.6133651399172,-58.4327901730639 -34.6129903697317,-58.4327291191504 -34.6131682485037,-58.4325603574767 -34.613685760821,-58.4323660955694 -34.614281579198,-58.4337289925679 -34.6148548183542,-58.4337077904311 -34.6148990239413,-58.4337078622667 -34.6148990536575,-58.4337043074174 -34.6149061498437,-58.4336280718392 -34.615065022353,-58.4336797617242 -34.6150846740479,-58.4336658677367 -34.6151106575886,-58.434052033735 -34.6152763886149,-58.4343445986882 -34.615398926137,-58.4350992229321 -34.6157192514891,-58.4360777685989 -34.6161362240704,-58.4362080710104 -34.6158693290828,-58.4362080521092 -34.6158693759207,-58.4363667366433 -34.6155417788364,-58.4362728721309 -34.6155152082942,-58.4352500795106 -34.6152165210639,-58.4352706233111 -34.6151724395987,-58.4338043504925 -34.6146939149598,-58.4339922326793 -34.6142923955938,-58.4343611721275 -34.6135038618936,-58.4344276611717 -34.6133651399172)))";;"2876";6_8_7;COMUNA 6;"8";"7";"664";"296";"368";"80,43%";"375";"375";"100,00%";"0";"0,00%";"319";"38";"11.91";"281";"88,09%";"11.91";11.910
"MULTIPOLYGON (((-58.4313211128821 -34.6123625132197,-58.43125785051 -34.6125167278756,-58.4308841544601 -34.6136507564954,-58.4322413218267 -34.6142291518602,-58.4323660955694 -34.614281579198,-58.4325603574767 -34.613685760821,-58.4327291191504 -34.6131682485037,-58.4327901730639 -34.6129903697317,-58.4328321262175 -34.6128679812155,-58.4331553103722 -34.6121301458355,-58.4324104335605 -34.6118182617132,-58.4316767191762 -34.6115110239241,-58.4316074105522 -34.6116646034197,-58.4313211128821 -34.6123625132197)))";;"2877";6_8_8;COMUNA 6;"8";"8";"1333";"565";"768";"73,57%";"524";"517";"98,66%";"7";"1,35%";"509";"26";"5.11";"483";"94,89%";"5.11";5.110
"MULTIPOLYGON (((-58.4316767191762 -34.6115110239241,-58.4303302540484 -34.6109154411486,-58.4303186720573 -34.6111286148663,-58.4302546269411 -34.6117598180184,-58.4302328524247 -34.6118973524365,-58.4313211128821 -34.6123625132197,-58.4316074105522 -34.6116646034197,-58.4316767191762 -34.6115110239241)))";;"2878";6_8_9;COMUNA 6;"8";"9";"511";"232";"279";"83,15%";"313";"313";"100,00%";"0";"0,00%";"266";"29";"10.9";"237";"89,10%";"10.9";10.900
"MULTIPOLYGON (((-58.439056654468 -34.6159384002954,-58.4375769971691 -34.6159435977134,-58.4375635911153 -34.6160500072002,-58.4373711243654 -34.6164442772226,-58.4373712523767 -34.6164443708327,-58.4375472657123 -34.6165151612593,-58.4386134042959 -34.6169439832096,-58.4387529387657 -34.6166456902118,-58.4389982601911 -34.6160891689935,-58.439056654468 -34.6159384002954)))";;"2879";6_9_1;COMUNA 6;"9";"1";"600";"239";"361";"66,20%";"365";"365";"100,00%";"0";"0,00%";"297";"3";"1.01";"294";"98,99%";"1.01";1.010
"MULTIPOLYGON (((-58.4301125135935 -34.6135652539065,-58.4300858545243 -34.6140152771461,-58.4300285611138 -34.6154491864935,-58.4302529824051 -34.6155486161375,-58.4307760095446 -34.6157804525409,-58.4308431597153 -34.61437753252,-58.4320957261493 -34.6149751985462,-58.4322819416373 -34.6144966363965,-58.4322816462073 -34.6144965096245,-58.4323470109142 -34.614330633866,-58.4323660955694 -34.614281579198,-58.4322413218267 -34.6142291518602,-58.4308841544601 -34.6136507564954,-58.4301272661105 -34.6133281507648,-58.4301216975994 -34.6133980688608,-58.4301125135935 -34.6135652539065)))";;"2880";6_9_10;COMUNA 6;"9";"10";"735";"326";"409";"79,71%";"391";"391";"100,00%";"0";"0,00%";"324";"2";"0.62";"322";"99,38%";"0.62";0.620
"MULTIPOLYGON (((-58.4372808936583 -34.6167070060241,-58.4372808332776 -34.6167070142738,-58.4370882851928 -34.6170794520287,-58.4383027835282 -34.6176428899449,-58.4384975592723 -34.6172120683952,-58.4384857089028 -34.617207149266,-58.4385009800375 -34.617203584607,-58.4385910656524 -34.6169944268181,-58.4385872382299 -34.6169927121665,-58.4386134042959 -34.6169439832096,-58.4375472657123 -34.6165151612593,-58.4373712523767 -34.6164443708327,-58.4372808936583 -34.6167070060241)))";;"2881";6_9_2;COMUNA 6;"9";"2";"598";"261";"337";"77,45%";"306";"306";"100,00%";"0";"0,00%";"260";"0";"0";"260";"100,00%";"0";0.000
"MULTIPOLYGON (((-58.4383027835282 -34.6176428899449,-58.4370882851928 -34.6170794520287,-58.4364568449873 -34.6183006991031,-58.4377465747139 -34.6188732434345,-58.4383027835282 -34.6176428899449)))";;"2882";6_9_3;COMUNA 6;"9";"3";"653";"289";"364";"79,40%";"378";"378";"100,00%";"0";"0,00%";"293";"3";"1.02";"290";"98,98%";"1.02";1.020
"MULTIPOLYGON (((-58.4360781132049 -34.6161365965932,-58.4358582753463 -34.6165912829312,-58.4352835657606 -34.6177798592834,-58.4364568449873 -34.6183006991031,-58.4370882851928 -34.6170794520287,-58.4372808332776 -34.6167070142738,-58.4371566475352 -34.6166597331328,-58.4371855427597 -34.6166028357462,-58.4360781132049 -34.6161365965932)))";;"2883";6_9_4;COMUNA 6;"9";"4";"1012";"442";"570";"77,54%";"606";"606";"100,00%";"0";"0,00%";"430";"2";"0.47";"428";"99,53%";"0.47";0.470
"MULTIPOLYGON (((-58.4372808936583 -34.6167070060241,-58.4373712523767 -34.6164443708327,-58.4373711243654 -34.6164442772226,-58.4375635911153 -34.6160500072002,-58.4375769971691 -34.6159435977134,-58.4375841699176 -34.615886343625,-58.4363667366433 -34.6155417788364,-58.4362080521092 -34.6158693759207,-58.4362080710104 -34.6158693290828,-58.4360777685989 -34.6161362240704,-58.4360781132049 -34.6161365965932,-58.4371855427597 -34.6166028357462,-58.4371566475352 -34.6166597331328,-58.4372808332776 -34.6167070142738,-58.4372808936583 -34.6167070060241)))";;"2884";6_9_5;COMUNA 6;"9";"5";"438";"160";"278";"57,55%";"215";"211";"98,14%";"4";"1,90%";"170";"0";"0";"170";"100,00%";"0";0.000
"MULTIPOLYGON (((-58.4347368354355 -34.6175371209638,-58.4352835657606 -34.6177798592834,-58.4358582753463 -34.6165912829312,-58.4360781132049 -34.6161365965932,-58.4360777685989 -34.6161362240704,-58.4350992229321 -34.6157192514891,-58.4343445986882 -34.615398926137,-58.434052033735 -34.6152763886149,-58.4336658677367 -34.6151106575886,-58.4336797617242 -34.6150846740479,-58.4336280718392 -34.615065022353,-58.4336280717871 -34.6150651716973,-58.433396959816 -34.6155469469384,-58.4332376310051 -34.6158855122091,-58.4328609927907 -34.6167045343571,-58.433118723123 -34.6168186856863,-58.4341311685815 -34.6172682387102,-58.4347368354355 -34.6175371209638)))";;"2885";6_9_6;COMUNA 6;"9";"6";"864";"395";"469";"84,22%";"505";"505";"100,00%";"0";"0,00%";"381";"2";"0.52";"379";"99,48%";"0.52";0.520
"MULTIPOLYGON (((-58.433396959816 -34.6155469469384,-58.4336280717871 -34.6150651716973,-58.4336280718392 -34.615065022353,-58.4337043074174 -34.6149061498437,-58.4337078622667 -34.6148990536575,-58.4337077904311 -34.6148990239413,-58.4337289925679 -34.6148548183542,-58.4323660955694 -34.614281579198,-58.4323470109142 -34.614330633866,-58.4322816462073 -34.6144965096245,-58.4322819416373 -34.6144966363965,-58.4320957261493 -34.6149751985462,-58.433396959816 -34.6155469469384)))";;"2886";6_9_7;COMUNA 6;"9";"7";"540";"232";"308";"75,32%";"287";"287";"100,00%";"0";"0,00%";"249";"48";"19.28";"201";"80,72%";"19.28";19.280
"MULTIPOLYGON (((-58.433396959816 -34.6155469469384,-58.4320957261493 -34.6149751985462,-58.4316345264817 -34.6161608990079,-58.4322112191591 -34.6164165465554,-58.4328609927907 -34.6167045343571,-58.4332376310051 -34.6158855122091,-58.433396959816 -34.6155469469384)))";;"2887";6_9_8;COMUNA 6;"9";"8";"401";"159";"242";"65,70%";"232";"232";"100,00%";"0";"0,00%";"196";"2";"1.02";"194";"98,98%";"1.02";1.020
"MULTIPOLYGON (((-58.4320957261493 -34.6149751985462,-58.4308431597153 -34.61437753252,-58.4307760095446 -34.6157804525409,-58.4308688448227 -34.6158216050275,-58.4313591699306 -34.6160389228248,-58.4316345264817 -34.6161608990079,-58.4320957261493 -34.6149751985462)))";;"2888";6_9_9;COMUNA 6;"9";"9";"838";"363";"475";"76,42%";"443";"443";"100,00%";"0";"0,00%";"362";"12";"3.31";"350";"96,69%";"3.31";3.310
"MULTIPOLYGON (((-58.4767417617743 -34.6218301612607,-58.476026442212 -34.6214581158819,-58.4757455470922 -34.6213108875946,-58.4755627899521 -34.6217043009774,-58.4751363782953 -34.6226221235224,-58.4746720584001 -34.6236216411229,-58.4748294149145 -34.62366381013,-58.475814024511 -34.6239208297822,-58.4754154573715 -34.6248042825984,-58.4753615480197 -34.6249241514673,-58.4764901590307 -34.6252236168158,-58.4769505460416 -34.6242175434979,-58.4770145019904 -34.6240777424719,-58.4774145872498 -34.6232230879565,-58.4778072555519 -34.6223842785486,-58.4767417617743 -34.6218301612607)))";;"2889";7_1_1;COMUNA 7;"1";"1";"601";"287";"314";"91,40%";"266";"266";"100,00%";"0";"0,00%";"223";"20";"8.97";"203";"91,03%";"8.97";8.970
"MULTIPOLYGON (((-58.4711932247495 -34.6311301448541,-58.469639651188 -34.6307070600452,-58.4689913059796 -34.6321553827115,-58.4691964755592 -34.6322227685508,-58.4703870248068 -34.632579049126,-58.4705276100017 -34.632606858004,-58.4706654687914 -34.632634173924,-58.4717449155615 -34.6328868534636,-58.4728742987558 -34.6331512098091,-58.4734838294236 -34.6317918167907,-58.4732283010115 -34.6317021178325,-58.4723782260926 -34.6314623211379,-58.4714111727682 -34.6311894976532,-58.4711932247495 -34.6311301448541)))";;"2890";7_1_10;COMUNA 7;"1";"10";"1125";"480";"645";"74,42%";"483";"481";"99,59%";"2";"0,42%";"419";"51";"12.17";"368";"87,83%";"12.17";12.170
"MULTIPOLYGON (((-58.4754900415845 -34.6211768958956,-58.474509432888 -34.6206627514648,-58.4741896943515 -34.6204974945297,-58.473904829499 -34.6211900099981,-58.4734618838529 -34.6221749432921,-58.4730140731792 -34.6231710023758,-58.473229702066 -34.6232348593987,-58.4746720584001 -34.6236216411229,-58.4751363782953 -34.6226221235224,-58.4755627899521 -34.6217043009774,-58.4757455470922 -34.6213108875946,-58.4754900415845 -34.6211768958956)))";;"2891";7_1_2;COMUNA 7;"1";"2";"891";"406";"485";"83,71%";"322";"321";"99,69%";"1";"0,31%";"306";"16";"5.23";"290";"94,77%";"5.23";5.230
"MULTIPOLYGON (((-58.4725633559706 -34.62417318686,-58.4721172272808 -34.6251654392437,-58.4723275785037 -34.625228382723,-58.473748409791 -34.6256063738187,-58.4741446176746 -34.6247568716104,-58.4742090048855 -34.6246183396757,-58.4746720584001 -34.6236216411229,-58.473229702066 -34.6232348593987,-58.4730140731792 -34.6231710023758,-58.4725633559706 -34.62417318686)))";;"2892";7_1_3;COMUNA 7;"1";"3";"878";"393";"485";"81,03%";"396";"395";"99,75%";"1";"0,25%";"316";"17";"5.38";"299";"94,62%";"5.38";5.380
"MULTIPOLYGON (((-58.4743479700963 -34.6271623568776,-58.4754686835695 -34.6274556349253,-58.4760364889766 -34.6262150391113,-58.4764901590307 -34.6252236168158,-58.4753615480197 -34.6249241514673,-58.4754154573715 -34.6248042825984,-58.475814024511 -34.6239208297822,-58.4748294149145 -34.62366381013,-58.4746720584001 -34.6236216411229,-58.4742090048855 -34.6246183396757,-58.4741446176746 -34.6247568716104,-58.473748409791 -34.6256063738187,-58.4735229628854 -34.6260897907955,-58.4731667735602 -34.6268532985399,-58.4743479700963 -34.6271623568776)))";;"2893";7_1_4;COMUNA 7;"1";"4";"738";"352";"386";"91,19%";"310";"310";"100,00%";"0";"0,00%";"255";"36";"14.12";"219";"85,88%";"14.12";14.120
"MULTIPOLYGON (((-58.4738665836843 -34.6282187756265,-58.4734352674271 -34.6291651137821,-58.4733045248907 -34.6294520362481,-58.4731479696504 -34.6297660039326,-58.4742537259749 -34.6301103523385,-58.4745537037572 -34.6294548086684,-58.4749901195969 -34.6285012827499,-58.4754686835695 -34.6274556349253,-58.4743479700963 -34.6271623568776,-58.4738665836843 -34.6282187756265)))";;"2894";7_1_5;COMUNA 7;"1";"5";"450";"219";"231";"94,81%";"234";"234";"100,00%";"0";"0,00%";"172";"17";"9.88";"155";"90,12%";"9.88";9.880
"MULTIPOLYGON (((-58.4722312132104 -34.6288588654943,-58.4719779806891 -34.6294016497145,-58.4731479696504 -34.6297660039326,-58.4733045248907 -34.6294520362481,-58.4734352674271 -34.6291651137821,-58.4738665836843 -34.6282187756265,-58.4743479700963 -34.6271623568776,-58.4731667735602 -34.6268532985399,-58.4729661311904 -34.6268007785972,-58.4715756921294 -34.6263695350099,-58.4714472477121 -34.6266551173761,-58.4711044134203 -34.6274250267384,-58.4714217800934 -34.6275250782672,-58.4725211102898 -34.6278735980391,-58.472671572686 -34.6279147844059,-58.4722312132104 -34.6288588654943)))";;"2895";7_1_6;COMUNA 7;"1";"6";"749";"339";"410";"82,68%";"287";"287";"100,00%";"0";"0,00%";"269";"16";"5.95";"253";"94,05%";"5.95";5.950
"MULTIPOLYGON (((-58.4706595285694 -34.6284240339693,-58.4704378061731 -34.6289218818843,-58.4703721322247 -34.6290693557745,-58.4703177018923 -34.6291916168106,-58.4702094370163 -34.6294348006928,-58.4715567999779 -34.6297758484839,-58.4717832645433 -34.6298347774635,-58.4718523444489 -34.629686457478,-58.4719534511119 -34.629469541177,-58.4719779806891 -34.6294016497145,-58.4722312132104 -34.6288588654943,-58.472671572686 -34.6279147844059,-58.4725211102898 -34.6278735980391,-58.4714217800934 -34.6275250782672,-58.4711044134203 -34.6274250267384,-58.4706595285694 -34.6284240339693)))";;"2896";7_1_7;COMUNA 7;"1";"7";"487";"230";"257";"89,49%";"242";"242";"100,00%";"0";"0,00%";"185";"16";"8.65";"169";"91,35%";"8.65";8.650
"MULTIPOLYGON (((-58.4717832645433 -34.6298347774635,-58.4715567999779 -34.6297758484839,-58.4702094370163 -34.6294348006928,-58.469639651188 -34.6307070600452,-58.4711932247495 -34.6311301448541,-58.4717020897599 -34.6300165501218,-58.4717832645433 -34.6298347774635)))";;"2897";7_1_8;COMUNA 7;"1";"8";"721";"313";"408";"76,72%";"407";"406";"99,75%";"1";"0,25%";"319";"13";"4.08";"306";"95,92%";"4.08";4.080
"MULTIPOLYGON (((-58.4717832645433 -34.6298347774635,-58.4717020897599 -34.6300165501218,-58.4711932247495 -34.6311301448541,-58.4714111727682 -34.6311894976532,-58.4723782260926 -34.6314623211379,-58.4732283010115 -34.6317021178325,-58.4734838294236 -34.6317918167907,-58.4741036501344 -34.6304382647285,-58.4742537259749 -34.6301103523385,-58.4731479696504 -34.6297660039326,-58.4719779806891 -34.6294016497145,-58.4719534511119 -34.629469541177,-58.4718523444489 -34.629686457478,-58.4717832645433 -34.6298347774635)))";;"2898";7_1_9;COMUNA 7;"1";"9";"680";"328";"352";"93,18%";"323";"323";"100,00%";"0";"0,00%";"291";"107";"36.77";"184";"63,23%";"36.77";36.770
"MULTIPOLYGON (((-58.461206971522 -34.6284156926904,-58.4609886974402 -34.6283463212891,-58.4600185671035 -34.6280163631165,-58.4598574618367 -34.6279555827691,-58.459306273587 -34.629181032462,-58.460469387944 -34.6295542408041,-58.4606414875758 -34.6296062174017,-58.4622373384925 -34.6300886443974,-58.4622937409303 -34.6299477243955,-58.4627118968538 -34.6288497305166,-58.4613869073369 -34.6284729502096,-58.461206971522 -34.6284156926904)))";;"2899";7_10_1;COMUNA 7;"10";"1";"733";"316";"417";"75,78%";"396";"396";"100,00%";"0";"0,00%";"303";"1";"0.33";"302";"99,67%";"0.33";0.330
"MULTIPOLYGON (((-58.4582283092899 -34.631477905339,-58.4581721557413 -34.6315967804501,-58.4577187458381 -34.6325623581,-58.4578991138437 -34.6326260998303,-58.4590250379316 -34.6329715728737,-58.4595434475792 -34.6318923263971,-58.4600849344425 -34.6307649778295,-58.4599447823106 -34.6307228606655,-58.458761717411 -34.6303485903763,-58.4582283092899 -34.631477905339)))";;"2900";7_10_10;COMUNA 7;"10";"10";"932";"382";"550";"69,45%";"394";"392";"99,49%";"2";"0,51%";"332";"21";"6.33";"311";"93,67%";"6.33";6.330
"MULTIPOLYGON (((-58.4598574618367 -34.6279555827691,-58.4596870704835 -34.6278912807336,-58.4588540322439 -34.6275487105237,-58.458270631354 -34.6286961942299,-58.4582025514217 -34.6288269003593,-58.459306273587 -34.629181032462,-58.4598574618367 -34.6279555827691)))";;"2901";7_10_2;COMUNA 7;"10";"2";"380";"160";"220";"72,73%";"239";"239";"100,00%";"0";"0,00%";"185";"1";"0.54";"184";"99,46%";"0.54";0.540
"MULTIPOLYGON (((-58.4588540322439 -34.6275487105237,-58.4578380892681 -34.6271309840608,-58.457137261968 -34.6284829716194,-58.4580763758311 -34.6287864013226,-58.4582025514217 -34.6288269003593,-58.458270631354 -34.6286961942299,-58.4588540322439 -34.6275487105237)))";;"2902";7_10_3;COMUNA 7;"10";"3";"588";"248";"340";"72,94%";"321";"321";"100,00%";"0";"0,00%";"254";"4";"1.57";"250";"98,43%";"1.57";1.570
"MULTIPOLYGON (((-58.4582025514217 -34.6288269003593,-58.4580763758311 -34.6287864013226,-58.457137261968 -34.6284829716194,-58.4566225119281 -34.6294796706787,-58.4565424131193 -34.6296463623856,-58.4576021775835 -34.6299817041884,-58.4576642097346 -34.6298601534051,-58.4582025514217 -34.6288269003593)))";;"2903";7_10_4;COMUNA 7;"10";"4";"690";"302";"388";"77,84%";"347";"347";"100,00%";"0";"0,00%";"295";"0";"0";"295";"100,00%";"0";0.000
"MULTIPOLYGON (((-58.4560417137964 -34.6294879504948,-58.4554616989907 -34.6293044606003,-58.454911811216 -34.6304139004546,-58.456002845585 -34.6307689066453,-58.4560913658096 -34.6307976448246,-58.4570670522784 -34.631108337923,-58.4571376070484 -34.6309717168996,-58.4575377593905 -34.6301079028793,-58.4576021775835 -34.6299817041884,-58.4565424131193 -34.6296463623856,-58.4560417137964 -34.6294879504948)))";;"2904";7_10_5;COMUNA 7;"10";"5";"640";"284";"356";"79,78%";"291";"290";"99,66%";"1";"0,34%";"240";"4";"1.67";"236";"98,33%";"1.67";1.670
"MULTIPOLYGON (((-58.459306273587 -34.629181032462,-58.4582025514217 -34.6288269003593,-58.4576642097346 -34.6298601534051,-58.4576021775835 -34.6299817041884,-58.4575377593905 -34.6301079028793,-58.4571376070484 -34.6309717168996,-58.4570670522784 -34.631108337923,-58.4581419175388 -34.6314505772908,-58.4582283092899 -34.631477905339,-58.458761717411 -34.6303485903763,-58.4588302243759 -34.6302034468792,-58.459306273587 -34.629181032462)))";;"2905";7_10_6;COMUNA 7;"10";"6";"760";"349";"411";"84,91%";"460";"459";"99,78%";"1";"0,22%";"351";"34";"9.69";"317";"90,31%";"9.69";9.690
"MULTIPOLYGON (((-58.4606414875758 -34.6296062174017,-58.460469387944 -34.6295542408041,-58.459306273587 -34.629181032462,-58.4588302243759 -34.6302034468792,-58.458761717411 -34.6303485903763,-58.4599447823106 -34.6307228606655,-58.4600849344425 -34.6307649778295,-58.4606414875758 -34.6296062174017)))";;"2906";7_10_7;COMUNA 7;"10";"7";"710";"292";"418";"69,86%";"448";"448";"100,00%";"0";"0,00%";"339";"14";"4.13";"325";"95,87%";"4.13";4.130
"MULTIPOLYGON (((-58.4622373384925 -34.6300886443974,-58.4606414875758 -34.6296062174017,-58.4600849344425 -34.6307649778295,-58.4617372066929 -34.6312619904228,-58.4621846846868 -34.6302199161763,-58.4622373384925 -34.6300886443974)))";;"2907";7_10_8;COMUNA 7;"10";"8";"1072";"467";"605";"77,19%";"566";"566";"100,00%";"0";"0,00%";"428";"0";"0";"428";"100,00%";"0";0.000
"MULTIPOLYGON (((-58.4617372066929 -34.6312619904228,-58.4600849344425 -34.6307649778295,-58.4595434475792 -34.6318923263971,-58.4612465187024 -34.6324046290448,-58.4617372066929 -34.6312619904228)))";;"2908";7_10_9;COMUNA 7;"10";"9";"682";"292";"390";"74,87%";"384";"384";"100,00%";"0";"0,00%";"307";"3";"0.98";"304";"99,02%";"0.98";0.980
"MULTIPOLYGON (((-58.4553769478836 -34.6261551237599,-58.4540312622009 -34.625631003598,-58.4539380454384 -34.6257643817714,-58.4534370734072 -34.6267810694993,-58.4545158219998 -34.6276342037179,-58.4547078893996 -34.6272747676704,-58.4553769478836 -34.6261551237599)))";;"2909";7_11_1;COMUNA 7;"11";"1";"855";"370";"485";"76,29%";"434";"429";"98,85%";"5";"1,17%";"315";"27";"8.57";"288";"91,43%";"8.57";8.570
"MULTIPOLYGON (((-58.4582283092899 -34.631477905339,-58.4581419175388 -34.6314505772908,-58.4570670522784 -34.631108337923,-58.4569994796645 -34.6312393954769,-58.4565457184431 -34.6321896866104,-58.4575559292313 -34.6325048142314,-58.4577187458381 -34.6325623581,-58.4581721557413 -34.6315967804501,-58.4582283092899 -34.631477905339)))";;"2910";7_11_10;COMUNA 7;"11";"10";"645";"277";"368";"75,27%";"285";"285";"100,00%";"0";"0,00%";"249";"2";"0.8";"247";"99,20%";"0.8";0.800
"MULTIPOLYGON (((-58.4567097868419 -34.6266670448897,-58.4553769478836 -34.6261551237599,-58.4547078893996 -34.6272747676704,-58.4561825077556 -34.627807760725,-58.4567097868419 -34.6266670448897)))";;"2911";7_11_2;COMUNA 7;"11";"2";"863";"367";"496";"73,99%";"534";"534";"100,00%";"0";"0,00%";"402";"0";"0";"402";"100,00%";"0";0.000
"MULTIPOLYGON (((-58.4578380892681 -34.6271309840608,-58.4567097868419 -34.6266670448897,-58.4561825077556 -34.627807760725,-58.4560302358639 -34.6281252984241,-58.4566180814832 -34.6283139270592,-58.457137261968 -34.6284829716194,-58.4578380892681 -34.6271309840608)))";;"2912";7_11_3;COMUNA 7;"11";"3";"850";"366";"484";"75,62%";"459";"459";"100,00%";"0";"0,00%";"367";"38";"10.35";"329";"89,65%";"10.35";10.350
"MULTIPOLYGON (((-58.457137261968 -34.6284829716194,-58.4566180814832 -34.6283139270592,-58.4560302358639 -34.6281252984241,-58.4561825077556 -34.627807760725,-58.4547078893996 -34.6272747676704,-58.4545158219998 -34.6276342037179,-58.4539972999305 -34.6286044118183,-58.4548023690692 -34.6291030749084,-58.4554616989907 -34.6293044606003,-58.4560417137964 -34.6294879504948,-58.4565424131193 -34.6296463623856,-58.4566225119281 -34.6294796706787,-58.457137261968 -34.6284829716194)))";;"2913";7_11_4;COMUNA 7;"11";"4";"939";"420";"519";"80,92%";"484";"484";"100,00%";"0";"0,00%";"380";"3";"0.79";"377";"99,21%";"0.79";0.790
"MULTIPOLYGON (((-58.4539972999305 -34.6286044118183,-58.4545158219998 -34.6276342037179,-58.4534370734072 -34.6267810694993,-58.4528705579412 -34.6279246554289,-58.452669188958 -34.6283312020432,-58.452568801026 -34.6285418346427,-58.4528452607714 -34.6285920702493,-58.4540006805367 -34.628865899726,-58.4541229356092 -34.6289021067835,-58.4548023690692 -34.6291030749084,-58.4539972999305 -34.6286044118183)))";;"2914";7_11_5;COMUNA 7;"11";"5";"548";"254";"294";"86,39%";"281";"281";"100,00%";"0";"0,00%";"229";"7";"3.06";"222";"96,94%";"3.06";3.060
"MULTIPOLYGON (((-58.4541229356092 -34.6289021067835,-58.4540006805367 -34.628865899726,-58.4528452607714 -34.6285920702493,-58.452568801026 -34.6285418346427,-58.4521029023144 -34.6295195743664,-58.4537412123407 -34.6300397935221,-58.4541229356092 -34.6289021067835)))";;"2915";7_11_6;COMUNA 7;"11";"6";"801";"375";"426";"88,03%";"360";"359";"99,72%";"1";"0,28%";"267";"1";"0.37";"266";"99,63%";"0.37";0.370
"MULTIPOLYGON (((-58.4537412123407 -34.6300397935221,-58.4521029023144 -34.6295195743664,-58.4519952676798 -34.6297454175993,-58.4515763969476 -34.6306390719281,-58.4532329607238 -34.6311398622143,-58.4537060138423 -34.6301447240145,-58.4537412123407 -34.6300397935221)))";;"2916";7_11_7;COMUNA 7;"11";"7";"1123";"489";"634";"77,13%";"600";"599";"99,83%";"1";"0,17%";"496";"0";"0";"496";"100,00%";"0";0.000
"MULTIPOLYGON (((-58.4537412123407 -34.6300397935221,-58.4537060138423 -34.6301447240145,-58.4532329607238 -34.6311398622143,-58.4543780991686 -34.6315005210732,-58.4548451726586 -34.6305482668589,-58.454911811216 -34.6304139004546,-58.4554616989907 -34.6293044606003,-58.4548023690692 -34.6291030749084,-58.4541229356092 -34.6289021067835,-58.4537412123407 -34.6300397935221)))";;"2917";7_11_8;COMUNA 7;"11";"8";"1005";"463";"542";"85,42%";"638";"638";"100,00%";"0";"0,00%";"452";"39";"8.63";"413";"91,37%";"8.63";8.630
"MULTIPOLYGON (((-58.4570670522784 -34.631108337923,-58.4560913658096 -34.6307976448246,-58.456002845585 -34.6307689066453,-58.454911811216 -34.6304139004546,-58.4548451726586 -34.6305482668589,-58.4543780991686 -34.6315005210732,-58.4545739690151 -34.631562226467,-58.4553463754372 -34.6318063680784,-58.4554872936055 -34.6318515892581,-58.4563761721345 -34.6321367888648,-58.4565457184431 -34.6321896866104,-58.4569994796645 -34.6312393954769,-58.4570670522784 -34.631108337923)))";;"2918";7_11_9;COMUNA 7;"11";"9";"987";"408";"579";"70,47%";"442";"441";"99,77%";"1";"0,23%";"366";"2";"0.55";"364";"99,45%";"0.55";0.550
"MULTIPOLYGON (((-58.453870280075 -34.6325343223944,-58.4539416941436 -34.632389745305,-58.4543780991686 -34.6315005210732,-58.4532329607238 -34.6311398622143,-58.4515763969476 -34.6306390719281,-58.4511006716497 -34.6316537796447,-58.4512300005364 -34.631694849574,-58.4516927058045 -34.631842643582,-58.4512080328647 -34.6328282652432,-58.4522613411879 -34.6331617511972,-58.4531281564477 -34.6334361975212,-58.4533841805707 -34.6335186144177,-58.453870280075 -34.6325343223944)))";;"2919";7_12_1;COMUNA 7;"12";"1";"1020";"467";"553";"84,45%";"511";"510";"99,80%";"1";"0,20%";"422";"1";"0.24";"421";"99,76%";"0.24";0.240
"MULTIPOLYGON (((-58.4513000765452 -34.6351314479345,-58.4508200663968 -34.6361150256356,-58.4504389139244 -34.6368958582445,-58.4505838366344 -34.6369829177907,-58.4512432801907 -34.6373567963881,-58.451441029485 -34.6374668887708,-58.4519236811044 -34.6364861260701,-58.4524162075644 -34.6354852910583,-58.4528992623551 -34.6345035382621,-58.4533226503199 -34.6336432616824,-58.4533841805707 -34.6335186144177,-58.4531281564477 -34.6334361975212,-58.4522613411879 -34.6331617511972,-58.4517780299103 -34.6341522343404,-58.4513000765452 -34.6351314479345)))";;"2920";7_12_2;COMUNA 7;"12";"2";"578";"265";"313";"84,66%";"268";"267";"99,63%";"1";"0,37%";"216";"6";"2.78";"210";"97,22%";"2.78";2.780
"MULTIPOLYGON (((-58.4516927058045 -34.631842643582,-58.4512300005364 -34.631694849574,-58.4511006716497 -34.6316537796447,-58.451048006915 -34.631730678582,-58.4501956282359 -34.6325044225817,-58.449244130821 -34.633356532488,-58.4494607041607 -34.6334261359397,-58.4507200245644 -34.6338207157001,-58.4505725800304 -34.6341204996839,-58.4502406128577 -34.6347955587118,-58.4497557350708 -34.6357816670733,-58.4495612381511 -34.6361588416091,-58.4494817255219 -34.6362606673025,-58.4503046413103 -34.6368151378405,-58.4504389139244 -34.6368958582445,-58.4508200663968 -34.6361150256356,-58.4513000765452 -34.6351314479345,-58.4517780299103 -34.6341522343404,-58.4522613411879 -34.6331617511972,-58.4512080328647 -34.6328282652432,-58.4516927058045 -34.631842643582)))";;"2921";7_12_3;COMUNA 7;"12";"3";"772";"387";"385";"100,52%";"309";"305";"98,71%";"4";"1,31%";"278";"30";"10.79";"248";"89,21%";"10.79";10.790
"MULTIPOLYGON (((-58.4507200245644 -34.6338207157001,-58.4494607041607 -34.6334261359397,-58.449244130821 -34.633356532488,-58.4483172414959 -34.6341865243545,-58.4476683994471 -34.6347675918663,-58.4475039286273 -34.6349182806264,-58.4476697988006 -34.6350398544377,-58.448249289245 -34.6354302892939,-58.4485894413488 -34.6353368753772,-58.4487193747596 -34.6353563980174,-58.448819865734 -34.6351464026588,-58.4485776451234 -34.6350584846656,-58.4487549227684 -34.6347411003469,-58.4493103339966 -34.6349413803843,-58.4497949687022 -34.6338768203564,-58.4505725800304 -34.6341204996839,-58.4507200245644 -34.6338207157001)))";;"2922";7_12_4;COMUNA 7;"12";"4";"797";"349";"448";"77,90%";"347";"347";"100,00%";"0";"0,00%";"319";"0";"0";"319";"100,00%";"0";0.000
"MULTIPOLYGON (((-58.4502406128577 -34.6347955587118,-58.4505725800304 -34.6341204996839,-58.4497949687022 -34.6338768203564,-58.4493103339966 -34.6349413803843,-58.4487549227684 -34.6347411003469,-58.4485776451234 -34.6350584846656,-58.448819865734 -34.6351464026588,-58.4487193747596 -34.6353563980174,-58.4485894413488 -34.6353368753772,-58.448249289245 -34.6354302892939,-58.4485020619157 -34.6356006062069,-58.4494817255219 -34.6362606673025,-58.4495612381511 -34.6361588416091,-58.4497557350708 -34.6357816670733,-58.4502406128577 -34.6347955587118)))";;"2923";7_12_5;COMUNA 7;"12";"5";"740";"311";"429";"72,49%";"333";"333";"100,00%";"0";"0,00%";"297";"0";"0";"297";"100,00%";"0";0.000
"MULTIPOLYGON (((-58.4468875252442 -34.6355673079054,-58.4458766081092 -34.6366565741534,-58.4453146354789 -34.6372605289157,-58.4463426398362 -34.6381808415442,-58.4471358722633 -34.6388910385057,-58.4472401495605 -34.6389843646087,-58.4485179254422 -34.6380126577846,-58.4484339186027 -34.6379695480119,-58.4489896122176 -34.6370976822813,-58.4493243864371 -34.6365724208016,-58.4494817255219 -34.6362606673025,-58.4485020619157 -34.6356006062069,-58.448249289245 -34.6354302892939,-58.4476697988006 -34.6350398544377,-58.4475039286273 -34.6349182806264,-58.4472968258563 -34.6347665595584,-58.4471937687898 -34.6350119770383,-58.4471159450637 -34.635185353049,-58.446989217098 -34.6353406235349,-58.4468875252442 -34.6355673079054)))";;"2924";7_12_6;COMUNA 7;"12";"6";"755";"346";"409";"84,60%";"378";"376";"99,47%";"2";"0,53%";"302";"0";"0";"302";"100,00%";"0";0.000
"MULTIPOLYGON (((-58.4485179254422 -34.6380126577846,-58.4472401495605 -34.6389843646087,-58.4481268567007 -34.6397785131793,-58.4494075316428 -34.6388058819859,-58.4495589642757 -34.6386908947188,-58.4503224166072 -34.6381825780238,-58.4505163675324 -34.6380458056627,-58.4509348548365 -34.6377608648492,-58.4513028064787 -34.6375111947624,-58.451441029485 -34.6374668887708,-58.4512432801907 -34.6373567963881,-58.4505838366344 -34.6369829177907,-58.4504389139244 -34.6368958582445,-58.4503046413103 -34.6368151378405,-58.4494817255219 -34.6362606673025,-58.4493243864371 -34.6365724208016,-58.4489896122176 -34.6370976822813,-58.4484339186027 -34.6379695480119,-58.4485179254422 -34.6380126577846)))";;"2925";7_12_7;COMUNA 7;"12";"7";"612";"302";"310";"97,42%";"251";"251";"100,00%";"0";"0,00%";"218";"1";"0.46";"217";"99,54%";"0.46";0.460
"MULTIPOLYGON (((-58.4452516043343 -34.6420396860926,-58.445309059982 -34.641928211921,-58.4460527620187 -34.6413619978998,-58.4462044146021 -34.6412452166881,-58.4463389909316 -34.6411415690812,-58.4471509907734 -34.6405205993266,-58.4473389898397 -34.6403768862004,-58.4481268567007 -34.6397785131793,-58.4472401495605 -34.6389843646087,-58.4462649667972 -34.6397260213012,-58.4452956470626 -34.6404632341798,-58.4443188956423 -34.6412060016984,-58.4433123828379 -34.6419714333423,-58.4442440671012 -34.6428068153681,-58.4452516043343 -34.6420396860926)))";;"2926";7_12_8;COMUNA 7;"12";"8";"595";"303";"292";"103,77%";"241";"241";"100,00%";"0";"0,00%";"213";"4";"1.88";"209";"98,12%";"1.88";1.880
"MULTIPOLYGON (((-58.4449778860863 -34.6385275633903,-58.4448537140686 -34.6390396039054,-58.4447312741344 -34.6394151612858,-58.4444966226058 -34.6397464046395,-58.444405335567 -34.6398753387419,-58.4437944467892 -34.6407376672907,-58.4431803915392 -34.6416043584833,-58.4430780125391 -34.6417777277947,-58.4433123828379 -34.6419714333423,-58.4443188956423 -34.6412060016984,-58.4452956470626 -34.6404632341798,-58.4462649667972 -34.6397260213012,-58.4472401495605 -34.6389843646087,-58.4471358722633 -34.6388910385057,-58.4463426398362 -34.6381808415442,-58.4453146354789 -34.6372605289157,-58.4452661366651 -34.6373389047991,-58.4449778860863 -34.6385275633903)))";;"2927";7_12_9;COMUNA 7;"12";"9";"823";"396";"427";"92,74%";"327";"327";"100,00%";"0";"0,00%";"290";"4";"1.38";"286";"98,62%";"1.38";1.380
"MULTIPOLYGON (((-58.4617642601983 -34.634838798537,-58.4612327363869 -34.6360899607591,-58.4617978121302 -34.6365377272292,-58.462970749056 -34.635445511734,-58.4633889246897 -34.6344736474098,-58.4634570860899 -34.634319346185,-58.4621522846553 -34.6339252498919,-58.4617642601983 -34.634838798537)))";;"2928";7_13_1;COMUNA 7;"13";"1";"721";"344";"377";"91,25%";"373";"373";"100,00%";"0";"0,00%";"320";"45";"14.06";"275";"85,94%";"14.06";14.060
"MULTIPOLYGON (((-58.4567657924073 -34.6345916778687,-58.4555771489021 -34.6342144892362,-58.4551017947621 -34.635206746467,-58.4563074924607 -34.6355674611576,-58.4564837666771 -34.6357570538942,-58.4566029601943 -34.6358666409337,-58.4566885854651 -34.6359453801337,-58.4567518886328 -34.6360035541386,-58.4568370881395 -34.6360825749111,-58.4568922123061 -34.6361337059667,-58.4576729177887 -34.6352148375478,-58.4574819877472 -34.6350119355937,-58.4572908882416 -34.634808822052,-58.4572231559155 -34.6347368448491,-58.4567657924073 -34.6345916778687)))";;"2929";7_13_10;COMUNA 7;"13";"10";"497";"230";"267";"86,14%";"231";"231";"100,00%";"0";"0,00%";"193";"2";"1.04";"191";"98,96%";"1.04";1.040
"MULTIPOLYGON (((-58.4588452009325 -34.6379703214611,-58.4580769296141 -34.6372330879399,-58.4579734093755 -34.6371370949613,-58.4577320334905 -34.6369131344791,-58.4575388826019 -34.6367338248918,-58.457327840425 -34.6365380348003,-58.4570640604046 -34.6362932262397,-58.4568922123061 -34.6361337059667,-58.4568370881395 -34.6360825749111,-58.4567518886328 -34.6360035541386,-58.4566885854651 -34.6359453801337,-58.4566029601943 -34.6358666409337,-58.4564837666771 -34.6357570538942,-58.4563074924607 -34.6355674611576,-58.4551017947621 -34.635206746467,-58.4546307756402 -34.6361899875931,-58.4555385276198 -34.6364789268666,-58.4557643033874 -34.6367065529096,-58.4558560624287 -34.636798955445,-58.4559847128521 -34.6369286850957,-58.4560497198121 -34.6369941837296,-58.456115578869 -34.6370605274718,-58.4562076796793 -34.6371508170117,-58.4562442303787 -34.6371866651782,-58.4564649836406 -34.637403162513,-58.456643734137 -34.6375783884286,-58.4568383327655 -34.6377691787206,-58.4569787442416 -34.6379067954442,-58.4570639452901 -34.6379949712573,-58.4571626083288 -34.638097091731,-58.4578270981771 -34.6388009454558,-58.4587518956308 -34.6380452504598,-58.4588452009325 -34.6379703214611)))";;"2930";7_13_11;COMUNA 7;"13";"11";"750";"353";"397";"88,92%";"277";"277";"100,00%";"0";"0,00%";"253";"1";"0.4";"252";"99,60%";"0.4";0.400
"MULTIPOLYGON (((-58.456643734137 -34.6375783884286,-58.4564649836406 -34.637403162513,-58.4559296728816 -34.6379389258524,-58.4558877473355 -34.637983924963,-58.4555964828956 -34.6382958901876,-58.4554734319651 -34.6384276477449,-58.4544989713427 -34.6395688197507,-58.4547073708545 -34.6397877137934,-58.4549122782282 -34.640002945161,-58.4552164575837 -34.640195928081,-58.4554625297111 -34.6403396798883,-58.4557439629688 -34.6405040676747,-58.4558616454941 -34.6404069585749,-58.4567944034812 -34.6396447999899,-58.4573614976779 -34.6391814310779,-58.4578270981771 -34.6388009454558,-58.4571626083288 -34.638097091731,-58.4570639452901 -34.6379949712573,-58.4569787442416 -34.6379067954442,-58.4568383327655 -34.6377691787206,-58.456643734137 -34.6375783884286)))";;"2931";7_13_12;COMUNA 7;"13";"12";"692";"331";"361";"91,69%";"244";"244";"100,00%";"0";"0,00%";"222";"7";"3.15";"215";"96,85%";"3.15";3.150
"MULTIPOLYGON (((-58.4536664032578 -34.6387253537211,-58.4537963339616 -34.6388307891825,-58.4538976349802 -34.6389372083878,-58.4540897583174 -34.6391389891101,-58.4542823085849 -34.6393411921014,-58.454328486698 -34.6393897883785,-58.4544989713427 -34.6395688197507,-58.4554734319651 -34.6384276477449,-58.4555964828956 -34.6382958901876,-58.4558877473355 -34.637983924963,-58.4559296728816 -34.6379389258524,-58.4564649836406 -34.637403162513,-58.4562442303787 -34.6371866651782,-58.4562076796793 -34.6371508170117,-58.456115578869 -34.6370605274718,-58.4560497198121 -34.6369941837296,-58.4559847128521 -34.6369286850957,-58.4558560624287 -34.636798955445,-58.4557643033874 -34.6367065529096,-58.4555385276198 -34.6364789268666,-58.4550666891102 -34.6370832135476,-58.4548964283102 -34.6372846881422,-58.4545913877354 -34.6376482993099,-58.4544935330777 -34.6375868212944,-58.4542739037757 -34.637456105446,-58.4540793885337 -34.6373397647879,-58.4534778525446 -34.6385965326708,-58.4535720865554 -34.6386487949535,-58.4536664032578 -34.6387253537211)))";;"2932";7_13_13;COMUNA 7;"13";"13";"565";"287";"278";"103,24%";"229";"229";"100,00%";"0";"0,00%";"196";"1";"0.51";"195";"99,49%";"0.51";0.510
"MULTIPOLYGON (((-58.4555771489021 -34.6342144892362,-58.4545215136633 -34.6338795528949,-58.4541073379227 -34.6347491303312,-58.454049897932 -34.6348708908076,-58.4535841507094 -34.6358568044621,-58.4532897825546 -34.6364799008905,-58.4531068016347 -34.6368672230993,-58.4530512738193 -34.6369842344173,-58.4525365413569 -34.6380744692987,-58.4534778525446 -34.6385965326708,-58.4540793885337 -34.6373397647879,-58.4542739037757 -34.637456105446,-58.4544935330777 -34.6375868212944,-58.4545913877354 -34.6376482993099,-58.4548964283102 -34.6372846881422,-58.4550666891102 -34.6370832135476,-58.4555385276198 -34.6364789268666,-58.4546307756402 -34.6361899875931,-58.4551017947621 -34.635206746467,-58.4555771489021 -34.6342144892362)))";;"2933";7_13_14;COMUNA 7;"13";"14";"709";"320";"389";"82,26%";"256";"254";"99,22%";"2";"0,79%";"220";"4";"1.82";"216";"98,18%";"1.82";1.820
"MULTIPOLYGON (((-58.4525365413569 -34.6380744692987,-58.4530512738193 -34.6369842344173,-58.4531068016347 -34.6368672230993,-58.4532897825546 -34.6364799008905,-58.4535841507094 -34.6358568044621,-58.454049897932 -34.6348708908076,-58.4541073379227 -34.6347491303312,-58.4545215136633 -34.6338795528949,-58.4533841805707 -34.6335186144177,-58.4533226503199 -34.6336432616824,-58.4528992623551 -34.6345035382621,-58.4524162075644 -34.6354852910583,-58.4519236811044 -34.6364861260701,-58.451441029485 -34.6374668887708,-58.4514423883772 -34.6374679468336,-58.4525365413569 -34.6380744692987)))";;"2934";7_13_15;COMUNA 7;"13";"15";"503";"220";"283";"77,74%";"217";"216";"99,54%";"1";"0,46%";"185";"5";"2.7";"180";"97,30%";"2.7";2.700
"MULTIPOLYGON (((-58.4621522846553 -34.6339252498919,-58.4609258813951 -34.6335548035292,-58.4607652757064 -34.6335055741183,-58.4606757234002 -34.633689381517,-58.4600024103013 -34.6349668750647,-58.4601506611063 -34.6351030798765,-58.46109632521 -34.6359716453451,-58.4612327363869 -34.6360899607591,-58.4617642601983 -34.634838798537,-58.4621522846553 -34.6339252498919)))";;"2935";7_13_2;COMUNA 7;"13";"2";"713";"322";"391";"82,35%";"376";"376";"100,00%";"0";"0,00%";"294";"10";"3.4";"284";"96,60%";"3.4";3.400
"MULTIPOLYGON (((-58.4607652757064 -34.6335055741183,-58.4590250379316 -34.6329715728737,-58.4578991138437 -34.6326260998303,-58.4577187458381 -34.6325623581,-58.4572336256617 -34.6335953290731,-58.4585429137234 -34.6340034927032,-58.4592401211179 -34.6342186623648,-58.4594501390668 -34.6344248720706,-58.4596727677523 -34.6346433356429,-58.4598942899876 -34.6348608128279,-58.4600024103013 -34.6349668750647,-58.4606757234002 -34.633689381517,-58.4607652757064 -34.6335055741183)))";;"2936";7_13_3;COMUNA 7;"13";"3";"1000";"451";"549";"82,15%";"541";"539";"99,63%";"2";"0,37%";"415";"3";"0.72";"412";"99,28%";"0.72";0.720
"MULTIPOLYGON (((-58.4565457184431 -34.6321896866104,-58.4563761721345 -34.6321367888648,-58.4554872936055 -34.6318515892581,-58.4553463754372 -34.6318063680784,-58.4545739690151 -34.631562226467,-58.4543780991686 -34.6315005210732,-58.4539416941436 -34.632389745305,-58.453870280075 -34.6325343223944,-58.4549926919729 -34.6328902552896,-58.4560507873882 -34.6332258215643,-58.4562064480141 -34.6332751273469,-58.4572336256617 -34.6335953290731,-58.4577187458381 -34.6325623581,-58.4575559292313 -34.6325048142314,-58.4565457184431 -34.6321896866104)))";;"2937";7_13_4;COMUNA 7;"13";"4";"562";"252";"310";"81,29%";"264";"264";"100,00%";"0";"0,00%";"216";"1";"0.46";"215";"99,54%";"0.46";0.460
"MULTIPOLYGON (((-58.4572336256617 -34.6335953290731,-58.4562064480141 -34.6332751273469,-58.4560507873882 -34.6332258215643,-58.4549926919729 -34.6328902552896,-58.453870280075 -34.6325343223944,-58.4533841805707 -34.6335186144177,-58.4545215136633 -34.6338795528949,-58.4555771489021 -34.6342144892362,-58.4567657924073 -34.6345916778687,-58.4572336256617 -34.6335953290731)))";;"2938";7_13_5;COMUNA 7;"13";"5";"819";"361";"458";"78,82%";"399";"399";"100,00%";"0";"0,00%";"329";"3";"0.91";"326";"99,09%";"0.91";0.910
"MULTIPOLYGON (((-58.4598942899876 -34.6348608128279,-58.4596727677523 -34.6346433356429,-58.4594501390668 -34.6344248720706,-58.4592401211179 -34.6342186623648,-58.4585429137234 -34.6340034927032,-58.4572336256617 -34.6335953290731,-58.4567657924073 -34.6345916778687,-58.4572231559155 -34.6347368448491,-58.4572908882416 -34.634808822052,-58.4574819877472 -34.6350119355937,-58.4576729177887 -34.6352148375478,-58.457865552739 -34.6354196407342,-58.4579200802748 -34.6354776025152,-58.4581067524617 -34.6356759964191,-58.4581727823216 -34.6357460715869,-58.4583410524545 -34.6359248863389,-58.4585406771456 -34.6361370832908,-58.4587718272819 -34.6363827327154,-58.4589085878724 -34.6362544934534,-58.4601506611063 -34.6351030798765,-58.4600024103013 -34.6349668750647,-58.4598942899876 -34.6348608128279)))";;"2939";7_13_6;COMUNA 7;"13";"6";"744";"351";"393";"89,31%";"299";"299";"100,00%";"0";"0,00%";"265";"1";"0.38";"264";"99,62%";"0.38";0.380
"MULTIPOLYGON (((-58.4612327363869 -34.6360899607591,-58.46109632521 -34.6359716453451,-58.4601506611063 -34.6351030798765,-58.4589085878724 -34.6362544934534,-58.4587718272819 -34.6363827327154,-58.4599604192736 -34.6371158170643,-58.4605299281058 -34.6374782345726,-58.4606733283942 -34.6375759866652,-58.4617978121302 -34.6365377272292,-58.4612327363869 -34.6360899607591)))";;"2940";7_13_7;COMUNA 7;"13";"7";"549";"240";"309";"77,67%";"257";"256";"99,61%";"1";"0,39%";"202";"1";"0.5";"201";"99,50%";"0.5";0.500
"MULTIPOLYGON (((-58.4578270981771 -34.6388009454558,-58.4573614976779 -34.6391814310779,-58.4567944034812 -34.6396447999899,-58.4558616454941 -34.6404069585749,-58.4557439629688 -34.6405040676747,-58.4560218186879 -34.6406664122932,-58.4562644853533 -34.6408081199668,-58.4568388642139 -34.6411154121614,-58.4575478543436 -34.6404609868392,-58.4585523515742 -34.6395338125699,-58.4595466863719 -34.6386159961199,-58.4606733283942 -34.6375759866652,-58.4605299281058 -34.6374782345726,-58.4599604192736 -34.6371158170643,-58.4589249576616 -34.6379062373903,-58.4588452009325 -34.6379703214611,-58.4587518956308 -34.6380452504598,-58.4578270981771 -34.6388009454558)))";;"2941";7_13_8;COMUNA 7;"13";"8";"560";"268";"292";"91,78%";"257";"257";"100,00%";"0";"0,00%";"194";"5";"2.58";"189";"97,42%";"2.58";2.580
"MULTIPOLYGON (((-58.4599604192736 -34.6371158170643,-58.4587718272819 -34.6363827327154,-58.4585406771456 -34.6361370832908,-58.4583410524545 -34.6359248863389,-58.4581727823216 -34.6357460715869,-58.4581067524617 -34.6356759964191,-58.4579200802748 -34.6354776025152,-58.457865552739 -34.6354196407342,-58.4576729177887 -34.6352148375478,-58.4568922123061 -34.6361337059667,-58.4570640604046 -34.6362932262397,-58.457327840425 -34.6365380348003,-58.4575388826019 -34.6367338248918,-58.4577320334905 -34.6369131344791,-58.4579734093755 -34.6371370949613,-58.4580769296141 -34.6372330879399,-58.4588452009325 -34.6379703214611,-58.4589249576616 -34.6379062373903,-58.4599604192736 -34.6371158170643)))";;"2942";7_13_9;COMUNA 7;"13";"9";"493";"245";"248";"98,79%";"186";"186";"100,00%";"0";"0,00%";"166";"0";"0";"166";"100,00%";"0";0.000
"MULTIPOLYGON (((-58.4665027518705 -34.6377685560488,-58.4680504754925 -34.6381733701279,-58.4684632399907 -34.6372365606323,-58.4685194673128 -34.6371097933114,-58.4697225235916 -34.637465304813,-58.4706660425162 -34.6377441994727,-58.4708088533857 -34.6377872900384,-58.4712236279954 -34.6368318788599,-58.4713029364562 -34.6366551774409,-58.4702104843707 -34.6363292531431,-58.4690224385816 -34.6359748019828,-58.4677514120469 -34.6355956235804,-58.4674919594615 -34.6355186597166,-58.4673933902567 -34.6357402904706,-58.466990589212 -34.6366576589775,-58.4665027518705 -34.6377685560488)))";;"2943";7_14_1;COMUNA 7;"14";"1";"833";"410";"423";"96,93%";"341";"341";"100,00%";"0";"0,00%";"313";"28";"8.95";"285";"91,05%";"8.95";8.950
"MULTIPOLYGON (((-58.4635895850489 -34.6430258915164,-58.464670651815 -34.6421363439014,-58.4653430369416 -34.6415830743309,-58.4659167428545 -34.6411110738204,-58.4646041446303 -34.6402840329323,-58.4644185559678 -34.6401632572065,-58.4639720546847 -34.6398725492167,-58.4632909019914 -34.6410349856446,-58.4631987906851 -34.6411909769011,-58.4631358199987 -34.6411487222864,-58.4619959543574 -34.6419846628798,-58.4623305776304 -34.6422210802358,-58.4625192354666 -34.6423416478285,-58.4623373931012 -34.6425526399602,-58.4619798430891 -34.6427196858635,-58.4621339059982 -34.6427596879294,-58.4622395686387 -34.6427979290087,-58.4623122543447 -34.6428288457227,-58.4623848548514 -34.6428706782279,-58.4624420320289 -34.6429144121259,-58.4624992944569 -34.6429671603635,-58.4625873185133 -34.6430672340302,-58.4626423655946 -34.6431528001248,-58.4626929817374 -34.6432783674432,-58.4627149665896 -34.6434185126649,-58.4627588512221 -34.6435842924732,-58.4628077632793 -34.6435054167394,-58.4628647704947 -34.6434509783568,-58.4629415469815 -34.6434020330388,-58.4630138923849 -34.6433693557973,-58.4631279919552 -34.6433494252503,-58.463180653215 -34.6433294948541,-58.4632595598262 -34.6432968174405,-58.4633227019242 -34.6432454070773,-58.4635895850489 -34.6430258915164)))";;"2944";7_14_10;COMUNA 7;"14";"10";"766";"349";"417";"83,69%";"258";"257";"99,61%";"1";"0,39%";"233";"8";"3.43";"225";"96,57%";"3.43";3.430
"MULTIPOLYGON (((-58.4639720546847 -34.6398725492167,-58.4637951592371 -34.6397574064252,-58.4633567569769 -34.6394482447979,-58.4627523721794 -34.6390219653471,-58.4621456077619 -34.6385939926657,-58.4615400424684 -34.6381668620445,-58.4614311486946 -34.6380927036509,-58.4606733283942 -34.6375759866652,-58.4595466863719 -34.6386159961199,-58.4596944324446 -34.6387309331058,-58.4602619049876 -34.6391334938464,-58.4608488954972 -34.6395497850498,-58.4613515358113 -34.6399063522875,-58.4614572791888 -34.6399776937071,-58.461567112751 -34.6400518520632,-58.4620655839476 -34.6404020780608,-58.4629659102375 -34.6410345642377,-58.4631358199987 -34.6411487222864,-58.4631987906851 -34.6411909769011,-58.4632909019914 -34.6410349856446,-58.4639720546847 -34.6398725492167)))";;"2945";7_14_11;COMUNA 7;"14";"11";"922";"448";"474";"94,51%";"349";"349";"100,00%";"0";"0,00%";"323";"14";"4.33";"309";"95,67%";"4.33";4.330
"MULTIPOLYGON (((-58.4608488954972 -34.6395497850498,-58.4602619049876 -34.6391334938464,-58.4596944324446 -34.6387309331058,-58.4595466863719 -34.6386159961199,-58.4585523515742 -34.6395338125699,-58.4587064880052 -34.6396603710408,-58.4592432877501 -34.6400396952763,-58.4597236850636 -34.640379155343,-58.46033138731 -34.640808548462,-58.4609360282922 -34.641235755311,-58.4619959543574 -34.6419846628798,-58.4631358199987 -34.6411487222864,-58.4629659102375 -34.6410345642377,-58.4620655839476 -34.6404020780608,-58.461567112751 -34.6400518520632,-58.4614572791888 -34.6399776937071,-58.4613515358113 -34.6399063522875,-58.4608488954972 -34.6395497850498)))";;"2946";7_14_12;COMUNA 7;"14";"12";"924";"438";"486";"90,12%";"358";"358";"100,00%";"0";"0,00%";"339";"14";"4.13";"325";"95,87%";"4.13";4.130
"MULTIPOLYGON (((-58.4625192354666 -34.6423416478285,-58.4623305776304 -34.6422210802358,-58.4619959543574 -34.6419846628798,-58.4609360282922 -34.641235755311,-58.46033138731 -34.640808548462,-58.4597236850636 -34.640379155343,-58.4592432877501 -34.6400396952763,-58.4587064880052 -34.6396603710408,-58.4585523515742 -34.6395338125699,-58.4575478543436 -34.6404609868392,-58.4568388642139 -34.6411154121614,-58.4576617168233 -34.6414991934395,-58.4579974380948 -34.6416557610777,-58.4587240148227 -34.6419946004137,-58.4594235858991 -34.6423208286501,-58.4607158043743 -34.642923340199,-58.461212250007 -34.6429413759992,-58.4612584354565 -34.6429149672765,-58.4615600881241 -34.6427903186783,-58.4617598256811 -34.6427363750297,-58.4619798430891 -34.6427196858635,-58.4623373931012 -34.6425526399602,-58.4625192354666 -34.6423416478285)))";;"2947";7_14_13;COMUNA 7;"14";"13";"747";"365";"382";"95,55%";"275";"274";"99,64%";"1";"0,36%";"251";"0";"0";"251";"100,00%";"0";0.000
"MULTIPOLYGON (((-58.4642005745213 -34.6345438536871,-58.4634570860899 -34.634319346185,-58.4633889246897 -34.6344736474098,-58.462970749056 -34.635445511734,-58.463084752915 -34.6354980483477,-58.4643042926153 -34.6358601628459,-58.4657288490541 -34.6362830368259,-58.466990589212 -34.6366576589775,-58.4673933902567 -34.6357402904706,-58.4674919594615 -34.6355186597166,-58.466218305593 -34.6351412260322,-58.4660525814748 -34.6350920741689,-58.4648053540751 -34.6347251886986,-58.4646354566164 -34.6346751898803,-58.4642005745213 -34.6345438536871)))";;"2948";7_14_2;COMUNA 7;"14";"2";"817";"359";"458";"78,38%";"380";"380";"100,00%";"0";"0,00%";"298";"34";"11.41";"264";"88,59%";"11.41";11.410
"MULTIPOLYGON (((-58.4657288490541 -34.6362830368259,-58.4643042926153 -34.6358601628459,-58.463084752915 -34.6354980483477,-58.462970749056 -34.635445511734,-58.4617978121302 -34.6365377272292,-58.4620981613504 -34.6366162527477,-58.4637766339869 -34.6370554185967,-58.4652261723872 -34.6374346347639,-58.4665027518705 -34.6377685560488,-58.466990589212 -34.6366576589775,-58.4657288490541 -34.6362830368259)))";;"2949";7_14_3;COMUNA 7;"14";"3";"725";"327";"398";"82,16%";"291";"290";"99,66%";"1";"0,34%";"257";"11";"4.28";"246";"95,72%";"4.28";4.280
"MULTIPOLYGON (((-58.4625435306726 -34.6370630995523,-58.4634290833147 -34.6376479050469,-58.463495715412 -34.6376918497059,-58.4635585132472 -34.637733399912,-58.4640591939052 -34.6380575607045,-58.4641960382075 -34.6381461534954,-58.4642529573505 -34.6381834075004,-58.4647504055665 -34.6385092556674,-58.464995978388 -34.6386701015116,-58.4657964396261 -34.6391872130184,-58.4659147909024 -34.6391072778271,-58.4665027518705 -34.6377685560488,-58.4652261723872 -34.6374346347639,-58.4637766339869 -34.6370554185967,-58.4620981613504 -34.6366162527477,-58.4617978121302 -34.6365377272292,-58.4625435306726 -34.6370630995523)))";;"2950";7_14_4;COMUNA 7;"14";"4";"696";"323";"373";"86,60%";"279";"279";"100,00%";"0";"0,00%";"258";"9";"3.49";"249";"96,51%";"3.49";3.490
"MULTIPOLYGON (((-58.4647504055665 -34.6385092556674,-58.4642529573505 -34.6381834075004,-58.4641960382075 -34.6381461534954,-58.4640591939052 -34.6380575607045,-58.4635585132472 -34.637733399912,-58.463495715412 -34.6376918497059,-58.4634290833147 -34.6376479050469,-58.4625435306726 -34.6370630995523,-58.4617978121302 -34.6365377272292,-58.4606733283942 -34.6375759866652,-58.4614311486946 -34.6380927036509,-58.4615400424684 -34.6381668620445,-58.4621456077619 -34.6385939926657,-58.4627523721794 -34.6390219653471,-58.4633567569769 -34.6394482447979,-58.4643022180595 -34.6387497630346,-58.4645688358437 -34.6388541287754,-58.4646686103673 -34.6386838400689,-58.4647504055665 -34.6385092556674)))";;"2951";7_14_5;COMUNA 7;"14";"5";"929";"425";"504";"84,33%";"322";"321";"99,69%";"1";"0,31%";"295";"1";"0.34";"294";"99,66%";"0.34";0.340
"MULTIPOLYGON (((-58.4680504754925 -34.6381733701279,-58.4665027518705 -34.6377685560488,-58.4659147909024 -34.6391072778271,-58.4657964396261 -34.6391872130184,-58.464995978388 -34.6386701015116,-58.4647504055665 -34.6385092556674,-58.4646686103673 -34.6386838400689,-58.4645688358437 -34.6388541287754,-58.4643022180595 -34.6387497630346,-58.4633567569769 -34.6394482447979,-58.4637951592371 -34.6397574064252,-58.4639720546847 -34.6398725492167,-58.4644185559678 -34.6401632572065,-58.4646041446303 -34.6402840329323,-58.4659167428545 -34.6411110738204,-58.4665598003972 -34.6405818130644,-58.4671767769207 -34.6400743110869,-58.4672552493538 -34.6399779670914,-58.4680504754925 -34.6381733701279)))";;"2952";7_14_6;COMUNA 7;"14";"6";"1125";"525";"600";"87,50%";"399";"399";"100,00%";"0";"0,00%";"379";"7";"1.85";"372";"98,15%";"1.85";1.850
"MULTIPOLYGON (((-58.4703750719849 -34.6387869276213,-58.4704420310264 -34.6386322001294,-58.4708088533857 -34.6377872900384,-58.4706660425162 -34.6377441994727,-58.4697225235916 -34.637465304813,-58.4685194673128 -34.6371097933114,-58.4684632399907 -34.6372365606323,-58.4680504754925 -34.6381733701279,-58.4672552493538 -34.6399779670914,-58.4671767769207 -34.6400743110869,-58.468302354237 -34.6407968931241,-58.4683523645281 -34.6406795631582,-58.4688218750663 -34.6395780970612,-58.4699054997511 -34.6398712866227,-58.469971097526 -34.6397203624351,-58.4703750719849 -34.6387869276213)))";;"2953";7_14_7;COMUNA 7;"14";"7";"939";"443";"496";"89,31%";"312";"311";"99,68%";"1";"0,32%";"272";"3";"1.1";"269";"98,90%";"1.1";1.100
"MULTIPOLYGON (((-58.468302354237 -34.6407968931241,-58.4671767769207 -34.6400743110869,-58.4665598003972 -34.6405818130644,-58.4659167428545 -34.6411110738204,-58.4653430369416 -34.6415830743309,-58.464670651815 -34.6421363439014,-58.4657686256708 -34.642835216384,-58.4664541321841 -34.6422923632828,-58.4670467536706 -34.6418230330683,-58.467989821747 -34.6424171694158,-58.4692423525276 -34.6413968652819,-58.4692929584004 -34.6412804504319,-58.4699054997511 -34.6398712866227,-58.4688218750663 -34.6395780970612,-58.4683523645281 -34.6406795631582,-58.468302354237 -34.6407968931241)))";;"2954";7_14_8;COMUNA 7;"14";"8";"936";"466";"470";"99,15%";"320";"320";"100,00%";"0";"0,00%";"300";"8";"2.67";"292";"97,33%";"2.67";2.670
"MULTIPOLYGON (((-58.4667082022474 -34.643426756916,-58.4668502461436 -34.643314213439,-58.467989821747 -34.6424171694158,-58.4670467536706 -34.6418230330683,-58.4664541321841 -34.6422923632828,-58.4657686256708 -34.642835216384,-58.464670651815 -34.6421363439014,-58.4635895850489 -34.6430258915164,-58.4633227019242 -34.6432454070773,-58.4632595598262 -34.6432968174405,-58.463180653215 -34.6433294948541,-58.4631279919552 -34.6433494252503,-58.4630138923849 -34.6433693557973,-58.4629415469815 -34.6434020330388,-58.4628647704947 -34.6434509783568,-58.4628077632793 -34.6435054167394,-58.4627588512221 -34.6435842924732,-58.4625834828411 -34.6438672589988,-58.4628801098935 -34.643966909912,-58.4631073739043 -34.6440433201937,-58.4631664268301 -34.6440639544271,-58.4638307539568 -34.6443696638072,-58.4648661970986 -34.6448462138926,-58.4650856195918 -34.6447119802846,-58.4655964632967 -34.6443073087724,-58.4667082022474 -34.643426756916)))";;"2955";7_14_9;COMUNA 7;"14";"9";"856";"400";"456";"87,72%";"331";"329";"99,40%";"2";"0,61%";"289";"9";"3.11";"280";"96,89%";"3.11";3.110
"MULTIPOLYGON (((-58.4590719296238 -34.6557451691146,-58.459655363212 -34.6562531576359,-58.4603553912461 -34.6568413592169,-58.461279266793 -34.6561586762673,-58.4619987878687 -34.655532785651,-58.4629586667054 -34.6547232704622,-58.463766456962 -34.6540928460121,-58.4645931981392 -34.6535337349694,-58.4656843627853 -34.652678124413,-58.466459597703 -34.6519968150963,-58.4666292637506 -34.6517887753723,-58.4670088234769 -34.6514879084935,-58.4663383476857 -34.6505057882236,-58.4658927417898 -34.6499627551244,-58.4657474065277 -34.649785641889,-58.4650403175107 -34.648874714459,-58.4649141202025 -34.6487303186767,-58.4644095173297 -34.6481529424383,-58.4638832055309 -34.6475511697665,-58.4633574116754 -34.6468277713143,-58.4630002572372 -34.6461715967127,-58.4625790507253 -34.6465436378986,-58.4625806669682 -34.646547694011,-58.4617468226291 -34.6471786956043,-58.4607111679385 -34.6479570871664,-58.4608349012786 -34.6480540639073,-58.4612003929657 -34.6483714729761,-58.4616736871093 -34.6487825467024,-58.4621248292326 -34.6491743925273,-58.4625922524007 -34.6495803920308,-58.4620531438709 -34.6500022217423,-58.4618597896499 -34.6501578713913,-58.4621434004546 -34.6501349145777,-58.4605468042434 -34.6513883061287,-58.4593601295577 -34.6522914135548,-58.4585705195347 -34.6529103514247,-58.4578331418617 -34.6534883695115,-58.4574788526222 -34.6537661095412,-58.4571129701805 -34.6540503974868,-58.4580167906115 -34.6548321061307,-58.4583374064496 -34.6551080137345,-58.4583699608929 -34.655134142421,-58.4589260313857 -34.655581568358,-58.4590719296238 -34.6557451691146)))";;"2956";7_15_1;COMUNA 7;"15";"1";"688";"340";"348";"97,70%";"194";"194";"100,00%";"0";"0,00%";"225";"15";"6.67";"210";"93,33%";"6.67";6.670
"MULTIPOLYGON (((-58.4526204357936 -34.6503318995729,-58.4528447279217 -34.6503841729993,-58.4529757908319 -34.6504279172307,-58.4530741263171 -34.650498772233,-58.4531497929818 -34.6505737804363,-58.4532253731446 -34.650661253748,-58.4532808405629 -34.650757105993,-58.4533385982729 -34.6509488767566,-58.4538210355988 -34.6509029959693,-58.4546362608147 -34.6508230502041,-58.457395027249 -34.6505524186511,-58.4573386155504 -34.650491710134,-58.4574644060469 -34.6503972057159,-58.4584953489864 -34.6496223631124,-58.4596032269288 -34.648789765441,-58.4607111679386 -34.6479570871664,-58.4605814698012 -34.6478554621658,-58.4598741843188 -34.6473485309399,-58.4592914045916 -34.6469308976253,-58.4586300644821 -34.6464568487171,-58.457976849771 -34.6470901544505,-58.4576513039569 -34.6474058552909,-58.4566784015648 -34.6483490793261,-58.4566151655533 -34.6484104160804,-58.4561765157554 -34.6488444206673,-58.4562569849918 -34.6485438524416,-58.456252073024 -34.6481477133744,-58.456171486643 -34.6477731202065,-58.4560223807394 -34.6474733846723,-58.4559081196624 -34.6472937249829,-58.4555332003704 -34.6469007337476,-58.4552835309948 -34.6467420519824,-58.4550045504002 -34.6465606911032,-58.4547444818451 -34.646453206325,-58.4545369868929 -34.6463979796481,-58.454428850815 -34.6463713518253,-58.4543559930247 -34.6463552900303,-58.4542570594627 -34.6463373953471,-58.4541197790747 -34.6463179485482,-58.4540038019074 -34.6463056160103,-58.4539426175925 -34.6463009636017,-58.4538740193038 -34.6462984233669,-58.4537703121947 -34.6462958805278,-58.4536467492544 -34.6462988996794,-58.4535914440546 -34.6463014308503,-58.4535283840845 -34.6463052994824,-58.45343430493 -34.6463154335273,-58.453246657015 -34.6463430256077,-58.4531606727223 -34.6463579489483,-58.4530961628294 -34.6463721696743,-58.4529758347981 -34.6464021610606,-58.4526871142365 -34.6464833373737,-58.4520054620411 -34.64590628992,-58.4517181256712 -34.6458359805271,-58.4515155759818 -34.6457863831257,-58.4512198998236 -34.6456402243826,-58.4501937882168 -34.6464655714126,-58.449217599717 -34.6472507027268,-58.449836519738 -34.6478538161669,-58.4500776450985 -34.6481130041885,-58.4501412048183 -34.6481959005977,-58.4501659964337 -34.6482403411202,-58.4502111501145 -34.6483179537473,-58.45024658634 -34.648413734931,-58.4502673683294 -34.6484883872073,-58.4502842290617 -34.6485715604656,-58.4503075655577 -34.6486603683525,-58.4503198283356 -34.6487183291035,-58.4503343873772 -34.6488075586397,-58.4503414497309 -34.6488800263418,-58.4503526017196 -34.6489582692798,-58.4503760240946 -34.6490438376219,-58.4504016590682 -34.6491506040063,-58.4504163943298 -34.6492017337997,-58.4504312155128 -34.6492482155716,-58.4504606038974 -34.6493301224109,-58.4505302105515 -34.6494466117724,-58.4506265761974 -34.649562751621,-58.4506844311875 -34.6496228295722,-58.4507443321655 -34.6496784005177,-58.4508159077492 -34.6497374233799,-58.4508894450235 -34.6497855305674,-58.4509813878499 -34.6498470201655,-58.4510854326781 -34.6499032994222,-58.4512619099767 -34.6499895158848,-58.4513673200251 -34.6500359355758,-58.4514757977502 -34.6500848907454,-58.4515868327429 -34.6501296909965,-58.4517002545703 -34.6501701954575,-58.4518158075595 -34.650206404099,-58.4519332360547 -34.6502381760432,-58.4520523696091 -34.6502654408452,-58.4521727821065 -34.6502881984632,-58.4522943883175 -34.6503063784616,-58.4524169325812 -34.650319839966,-58.452538454815 -34.6503286532348,-58.4526204357936 -34.6503318995729)))";;"2957";7_15_10;COMUNA 7;"15";"10";"1023";"504";"519";"97,11%";"324";"324";"100,00%";"0";"0,00%";"327";"18";"5.5";"309";"94,50%";"5.5";5.500
"MULTIPOLYGON (((-58.4618597896499 -34.6501578713913,-58.462053143871 -34.6500022217423,-58.4625922524007 -34.6495803920308,-58.4621248292326 -34.6491743925273,-58.4616736871094 -34.6487825467024,-58.4612003929657 -34.6483714729761,-58.4608349012786 -34.6480540639073,-58.4607111679386 -34.6479570871664,-58.4596032269288 -34.648789765441,-58.4584953489864 -34.6496223631124,-58.4574644060469 -34.6503972057159,-58.4573386155504 -34.650491710134,-58.457395027249 -34.6505524186511,-58.4546362608147 -34.6508230502041,-58.4546998885119 -34.6511541910819,-58.4547647944445 -34.6514914589354,-58.4547982595854 -34.6517725962668,-58.4548605357747 -34.6519904236854,-58.4549419912211 -34.6521646594388,-58.4550618004388 -34.6522993188987,-58.4553124902758 -34.6525231755173,-58.4569951994309 -34.6539311631662,-58.4571129701805 -34.6540503974868,-58.4574788526222 -34.6537661095412,-58.4578331418618 -34.6534883695115,-58.4585705195347 -34.6529103514247,-58.4593601295577 -34.6522914135548,-58.4605468042434 -34.6513883061287,-58.4621434004547 -34.6501349145777,-58.4618597896499 -34.6501578713913)))";;"2958";7_15_11;COMUNA 7;"15";"11";"1148";"537";"611";"87,89%";"354";"354";"100,00%";"0";"0,00%";"367";"16";"4.36";"351";"95,64%";"4.36";4.360
"MULTIPOLYGON (((-58.461212250007 -34.6429413759992,-58.4607158043743 -34.642923340199,-58.4605908806563 -34.6430305245554,-58.4609352988844 -34.6434885725077,-58.4609262628462 -34.6436524507286,-58.4609173972663 -34.643813159834,-58.4609156055714 -34.6439168250087,-58.460910831978 -34.6439939400157,-58.4609075925019 -34.6440577447708,-58.4608963431942 -34.6441109152733,-58.4608786171015 -34.6441892977294,-58.4609045199075 -34.6442857799862,-58.4606593555695 -34.6444893740039,-58.4595419066291 -34.6455728344312,-58.4586300644821 -34.6464568487171,-58.4592914045916 -34.6469308976253,-58.4598741843188 -34.6473485309399,-58.4605814698012 -34.6478554621658,-58.4607111679386 -34.6479570871664,-58.4617468226291 -34.6471786956043,-58.4625806669682 -34.646547694011,-58.4625790507253 -34.6465436378986,-58.4630002572372 -34.6461715967127,-58.4629989413109 -34.6461691790331,-58.4633304909565 -34.6459709299253,-58.463332077284 -34.6459700348783,-58.4634165438674 -34.6459201374494,-58.4641188785639 -34.645387790931,-58.4646959417976 -34.6449503045296,-58.4648661970986 -34.6448462138926,-58.4638307539568 -34.6443696638072,-58.4631664268301 -34.6440639544271,-58.4631073739043 -34.6440433201937,-58.4628801098935 -34.643966909912,-58.4625834828411 -34.6438672589988,-58.4627588512221 -34.6435842924732,-58.4627149665896 -34.6434185126649,-58.4626929817374 -34.6432783674432,-58.4626423655946 -34.6431528001248,-58.4625873185133 -34.6430672340302,-58.4624992944569 -34.6429671603635,-58.4624420320289 -34.6429144121259,-58.4623848548514 -34.6428706782279,-58.4623122543447 -34.6428288457227,-58.4622395686387 -34.6427979290087,-58.4621339059982 -34.6427596879294,-58.4619798430891 -34.6427196858635,-58.4617598256811 -34.6427363750297,-58.4615600881241 -34.6427903186783,-58.4612584354565 -34.6429149672765,-58.461212250007 -34.6429413759992)))";;"2959";7_15_2;COMUNA 7;"15";"2";"1067";"509";"558";"91,22%";"302";"302";"100,00%";"0";"0,00%";"360";"52";"14.44";"308";"85,56%";"14.44";14.440
"MULTIPOLYGON (((-58.4586664475921 -34.6430204757765,-58.4575205327075 -34.6440793387686,-58.4585598414915 -34.6448472192238,-58.4595419066291 -34.6455728344312,-58.4606593555695 -34.6444893740039,-58.4609045199075 -34.6442857799862,-58.4608786171015 -34.6441892977294,-58.4608963431942 -34.6441109152733,-58.4609075925019 -34.6440577447708,-58.460910831978 -34.6439939400157,-58.4609156055714 -34.6439168250087,-58.4609173972663 -34.643813159834,-58.4609262628462 -34.6436524507286,-58.4609352988844 -34.6434885725077,-58.4605908806563 -34.6430305245554,-58.4607158043743 -34.642923340199,-58.4594235858991 -34.6423208286501,-58.4586664475921 -34.6430204757765)))";;"2960";7_15_3;COMUNA 7;"15";"3";"960";"450";"510";"88,24%";"329";"329";"100,00%";"0";"0,00%";"316";"28";"8.86";"288";"91,14%";"8.86";8.860
"MULTIPOLYGON (((-58.4565027717329 -34.6414256166081,-58.4553586409847 -34.6424816426642,-58.4563073341528 -34.6431829152261,-58.4575205327075 -34.6440793387686,-58.4586664475921 -34.6430204757765,-58.4594235858991 -34.6423208286501,-58.4587240148227 -34.6419946004137,-58.4579974380948 -34.6416557610777,-58.4576617168233 -34.6414991934395,-58.4568388642139 -34.6411154121614,-58.4565027717329 -34.6414256166081)))";;"2961";7_15_4;COMUNA 7;"15";"4";"655";"311";"344";"90,41%";"273";"272";"99,63%";"1";"0,37%";"232";"9";"3.88";"223";"96,12%";"3.88";3.880
"MULTIPOLYGON (((-58.4595419066291 -34.6455728344312,-58.4585598414915 -34.6448472192238,-58.4575205327075 -34.6440793387686,-58.4563073341528 -34.6431829152261,-58.4553586409847 -34.6424816426642,-58.4544212263874 -34.6433467505571,-58.4553690693932 -34.6440478894113,-58.4561160054622 -34.6446004139799,-58.456582866847 -34.6449456602604,-58.4576209847887 -34.6457134781234,-58.4585018193967 -34.6463649401369,-58.4586300644821 -34.6464568487171,-58.4595419066291 -34.6455728344312)))";;"2962";7_15_5;COMUNA 7;"15";"5";"705";"335";"370";"90,54%";"256";"255";"99,61%";"1";"0,39%";"233";"4";"1.72";"229";"98,28%";"1.72";1.720
"MULTIPOLYGON (((-58.456582866847 -34.6449456602604,-58.4561160054622 -34.6446004139799,-58.4553690693932 -34.6440478894113,-58.4544212263874 -34.6433467505571,-58.4540592086965 -34.6436808908006,-58.4539567728629 -34.643775252638,-58.453354936393 -34.6443292393272,-58.4529680251133 -34.6446854173038,-58.4547187127941 -34.645917624784,-58.4554422491772 -34.6452374377286,-58.4558347264069 -34.6454899330453,-58.4559398233875 -34.6462051018037,-58.4564331490036 -34.6460313199872,-58.4568675503108 -34.6464085362384,-58.4569297617505 -34.6463512134924,-58.4576209847887 -34.6457134781234,-58.456582866847 -34.6449456602604)))";;"2963";7_15_6;COMUNA 7;"15";"6";"1110";"509";"601";"84,69%";"373";"372";"99,73%";"1";"0,27%";"334";"4";"1.2";"330";"98,80%";"1.2";1.200
"MULTIPOLYGON (((-58.4529680251133 -34.6446854173038,-58.4524685296866 -34.6451452498174,-58.4517181256712 -34.6458359805271,-58.4520054620411 -34.64590628992,-58.4526871142365 -34.6464833373737,-58.4529758347981 -34.6464021610606,-58.4530961628294 -34.6463721696743,-58.4531606727223 -34.6463579489483,-58.453246657015 -34.6463430256077,-58.45343430493 -34.6463154335273,-58.4535283840845 -34.6463052994824,-58.4535914440546 -34.6463014308503,-58.4536467492544 -34.6462988996794,-58.4537703121947 -34.6462958805278,-58.4538740193038 -34.6462984233669,-58.4539426175925 -34.6463009636017,-58.4540038019074 -34.6463056160103,-58.4541197790747 -34.6463179485482,-58.4542570594627 -34.6463373953471,-58.4547187127941 -34.645917624784,-58.4529680251133 -34.6446854173038)))";;"2964";7_15_7;COMUNA 7;"15";"7";"714";"337";"377";"89,39%";"334";"334";"100,00%";"0";"0,00%";"285";"1";"0.35";"284";"99,65%";"0.35";0.350
"MULTIPOLYGON (((-58.4554422491772 -34.6452374377286,-58.4547187127941 -34.645917624784,-58.4542570594627 -34.6463373953471,-58.4543559930247 -34.6463552900303,-58.454428850815 -34.6463713518253,-58.4545369868929 -34.6463979796481,-58.4547444818451 -34.646453206325,-58.4550045504002 -34.6465606911032,-58.4552835309948 -34.6467420519824,-58.4555332003704 -34.6469007337476,-58.4559081196624 -34.6472937249829,-58.4568675503108 -34.6464085362384,-58.4564331490036 -34.6460313199872,-58.4559398233875 -34.6462051018037,-58.4558347264069 -34.6454899330453,-58.4554422491772 -34.6452374377286)))";;"2965";7_15_8;COMUNA 7;"15";"8";"797";"371";"426";"87,09%";"292";"292";"100,00%";"0";"0,00%";"293";"7";"2.39";"286";"97,61%";"2.39";2.390
"MULTIPOLYGON (((-58.4576209847887 -34.6457134781234,-58.4569297617505 -34.6463512134924,-58.4568675503108 -34.6464085362384,-58.4559081196624 -34.6472937249829,-58.4560223807394 -34.6474733846723,-58.456171486643 -34.6477731202065,-58.456252073024 -34.6481477133744,-58.4562569849918 -34.6485438524416,-58.4561765157554 -34.6488444206673,-58.4566151655533 -34.6484104160804,-58.4566784015648 -34.6483490793261,-58.4576513039569 -34.6474058552909,-58.457976849771 -34.6470901544505,-58.4586300644821 -34.6464568487171,-58.4585018193967 -34.6463649401369,-58.4576209847887 -34.6457134781234)))";;"2966";7_15_9;COMUNA 7;"15";"9";"1218";"566";"652";"86,81%";"386";"386";"100,00%";"0";"0,00%";"397";"10";"2.52";"387";"97,48%";"2.52";2.520
"MULTIPOLYGON (((-58.4544186679813 -34.6416528944313,-58.4531206062938 -34.642784243373,-58.4530035994198 -34.6428769835092,-58.4532329658107 -34.6430932054781,-58.4534309784773 -34.6432797758154,-58.4536296736558 -34.6434670501237,-58.4539567728629 -34.643775252638,-58.4540592086965 -34.6436808908006,-58.4544212263874 -34.6433467505571,-58.4553586409847 -34.6424816426642,-58.4565027717329 -34.6414256166081,-58.4568388642139 -34.6411154121614,-58.4562644853533 -34.6408081199668,-58.4560218186879 -34.6406664122932,-58.4557439629688 -34.6405040676747,-58.4556036979848 -34.6406199083353,-58.4544186679813 -34.6416528944313)))";;"2967";7_16_1;COMUNA 7;"16";"1";"722";"342";"380";"90,00%";"276";"276";"100,00%";"0";"0,00%";"248";"1";"0.4";"247";"99,60%";"0.4";0.400
"MULTIPOLYGON (((-58.4547073708545 -34.6397877137934,-58.4544989713427 -34.6395688197507,-58.454328486698 -34.6393897883785,-58.4542823085849 -34.6393411921014,-58.4540897583174 -34.6391389891101,-58.4538976349802 -34.6389372083878,-58.4537963339616 -34.6388307891825,-58.4536664032578 -34.6387253537211,-58.452302432998 -34.6397942932505,-58.4524080814726 -34.6398802204374,-58.4527736750164 -34.6402025849261,-58.4530869579626 -34.6404788159673,-58.4532918667537 -34.6406594714731,-58.4534986508749 -34.6408417465404,-58.4537269920262 -34.6410431079501,-58.4539833659324 -34.641269119598,-58.4541878525942 -34.6414494214213,-58.4544186679813 -34.6416528944313,-58.4556036979848 -34.6406199083353,-58.4557439629688 -34.6405040676747,-58.4554625297111 -34.6403396798883,-58.4552164575837 -34.640195928081,-58.4549122782282 -34.640002945161,-58.4547073708545 -34.6397877137934)))";;"2968";7_16_2;COMUNA 7;"16";"2";"796";"371";"425";"87,29%";"255";"255";"100,00%";"0";"0,00%";"253";"3";"1.19";"250";"98,81%";"1.19";1.190
"MULTIPOLYGON (((-58.4530869579626 -34.6404788159673,-58.4527736750164 -34.6402025849261,-58.4524080814726 -34.6398802204374,-58.452302432998 -34.6397942932505,-58.4513089654314 -34.6405381013635,-58.4517044394374 -34.6410642106461,-58.451984732134 -34.6414451631144,-58.4521425150365 -34.6416596906798,-58.4523031102599 -34.6418778803603,-58.4524885838707 -34.6421299462115,-58.4526859010592 -34.6423982808595,-58.4528468399267 -34.6426168923746,-58.4530035994198 -34.6428769835092,-58.4531206062938 -34.642784243373,-58.4544186679813 -34.6416528944313,-58.4541878525942 -34.6414494214213,-58.4539833659324 -34.641269119598,-58.4537269920262 -34.6410431079501,-58.4534986508749 -34.6408417465404,-58.4532918667537 -34.6406594714731,-58.4530869579626 -34.6404788159673)))";;"2969";7_16_3;COMUNA 7;"16";"3";"815";"381";"434";"87,79%";"256";"256";"100,00%";"0";"0,00%";"264";"0";"0";"264";"100,00%";"0";0.000
"MULTIPOLYGON (((-58.4514423883772 -34.6374679468336,-58.451441029485 -34.6374668887708,-58.4513028064787 -34.6375111947624,-58.4509348548365 -34.6377608648492,-58.4505163675324 -34.6380458056627,-58.4503224166072 -34.6381825780238,-58.4495589642757 -34.6386908947188,-58.4494075316428 -34.6388058819859,-58.4495191238102 -34.6389023197036,-58.4495819280369 -34.6389598494505,-58.4503710186523 -34.639680940679,-58.4513089654314 -34.6405381013635,-58.452302432998 -34.6397942932505,-58.4536664032578 -34.6387253537211,-58.4535720865554 -34.6386487949535,-58.4534778525446 -34.6385965326708,-58.4525365413569 -34.6380744692987,-58.4514423883772 -34.6374679468336)))";;"2970";7_16_4;COMUNA 7;"16";"4";"726";"335";"391";"85,68%";"225";"225";"100,00%";"0";"0,00%";"241";"11";"4.56";"230";"95,44%";"4.56";4.560
"MULTIPOLYGON (((-58.4503710186523 -34.639680940679,-58.4495819280369 -34.6389598494505,-58.4495191238102 -34.6389023197036,-58.4494075316428 -34.6388058819859,-58.4481268567007 -34.6397785131793,-58.4473389898397 -34.6403768862004,-58.4471509907734 -34.6405205993266,-58.4472565966198 -34.6406151601935,-58.4481238484182 -34.6413879299971,-58.4489272657049 -34.6421041726848,-58.4490381952076 -34.6421993994212,-58.4500236912703 -34.6414673701193,-58.4501601287918 -34.641365972575,-58.451144493619 -34.6406612588065,-58.4513089654314 -34.6405381013635,-58.4503710186523 -34.639680940679)))";;"2971";7_16_5;COMUNA 7;"16";"5";"795";"411";"384";"107,03%";"315";"315";"100,00%";"0";"0,00%";"274";"20";"7.3";"254";"92,70%";"7.3";7.300
"MULTIPOLYGON (((-58.4530035994198 -34.6428769835092,-58.4528468399267 -34.6426168923746,-58.4526859010592 -34.6423982808595,-58.4524885838707 -34.6421299462115,-58.4523031102599 -34.6418778803603,-58.4521425150365 -34.6416596906798,-58.451984732134 -34.6414451631144,-58.4517044394374 -34.6410642106461,-58.4513089654314 -34.6405381013635,-58.451144493619 -34.6406612588065,-58.4501601287918 -34.641365972575,-58.4500236912703 -34.6414673701193,-58.4501458691572 -34.6415615406555,-58.4504408315143 -34.641814747651,-58.4508031042985 -34.6421258496511,-58.4509395963102 -34.6422429792453,-58.4511537924007 -34.6424268787246,-58.4511977563922 -34.6424646305423,-58.451354271945 -34.6425989451902,-58.4516043400187 -34.6428136228114,-58.4522263207156 -34.6433475677499,-58.4523136541324 -34.6434235635071,-58.4514622887185 -34.6440979456623,-58.4513511585423 -34.6441858254282,-58.4524685296866 -34.6451452498174,-58.4529680251133 -34.6446854173038,-58.453354936393 -34.6443292393272,-58.4539567728629 -34.643775252638,-58.4536296736558 -34.6434670501237,-58.4534309784773 -34.6432797758154,-58.4532329658107 -34.6430932054781,-58.4530035994198 -34.6428769835092)))";;"2972";7_16_6;COMUNA 7;"16";"6";"1007";"481";"526";"91,44%";"378";"378";"100,00%";"0";"0,00%";"352";"28";"7.95";"324";"92,05%";"7.95";7.950
"MULTIPOLYGON (((-58.4495117416316 -34.644183879761,-58.4503953788508 -34.6449373053519,-58.4512198998236 -34.6456402243826,-58.4515155759818 -34.6457863831257,-58.4517181256712 -34.6458359805271,-58.4524685296866 -34.6451452498174,-58.4513511585423 -34.6441858254282,-58.4514622887185 -34.6440979456623,-58.4523136541324 -34.6434235635071,-58.4522263207156 -34.6433475677499,-58.4516043400187 -34.6428136228114,-58.451354271945 -34.6425989451902,-58.4511977563922 -34.6424646305423,-58.4511537924007 -34.6424268787246,-58.4509395963102 -34.6422429792453,-58.4508031042985 -34.6421258496511,-58.4504408315143 -34.641814747651,-58.4501458691572 -34.6415615406555,-58.4500236912703 -34.6414673701193,-58.4490381952076 -34.6421993994212,-58.4481710568434 -34.6428434743279,-58.4480543854612 -34.6429348716841,-58.4482124294482 -34.6430760921612,-58.4494611317144 -34.644140703921,-58.4495117416316 -34.644183879761)))";;"2973";7_16_7;COMUNA 7;"16";"7";"947";"473";"474";"99,79%";"336";"336";"100,00%";"0";"0,00%";"320";"9";"2.81";"311";"97,19%";"2.81";2.810
"MULTIPOLYGON (((-58.4474408675798 -34.6456731913877,-58.4483503115442 -34.6464886085733,-58.449047444693 -34.6471136373494,-58.449217599717 -34.6472507027268,-58.4501937882168 -34.6464655714126,-58.4512198998236 -34.6456402243826,-58.4503953788508 -34.6449373053519,-58.4495117416316 -34.644183879761,-58.4494611317144 -34.644140703921,-58.4482124294482 -34.6430760921612,-58.4480543854612 -34.6429348716841,-58.4470885342004 -34.6436920290365,-58.4460975234364 -34.6444687532926,-58.4474408675798 -34.6456731913877)))";;"2974";7_16_8;COMUNA 7;"16";"8";"1106";"535";"571";"93,70%";"382";"382";"100,00%";"0";"0,00%";"352";"13";"3.69";"339";"96,31%";"3.69";3.690
"MULTIPOLYGON (((-58.4481238484182 -34.6413879299971,-58.4472565966198 -34.6406151601935,-58.4471509907734 -34.6405205993266,-58.4463389909316 -34.6411415690812,-58.4462044146021 -34.6412452166881,-58.4460527620187 -34.6413619978998,-58.445309059982 -34.641928211921,-58.4452516043343 -34.6420396860926,-58.4442440671012 -34.6428068153681,-58.4443001255041 -34.6428571071028,-58.4451677615378 -34.6436350761185,-58.4460975234364 -34.6444687532926,-58.4470885342004 -34.6436920290365,-58.4480543854612 -34.6429348716841,-58.4481710568434 -34.6428434743279,-58.4490381952076 -34.6421993994212,-58.4489272657049 -34.6421041726848,-58.4481238484182 -34.6413879299971)))";;"2975";7_16_9;COMUNA 7;"16";"9";"1057";"498";"559";"89,09%";"351";"351";"100,00%";"0";"0,00%";"335";"27";"8.06";"308";"91,94%";"8.06";8.060
"MULTIPOLYGON (((-58.4455201710002 -34.6475034850607,-58.4451838522145 -34.647756332257,-58.4455111961405 -34.648047655318,-58.4457426046262 -34.6482536094758,-58.4458031833911 -34.648307563187,-58.4457436065755 -34.6483550915738,-58.4455525180895 -34.6485027453967,-58.445398680867 -34.6485942053185,-58.4453423443799 -34.648629832197,-58.4452860787934 -34.6487337005664,-58.4453310636024 -34.6487832859505,-58.4454436104208 -34.6489104184586,-58.4456123886762 -34.6491011522276,-58.4459983397806 -34.6495426274976,-58.4461556200092 -34.6497132174672,-58.4452205235128 -34.650465292762,-58.4450870465165 -34.6505726007237,-58.444965928187 -34.6506700508844,-58.4446202152324 -34.6509480366245,-58.4449506864848 -34.6510103405613,-58.4458047581417 -34.6510466601541,-58.4488281880571 -34.6511750735818,-58.4519747150075 -34.6510784866211,-58.4533385982729 -34.6509488767566,-58.4532808405629 -34.650757105993,-58.4532253731446 -34.650661253748,-58.4531497929818 -34.6505737804363,-58.4530741263171 -34.650498772233,-58.4529757908319 -34.6504279172307,-58.4528447279217 -34.6503841729993,-58.4526204357936 -34.6503318995729,-58.452538454815 -34.6503286532348,-58.4524169325812 -34.650319839966,-58.4522943883175 -34.6503063784616,-58.4521727821065 -34.6502881984632,-58.4520523696091 -34.6502654408452,-58.4519332360547 -34.6502381760432,-58.4518158075595 -34.650206404099,-58.4517002545703 -34.6501701954575,-58.4515868327429 -34.6501296909965,-58.4514757977502 -34.6500848907454,-58.4513673200251 -34.6500359355758,-58.4512619099767 -34.6499895158848,-58.4510854326781 -34.6499032994222,-58.4509813878499 -34.6498470201655,-58.4508894450235 -34.6497855305674,-58.4508159077492 -34.6497374233799,-58.4507443321655 -34.6496784005177,-58.4506844311875 -34.6496228295722,-58.4506265761974 -34.649562751621,-58.4505302105515 -34.6494466117724,-58.4504606038974 -34.6493301224109,-58.4504312155128 -34.6492482155716,-58.4504163943298 -34.6492017337997,-58.4504016590682 -34.6491506040063,-58.4503760240946 -34.6490438376219,-58.4503526017196 -34.6489582692798,-58.4503414497309 -34.6488800263418,-58.4503343873772 -34.6488075586397,-58.4503198283356 -34.6487183291035,-58.4503075655577 -34.6486603683525,-58.4502842290617 -34.6485715604656,-58.4502673683294 -34.6484883872073,-58.45024658634 -34.648413734931,-58.4502111501145 -34.6483179537473,-58.4501659964337 -34.6482403411202,-58.4501412048183 -34.6481959005977,-58.4500776450985 -34.6481130041885,-58.449836519738 -34.6478538161669,-58.449217599717 -34.6472507027268,-58.449047444693 -34.6471136373494,-58.4483503115442 -34.6464886085733,-58.4474408675798 -34.6456731913877,-58.4460975234364 -34.6444687532926,-58.4460142565381 -34.6445340960688,-58.4458747394733 -34.644643446489,-58.4451274559064 -34.6452504725679,-58.4450462324814 -34.6453164487913,-58.4449945835183 -34.645358414431,-58.444408969269 -34.6458342581755,-58.4440383872211 -34.6461319576735,-58.4439755721028 -34.6461824425554,-58.4448687222894 -34.6469468956532,-58.4452500322187 -34.6466968727261,-58.4452933997747 -34.6467322321208,-58.4458950114588 -34.6472217681183,-58.4455201710002 -34.6475034850607)))";;"2976";7_17_1;COMUNA 7;"17";"1";"1605";"822";"783";"104,98%";"346";"346";"100,00%";"0";"0,00%";"439";"107";"24.37";"332";"75,63%";"24.37";24.370
"MULTIPOLYGON (((-58.4426290317265 -34.6496908117867,-58.4428360501424 -34.6497555831492,-58.4430945793302 -34.6499518554605,-58.4431996730143 -34.6501209460904,-58.4433941708413 -34.6501229647494,-58.4436242654438 -34.6501145500022,-58.4438311769799 -34.6501207795641,-58.4438996056184 -34.6501324102014,-58.4442879372358 -34.650194513575,-58.4443498898219 -34.6502038189679,-58.4444192531259 -34.6502286188644,-58.4445936683547 -34.6503635080979,-58.444965928187 -34.6506700508844,-58.4450870465165 -34.6505726007237,-58.4452205235128 -34.650465292762,-58.4461556200092 -34.6497132174672,-58.4459983397806 -34.6495426274976,-58.4454486681614 -34.6495890312508,-58.4453023446166 -34.649601405203,-58.4451892566254 -34.649612868236,-58.4451419590642 -34.6496177207366,-58.4450968818359 -34.6496006010451,-58.4447929763071 -34.6496687982923,-58.44477047381 -34.6496904857812,-58.4445566510617 -34.6497277088,-58.4444897525881 -34.6497344595954,-58.4439534564813 -34.6497888165902,-58.4436914866939 -34.6498153965565,-58.4436504926059 -34.6498313765569,-58.4434985453133 -34.64983762052,-58.4431794264954 -34.6497217917135,-58.4429796765046 -34.6497066886967,-58.4426290317265 -34.6496908117867)))";;"2977";7_17_10;COMUNA 7;"17";"10";"1507";"733";"774";"94,70%";"221";"221";"100,00%";"0";"0,00%";"500";"190";"38";"310";"62,00%";"38";38.000
"MULTIPOLYGON (((-58.4433660093166 -34.6507146236195,-58.4434619976887 -34.6507324317229,-58.4436692252 -34.6507702741992,-58.4441258432966 -34.6508570851004,-58.4446202152324 -34.6509480366245,-58.444965928187 -34.6506700508844,-58.4445936683547 -34.6503635080979,-58.4444192531259 -34.6502286188644,-58.4443498898219 -34.6502038189679,-58.4442879372358 -34.650194513575,-58.4438996056184 -34.6501324102014,-58.4438311769799 -34.6501207795641,-58.4436242654438 -34.6501145500022,-58.4433941708413 -34.6501229647494,-58.4431996730143 -34.6501209460904,-58.4433730552958 -34.6504631574021,-58.4433660093166 -34.6507146236195)))";;"2978";7_17_11;COMUNA 7;"17";"11";"560";"270";"290";"93,10%";"93";"93";"100,00%";"0";"0,00%";"190";"49";"25.79";"141";"74,21%";"25.79";25.790
"MULTIPOLYGON (((-58.4452933997747 -34.6467322321208,-58.4452500322187 -34.6466968727261,-58.4448687222894 -34.6469468956532,-58.4447704502982 -34.6470288555851,-58.4449862588339 -34.6472379076035,-58.4442946892124 -34.6477921178849,-58.4442848758518 -34.6478526816298,-58.4440371815814 -34.6480897638714,-58.4440055592612 -34.6481194078174,-58.4442325386184 -34.6482995887272,-58.4445622520685 -34.6486615506147,-58.4449005254031 -34.6484601858938,-58.4453511307397 -34.648177988731,-58.4453593201407 -34.6481370731578,-58.4455111961405 -34.648047655318,-58.4451838522145 -34.647756332257,-58.4455201710002 -34.6475034850607,-58.4458950114588 -34.6472217681183,-58.4452933997747 -34.6467322321208)))";;"2979";7_17_2;COMUNA 7;"17";"2";"1587";"750";"837";"89,61%";"312";"312";"100,00%";"0";"0,00%";"500";"185";"37";"315";"63,00%";"37";37.000
"MULTIPOLYGON (((-58.4448312074214 -34.649024699921,-58.4451892566254 -34.649612868236,-58.4453023446166 -34.649601405203,-58.4454486681614 -34.6495890312508,-58.4459983397806 -34.6495426274976,-58.4456123886762 -34.6491011522276,-58.4454436104208 -34.6489104184586,-58.4453310636024 -34.6487832859505,-58.4452860787934 -34.6487337005664,-58.4453423443799 -34.648629832197,-58.445398680867 -34.6485942053185,-58.4455525180895 -34.6485027453967,-58.4457436065755 -34.6483550915738,-58.4458031833911 -34.648307563187,-58.4457426046262 -34.6482536094758,-58.4455111961405 -34.648047655318,-58.4453593201407 -34.6481370731578,-58.4453511307397 -34.648177988731,-58.4449005254031 -34.6484601858938,-58.4445622520685 -34.6486615506147,-58.4448312074214 -34.649024699921)))";;"2980";7_17_3;COMUNA 7;"17";"3";"1374";"679";"695";"97,70%";"220";"220";"100,00%";"0";"0,00%";"416";"174";"41.83";"242";"58,17%";"41.83";41.830
"MULTIPOLYGON (((-58.4440055592612 -34.6481194078174,-58.4437011826599 -34.6484045807164,-58.4436803823402 -34.6484360573036,-58.4436630667753 -34.6485076060707,-58.4438636368533 -34.6486524303448,-58.444064864523 -34.6489083140905,-58.4442164888542 -34.6491975008522,-58.4442985280288 -34.6493165309439,-58.4444897525881 -34.6497344595954,-58.4445566510617 -34.6497277088,-58.44477047381 -34.6496904857812,-58.4447929763071 -34.6496687982923,-58.4450968818359 -34.6496006010451,-58.4451419590642 -34.6496177207366,-58.4451892566254 -34.649612868236,-58.4448312074214 -34.649024699921,-58.4445622520685 -34.6486615506147,-58.4442325386184 -34.6482995887272,-58.4440055592612 -34.6481194078174)))";;"2981";7_17_4;COMUNA 7;"17";"4";"1645";"827";"818";"101,10%";"252";"252";"100,00%";"0";"0,00%";"509";"206";"40.47";"303";"59,53%";"40.47";40.470
"MULTIPOLYGON (((-58.4442946892124 -34.6477921178849,-58.4440841255516 -34.6473757351876,-58.4438971337171 -34.6471152055762,-58.4430555747474 -34.6480358052381,-58.4430329009732 -34.6480610136186,-58.4436803823402 -34.6484360573036,-58.4437011826599 -34.6484045807164,-58.4440055592612 -34.6481194078174,-58.4440371815814 -34.6480897638714,-58.4442848758518 -34.6478526816298,-58.4442946892124 -34.6477921178849)))";;"2982";7_17_5;COMUNA 7;"17";"5";"891";"429";"462";"92,86%";"104";"104";"100,00%";"0";"0,00%";"268";"60";"22.39";"208";"77,61%";"22.39";22.390
"MULTIPOLYGON (((-58.4439755721028 -34.6461824425554,-58.4436556144208 -34.6464395135848,-58.4433937828825 -34.6466499718317,-58.4431807881113 -34.6468210699322,-58.4429439273398 -34.6470113897323,-58.4423082589677 -34.6475220049307,-58.4423621912211 -34.6475630011038,-58.4423813616014 -34.6475770188117,-58.4424414291009 -34.6476198470134,-58.442531487687 -34.6476847934995,-58.4426229097339 -34.6477503739651,-58.4427209790311 -34.647815251204,-58.4428198153688 -34.6478804101871,-58.4429183960587 -34.64794620287,-58.4430555747474 -34.6480358052381,-58.4438971337171 -34.6471152055762,-58.4440841255516 -34.6473757351876,-58.4442946892124 -34.6477921178849,-58.4449862588339 -34.6472379076035,-58.4447704502982 -34.6470288555851,-58.4448687222894 -34.6469468956532,-58.4439755721028 -34.6461824425554)))";;"2983";7_17_6;COMUNA 7;"17";"6";"1313";"635";"678";"93,66%";"364";"364";"100,00%";"0";"0,00%";"375";"162";"43.2";"213";"56,80%";"43.2";43.200
"MULTIPOLYGON (((-58.4423082589677 -34.6475220049307,-58.4420946630778 -34.6476936644058,-58.4419149043182 -34.647838145347,-58.4406992790096 -34.6488148631875,-58.4418737154035 -34.6493808701103,-58.4421373706412 -34.6490182189084,-58.4421858831595 -34.6489237875991,-58.4423798895521 -34.6487205744841,-58.4426310037108 -34.6484644815353,-58.4430329009732 -34.6480610136186,-58.4430555747474 -34.6480358052381,-58.4429183960587 -34.64794620287,-58.4428198153688 -34.6478804101871,-58.4427209790311 -34.647815251204,-58.4426229097339 -34.6477503739651,-58.442531487687 -34.6476847934995,-58.4424414291009 -34.6476198470134,-58.4423813616014 -34.6475770188117,-58.4423621912211 -34.6475630011038,-58.4423082589677 -34.6475220049307)))";;"2984";7_17_7;COMUNA 7;"17";"7";"2416";"1200";"1216";"98,68%";"466";"466";"100,00%";"0";"0,00%";"764";"282";"36.91";"482";"63,09%";"36.91";36.910
"MULTIPOLYGON (((-58.4436803823402 -34.6484360573036,-58.4430329009732 -34.6480610136186,-58.4426310037108 -34.6484644815353,-58.4423798895521 -34.6487205744841,-58.4421858831595 -34.6489237875991,-58.4421373706412 -34.6490182189084,-58.4418737154035 -34.6493808701103,-58.4420863165083 -34.6494918847499,-58.4422342508503 -34.6494182473056,-58.4422914433549 -34.6493745935996,-58.4425598286576 -34.6492444230172,-58.4428785189404 -34.6490011580126,-58.4428993197043 -34.6489696815652,-58.4431279196431 -34.6487808395065,-58.4433139447119 -34.6488071376238,-58.4434500607234 -34.648709339319,-58.4436630667753 -34.6485076060707,-58.4436803823402 -34.6484360573036)))";;"2985";7_17_8;COMUNA 7;"17";"8";"1103";"517";"586";"88,23%";"155";"155";"100,00%";"0";"0,00%";"338";"152";"44.97";"186";"55,03%";"44.97";44.970
"MULTIPOLYGON (((-58.4433139447119 -34.6488071376238,-58.4431279196431 -34.6487808395065,-58.4428993197043 -34.6489696815652,-58.4428785189404 -34.6490011580126,-58.4425598286576 -34.6492444230172,-58.4422914433549 -34.6493745935996,-58.4422342508503 -34.6494182473056,-58.4420863165083 -34.6494918847499,-58.4423548788659 -34.6495797878429,-58.4426290317265 -34.6496908117867,-58.4429796765046 -34.6497066886967,-58.4431794264954 -34.6497217917135,-58.4434985453133 -34.64983762052,-58.4436504926059 -34.6498313765569,-58.4436914866939 -34.6498153965565,-58.4439534564813 -34.6497888165902,-58.4444897525881 -34.6497344595954,-58.4442985280288 -34.6493165309439,-58.4442164888542 -34.6491975008522,-58.444064864523 -34.6489083140905,-58.4438636368533 -34.6486524303448,-58.4436630667753 -34.6485076060707,-58.4434500607234 -34.648709339319,-58.4433139447119 -34.6488071376238)))";;"2986";7_17_9;COMUNA 7;"17";"9";"1846";"865";"981";"88,18%";"341";"341";"100,00%";"0";"0,00%";"618";"237";"38.35";"381";"61,65%";"38.35";38.350
"MULTIPOLYGON (((-58.4419378335202 -34.6508913401205,-58.4427938236774 -34.6510909254554,-58.4429870952276 -34.6511270142705,-58.4433239573799 -34.6511898870441,-58.4435215039486 -34.6511672415388,-58.443638685318 -34.6511538088057,-58.4444062010791 -34.6510656842872,-58.4446199477548 -34.6509481173021,-58.4446202152324 -34.6509480366245,-58.4441258432966 -34.6508570851004,-58.4436692252 -34.6507702741992,-58.4434619976887 -34.6507324317229,-58.4433660093166 -34.6507146236195,-58.4433730552958 -34.6504631574021,-58.4431996730143 -34.6501209460904,-58.4430945793302 -34.6499518554605,-58.4428360501424 -34.6497555831492,-58.4426290317265 -34.6496908117867,-58.4423548788659 -34.6495797878429,-58.4420863165083 -34.6494918847499,-58.4407873614838 -34.6505600725398,-58.4404372012943 -34.6508466374309,-58.4419378335202 -34.6508913401205)))";;"2987";7_18_1;COMUNA 7;"18";"1";"1545";"758";"787";"96,32%";"437";"437";"100,00%";"0";"0,00%";"395";"164";"41.52";"231";"58,48%";"41.52";41.520
"MULTIPOLYGON (((-58.4335731823657 -34.6494969110987,-58.4334808094464 -34.6494845646843,-58.4333581835956 -34.6494729855954,-58.433281155994 -34.6494440225011,-58.4331549870194 -34.6493310308401,-58.4331305343816 -34.6493165878574,-58.4325663961875 -34.6492903926319,-58.4322921103798 -34.6491998992767,-58.4311141834386 -34.650193503052,-58.4313108937624 -34.6503571503102,-58.4309830594401 -34.6503412903597,-58.4317978503958 -34.6510164493759,-58.4320307719377 -34.6512094716981,-58.4320921571802 -34.6511376539881,-58.4321908599783 -34.6510901420902,-58.4323939954043 -34.6509390614617,-58.4328646195208 -34.6505968433156,-58.4329208919088 -34.6505207984508,-58.4329358287008 -34.6504555888727,-58.4335459052087 -34.6504909485823,-58.4335507965825 -34.6499073406573,-58.4335731823657 -34.6494969110987)))";;"2988";7_18_10;COMUNA 7;"18";"10";"1493";"723";"770";"93,90%";"393";"393";"100,00%";"0";"0,00%";"414";"185";"44.69";"229";"55,31%";"44.69";44.690
"MULTIPOLYGON (((-58.4406992790096 -34.6488148631875,-58.4395585196134 -34.6483057633559,-58.438812094781 -34.6489119758469,-58.4396827391617 -34.6496396300739,-58.4407873614838 -34.6505600725398,-58.4420863165083 -34.6494918847499,-58.4418737154035 -34.6493808701103,-58.4406992790096 -34.6488148631875)))";;"2989";7_18_2;COMUNA 7;"18";"2";"487";"241";"246";"97,97%";"134";"134";"100,00%";"0";"0,00%";"124";"55";"44.35";"69";"55,65%";"44.35";44.350
"MULTIPOLYGON (((-58.438812094781 -34.6489119758469,-58.4385981466571 -34.6490856714025,-58.4380452016294 -34.6495347997897,-58.4384831188983 -34.6499058846462,-58.4385109735958 -34.6499472294482,-58.4386570247551 -34.6499983866324,-58.4387118111983 -34.6500317787089,-58.4387714526845 -34.6500739043707,-58.4387887485736 -34.6500866546259,-58.4390063698569 -34.650189446675,-58.4389192552434 -34.6502602064937,-58.4388846720325 -34.6508003568072,-58.4404372012943 -34.6508466374309,-58.4407873614838 -34.6505600725398,-58.4396827391617 -34.6496396300739,-58.438812094781 -34.6489119758469)))";;"2990";7_18_3;COMUNA 7;"18";"3";"942";"474";"468";"101,28%";"235";"235";"100,00%";"0";"0,00%";"288";"54";"18.75";"234";"81,25%";"18.75";18.750
"MULTIPOLYGON (((-58.4395585196134 -34.6483057633559,-58.4377256480849 -34.6474877007991,-58.4376781563839 -34.6475740317263,-58.437641480721 -34.6476817035357,-58.4376395924271 -34.6477266340948,-58.4376095838683 -34.6477669812668,-58.4376976760156 -34.647841367823,-58.4377596052133 -34.6479204674203,-58.4378214544233 -34.6479824537718,-58.4378946279248 -34.6480770490213,-58.4379808320533 -34.6481979856967,-58.4381647063651 -34.6482833071134,-58.4381731349246 -34.6483104223089,-58.4381111157814 -34.6485336560354,-58.438208654235 -34.6486561441685,-58.4383024560866 -34.6487352498769,-58.4383914906682 -34.6487980160386,-58.4384684304633 -34.6488399340299,-58.4384196698487 -34.6488941513258,-58.4384159143728 -34.6489142920332,-58.4384815211535 -34.6489531090726,-58.4385715789479 -34.6490151006326,-58.4385981466571 -34.6490856714025,-58.438812094781 -34.6489119758469,-58.4395585196134 -34.6483057633559)))";;"2991";7_18_4;COMUNA 7;"18";"4";"813";"400";"413";"96,85%";"124";"124";"100,00%";"0";"0,00%";"254";"89";"35.04";"165";"64,96%";"35.04";35.040
"MULTIPOLYGON (((-58.4377256480849 -34.6474877007991,-58.4374223173153 -34.6473523524797,-58.437406417359 -34.6473652158882,-58.4364604872228 -34.6481304828923,-58.4364233229211 -34.6481605462268,-58.4372371949771 -34.648849753882,-58.4380452016294 -34.6495347997897,-58.4385981466571 -34.6490856714025,-58.4385715789479 -34.6490151006326,-58.4384815211535 -34.6489531090726,-58.4384159143728 -34.6489142920332,-58.4384196698487 -34.6488941513258,-58.4384684304633 -34.6488399340299,-58.4383914906682 -34.6487980160386,-58.4383024560866 -34.6487352498769,-58.438208654235 -34.6486561441685,-58.4381111157814 -34.6485336560354,-58.4381731349246 -34.6483104223089,-58.4381647063651 -34.6482833071134,-58.4379808320533 -34.6481979856967,-58.4378946279248 -34.6480770490213,-58.4378214544233 -34.6479824537718,-58.4377596052133 -34.6479204674203,-58.4376976760156 -34.647841367823,-58.4376095838683 -34.6477669812668,-58.4376395924271 -34.6477266340948,-58.437641480721 -34.6476817035357,-58.4376781563839 -34.6475740317263,-58.4377256480849 -34.6474877007991)))";;"2992";7_18_5;COMUNA 7;"18";"5";"1003";"503";"500";"100,60%";"106";"106";"100,00%";"0";"0,00%";"292";"91";"31.16";"201";"68,84%";"31.16";31.160
"MULTIPOLYGON (((-58.4355464270489 -34.6494913099345,-58.4357472369683 -34.6499120009703,-58.435660395498 -34.6499212777995,-58.4354506816437 -34.6498881315286,-58.4354323415164 -34.6499430586606,-58.4353661554566 -34.6501132602333,-58.4353877139092 -34.6501196032826,-58.4354030442544 -34.6501475653028,-58.4353938247275 -34.650195804126,-58.4353892124541 -34.6502275646114,-58.4353496349236 -34.650595524539,-58.4339312618028 -34.6505132942948,-58.4335459052087 -34.6504909485823,-58.4329358287008 -34.6504555888727,-58.4329208919088 -34.6505207984508,-58.4328646195208 -34.6505968433156,-58.4323939954043 -34.6509390614617,-58.4321908599783 -34.6510901420902,-58.4320921571802 -34.6511376539881,-58.4320307719377 -34.6512094716981,-58.4329906795993 -34.6519748025941,-58.4336781429241 -34.6525147025054,-58.4344335176544 -34.6531130666909,-58.43506101685 -34.6536101970544,-58.4360212372233 -34.6543707854286,-58.437097901142 -34.6551016010512,-58.4380019251827 -34.6558061742899,-58.4384180869404 -34.6554916712301,-58.4388456871086 -34.6551023076253,-58.4394861186206 -34.6546035433682,-58.4404034916516 -34.653889045655,-58.4415331805756 -34.6530090801353,-58.44163154668 -34.6529324751821,-58.4426521908941 -34.6521375532185,-58.4427480830607 -34.6520628484116,-58.4428229219197 -34.6520025771482,-58.4429084151156 -34.6519348425567,-58.4429516311637 -34.6518976653565,-58.4430054175938 -34.6518478838386,-58.4430601437019 -34.6517883134237,-58.4431117175265 -34.6517245874237,-58.4431571561477 -34.6516574800354,-58.4432047288976 -34.6515746682764,-58.4432430122271 -34.6514929113854,-58.4432661211784 -34.6514325611544,-58.4432953728194 -34.6513429152455,-58.4433239573799 -34.6511898870441,-58.4429870952276 -34.6511270142705,-58.4427938236774 -34.6510909254554,-58.4419378335202 -34.6508913401205,-58.4404372012943 -34.6508466374309,-58.4388846720325 -34.6508003568072,-58.4389192552434 -34.6502602064937,-58.4390063698569 -34.650189446675,-58.4387887485736 -34.6500866546259,-58.4387714526845 -34.6500739043707,-58.4387118111983 -34.6500317787089,-58.4386570247551 -34.6499983866324,-58.4385109735958 -34.6499472294482,-58.4384831188983 -34.6499058846462,-58.4380452016294 -34.6495347997897,-58.4372371949771 -34.648849753882,-58.4364233229211 -34.6481605462268,-58.4356389452081 -34.6487953939608,-58.4356058718851 -34.6488220775664,-58.4353204006853 -34.6490518094944,-58.4353560051681 -34.6491030162154,-58.4355464270489 -34.6494913099345)))";;"2993";7_18_6;COMUNA 7;"18";"6";"1674";"823";"851";"96,71%";"302";"301";"99,67%";"1";"0,33%";"485";"188";"38.76";"297";"61,24%";"38.76";38.760
"MULTIPOLYGON (((-58.4343358751433 -34.6490436969052,-58.4347275326205 -34.6494047798596,-58.434763202167 -34.6494374335946,-58.4348014196448 -34.6494721940668,-58.4349628987854 -34.649339695154,-58.4353204006853 -34.6490518094944,-58.4356058718851 -34.6488220775664,-58.4356389452081 -34.6487953939608,-58.4364233229211 -34.6481605462268,-58.4364604872228 -34.6481304828923,-58.437406417359 -34.6473652158882,-58.4374223173153 -34.6473523524797,-58.4374096540699 -34.6473467006025,-58.4350125769324 -34.6462767962457,-58.4349231139056 -34.646236845097,-58.4348172215991 -34.6463460108993,-58.4346055484089 -34.6465736225524,-58.4351202184505 -34.6470057866436,-58.4355236064873 -34.6473466622717,-58.4346963528983 -34.6480183265716,-58.4338969600572 -34.6486674558716,-58.4343358751433 -34.6490436969052)))";;"2994";7_18_7;COMUNA 7;"18";"7";"1216";"579";"637";"90,89%";"267";"267";"100,00%";"0";"0,00%";"286";"14";"4.9";"272";"95,10%";"4.9";4.900
"MULTIPOLYGON (((-58.4351202184505 -34.6470057866436,-58.4346055484089 -34.6465736225524,-58.434502426826 -34.64667528313,-58.4337651087253 -34.6472506209784,-58.432967003288 -34.6478744621097,-58.4334222657042 -34.6482679645085,-58.4334530198604 -34.6482947332647,-58.4338969600572 -34.6486674558716,-58.4346963528983 -34.6480183265716,-58.4355236064873 -34.6473466622717,-58.4351202184505 -34.6470057866436)))";;"2995";7_18_8;COMUNA 7;"18";"8";"1010";"508";"502";"101,20%";"224";"224";"100,00%";"0";"0,00%";"246";"9";"3.66";"237";"96,34%";"3.66";3.660
"MULTIPOLYGON (((-58.4451677615378 -34.6436350761185,-58.4443001255041 -34.6428571071028,-58.4442440671012 -34.6428068153681,-58.4433123828379 -34.6419714333423,-58.4430780125391 -34.6417777277947,-58.4429520201426 -34.6419910944514,-58.442439483588 -34.642655819974,-58.4423888517185 -34.6427215178352,-58.4414752466129 -34.6435785017086,-58.4415925786906 -34.6436020439328,-58.441922591499 -34.643668229426,-58.4422723732566 -34.6437384315481,-58.4424214034772 -34.6437683165054,-58.4425697555384 -34.6437839753733,-58.4428046049258 -34.6437743657253,-58.4429289379288 -34.643743962463,-58.4430808013413 -34.6436850414905,-58.4432266220159 -34.6435936535628,-58.4433162820999 -34.6435240882126,-58.4431858030077 -34.6439661938512,-58.4434993739882 -34.6440253299694,-58.4438119219121 -34.6440886201812,-58.4441274526704 -34.6441524030188,-58.4444391494608 -34.6442154802181,-58.4447500798474 -34.6442783452332,-58.4450609254752 -34.6443412798675,-58.445375946881 -34.644404988974,-58.4460142565381 -34.6445340960688,-58.4460975234364 -34.6444687532926,-58.4451677615378 -34.6436350761185)))";;"2996";7_19_1;COMUNA 7;"19";"1";"878";"421";"457";"92,12%";"198";"198";"100,00%";"0";"0,00%";"274";"29";"10.58";"245";"89,42%";"10.58";10.580
"MULTIPOLYGON (((-58.4385545650333 -34.6471488433008,-58.4382539397184 -34.6470862462826,-58.4378702500538 -34.6469527843996,-58.4374223173153 -34.6473523524797,-58.4377256480849 -34.6474877007991,-58.4395585196134 -34.6483057633559,-58.4406992790096 -34.6488148631875,-58.4419149043182 -34.647838145347,-58.4417224936574 -34.6477995900988,-58.4414109557524 -34.6477372806901,-58.4410943055496 -34.6476739836337,-58.4407507287066 -34.6476052582103,-58.4406672205323 -34.6475885525009,-58.440420020026 -34.6475370975675,-58.4401079735042 -34.6474721085968,-58.4397950753413 -34.6474069778176,-58.4394808994772 -34.6473416347177,-58.4391716663903 -34.6472772777071,-58.4388606443557 -34.647212497014,-58.4385545650333 -34.6471488433008)))";;"2997";7_19_6;COMUNA 7;"19";"6";"1927";"935";"992";"94,25%";"448";"448";"100,00%";"0";"0,00%";"440";"19";"4.32";"421";"95,68%";"4.32";4.320
"MULTIPOLYGON (((-58.4707049392249 -34.6213320978749,-58.4708308539446 -34.6213710345661,-58.4721039794956 -34.6217660976629,-58.4722424189946 -34.6218090461521,-58.4732208705816 -34.6221105254603,-58.4734618838529 -34.6221749432921,-58.473904829499 -34.6211900099981,-58.4741896943515 -34.6204974945297,-58.4729342663606 -34.6198482173672,-58.4727888404095 -34.619773085999,-58.471621181049 -34.6191552679353,-58.4711426298278 -34.6203331602416,-58.4697966925109 -34.6199156256976,-58.4697450796324 -34.6200508446983,-58.4693628216905 -34.6209168823874,-58.4707049392249 -34.6213320978749)))";;"2998";7_2_1;COMUNA 7;"2";"1";"828";"387";"441";"87,76%";"343";"343";"100,00%";"0";"0,00%";"289";"4";"1.38";"285";"98,62%";"1.38";1.380
"MULTIPOLYGON (((-58.4690936387863 -34.617797843437,-58.4687968379826 -34.617644895464,-58.4684258086213 -34.618258949264,-58.4678084364441 -34.6192820409269,-58.4679498522951 -34.6193426004339,-58.4683917319992 -34.6194796981147,-58.4697966925109 -34.6199156256976,-58.4711426298278 -34.6203331602416,-58.471621181049 -34.6191552679353,-58.4713995952313 -34.6190380262888,-58.4703868330932 -34.6184906806371,-58.469339837755 -34.6179247361881,-58.4690936387863 -34.617797843437)))";;"2999";7_2_2;COMUNA 7;"2";"2";"989";"467";"522";"89,46%";"428";"428";"100,00%";"0";"0,00%";"370";"2";"0.54";"368";"99,46%";"0.54";0.540
"MULTIPOLYGON (((-58.4697966925109 -34.6199156256976,-58.4683917319992 -34.6194796981147,-58.4679498522951 -34.6193426004339,-58.4678084364441 -34.6192820409269,-58.4675856915495 -34.6196516405077,-58.467235513842 -34.6202326603233,-58.4677972618188 -34.6204300394217,-58.467952990633 -34.6204784852148,-58.4675162830604 -34.6214727632943,-58.4670775207155 -34.6224714764959,-58.467213402994 -34.6225132335547,-58.4684859326574 -34.6229104471087,-58.4688708488077 -34.6220315245437,-58.468923572986 -34.6219120810961,-58.4693628216905 -34.6209168823874,-58.4697450796324 -34.6200508446983,-58.4697966925109 -34.6199156256976)))";;"3000";7_2_3;COMUNA 7;"2";"3";"824";"401";"423";"94,80%";"347";"346";"99,71%";"1";"0,29%";"303";"57";"18.81";"246";"81,19%";"18.81";18.810
"MULTIPOLYGON (((-58.468923572986 -34.6219120810961,-58.4688708488077 -34.6220315245437,-58.4684859326574 -34.6229104471087,-58.4686270984089 -34.622954526363,-58.4698308897929 -34.6233318693373,-58.4699527178346 -34.6233700324862,-58.4712189689949 -34.6237634853224,-58.4716604149427 -34.6227675038159,-58.4720435947831 -34.6219031493203,-58.4721039794956 -34.6217660976629,-58.4708308539446 -34.6213710345661,-58.4707049392249 -34.6213320978749,-58.4693628216905 -34.6209168823874,-58.468923572986 -34.6219120810961)))";;"3001";7_2_4;COMUNA 7;"2";"4";"1777";"859";"918";"93,57%";"707";"706";"99,86%";"1";"0,14%";"660";"79";"11.97";"581";"88,03%";"11.97";11.970
"MULTIPOLYGON (((-58.4712189689949 -34.6237634853224,-58.4711676096461 -34.6238792675331,-58.4707785350621 -34.6247619298756,-58.4710022603308 -34.6248316355534,-58.4721172272808 -34.6251654392437,-58.4725633559706 -34.62417318686,-58.4730140731792 -34.6231710023758,-58.4734618838529 -34.6221749432921,-58.4732208705816 -34.6221105254603,-58.4722424189946 -34.6218090461521,-58.4721039794956 -34.6217660976629,-58.4720435947831 -34.6219031493203,-58.4716604149427 -34.6227675038159,-58.4712189689949 -34.6237634853224)))";;"3002";7_2_5;COMUNA 7;"2";"5";"985";"472";"513";"92,01%";"456";"454";"99,56%";"2";"0,44%";"358";"93";"25.98";"265";"74,02%";"25.98";25.980
"MULTIPOLYGON (((-58.473748409791 -34.6256063738187,-58.4723275785037 -34.625228382723,-58.4721172272808 -34.6251654392437,-58.4710022603308 -34.6248316355534,-58.4707785350621 -34.6247619298756,-58.4702512952103 -34.6259582017278,-58.4704363436878 -34.6260161498537,-58.4715756921294 -34.6263695350099,-58.4729661311904 -34.6268007785972,-58.4731667735602 -34.6268532985399,-58.4735229628854 -34.6260897907955,-58.473748409791 -34.6256063738187)))";;"3003";7_2_6;COMUNA 7;"2";"6";"1100";"503";"597";"84,25%";"492";"490";"99,59%";"2";"0,41%";"396";"4";"1.01";"392";"98,99%";"1.01";1.010
"MULTIPOLYGON (((-58.4688678700319 -34.625524884455,-58.4702512952103 -34.6259582017278,-58.4707785350621 -34.6247619298756,-58.4711676096461 -34.6238792675331,-58.4712189689949 -34.6237634853224,-58.4699527178346 -34.6233700324862,-58.4698308897929 -34.6233318693373,-58.4686270984089 -34.622954526363,-58.4684859326574 -34.6229104471087,-58.4680484522601 -34.6239092339309,-58.4675249270972 -34.6251045784812,-58.4677323782063 -34.6251692201989,-58.4688678700319 -34.625524884455)))";;"3004";7_2_7;COMUNA 7;"2";"7";"724";"324";"400";"81,00%";"282";"282";"100,00%";"0";"0,00%";"245";"56";"22.86";"189";"77,14%";"22.86";22.860
"MULTIPOLYGON (((-58.4684859326574 -34.6229104471087,-58.467213402994 -34.6225132335547,-58.4670775207155 -34.6224714764959,-58.4666360220125 -34.6234766671411,-58.4662050756089 -34.6244575591115,-58.4661152052222 -34.6246651744191,-58.4675249270972 -34.6251045784812,-58.4680484522601 -34.6239092339309,-58.4684859326574 -34.6229104471087)))";;"3005";7_2_8;COMUNA 7;"2";"8";"712";"356";"356";"100,00%";"344";"343";"99,71%";"1";"0,29%";"296";"72";"24.32";"224";"75,68%";"24.32";24.320
"MULTIPOLYGON (((-58.465990552576 -34.6221373441386,-58.4656785970992 -34.6225171540598,-58.4651955801417 -34.6231051429905,-58.4654221926708 -34.6231702108147,-58.4666360220125 -34.6234766671411,-58.4670775207155 -34.6224714764959,-58.4675162830604 -34.6214727632943,-58.467952990633 -34.6204784852148,-58.4677972618188 -34.6204300394217,-58.467235513842 -34.6202326603233,-58.4671602134978 -34.6203575970519,-58.4666317399136 -34.6211936303532,-58.4665626559464 -34.6213029321451,-58.4660606612393 -34.6220519871509,-58.465990552576 -34.6221373441386)))";;"3006";7_2_9;COMUNA 7;"2";"9";"998";"462";"536";"86,19%";"447";"447";"100,00%";"0";"0,00%";"394";"46";"11.68";"348";"88,32%";"11.68";11.680
"MULTIPOLYGON (((-58.4372879676683 -34.6349402426889,-58.4369424024137 -34.634868829847,-58.4366386706714 -34.6348043266048,-58.4363292298115 -34.6347427792143,-58.4357075361702 -34.6346245407677,-58.4354738364431 -34.6353643016478,-58.4352563664036 -34.6359678640472,-58.4362149716405 -34.6366188716825,-58.4362969218813 -34.6366745250506,-58.4365921821871 -34.6368750176164,-58.4377937682856 -34.6376909289765,-58.4379419133347 -34.6377903989536,-58.4382211101485 -34.6370094442641,-58.4385910335728 -34.6359747661888,-58.4388572494119 -34.6352558515133,-58.4379457048587 -34.6350665088257,-58.437635152202 -34.6350122887072,-58.4372879676683 -34.6349402426889)))";;"3007";7_20_1;COMUNA 7;"20";"1";"1021";"491";"530";"92,64%";"433";"433";"100,00%";"0";"0,00%";"380";"8";"2.11";"372";"97,89%";"2.11";2.110
"MULTIPOLYGON (((-58.4377382364564 -34.6454670337808,-58.4374119089836 -34.6473338015858,-58.4374223173153 -34.6473523524797,-58.4378702500538 -34.6469527843996,-58.4388507555696 -34.6460349237586,-58.43911806166 -34.6457847567721,-58.4396525838476 -34.6452842801431,-58.4397616013641 -34.6451822552915,-58.4398704481461 -34.6450803711581,-58.4399615655242 -34.6449952447032,-58.4401843718673 -34.6447871105857,-58.4405219886867 -34.6444717401397,-58.4405655437345 -34.6444309721399,-58.4406252933065 -34.6443752065911,-58.4407454741041 -34.6442629712797,-58.4414752466129 -34.6435785017086,-58.4412879582724 -34.6435418481089,-58.4404995272957 -34.6433811387417,-58.4398593607285 -34.6432506643432,-58.439225416312 -34.6431214554251,-58.4386553792591 -34.6430052844023,-58.4381613549353 -34.6443288187774,-58.4379457390746 -34.6442799633886,-58.4377382364564 -34.6454670337808)))";;"3008";7_20_10;COMUNA 7;"20";"10";"1327";"622";"705";"88,23%";"375";"367";"97,87%";"8";"2,18%";"368";"109";"29.62";"259";"70,38%";"29.62";29.620
"MULTIPOLYGON (((-58.4357911422745 -34.6437918232704,-58.4373254674177 -34.6441394164894,-58.4379457390746 -34.6442799633886,-58.4381613549353 -34.6443288187774,-58.4386553792591 -34.6430052844023,-58.4379407476317 -34.6428595734778,-58.4377853300816 -34.6428285549407,-58.436246583335 -34.6425213198559,-58.4346794744713 -34.6422083544257,-58.434444665824 -34.642861771423,-58.4342368917251 -34.6434396988991,-58.4341988506605 -34.6435455383839,-58.4338370201228 -34.6445785135524,-58.435387370857 -34.6449291631667,-58.4357911422745 -34.6437918232704)))";;"3009";7_20_11;COMUNA 7;"20";"11";"1089";"510";"579";"88,08%";"364";"364";"100,00%";"0";"0,00%";"363";"19";"5.23";"344";"94,77%";"5.23";5.230
"MULTIPOLYGON (((-58.4331204718743 -34.6418969905808,-58.432516454141 -34.6417764162632,-58.4323444260195 -34.6417412316153,-58.4323061342064 -34.6422963099315,-58.4322527952888 -34.6429861773744,-58.4322161835523 -34.6436040748261,-58.4321749769685 -34.6442022521319,-58.4321075608723 -34.6451636734593,-58.4326181468579 -34.6452159851866,-58.4334815780674 -34.6455933898513,-58.4335364478593 -34.645617910783,-58.4349231139056 -34.646236845097,-58.435387370857 -34.6449291631667,-58.4338370201228 -34.6445785135524,-58.4341988506605 -34.6435455383839,-58.4342368917251 -34.6434396988991,-58.434444665824 -34.642861771423,-58.4346794744713 -34.6422083544257,-58.4331204718743 -34.6418969905808)))";;"3010";7_20_12;COMUNA 7;"20";"12";"659";"318";"341";"93,26%";"244";"244";"100,00%";"0";"0,00%";"223";"21";"9.42";"202";"90,58%";"9.42";9.420
"MULTIPOLYGON (((-58.4373254674177 -34.6441394164894,-58.4357911422745 -34.6437918232704,-58.435387370857 -34.6449291631667,-58.4349231139056 -34.646236845097,-58.4350125769324 -34.6462767962457,-58.4374096540699 -34.6473467006025,-58.4374223173153 -34.6473523524797,-58.4374119089836 -34.6473338015858,-58.4377382364564 -34.6454670337808,-58.4379457390746 -34.6442799633886,-58.4373254674177 -34.6441394164894)))";;"3011";7_20_13;COMUNA 7;"20";"13";"1617";"768";"849";"90,46%";"653";"653";"100,00%";"0";"0,00%";"575";"5";"0.87";"570";"99,13%";"0.87";0.870
"MULTIPOLYGON (((-58.4402048419767 -34.6374599816264,-58.4396978234702 -34.6372944591965,-58.4391398373155 -34.6371867435841,-58.4382211101485 -34.6370094442641,-58.4379419133347 -34.6377903989536,-58.4382673395779 -34.6380089222964,-58.4389982710329 -34.6385207026446,-58.439052452334 -34.6385586016982,-58.4392207894916 -34.6386764548912,-58.4395527796938 -34.6389089201446,-58.4403695761286 -34.6395738119348,-58.4404931872006 -34.6396742602357,-58.4407505312986 -34.638976326833,-58.4407963207474 -34.6388519648962,-58.4411879641365 -34.6377553797541,-58.4407468831657 -34.6376228321112,-58.4406038324626 -34.6375799175753,-58.4402048419767 -34.6374599816264)))";;"3012";7_20_2;COMUNA 7;"20";"2";"552";"259";"293";"88,40%";"213";"213";"100,00%";"0";"0,00%";"192";"4";"2.08";"188";"97,92%";"2.08";2.080
"MULTIPOLYGON (((-58.4449778860863 -34.6385275633903,-58.4436338833076 -34.6382538307999,-58.4423579664566 -34.6379938980228,-58.4418810865841 -34.6378967721828,-58.4411879641365 -34.6377553797541,-58.4407963207474 -34.6388519648962,-58.4407505312986 -34.638976326833,-58.4415844962363 -34.6391814806148,-58.4420560103087 -34.6392974805283,-58.4432658154404 -34.6395950831508,-58.443322305605 -34.6396089658205,-58.444405335567 -34.6398753387419,-58.4444966226058 -34.6397464046395,-58.4447312741344 -34.6394151612858,-58.4448537140686 -34.6390396039054,-58.4449778860863 -34.6385275633903)))";;"3013";7_20_3;COMUNA 7;"20";"3";"722";"349";"373";"93,57%";"287";"287";"100,00%";"0";"0,00%";"259";"5";"1.93";"254";"98,07%";"1.93";1.930
"MULTIPOLYGON (((-58.4409130070818 -34.6400152622846,-58.4412376712956 -34.640278919766,-58.4415508364356 -34.6405339825572,-58.4426026287357 -34.6413905255103,-58.4429808907569 -34.6416986251332,-58.4430780125391 -34.6417777277947,-58.4431803915392 -34.6416043584833,-58.4437944467892 -34.6407376672907,-58.444405335567 -34.6398753387419,-58.443322305605 -34.6396089658205,-58.4432658154404 -34.6395950831508,-58.4420560103087 -34.6392974805283,-58.4415844962363 -34.6391814806148,-58.4407505312986 -34.638976326833,-58.4404931872006 -34.6396742602357,-58.4409130070818 -34.6400152622846)))";;"3014";7_20_4;COMUNA 7;"20";"4";"541";"266";"275";"96,73%";"218";"218";"100,00%";"0";"0,00%";"190";"4";"2.11";"186";"97,89%";"2.11";2.110
"MULTIPOLYGON (((-58.4404139706763 -34.6398893230461,-58.4409130070818 -34.6400152622846,-58.4404931872006 -34.6396742602357,-58.4403695761286 -34.6395738119348,-58.4395527796938 -34.6389089201446,-58.4392207894916 -34.6386764548912,-58.439052452334 -34.6385586016982,-58.4389982710329 -34.6385207026446,-58.4382673395779 -34.6380089222964,-58.4379419133347 -34.6377903989536,-58.437816213404 -34.6381418635221,-58.4374576983626 -34.6391444275367,-58.4361115156853 -34.6388057504028,-58.4359175980269 -34.6387572557207,-58.4357309093812 -34.6392780762696,-58.4355473739762 -34.6397901645178,-58.4370827159946 -34.6401902276808,-58.4385652467033 -34.6405765282236,-58.438779277546 -34.6406323468049,-58.4400244475243 -34.6409483693116,-58.4403725289995 -34.6400015725533,-58.4404139706763 -34.6398893230461)))";;"3015";7_20_5;COMUNA 7;"20";"5";"806";"384";"422";"91,00%";"302";"302";"100,00%";"0";"0,00%";"278";"7";"2.52";"271";"97,48%";"2.52";2.520
"MULTIPOLYGON (((-58.4351018327295 -34.6363970684232,-58.434785852611 -34.6372742079111,-58.4345821890768 -34.6378393905625,-58.4343891836953 -34.6383752081581,-58.4359175980269 -34.6387572557207,-58.4361115156853 -34.6388057504028,-58.4374576983626 -34.6391444275367,-58.437816213404 -34.6381418635221,-58.4379419133347 -34.6377903989536,-58.4377937682856 -34.6376909289765,-58.4365921821871 -34.6368750176164,-58.4362969218813 -34.6366745250506,-58.4362149716405 -34.6366188716825,-58.4352563664036 -34.6359678640472,-58.4351018327295 -34.6363970684232)))";;"3016";7_20_6;COMUNA 7;"20";"6";"815";"374";"441";"84,81%";"313";"313";"100,00%";"0";"0,00%";"283";"16";"5.65";"267";"94,35%";"5.65";5.650
"MULTIPOLYGON (((-58.4334841660447 -34.6408873985497,-58.4331204718743 -34.6418969905808,-58.4346794744713 -34.6422083544257,-58.4350418724665 -34.6412002364184,-58.4350828965479 -34.641085946334,-58.4355473739762 -34.6397901645178,-58.4357309093812 -34.6392780762696,-58.4359175980269 -34.6387572557207,-58.4343891836953 -34.6383752081581,-58.4341575398452 -34.6390182733076,-58.4339237601283 -34.6396673235502,-58.4334841660447 -34.6408873985497)))";;"3017";7_20_7;COMUNA 7;"20";"7";"816";"379";"437";"86,73%";"255";"255";"100,00%";"0";"0,00%";"279";"33";"11.83";"246";"88,17%";"11.83";11.830
"MULTIPOLYGON (((-58.4377853300816 -34.6428285549407,-58.4379407476317 -34.6428595734778,-58.4386553792591 -34.6430052844023,-58.439225416312 -34.6431214554251,-58.4392722337967 -34.6429937843814,-58.4395989281293 -34.6421055090072,-58.4400244475243 -34.6409483693116,-58.438779277546 -34.6406323468049,-58.4385652467033 -34.6405765282236,-58.4370827159946 -34.6401902276808,-58.4355473739762 -34.6397901645178,-58.4350828965479 -34.641085946334,-58.4350418724665 -34.6412002364184,-58.4346794744713 -34.6422083544257,-58.436246583335 -34.6425213198559,-58.4377853300816 -34.6428285549407)))";;"3018";7_20_8;COMUNA 7;"20";"8";"1189";"576";"613";"93,96%";"495";"495";"100,00%";"0";"0,00%";"441";"27";"6.12";"414";"93,88%";"6.12";6.120
"MULTIPOLYGON (((-58.442439483588 -34.642655819974,-58.4429520201426 -34.6419910944514,-58.4430780125391 -34.6417777277947,-58.4429808907569 -34.6416986251332,-58.4426026287357 -34.6413905255103,-58.4415508364356 -34.6405339825572,-58.4412376712956 -34.640278919766,-58.4409130070818 -34.6400152622846,-58.4404139706763 -34.6398893230461,-58.4403725289995 -34.6400015725533,-58.4400244475243 -34.6409483693116,-58.4395989281293 -34.6421055090072,-58.4392722337967 -34.6429937843814,-58.439225416312 -34.6431214554251,-58.4398593607285 -34.6432506643432,-58.4404995272957 -34.6433811387417,-58.4412879582724 -34.6435418481089,-58.4414752466129 -34.6435785017086,-58.4423888517185 -34.6427215178352,-58.442439483588 -34.642655819974)))";;"3019";7_20_9;COMUNA 7;"20";"9";"909";"417";"492";"84,76%";"307";"307";"100,00%";"0";"0,00%";"302";"21";"6.95";"281";"93,05%";"6.95";6.950
"MULTIPOLYGON (((-58.4485894122169 -34.631986835872,-58.4496474697539 -34.6323263311052,-58.4499839984345 -34.6324343279661,-58.4501956282359 -34.6325044225817,-58.451048006915 -34.631730678582,-58.4511006716497 -34.6316537796447,-58.4515763969476 -34.6306390719281,-58.4504979638399 -34.6304806536754,-58.4493589595847 -34.6303133457385,-58.4490540388145 -34.6302685217793,-58.4482222607585 -34.6301432808645,-58.4479821633337 -34.6306621426725,-58.447529403805 -34.6316466973763,-58.4485894122169 -34.631986835872)))";;"3020";7_21_1;COMUNA 7;"21";"1";"1138";"486";"652";"74,54%";"478";"477";"99,79%";"1";"0,21%";"424";"12";"2.83";"412";"97,17%";"2.83";2.830
"MULTIPOLYGON (((-58.4418626785894 -34.6358657175782,-58.4412022048066 -34.6357308802684,-58.4403007021749 -34.635547824773,-58.4400517939426 -34.6362689289515,-58.4402469035821 -34.6363081916482,-58.4405854060959 -34.6363776923621,-58.4410247870998 -34.6364679854252,-58.4416050918741 -34.6365871051078,-58.4421572818079 -34.6367005128856,-58.4426348365663 -34.6367986237218,-58.4428063623564 -34.6360582757579,-58.4418626785894 -34.6358657175782)))";;"3021";7_21_10;COMUNA 7;"21";"10";"911";"406";"505";"80,40%";"443";"443";"100,00%";"0";"0,00%";"376";"2";"0.53";"374";"99,47%";"0.53";0.530
"MULTIPOLYGON (((-58.4385910335728 -34.6359747661888,-58.4382211101485 -34.6370094442641,-58.4391398373155 -34.6371867435841,-58.4396978234702 -34.6372944591965,-58.4400517939426 -34.6362689289515,-58.4403007021749 -34.635547824773,-58.4388572494119 -34.6352558515133,-58.4385910335728 -34.6359747661888)))";;"3022";7_21_11;COMUNA 7;"21";"11";"811";"361";"450";"80,22%";"352";"352";"100,00%";"0";"0,00%";"339";"9";"2.65";"330";"97,35%";"2.65";2.650
"MULTIPOLYGON (((-58.4405854060959 -34.6363776923621,-58.4402469035821 -34.6363081916482,-58.4400517939426 -34.6362689289515,-58.4396978234702 -34.6372944591965,-58.4402048419767 -34.6374599816264,-58.4406038324626 -34.6375799175753,-58.4407468831657 -34.6376228321112,-58.4411879641365 -34.6377553797541,-58.4418810865841 -34.6378967721828,-58.4423579664566 -34.6379938980228,-58.4436338833076 -34.6382538307999,-58.4449778860863 -34.6385275633903,-58.4452661366651 -34.6373389047991,-58.4439082646522 -34.6370601026126,-58.4426348365663 -34.6367986237218,-58.4421572818079 -34.6367005128856,-58.4416050918741 -34.6365871051078,-58.4410247870998 -34.6364679854252,-58.4405854060959 -34.6363776923621)))";;"3023";7_21_12;COMUNA 7;"21";"12";"917";"412";"505";"81,58%";"295";"294";"99,66%";"1";"0,34%";"313";"12";"3.83";"301";"96,17%";"3.83";3.830
"MULTIPOLYGON (((-58.4460609103067 -34.6298184168624,-58.444477543156 -34.6295830418786,-58.4429251960712 -34.6293520881348,-58.4428142274402 -34.6298788482866,-58.4427578544116 -34.6301154667054,-58.4440725517723 -34.6305373787726,-58.4455451274522 -34.6310099344356,-58.4464570507801 -34.6313026042144,-58.447529403805 -34.6316466973763,-58.4479821633337 -34.6306621426725,-58.4482222607585 -34.6301432808645,-58.4475135091176 -34.6300365009756,-58.4464236760184 -34.6298723408503,-58.4460609103067 -34.6298184168624)))";;"3024";7_21_2;COMUNA 7;"21";"2";"1121";"499";"622";"80,23%";"561";"560";"99,82%";"1";"0,18%";"466";"2";"0.43";"464";"99,57%";"0.43";0.430
"MULTIPOLYGON (((-58.4440725517723 -34.6305373787726,-58.4427578544116 -34.6301154667054,-58.4424517083032 -34.6305728963115,-58.4421531497572 -34.6309973675508,-58.4423521412298 -34.6311431804012,-58.4424213965662 -34.6311938978444,-58.4434684145051 -34.631961205527,-58.4447275704876 -34.6328838928031,-58.4451017026425 -34.6320262429936,-58.4436400164805 -34.6315567824498,-58.4440725517723 -34.6305373787726)))";;"3025";7_21_3;COMUNA 7;"21";"3";"959";"438";"521";"84,07%";"512";"512";"100,00%";"0";"0,00%";"433";"34";"7.85";"399";"92,15%";"7.85";7.850
"MULTIPOLYGON (((-58.4455451274522 -34.6310099344356,-58.4440725517723 -34.6305373787726,-58.4436400164805 -34.6315567824498,-58.4451017026425 -34.6320262429936,-58.4455451274522 -34.6310099344356)))";;"3026";7_21_4;COMUNA 7;"21";"4";"565";"263";"302";"87,09%";"289";"288";"99,65%";"1";"0,35%";"240";"0";"0";"240";"100,00%";"0";0.000
"MULTIPOLYGON (((-58.447529403805 -34.6316466973763,-58.4464570507801 -34.6313026042144,-58.4455451274522 -34.6310099344356,-58.4451017026425 -34.6320262429936,-58.445998641021 -34.6323143363733,-58.4470640190043 -34.63265646072,-58.4481224195572 -34.6329963917386,-58.449244130821 -34.633356532488,-58.4501956282359 -34.6325044225817,-58.4499839984345 -34.6324343279661,-58.4496474697539 -34.6323263311052,-58.4485894122169 -34.631986835872,-58.447529403805 -34.6316466973763)))";;"3027";7_21_5;COMUNA 7;"21";"5";"686";"343";"343";"100,00%";"293";"292";"99,66%";"1";"0,34%";"250";"10";"4";"240";"96,00%";"4";4.000
"MULTIPOLYGON (((-58.445998641021 -34.6323143363733,-58.4451017026425 -34.6320262429936,-58.4447275704876 -34.6328838928031,-58.4450939670239 -34.6331524057819,-58.4455523243346 -34.6332994477473,-58.4466071486693 -34.6336378420299,-58.4476652190974 -34.6339772839452,-58.4481224195572 -34.6329963917386,-58.4470640190043 -34.63265646072,-58.445998641021 -34.6323143363733)))";;"3028";7_21_6;COMUNA 7;"21";"6";"927";"430";"497";"86,52%";"505";"505";"100,00%";"0";"0,00%";"423";"1";"0.24";"422";"99,76%";"0.24";0.240
"MULTIPOLYGON (((-58.4483172414959 -34.6341865243545,-58.449244130821 -34.633356532488,-58.4481224195572 -34.6329963917386,-58.4476652190974 -34.6339772839452,-58.4466071486693 -34.6336378420299,-58.4455523243346 -34.6332994477473,-58.4450939670239 -34.6331524057819,-58.4463907281809 -34.634102617249,-58.4464564955993 -34.6341507966165,-58.4472968258563 -34.6347665595584,-58.4475039286273 -34.6349182806264,-58.4476683994471 -34.6347675918663,-58.4483172414959 -34.6341865243545)))";;"3029";7_21_7;COMUNA 7;"21";"7";"722";"334";"388";"86,08%";"362";"361";"99,72%";"1";"0,28%";"303";"3";"0.99";"300";"99,01%";"0.99";0.990
"MULTIPOLYGON (((-58.4424213965662 -34.6311938978444,-58.4423521412298 -34.6311431804012,-58.4421531497572 -34.6309973675508,-58.4420053608709 -34.6312074903918,-58.4416568642551 -34.631655614644,-58.4409292621237 -34.6325912925207,-58.4401744545811 -34.6335619620372,-58.4395221659987 -34.6344008109576,-58.4388572494119 -34.6352558515133,-58.4403007021749 -34.635547824773,-58.4412022048066 -34.6357308802684,-58.4418626785894 -34.6358657175782,-58.4428063623564 -34.6360582757579,-58.4440788428016 -34.6363179921226,-58.4458766081092 -34.6366565741534,-58.4468875252442 -34.6355673079054,-58.446989217098 -34.6353406235349,-58.4471159450637 -34.635185353049,-58.4471937687898 -34.6350119770383,-58.4472968258563 -34.6347665595584,-58.4464564955993 -34.6341507966165,-58.4463907281809 -34.634102617249,-58.4450939670239 -34.6331524057819,-58.4447275704876 -34.6328838928031,-58.4434684145051 -34.631961205527,-58.4424213965662 -34.6311938978444)))";;"3030";7_21_8;COMUNA 7;"21";"8";"432";"186";"246";"75,61%";"201";"201";"100,00%";"0";"0,00%";"175";"3";"1.71";"172";"98,29%";"1.71";1.710
"MULTIPOLYGON (((-58.4440788428016 -34.6363179921226,-58.4428063623564 -34.6360582757579,-58.4426348365663 -34.6367986237218,-58.4439082646522 -34.6370601026126,-58.4452661366651 -34.6373389047991,-58.4453146354789 -34.6372605289157,-58.4458766081092 -34.6366565741534,-58.4440788428016 -34.6363179921226)))";;"3031";7_21_9;COMUNA 7;"21";"9";"709";"326";"383";"85,12%";"368";"368";"100,00%";"0";"0,00%";"307";"1";"0.33";"306";"99,67%";"0.33";0.330
"MULTIPOLYGON (((-58.4429251960712 -34.6293520881348,-58.4417593858374 -34.6291816765868,-58.4410036809965 -34.6301549573529,-58.4421531497572 -34.6309973675508,-58.4424517083032 -34.6305728963115,-58.4427578544116 -34.6301154667054,-58.4428142274402 -34.6298788482866,-58.4429251960712 -34.6293520881348)))";;"3032";7_22_1;COMUNA 7;"22";"1";"634";"284";"350";"81,14%";"347";"347";"100,00%";"0";"0,00%";"297";"0";"0";"297";"100,00%";"0";0.000
"MULTIPOLYGON (((-58.4349704054934 -34.6344702858697,-58.4352931345609 -34.6345364877356,-58.4354680445061 -34.6345761760951,-58.4357075361702 -34.6346245407677,-58.4367222831306 -34.6330763301183,-58.4367793103666 -34.6329893675593,-58.4370242105642 -34.6326164493313,-58.4373652579529 -34.6321040389463,-58.4364286814535 -34.6319805268775,-58.4348564613792 -34.6317462971283,-58.4347782211941 -34.6320779803522,-58.4347788750482 -34.6324151043076,-58.4347637390388 -34.6325802471321,-58.434712306017 -34.6327484098955,-58.4346672447825 -34.6329705195338,-58.4344566801739 -34.6335634481799,-58.4341905918365 -34.6343126361517,-58.4349704054934 -34.6344702858697)))";;"3033";7_22_10;COMUNA 7;"22";"10";"778";"384";"394";"97,46%";"312";"312";"100,00%";"0";"0,00%";"268";"11";"4.1";"257";"95,90%";"4.1";4.100
"MULTIPOLYGON (((-58.4391671670429 -34.6330392194697,-58.4388799083993 -34.6328901447192,-58.4385946953195 -34.6327421260658,-58.4383427068235 -34.6326113674715,-58.4380914858277 -34.6324809606331,-58.4378359210231 -34.6323482987937,-58.4373652579529 -34.6321040389463,-58.4370242105642 -34.6326164493313,-58.4367793103666 -34.6329893675593,-58.4367222831306 -34.6330763301183,-58.4357075361702 -34.6346245407677,-58.4363292298115 -34.6347427792143,-58.4374348373414 -34.6333266992919,-58.4376868269124 -34.6334563329494,-58.4379389876308 -34.6335861069681,-58.4382251398904 -34.6337333526499,-58.4385125710004 -34.633881302159,-58.4387655010176 -34.6340114267372,-58.4390181762555 -34.6341414098891,-58.4396711500021 -34.6333007327123,-58.4394192433292 -34.6331699763689,-58.4391671670429 -34.6330392194697)))";;"3034";7_22_11;COMUNA 7;"22";"11";"753";"348";"405";"85,93%";"336";"336";"100,00%";"0";"0,00%";"286";"5";"1.75";"281";"98,25%";"1.75";1.750
"MULTIPOLYGON (((-58.4401744545811 -34.6335619620372,-58.4396711500021 -34.6333007327123,-58.4390181762555 -34.6341414098891,-58.4395221659987 -34.6344008109576,-58.4401744545811 -34.6335619620372)))";;"3035";7_22_12;COMUNA 7;"22";"12";"582";"259";"323";"80,19%";"298";"298";"100,00%";"0";"0,00%";"256";"0";"0";"256";"100,00%";"0";0.000
"MULTIPOLYGON (((-58.4376868269124 -34.6334563329494,-58.4374348373414 -34.6333266992919,-58.4363292298115 -34.6347427792143,-58.4366386706714 -34.6348043266048,-58.4369424024137 -34.634868829847,-58.4372879676683 -34.6349402426889,-58.437635152202 -34.6350122887072,-58.4379457048587 -34.6350665088257,-58.4388572494119 -34.6352558515133,-58.4395221659987 -34.6344008109576,-58.4390181762555 -34.6341414098891,-58.4387655010176 -34.6340114267372,-58.4385125710004 -34.633881302159,-58.4382251398904 -34.6337333526499,-58.4379389876308 -34.6335861069681,-58.4376868269124 -34.6334563329494)))";;"3036";7_22_13;COMUNA 7;"22";"13";"753";"349";"404";"86,39%";"343";"343";"100,00%";"0";"0,00%";"289";"2";"0.69";"287";"99,31%";"0.69";0.690
"MULTIPOLYGON (((-58.4387169610917 -34.6300731884199,-58.4393434200486 -34.6304103634843,-58.4395942946981 -34.6305453453392,-58.4398425293392 -34.6306789881078,-58.4400928944648 -34.6308137575615,-58.4403744390706 -34.6309652933299,-58.4410036809965 -34.6301549573529,-58.4417593858374 -34.6291816765868,-58.4395276274238 -34.6288552761687,-58.4385927919983 -34.6287185411079,-58.4383060547446 -34.63004437358,-58.4387169610917 -34.6300731884199)))";;"3037";7_22_2;COMUNA 7;"22";"2";"923";"449";"474";"94,73%";"501";"501";"100,00%";"0";"0,00%";"365";"22";"6.03";"343";"93,97%";"6.03";6.030
"MULTIPOLYGON (((-58.4403744390706 -34.6309652933299,-58.4400928944648 -34.6308137575615,-58.4398425293392 -34.6306789881078,-58.4395942946981 -34.6305453453392,-58.4393434200486 -34.6304103634843,-58.4387169610917 -34.6300731884199,-58.4380448682179 -34.6310830176243,-58.4385959438689 -34.6313712359267,-58.4388499732402 -34.631504036744,-58.4391005107156 -34.6316350053074,-58.4393524971541 -34.6317668187293,-58.4396366856775 -34.6319153988391,-58.4399239420089 -34.6320655986281,-58.4401751643562 -34.6321969876497,-58.440426387496 -34.6323283761515,-58.4409292621237 -34.6325912925207,-58.4416568642551 -34.631655614644,-58.4420053608709 -34.6312074903918,-58.4421531497572 -34.6309973675508,-58.4410036809965 -34.6301549573529,-58.4403744390706 -34.6309652933299)))";;"3038";7_22_3;COMUNA 7;"22";"3";"874";"386";"488";"79,10%";"424";"424";"100,00%";"0";"0,00%";"361";"7";"1.94";"354";"98,06%";"1.94";1.940
"MULTIPOLYGON (((-58.4409292621237 -34.6325912925207,-58.440426387496 -34.6323283761515,-58.4401751643562 -34.6321969876497,-58.4399239420089 -34.6320655986281,-58.4396366856775 -34.6319153988391,-58.4393524971541 -34.6317668187293,-58.4391005107156 -34.6316350053074,-58.4388499732402 -34.631504036744,-58.4385959438689 -34.6313712359267,-58.4380448682179 -34.6310830176243,-58.4373652579529 -34.6321040389463,-58.4378359210231 -34.6323482987937,-58.4380914858277 -34.6324809606331,-58.4383427068235 -34.6326113674715,-58.4385946953195 -34.6327421260658,-58.4388799083993 -34.6328901447192,-58.4391671670429 -34.6330392194697,-58.4394192433292 -34.6331699763689,-58.4396711500021 -34.6333007327123,-58.4401744545811 -34.6335619620372,-58.4409292621237 -34.6325912925207)))";;"3039";7_22_4;COMUNA 7;"22";"4";"932";"426";"506";"84,19%";"448";"448";"100,00%";"0";"0,00%";"378";"1";"0.26";"377";"99,74%";"0.26";0.260
"MULTIPOLYGON (((-58.4368798032238 -34.6298363265834,-58.4366781052436 -34.6307590609634,-58.4366483249121 -34.6309050453762,-58.4364286814535 -34.6319805268775,-58.4373652579529 -34.6321040389463,-58.4380448682179 -34.6310830176243,-58.4387169610917 -34.6300731884199,-58.4383060547446 -34.63004437358,-58.4385927919983 -34.6287185411079,-58.4371695443988 -34.6285103572028,-58.4368798032238 -34.6298363265834)))";;"3040";7_22_5;COMUNA 7;"22";"5";"1000";"466";"534";"87,27%";"501";"500";"99,80%";"1";"0,20%";"386";"6";"1.55";"380";"98,45%";"1.55";1.550
"MULTIPOLYGON (((-58.4353445951275 -34.6296123224917,-58.4350992942508 -34.6306845565226,-58.4348564613792 -34.6317462971283,-58.4364286814535 -34.6319805268775,-58.4366483249121 -34.6309050453762,-58.4366781052436 -34.6307590609634,-58.4368798032238 -34.6298363265834,-58.4371695443988 -34.6285103572028,-58.4356474798731 -34.6282876977037,-58.4353445951275 -34.6296123224917)))";;"3041";7_22_6;COMUNA 7;"22";"6";"903";"420";"483";"86,96%";"419";"419";"100,00%";"0";"0,00%";"365";"6";"1.64";"359";"98,36%";"1.64";1.640
"MULTIPOLYGON (((-58.4356474798731 -34.6282876977037,-58.4347631765583 -34.6281583390948,-58.4347197544772 -34.6283274897673,-58.4344584038664 -34.6294829612745,-58.4342149651562 -34.630558715222,-58.4350992942508 -34.6306845565226,-58.4353445951275 -34.6296123224917,-58.4356474798731 -34.6282876977037)))";;"3042";7_22_7;COMUNA 7;"22";"7";"561";"266";"295";"90,17%";"267";"267";"100,00%";"0";"0,00%";"221";"2";"0.9";"219";"99,10%";"0.9";0.900
"MULTIPOLYGON (((-58.4335120684251 -34.6293449169776,-58.4332628234791 -34.6304231325273,-58.4342149651562 -34.630558715222,-58.4344584038664 -34.6294829612745,-58.4347197544772 -34.6283274897673,-58.4347631765583 -34.6281583390948,-58.4338183040698 -34.6280200862079,-58.4335120684251 -34.6293449169776)))";;"3043";7_22_8;COMUNA 7;"22";"8";"569";"258";"311";"82,96%";"275";"275";"100,00%";"0";"0,00%";"235";"2";"0.85";"233";"99,15%";"0.85";0.850
"MULTIPOLYGON (((-58.4342149651562 -34.630558715222,-58.4332628234791 -34.6304231325273,-58.4330207399727 -34.631470291751,-58.4329114860677 -34.6324991019381,-58.4328093482776 -34.6333968529592,-58.4327384917517 -34.6340191094852,-58.4332714843792 -34.6341254399079,-58.4337145090583 -34.6342164644626,-58.4341905918365 -34.6343126361517,-58.4344566801739 -34.6335634481799,-58.4346672447825 -34.6329705195338,-58.434712306017 -34.6327484098955,-58.4347637390388 -34.6325802471321,-58.4347788750482 -34.6324151043076,-58.4347782211941 -34.6320779803522,-58.4348564613792 -34.6317462971283,-58.4350992942508 -34.6306845565226,-58.4342149651562 -34.630558715222)))";;"3044";7_22_9;COMUNA 7;"22";"9";"606";"288";"318";"90,57%";"255";"255";"100,00%";"0";"0,00%";"224";"1";"0.45";"223";"99,55%";"0.45";0.450
"MULTIPOLYGON (((-58.431783683215 -34.6301778992667,-58.4312089620338 -34.6300932423793,-58.4310617462434 -34.6300718655425,-58.4303935672923 -34.6299769689263,-58.4301537464387 -34.6310317994371,-58.4303669891761 -34.6310648149915,-58.4308478325083 -34.6311316338623,-58.4313306361104 -34.6311987330407,-58.4315393639228 -34.6312323087825,-58.4322004785009 -34.6313384653185,-58.4324120184719 -34.6313724628188,-58.4330207399727 -34.631470291751,-58.4332628234791 -34.6304231325273,-58.4335120684251 -34.6293449169776,-58.4338183040698 -34.6280200862079,-58.4325451037918 -34.6278337859089,-58.4323337418832 -34.6278032394872,-58.432026801832 -34.6291281368185,-58.431783683215 -34.6301778992667)))";;"3045";7_23_1;COMUNA 7;"23";"1";"822";"386";"436";"88,53%";"354";"354";"100,00%";"0";"0,00%";"303";"14";"4.62";"289";"95,38%";"4.62";4.620
"MULTIPOLYGON (((-58.4306327847045 -34.6289246728972,-58.4303935672923 -34.6299769689263,-58.4310617462434 -34.6300718655425,-58.4312089620338 -34.6300932423793,-58.431783683215 -34.6301778992667,-58.432026801832 -34.6291281368185,-58.4323337418832 -34.6278032394872,-58.4309337820061 -34.6276008338618,-58.4296338436171 -34.6274128764268,-58.4293742167538 -34.6285627740952,-58.4293243077736 -34.6287337521074,-58.4306327847045 -34.6289246728972)))";;"3046";7_23_2;COMUNA 7;"23";"2";"984";"449";"535";"83,93%";"450";"449";"99,78%";"1";"0,22%";"388";"8";"2.06";"380";"97,94%";"2.06";2.060
"MULTIPOLYGON (((-58.4296338436171 -34.6274128764268,-58.4283671355998 -34.6272297033861,-58.4281601213502 -34.6272001369027,-58.4281108704359 -34.6274237220538,-58.4278905746784 -34.6283913680562,-58.4278628316377 -34.6285203785569,-58.4293243077736 -34.6287337521074,-58.4293742167538 -34.6285627740952,-58.4296338436171 -34.6274128764268)))";;"3047";7_23_3;COMUNA 7;"23";"3";"728";"324";"404";"80,20%";"379";"379";"100,00%";"0";"0,00%";"318";"8";"2.52";"310";"97,48%";"2.52";2.520
"MULTIPOLYGON (((-58.4281601213502 -34.6272001369027,-58.4270800716138 -34.6270458774205,-58.4267558364569 -34.6269984567619,-58.4265020660238 -34.6281109544838,-58.4264557999563 -34.6283162997674,-58.4267233880684 -34.6283540563084,-58.4278628316377 -34.6285203785569,-58.4278905746784 -34.6283913680562,-58.4281108704359 -34.6274237220538,-58.4281601213502 -34.6272001369027)))";;"3048";7_23_4;COMUNA 7;"23";"4";"633";"275";"358";"76,82%";"331";"331";"100,00%";"0";"0,00%";"272";"3";"1.1";"269";"98,90%";"1.1";1.100
"MULTIPOLYGON (((-58.4262127713714 -34.6293947846133,-58.4260154079062 -34.6302694024981,-58.4259797142156 -34.6304519330461,-58.4274022882351 -34.6306533456207,-58.4276023850311 -34.6297297810324,-58.4276302995428 -34.6296001368421,-58.4278628316377 -34.6285203785569,-58.4267233880684 -34.6283540563084,-58.4264557999563 -34.6283162997674,-58.4262507582548 -34.6292264100538,-58.4262127713714 -34.6293947846133)))";;"3049";7_23_5;COMUNA 7;"23";"5";"735";"320";"415";"77,11%";"307";"307";"100,00%";"0";"0,00%";"290";"4";"1.38";"286";"98,62%";"1.38";1.380
"MULTIPOLYGON (((-58.4287122429817 -34.6308352025796,-58.4289380096699 -34.63086660435,-58.4301537464387 -34.6310317994371,-58.4303935672923 -34.6299769689263,-58.4306327847045 -34.6289246728972,-58.4293243077736 -34.6287337521074,-58.4278628316377 -34.6285203785569,-58.4276302995428 -34.6296001368421,-58.4276023850311 -34.6297297810324,-58.4274022882351 -34.6306533456207,-58.4275505268914 -34.6306738116436,-58.4287122429817 -34.6308352025796)))";;"3050";7_23_6;COMUNA 7;"23";"6";"760";"348";"412";"84,47%";"347";"346";"99,71%";"1";"0,29%";"276";"2";"0.72";"274";"99,28%";"0.72";0.720
"MULTIPOLYGON (((-58.426934043628 -34.6326097528269,-58.4281716820222 -34.6328151866405,-58.4284224939937 -34.631833323593,-58.4284956144938 -34.6315813639534,-58.4287122429817 -34.6308352025796,-58.4275505268914 -34.6306738116436,-58.4274022882351 -34.6306533456207,-58.4259797142156 -34.6304519330461,-58.4259325777455 -34.6306931240514,-58.425802727457 -34.6312840903703,-58.4257528821022 -34.6314835185075,-58.4256863073124 -34.6317501972873,-58.4255287524562 -34.6323652401014,-58.426934043628 -34.6326097528269)))";;"3051";7_23_7;COMUNA 7;"23";"7";"821";"358";"463";"77,32%";"362";"361";"99,72%";"1";"0,28%";"313";"8";"2.56";"305";"97,44%";"2.56";2.560
"MULTIPOLYGON (((-58.4298153530626 -34.6320582919615,-58.430637157144 -34.6321753456043,-58.4308478325083 -34.6311316338623,-58.4303669891761 -34.6310648149915,-58.4301537464387 -34.6310317994371,-58.4289380096699 -34.63086660435,-58.4287122429817 -34.6308352025796,-58.4284956144938 -34.6315813639534,-58.4284224939937 -34.631833323593,-58.4281716820222 -34.6328151866405,-58.4294259398227 -34.6330233589948,-58.4305426111216 -34.6332086645977,-58.4315658261659 -34.6333784426865,-58.4315921189475 -34.6332433041135,-58.4312660500005 -34.6330173680232,-58.4302599083165 -34.6323380681262,-58.4298153530626 -34.6320582919615)))";;"3052";7_23_8;COMUNA 7;"23";"8";"814";"372";"442";"84,16%";"326";"326";"100,00%";"0";"0,00%";"322";"34";"10.56";"288";"89,44%";"10.56";10.560
"MULTIPOLYGON (((-58.4321084851701 -34.6335967561711,-58.4324666749727 -34.6338369237733,-58.4327384917517 -34.6340191094852,-58.4328093482776 -34.6333968529592,-58.4329114860677 -34.6324991019381,-58.4330207399727 -34.631470291751,-58.4324120184719 -34.6313724628188,-58.4322004785009 -34.6313384653185,-58.4315393639228 -34.6312323087825,-58.4313306361104 -34.6311987330407,-58.4308478325083 -34.6311316338623,-58.430637157144 -34.6321753456043,-58.4298153530626 -34.6320582919615,-58.4302599083165 -34.6323380681262,-58.4312660500005 -34.6330173680232,-58.4315921189475 -34.6332433041135,-58.4319164860559 -34.6334680416724,-58.4321084851701 -34.6335967561711)))";;"3053";7_23_9;COMUNA 7;"23";"9";"735";"342";"393";"87,02%";"285";"285";"100,00%";"0";"0,00%";"289";"9";"3.11";"280";"96,89%";"3.11";3.110
"MULTIPOLYGON (((-58.4332714843792 -34.6341254399079,-58.4327384917517 -34.6340191094852,-58.4325520803619 -34.6349255720134,-58.432305837177 -34.6361037181675,-58.4336118739783 -34.6363133391939,-58.4351018327295 -34.6363970684232,-58.4352563664036 -34.6359678640472,-58.4354738364431 -34.6353643016478,-58.4357075361702 -34.6346245407677,-58.4354680445061 -34.6345761760951,-58.4352931345609 -34.6345364877356,-58.4349704054934 -34.6344702858697,-58.4341905918365 -34.6343126361517,-58.4337145090583 -34.6342164644626,-58.4332714843792 -34.6341254399079)))";;"3054";7_24_1;COMUNA 7;"24";"1";"894";"432";"462";"93,51%";"413";"413";"100,00%";"0";"0,00%";"345";"11";"3.19";"334";"96,81%";"3.19";3.190
"MULTIPOLYGON (((-58.4276849610212 -34.6398236546895,-58.4274684208429 -34.6406867886822,-58.4274227587238 -34.6408635416297,-58.4279964374909 -34.6409604698411,-58.4283544655379 -34.6410209252121,-58.4285663685187 -34.6410569717553,-58.4292509860134 -34.6411732918705,-58.4297318808435 -34.641255115534,-58.4299224010162 -34.6412814353217,-58.4299564656456 -34.641114396952,-58.4301120849599 -34.6403961764994,-58.4301412007842 -34.6402442780561,-58.430170487168 -34.6400917458245,-58.4303471290189 -34.6392061308591,-58.4303844375855 -34.63901916296,-58.4305030954179 -34.6384537537507,-58.4305931548375 -34.6380244679731,-58.4306201301009 -34.6378951047264,-58.4293577940121 -34.637668280017,-58.4293310729909 -34.637796375412,-58.4291208849911 -34.6388102234081,-58.4290816226778 -34.6389754291303,-58.4281213148593 -34.6388002959059,-58.4279517637748 -34.6387698946347,-58.4279071300848 -34.6389374224664,-58.4276849610212 -34.6398236546895)))";;"3055";7_24_10;COMUNA 7;"24";"10";"962";"442";"520";"85,00%";"374";"374";"100,00%";"0";"0,00%";"323";"14";"4.33";"309";"95,67%";"4.33";4.330
"MULTIPOLYGON (((-58.423759604867 -34.6391685705002,-58.4234919060627 -34.6402003484821,-58.4249183723409 -34.6404400316581,-58.4250696076495 -34.6404659947288,-58.4261667706773 -34.6406514046021,-58.4267683081506 -34.6407529949692,-58.4274227587238 -34.6408635416297,-58.4274684208429 -34.6406867886822,-58.4276849610212 -34.6398236546895,-58.4279071300848 -34.6389374224664,-58.4279517637748 -34.6387698946347,-58.4267023721592 -34.6385456518759,-58.4265337593351 -34.6385153897589,-58.4254675554518 -34.6383265417719,-58.4252399024097 -34.6392268529029,-58.4251778758851 -34.6394045859704,-58.423759604867 -34.6391685705002)))";;"3056";7_24_11;COMUNA 7;"24";"11";"1040";"495";"545";"90,83%";"426";"425";"99,77%";"1";"0,24%";"371";"4";"1.08";"367";"98,92%";"1.08";1.080
"MULTIPOLYGON (((-58.4315921189475 -34.6332433041135,-58.4315658261659 -34.6333784426865,-58.4312833011159 -34.6347183436442,-58.4311025099692 -34.634688788937,-58.4301831356104 -34.6345376973028,-58.430016147417 -34.6345101869839,-58.4290828897935 -34.6343567593122,-58.4287827542018 -34.6355244607099,-58.4297708074202 -34.635686919836,-58.4310373819358 -34.6358951492845,-58.432305837177 -34.6361037181675,-58.4325520803619 -34.6349255720134,-58.4327384917517 -34.6340191094852,-58.4324666749727 -34.6338369237733,-58.4321084851701 -34.6335967561711,-58.4319164860559 -34.6334680416724,-58.4315921189475 -34.6332433041135)))";;"3057";7_24_2;COMUNA 7;"24";"2";"913";"443";"470";"94,26%";"331";"331";"100,00%";"0";"0,00%";"318";"45";"14.15";"273";"85,85%";"14.15";14.150
"MULTIPOLYGON (((-58.4281716820222 -34.6328151866405,-58.426934043628 -34.6326097528269,-58.4268891528436 -34.6327836890421,-58.4265905277761 -34.6339469490174,-58.4278292083528 -34.6341506259548,-58.4290828897935 -34.6343567593122,-58.430016147417 -34.6345101869839,-58.4301831356104 -34.6345376973028,-58.4311025099692 -34.634688788937,-58.4312833011159 -34.6347183436442,-58.4315658261659 -34.6333784426865,-58.4305426111216 -34.6332086645977,-58.4294259398227 -34.6330233589948,-58.4281716820222 -34.6328151866405)))";;"3058";7_24_3;COMUNA 7;"24";"3";"1214";"567";"647";"87,64%";"417";"417";"100,00%";"0";"0,00%";"384";"70";"18.23";"314";"81,77%";"18.23";18.230
"MULTIPOLYGON (((-58.426934043628 -34.6326097528269,-58.4255287524562 -34.6323652401014,-58.4254564608418 -34.6326473400172,-58.4252227733989 -34.6335487064905,-58.4251830856037 -34.6337010936469,-58.4250920248777 -34.6340322031961,-58.424859804032 -34.6348763842592,-58.4246737895358 -34.635654661547,-58.4245256133552 -34.6362239294624,-58.4243858777479 -34.6367774950642,-58.4242774850141 -34.6371706426394,-58.4240434301461 -34.6380744005023,-58.423759604867 -34.6391685705002,-58.4251778758851 -34.6394045859704,-58.4252399024097 -34.6392268529029,-58.4254675554518 -34.6383265417719,-58.4255185996938 -34.6381244382004,-58.4258050396639 -34.6370303351281,-58.4258571887213 -34.6368310486978,-58.4260892709413 -34.6359039759557,-58.4262549819356 -34.6359328997599,-58.4273231190651 -34.6361161779283,-58.4274856999539 -34.6354890919798,-58.4275294819318 -34.6353183948445,-58.4262907847333 -34.6351147148918,-58.4265905277761 -34.6339469490174,-58.4268891528436 -34.6327836890421,-58.426934043628 -34.6326097528269)))";;"3059";7_24_4;COMUNA 7;"24";"4";"1036";"488";"548";"89,05%";"471";"471";"100,00%";"0";"0,00%";"379";"32";"8.44";"347";"91,56%";"8.44";8.440
"MULTIPOLYGON (((-58.4278292083528 -34.6341506259548,-58.4265905277761 -34.6339469490174,-58.4262907847333 -34.6351147148918,-58.4275294819318 -34.6353183948445,-58.4274856999539 -34.6354890919798,-58.4273231190651 -34.6361161779283,-58.4262549819356 -34.6359328997599,-58.4260892709413 -34.6359039759557,-58.4258571887213 -34.6368310486978,-58.4258050396639 -34.6370303351281,-58.4255185996938 -34.6381244382004,-58.4254675554518 -34.6383265417719,-58.4265337593351 -34.6385153897589,-58.4267023721592 -34.6385456518759,-58.4279517637748 -34.6387698946347,-58.4280032247829 -34.638576241129,-58.4282819680654 -34.6374749467913,-58.4283272866026 -34.6372959397322,-58.4285753767799 -34.6363309782836,-58.4287827542018 -34.6355244607099,-58.4290828897935 -34.6343567593122,-58.4278292083528 -34.6341506259548)))";;"3060";7_24_5;COMUNA 7;"24";"5";"931";"441";"490";"90,00%";"396";"396";"100,00%";"0";"0,00%";"344";"18";"5.23";"326";"94,77%";"5.23";5.230
"MULTIPOLYGON (((-58.4285753767799 -34.6363309782836,-58.4283272866026 -34.6372959397322,-58.4282819680654 -34.6374749467913,-58.4280032247829 -34.638576241129,-58.4279517637748 -34.6387698946347,-58.4281213148593 -34.6388002959059,-58.4290816226778 -34.6389754291303,-58.4291208849911 -34.6388102234081,-58.4293310729909 -34.637796375412,-58.4293577940121 -34.637668280017,-58.4306201301009 -34.6378951047264,-58.4308645253499 -34.6367236522047,-58.4321309446462 -34.6369408846012,-58.432305837177 -34.6361037181675,-58.4310373819358 -34.6358951492845,-58.4297708074202 -34.635686919836,-58.4287827542018 -34.6355244607099,-58.4285753767799 -34.6363309782836)))";;"3061";7_24_6;COMUNA 7;"24";"6";"1059";"502";"557";"90,13%";"456";"456";"100,00%";"0";"0,00%";"371";"13";"3.5";"358";"96,50%";"3.5";3.500
"MULTIPOLYGON (((-58.4328885026023 -34.6376798282895,-58.4325916098436 -34.6382409001135,-58.4325426344219 -34.6388951342809,-58.4324968962335 -34.6395491578855,-58.4339237601283 -34.6396673235502,-58.4341575398452 -34.6390182733076,-58.4343891836953 -34.6383752081581,-58.4345821890768 -34.6378393905625,-58.434785852611 -34.6372742079111,-58.4351018327295 -34.6363970684232,-58.4336118739783 -34.6363133391939,-58.432305837177 -34.6361037181675,-58.4321309446462 -34.6369408846012,-58.4331840270878 -34.6371215019262,-58.4328885026023 -34.6376798282895)))";;"3062";7_24_7;COMUNA 7;"24";"7";"852";"416";"436";"95,41%";"294";"294";"100,00%";"0";"0,00%";"289";"18";"6.23";"271";"93,77%";"6.23";6.230
"MULTIPOLYGON (((-58.4306201301009 -34.6378951047264,-58.4305931548375 -34.6380244679731,-58.4305030954179 -34.6384537537507,-58.4303844375855 -34.63901916296,-58.4303471290189 -34.6392061308591,-58.4314051736746 -34.6393990891356,-58.431611026491 -34.6394285793406,-58.4318207988135 -34.6394587040135,-58.4323198401697 -34.6395283386003,-58.4324968962335 -34.6395491578855,-58.4325426344219 -34.6388951342809,-58.4325916098436 -34.6382409001135,-58.4328885026023 -34.6376798282895,-58.4331840270878 -34.6371215019262,-58.4321309446462 -34.6369408846012,-58.4308645253499 -34.6367236522047,-58.4306201301009 -34.6378951047264)))";;"3063";7_24_8;COMUNA 7;"24";"8";"877";"406";"471";"86,20%";"369";"369";"100,00%";"0";"0,00%";"331";"3";"0.91";"328";"99,09%";"0.91";0.910
"MULTIPOLYGON (((-58.4324968962335 -34.6395491578855,-58.4323198401697 -34.6395283386003,-58.4318207988135 -34.6394587040135,-58.431611026491 -34.6394285793406,-58.4314051736746 -34.6393990891356,-58.4303471290189 -34.6392061308591,-58.430170487168 -34.6400917458245,-58.4301412007842 -34.6402442780561,-58.4301120849599 -34.6403961764994,-58.4299564656456 -34.641114396952,-58.4299224010162 -34.6412814353217,-58.4301238277 -34.6413091662205,-58.4309236468991 -34.6414445927681,-58.4311582980382 -34.6414945848319,-58.431421663172 -34.6415507107652,-58.4321137773488 -34.6416940598292,-58.4323444260195 -34.6417412316153,-58.432516454141 -34.6417764162632,-58.4331204718743 -34.6418969905808,-58.4334841660447 -34.6408873985497,-58.4339237601283 -34.6396673235502,-58.4324968962335 -34.6395491578855)))";;"3064";7_24_9;COMUNA 7;"24";"9";"950";"443";"507";"87,38%";"383";"383";"100,00%";"0";"0,00%";"341";"9";"2.64";"332";"97,36%";"2.64";2.640
"MULTIPOLYGON (((-58.4687968379826 -34.617644895464,-58.4686352336432 -34.6175616610453,-58.4679607959446 -34.6172697098007,-58.4676872100775 -34.6177930497131,-58.4676252870478 -34.617920380682,-58.4674908784947 -34.6181966634157,-58.4672260620478 -34.6187404251255,-58.4671070681157 -34.6189843817439,-58.4669908843915 -34.6192225632865,-58.4666893489596 -34.6198449897587,-58.4666143043148 -34.6199827435008,-58.4670630882425 -34.6201720306852,-58.467235513842 -34.6202326603233,-58.4675856915495 -34.6196516405077,-58.4678084364441 -34.6192820409269,-58.4684258086213 -34.618258949264,-58.4687968379826 -34.617644895464)))";;"3065";7_3_1;COMUNA 7;"3";"1";"689";"319";"370";"86,22%";"371";"371";"100,00%";"0";"0,00%";"301";"9";"2.99";"292";"97,01%";"2.99";2.990
"MULTIPOLYGON (((-58.4651955801417 -34.6231051429905,-58.4649868583866 -34.6230451450082,-58.4637825808948 -34.6225889486706,-58.4637289971119 -34.6227168408873,-58.4634317698955 -34.6233858802421,-58.4632760410214 -34.6237345550715,-58.4634327105569 -34.6237894857009,-58.4643713688074 -34.6241085015159,-58.4646553190287 -34.6242049794854,-58.464838570782 -34.6242673024962,-58.4661152052222 -34.6246651744191,-58.4662050756089 -34.6244575591115,-58.4666360220125 -34.6234766671411,-58.4654221926708 -34.6231702108147,-58.4651955801417 -34.6231051429905)))";;"3066";7_3_10;COMUNA 7;"3";"10";"1062";"474";"588";"80,61%";"527";"526";"99,81%";"1";"0,19%";"425";"4";"0.94";"421";"99,06%";"0.94";0.940
"MULTIPOLYGON (((-58.4666516318934 -34.6167030489388,-58.4656774372922 -34.616281371434,-58.4653509451232 -34.6169603468122,-58.4648321919568 -34.6180221552146,-58.4656066358588 -34.618358559568,-58.4657834016723 -34.6184322198026,-58.4669469118877 -34.6189174836586,-58.4671070681157 -34.6189843817439,-58.4672260620478 -34.6187404251255,-58.4674908784947 -34.6181966634157,-58.4676252870478 -34.617920380682,-58.4676872100775 -34.6177930497131,-58.4679607959446 -34.6172697098007,-58.4667629714793 -34.6167512160106,-58.4666516318934 -34.6167030489388)))";;"3067";7_3_2;COMUNA 7;"3";"2";"953";"426";"527";"80,83%";"442";"442";"100,00%";"0";"0,00%";"381";"20";"5.25";"361";"94,75%";"5.25";5.250
"MULTIPOLYGON (((-58.4633649412528 -34.6186238834414,-58.4643402586457 -34.6190290293566,-58.4648321919568 -34.6180221552146,-58.4653509451232 -34.6169603468122,-58.4656774372922 -34.616281371434,-58.4655426727761 -34.6162229922839,-58.4645385893608 -34.6157877143089,-58.4644659265149 -34.6157617989626,-58.464373160063 -34.6157287004949,-58.463918455421 -34.616371123193,-58.4632397075447 -34.6173302467187,-58.4631235998863 -34.6174941966577,-58.4625523401755 -34.618286267606,-58.4633649412528 -34.6186238834414)))";;"3068";7_3_3;COMUNA 7;"3";"3";"1134";"519";"615";"84,39%";"580";"579";"99,83%";"1";"0,17%";"477";"47";"9.85";"430";"90,15%";"9.85";9.850
"MULTIPOLYGON (((-58.4671070681157 -34.6189843817439,-58.4669469118877 -34.6189174836586,-58.4657834016723 -34.6184322198026,-58.4656066358588 -34.618358559568,-58.4648321919568 -34.6180221552146,-58.4643402586457 -34.6190290293566,-58.4650820820821 -34.6193371969887,-58.4652859397028 -34.6194230409271,-58.4652097860913 -34.6195747379902,-58.4647355664978 -34.6205383017302,-58.4643076776206 -34.6214077750889,-58.465354423766 -34.6218729842587,-58.4659672496007 -34.6209671631854,-58.4665362780658 -34.6201259904376,-58.4666143043148 -34.6199827435008,-58.4666893489596 -34.6198449897587,-58.4669908843915 -34.6192225632865,-58.4671070681157 -34.6189843817439)))";;"3069";7_3_4;COMUNA 7;"3";"4";"1174";"553";"621";"89,05%";"395";"393";"99,49%";"2";"0,51%";"395";"38";"9.62";"357";"90,38%";"9.62";9.620
"MULTIPOLYGON (((-58.4627941903826 -34.6222124615111,-58.4636382661264 -34.6225343000853,-58.4637825808948 -34.6225889486706,-58.4649868583866 -34.6230451450082,-58.4651955801417 -34.6231051429905,-58.4656785970992 -34.6225171540598,-58.465990552576 -34.6221373441386,-58.4660606612393 -34.6220519871509,-58.4665626559464 -34.6213029321451,-58.4666317399136 -34.6211936303532,-58.4671602134978 -34.6203575970519,-58.467235513842 -34.6202326603233,-58.4670630882425 -34.6201720306852,-58.4666143043148 -34.6199827435008,-58.4665362780658 -34.6201259904376,-58.4659672496007 -34.6209671631854,-58.465354423766 -34.6218729842587,-58.4643076776206 -34.6214077750889,-58.4641795562607 -34.6216681378868,-58.4641098732043 -34.6218278625769,-58.4631797601324 -34.6214172921127,-58.4628439417371 -34.6221131622411,-58.4627941903826 -34.6222124615111)))";;"3070";7_3_5;COMUNA 7;"3";"5";"787";"369";"418";"88,28%";"390";"390";"100,00%";"0";"0,00%";"309";"1";"0.32";"308";"99,68%";"0.32";0.320
"MULTIPOLYGON (((-58.4625523401755 -34.618286267606,-58.4624281370304 -34.6184584565749,-58.4617953574875 -34.619335667541,-58.4616807776457 -34.6194945454634,-58.4627609641866 -34.6198629429251,-58.4637654269723 -34.6202055559338,-58.4637051998923 -34.6203287297728,-58.4631797601324 -34.6214172921127,-58.4641098732043 -34.6218278625769,-58.4641795562607 -34.6216681378868,-58.4643076776206 -34.6214077750889,-58.4647355664978 -34.6205383017302,-58.4652097860913 -34.6195747379902,-58.4652859397028 -34.6194230409271,-58.4650820820821 -34.6193371969887,-58.4643402586457 -34.6190290293566,-58.4633649412528 -34.6186238834414,-58.4625523401755 -34.618286267606)))";;"3071";7_3_6;COMUNA 7;"3";"6";"924";"408";"516";"79,07%";"370";"369";"99,73%";"1";"0,27%";"338";"9";"2.66";"329";"97,34%";"2.66";2.660
"MULTIPOLYGON (((-58.4610169725023 -34.6204235143546,-58.460510588646 -34.6211699408444,-58.4604174724023 -34.6213043100193,-58.4618000158657 -34.621833430978,-58.4627941903826 -34.6222124615111,-58.4628439417371 -34.6221131622411,-58.4631797601324 -34.6214172921127,-58.4637051998923 -34.6203287297728,-58.4637654269723 -34.6202055559338,-58.4627609641866 -34.6198629429251,-58.4616807776457 -34.6194945454634,-58.4610169725023 -34.6204235143546)))";;"3072";7_3_7;COMUNA 7;"3";"7";"1170";"558";"612";"91,18%";"501";"501";"100,00%";"0";"0,00%";"448";"34";"7.59";"414";"92,41%";"7.59";7.590
"MULTIPOLYGON (((-58.4618000158657 -34.621833430978,-58.4604174724023 -34.6213043100193,-58.4596217550307 -34.6224522901827,-58.4601765995134 -34.6226470279786,-58.4612021272794 -34.6230068460641,-58.4618000158657 -34.621833430978)))";;"3073";7_3_8;COMUNA 7;"3";"8";"736";"302";"434";"69,59%";"363";"362";"99,72%";"1";"0,28%";"307";"13";"4.23";"294";"95,77%";"4.23";4.230
"MULTIPOLYGON (((-58.4627941903826 -34.6222124615111,-58.4618000158657 -34.621833430978,-58.4612021272794 -34.6230068460641,-58.4622179520133 -34.6233632750705,-58.4632760410214 -34.6237345550715,-58.4634317698955 -34.6233858802421,-58.4637289971119 -34.6227168408873,-58.4637825808948 -34.6225889486706,-58.4636382661264 -34.6225343000853,-58.4627941903826 -34.6222124615111)))";;"3074";7_3_9;COMUNA 7;"3";"9";"711";"338";"373";"90,62%";"323";"323";"100,00%";"0";"0,00%";"273";"31";"11.36";"242";"88,64%";"11.36";11.360
"MULTIPOLYGON (((-58.462696135867 -34.6159596357161,-58.4626317362098 -34.6160996406977,-58.4622175627803 -34.6170165738421,-58.4632397075447 -34.6173302467187,-58.463918455421 -34.616371123193,-58.464373160063 -34.6157287004949,-58.464134812804 -34.615643630065,-58.4632040875209 -34.6152983434062,-58.4630301417298 -34.615233200821,-58.4629624210426 -34.6153806710589,-58.462696135867 -34.6159596357161)))";;"3075";7_4_1;COMUNA 7;"4";"1";"1069";"496";"573";"86,56%";"651";"651";"100,00%";"0";"0,00%";"534";"88";"16.48";"446";"83,52%";"16.48";16.480
"MULTIPOLYGON (((-58.4590680822505 -34.6208429936081,-58.4584985145994 -34.6206483206319,-58.4566230321572 -34.6200070924132,-58.4560760254784 -34.6212043593208,-58.4577147041089 -34.6217901619146,-58.4582734582375 -34.621989908721,-58.4590680822505 -34.6208429936081)))";;"3076";7_4_10;COMUNA 7;"4";"10";"928";"428";"500";"85,60%";"485";"483";"99,59%";"2";"0,41%";"365";"2";"0.55";"363";"99,45%";"0.55";0.550
"MULTIPOLYGON (((-58.4615081574205 -34.6155602494147,-58.4614503155111 -34.6156841265082,-58.46106867361 -34.6165143629137,-58.4610088709745 -34.6166456343818,-58.4622175627803 -34.6170165738421,-58.4626317362098 -34.6160996406977,-58.462696135867 -34.6159596357161,-58.4629624210426 -34.6153806710589,-58.4630301417298 -34.615233200821,-58.4618649163803 -34.6147967038733,-58.4615081574205 -34.6155602494147)))";;"3077";7_4_2;COMUNA 7;"4";"2";"770";"356";"414";"85,99%";"381";"381";"100,00%";"0";"0,00%";"334";"0";"0";"334";"100,00%";"0";0.000
"MULTIPOLYGON (((-58.4618649163803 -34.6147967038733,-58.4606674191903 -34.6143480116946,-58.4603934737136 -34.6142453974951,-58.4594483842544 -34.6138856446923,-58.4590330824291 -34.6147344662902,-58.4602965945919 -34.6151559917275,-58.4597790642947 -34.6162682033157,-58.4610088709745 -34.6166456343818,-58.46106867361 -34.6165143629137,-58.4614503155111 -34.6156841265082,-58.4615081574205 -34.6155602494147,-58.4618649163803 -34.6147967038733)))";;"3078";7_4_3;COMUNA 7;"4";"3";"1012";"450";"562";"80,07%";"549";"549";"100,00%";"0";"0,00%";"450";"3";"0.67";"447";"99,33%";"0.67";0.670
"MULTIPOLYGON (((-58.4602965945919 -34.6151559917275,-58.4590330824291 -34.6147344662902,-58.458499179768 -34.6159004767722,-58.4587192093546 -34.6159429504565,-58.4597790642947 -34.6162682033157,-58.4602965945919 -34.6151559917275)))";;"3079";7_4_4;COMUNA 7;"4";"4";"1302";"571";"731";"78,11%";"683";"683";"100,00%";"0";"0,00%";"560";"0";"0";"560";"100,00%";"0";0.000
"MULTIPOLYGON (((-58.4581986131446 -34.6165606304541,-58.4577657312247 -34.6175060698609,-58.457978777017 -34.6175907291815,-58.4589534578867 -34.6180394408741,-58.4591937649284 -34.6181500857344,-58.4602281744264 -34.618623437661,-58.460280824237 -34.618483574624,-58.4605437310129 -34.6177410180747,-58.4605828343763 -34.6176305218853,-58.4606152934067 -34.6175083350124,-58.4610088709745 -34.6166456343818,-58.4597790642947 -34.6162682033157,-58.4587192093546 -34.6159429504565,-58.458499179768 -34.6159004767722,-58.4581986131446 -34.6165606304541)))";;"3080";7_4_5;COMUNA 7;"4";"5";"833";"364";"469";"77,61%";"489";"489";"100,00%";"0";"0,00%";"397";"0";"0";"397";"100,00%";"0";0.000
"MULTIPOLYGON (((-58.4610745879441 -34.6190087471505,-58.4617953574875 -34.619335667541,-58.4624281370304 -34.6184584565749,-58.4625523401755 -34.618286267606,-58.4631235998863 -34.6174941966577,-58.4632397075447 -34.6173302467187,-58.4622175627803 -34.6170165738421,-58.4610088709745 -34.6166456343818,-58.4606152934067 -34.6175083350124,-58.4605828343763 -34.6176305218853,-58.4605437310129 -34.6177410180747,-58.460280824237 -34.618483574624,-58.4602281744264 -34.618623437661,-58.4605799087028 -34.6187843654508,-58.4610745879441 -34.6190087471505)))";;"3081";7_4_6;COMUNA 7;"4";"6";"1174";"550";"624";"88,14%";"439";"439";"100,00%";"0";"0,00%";"436";"5";"1.15";"431";"98,85%";"1.15";1.150
"MULTIPOLYGON (((-58.4610745879441 -34.6190087471505,-58.4605799087028 -34.6187843654508,-58.4602281744264 -34.618623437661,-58.4598158300204 -34.6197180446058,-58.4597465674116 -34.6198429064864,-58.4596905097044 -34.6199438241498,-58.4591221809819 -34.6207648234619,-58.4590680822505 -34.6208429936081,-58.4582734582375 -34.621989908721,-58.4594359549645 -34.6224019314944,-58.4596217550307 -34.6224522901827,-58.4604174724023 -34.6213043100193,-58.460510588646 -34.6211699408444,-58.4610169725023 -34.6204235143546,-58.4616807776457 -34.6194945454634,-58.4617953574875 -34.619335667541,-58.4610745879441 -34.6190087471505)))";;"3082";7_4_7;COMUNA 7;"4";"7";"1191";"561";"630";"89,05%";"501";"501";"100,00%";"0";"0,00%";"472";"2";"0.42";"470";"99,58%";"0.42";0.420
"MULTIPOLYGON (((-58.4602281744264 -34.618623437661,-58.4591937649284 -34.6181500857344,-58.4589534578867 -34.6180394408741,-58.457978777017 -34.6175907291815,-58.4577657312247 -34.6175060698609,-58.4572947553077 -34.6185368610292,-58.4572246361539 -34.6186903140222,-58.4583996830386 -34.6192272814298,-58.4592224974574 -34.619603377221,-58.4597465674116 -34.6198429064864,-58.4598158300204 -34.6197180446058,-58.4602281744264 -34.618623437661)))";;"3083";7_4_8;COMUNA 7;"4";"8";"951";"429";"522";"82,18%";"338";"338";"100,00%";"0";"0,00%";"396";"1";"0.25";"395";"99,75%";"0.25";0.250
"MULTIPOLYGON (((-58.4597465674116 -34.6198429064864,-58.4592224974574 -34.619603377221,-58.4583996830386 -34.6192272814298,-58.4572246361539 -34.6186903140222,-58.4566230321572 -34.6200070924132,-58.4584985145994 -34.6206483206319,-58.4590680822505 -34.6208429936081,-58.4591221809819 -34.6207648234619,-58.4596905097044 -34.6199438241498,-58.4597465674116 -34.6198429064864)))";;"3084";7_4_9;COMUNA 7;"4";"9";"612";"292";"320";"91,25%";"264";"264";"100,00%";"0";"0,00%";"223";"15";"6.73";"208";"93,27%";"6.73";6.730
"MULTIPOLYGON (((-58.4594501109934 -34.6264055200697,-58.4593721513551 -34.6265553117934,-58.4588540322439 -34.6275487105237,-58.4596870704835 -34.6278912807336,-58.4598574618367 -34.6279555827691,-58.4604192768273 -34.6269676033867,-58.4605050731109 -34.6268125292757,-58.460576981568 -34.6266825261337,-58.4607314484376 -34.6263708984124,-58.4607438023295 -34.6263459681855,-58.4608090648434 -34.6262139224669,-58.460727618949 -34.6261893428755,-58.4602241207468 -34.6260396807101,-58.4599671755272 -34.6259622077953,-58.4597918465478 -34.6259071314412,-58.4597255661772 -34.6258751569218,-58.4596552755901 -34.6260106527644,-58.4595290927651 -34.626253826846,-58.4594501109934 -34.6264055200697)))";;"3085";7_5_1;COMUNA 7;"5";"1";"746";"324";"422";"76,78%";"444";"444";"100,00%";"0";"0,00%";"341";"1";"0.29";"340";"99,71%";"0.29";0.290
"MULTIPOLYGON (((-58.4584264254577 -34.6260029395836,-58.4578380892681 -34.6271309840608,-58.4588540322439 -34.6275487105237,-58.4593721513551 -34.6265553117934,-58.4594501109934 -34.6264055200697,-58.4595290927651 -34.626253826846,-58.4596552755901 -34.6260106527644,-58.4597255661772 -34.6258751569218,-58.4599923275101 -34.6253614131995,-58.4600524782949 -34.6252452837882,-58.459886266581 -34.6251885879872,-58.4590089520612 -34.6248859486005,-58.4586755582453 -34.6255251852779,-58.4586113156601 -34.6256483563617,-58.4584264254577 -34.6260029395836)))";;"3086";7_5_2;COMUNA 7;"5";"2";"648";"260";"388";"67,01%";"313";"311";"99,36%";"2";"0,64%";"243";"0";"0";"243";"100,00%";"0";0.000
"MULTIPOLYGON (((-58.458142463273 -34.6245869653916,-58.4579600673249 -34.6245322382529,-58.456801894033 -34.6241059759255,-58.4564500090426 -34.6246167505962,-58.4564839149704 -34.6246309077439,-58.4565156909897 -34.6246461915734,-58.4566083787728 -34.6246830989114,-58.4568971761903 -34.6248055819793,-58.4576322936447 -34.6251063292597,-58.4577485802332 -34.6251588710445,-58.4576475312812 -34.6253055620596,-58.4575244295197 -34.625245061872,-58.4570143872237 -34.6250311586064,-58.4567105953187 -34.624900857916,-58.4564228201579 -34.6247785153108,-58.4563544119775 -34.6247486515928,-58.4561149908393 -34.6250933690219,-58.4574355488489 -34.6256133100895,-58.4567097868419 -34.6266670448897,-58.4578380892681 -34.6271309840608,-58.4584264254577 -34.6260029395836,-58.4586113156601 -34.6256483563617,-58.4586755582453 -34.6255251852779,-58.4590089520612 -34.6248859486005,-58.458142463273 -34.6245869653916)))";;"3087";7_5_3;COMUNA 7;"5";"3";"866";"377";"489";"77,10%";"459";"455";"99,13%";"4";"0,88%";"328";"7";"2.13";"321";"97,87%";"2.13";2.130
"MULTIPOLYGON (((-58.4574355488489 -34.6256133100895,-58.4561149908393 -34.6250933690219,-58.4553769478836 -34.6261551237599,-58.4567097868419 -34.6266670448897,-58.4574355488489 -34.6256133100895)))";;"3088";7_5_4;COMUNA 7;"5";"4";"1024";"444";"580";"76,55%";"614";"614";"100,00%";"0";"0,00%";"457";"5";"1.09";"452";"98,91%";"1.09";1.090
"MULTIPOLYGON (((-58.4575577073079 -34.6230194937929,-58.4582734582375 -34.621989908721,-58.4577147041089 -34.6217901619146,-58.4560760254784 -34.6212043593208,-58.4555578030921 -34.6223386652984,-58.4550485988027 -34.6234531095886,-58.4548301211898 -34.6239267739823,-58.4547625602595 -34.6240731171022,-58.4547625494278 -34.6240731126674,-58.4545749150793 -34.624479874854,-58.4540312622009 -34.625631003598,-58.4553769478836 -34.6261551237599,-58.4561149908393 -34.6250933690219,-58.4563544119775 -34.6247486515928,-58.4564228201579 -34.6247785153108,-58.4567105953187 -34.624900857916,-58.4570143872237 -34.6250311586064,-58.4575244295197 -34.625245061872,-58.4576475312812 -34.6253055620596,-58.4577485802332 -34.6251588710445,-58.4576322936447 -34.6251063292597,-58.4568971761903 -34.6248055819793,-58.4566083787728 -34.6246830989114,-58.4565156909897 -34.6246461915734,-58.4564839149704 -34.6246309077439,-58.4564500090426 -34.6246167505962,-58.456801894033 -34.6241059759255,-58.4575577073079 -34.6230194937929)))";;"3089";7_5_5;COMUNA 7;"5";"5";"1129";"527";"602";"87,54%";"544";"544";"100,00%";"0";"0,00%";"462";"6";"1.3";"456";"98,70%";"1.3";1.300
"MULTIPOLYGON (((-58.4596171930278 -34.6237196578099,-58.458916666378 -34.6234694886255,-58.4587482446414 -34.6233988470458,-58.4575577073079 -34.6230194937929,-58.456801894033 -34.6241059759255,-58.4579600673249 -34.6245322382529,-58.458142463273 -34.6245869653916,-58.4590089520612 -34.6248859486005,-58.4596171930278 -34.6237196578099)))";;"3090";7_5_6;COMUNA 7;"5";"6";"640";"281";"359";"78,27%";"324";"323";"99,69%";"1";"0,31%";"269";"21";"7.81";"248";"92,19%";"7.81";7.810
"MULTIPOLYGON (((-58.4601765995134 -34.6226470279786,-58.4596217550307 -34.6224522901827,-58.4594359549645 -34.6224019314944,-58.4582734582375 -34.621989908721,-58.4575577073079 -34.6230194937929,-58.4587482446414 -34.6233988470458,-58.458916666378 -34.6234694886255,-58.4596171930278 -34.6237196578099,-58.4601765995134 -34.6226470279786)))";;"3091";7_5_7;COMUNA 7;"5";"7";"660";"290";"370";"78,38%";"311";"311";"100,00%";"0";"0,00%";"269";"0";"0";"269";"100,00%";"0";0.000
"MULTIPOLYGON (((-58.4596171930278 -34.6237196578099,-58.4590089520612 -34.6248859486005,-58.459886266581 -34.6251885879872,-58.4600524782949 -34.6252452837882,-58.4605828373492 -34.6242225125976,-58.460646479617 -34.6240975093876,-58.4612021272794 -34.6230068460641,-58.4601765995134 -34.6226470279786,-58.4596171930278 -34.6237196578099)))";;"3092";7_5_8;COMUNA 7;"5";"8";"740";"300";"440";"68,18%";"415";"415";"100,00%";"0";"0,00%";"345";"14";"4.06";"331";"95,94%";"4.06";4.060
"MULTIPOLYGON (((-58.4600524782949 -34.6252452837882,-58.4599923275101 -34.6253614131995,-58.4597255661772 -34.6258751569218,-58.4597918465478 -34.6259071314412,-58.4599671755272 -34.6259622077953,-58.4602241207468 -34.6260396807101,-58.460727618949 -34.6261893428755,-58.4608090648434 -34.6262139224669,-58.4611094742282 -34.6256055961533,-58.4621763618782 -34.6259689276532,-58.4622680313262 -34.626000900933,-58.4626993728128 -34.6250345306583,-58.4627729801562 -34.6248679756356,-58.4622398391279 -34.6246796584744,-58.4616696416694 -34.6244714788331,-58.4607464952131 -34.6241343432829,-58.460646479617 -34.6240975093876,-58.4605828373492 -34.6242225125976,-58.4600524782949 -34.6252452837882)))";;"3093";7_5_9;COMUNA 7;"5";"9";"1098";"501";"597";"83,92%";"493";"492";"99,80%";"1";"0,20%";"460";"134";"29.13";"326";"70,87%";"29.13";29.130
"MULTIPOLYGON (((-58.4632760410214 -34.6237345550715,-58.4622179520133 -34.6233632750705,-58.4612021272794 -34.6230068460641,-58.460646479617 -34.6240975093876,-58.4607464952131 -34.6241343432829,-58.4616696416694 -34.6244714788331,-58.4622398391279 -34.6246796584744,-58.4627729801562 -34.6248679756356,-58.4630745627283 -34.6241857685685,-58.4632760410214 -34.6237345550715)))";;"3094";7_6_1;COMUNA 7;"6";"1";"927";"410";"517";"79,30%";"457";"456";"99,78%";"1";"0,22%";"372";"44";"11.83";"328";"88,17%";"11.83";11.830
"MULTIPOLYGON (((-58.4643713688074 -34.6241085015159,-58.4634327105569 -34.6237894857009,-58.4632760410214 -34.6237345550715,-58.4630745627283 -34.6241857685685,-58.4627729801562 -34.6248679756356,-58.4629380004865 -34.6249262872823,-58.4641919735423 -34.6252815722415,-58.4646553190287 -34.6242049794854,-58.4643713688074 -34.6241085015159)))";;"3095";7_6_2;COMUNA 7;"6";"2";"801";"355";"446";"79,60%";"300";"298";"99,33%";"2";"0,67%";"299";"4";"1.34";"295";"98,66%";"1.34";1.340
"MULTIPOLYGON (((-58.4661152052222 -34.6246651744191,-58.464838570782 -34.6242673024962,-58.4646553190287 -34.6242049794854,-58.4641919735423 -34.6252815722415,-58.4654213358581 -34.6256298727715,-58.4656640576013 -34.6257064190239,-58.4661152052222 -34.6246651744191)))";;"3096";7_6_3;COMUNA 7;"6";"3";"631";"301";"330";"91,21%";"283";"283";"100,00%";"0";"0,00%";"243";"58";"23.87";"185";"76,13%";"23.87";23.870
"MULTIPOLYGON (((-58.4656640576013 -34.6257064190239,-58.4654213358581 -34.6256298727715,-58.4641919735423 -34.6252815722415,-58.4637565592944 -34.6262934422966,-58.4637061251436 -34.6264071085622,-58.4638378374546 -34.6264397141475,-58.4651765225888 -34.626828510342,-58.4652387111672 -34.6266882226098,-58.4656640576013 -34.6257064190239)))";;"3097";7_6_4;COMUNA 7;"6";"4";"834";"391";"443";"88,26%";"333";"329";"98,80%";"4";"1,22%";"305";"57";"18.69";"248";"81,31%";"18.69";18.690
"MULTIPOLYGON (((-58.4641919735423 -34.6252815722415,-58.4629380004865 -34.6249262872823,-58.4627729801562 -34.6248679756356,-58.4626993728128 -34.6250345306583,-58.4622680313262 -34.626000900933,-58.4627607132163 -34.6261728793725,-58.4637061251436 -34.6264071085622,-58.4637565592944 -34.6262934422966,-58.4641919735423 -34.6252815722415)))";;"3098";7_6_5;COMUNA 7;"6";"5";"899";"396";"503";"78,73%";"493";"492";"99,80%";"1";"0,20%";"414";"98";"23.67";"316";"76,33%";"23.67";23.670
"MULTIPOLYGON (((-58.4634744006537 -34.6271181907368,-58.4638295842793 -34.6272342482359,-58.4638840248083 -34.6272497412022,-58.4639683693653 -34.6272760792747,-58.4642159506299 -34.627345867545,-58.4647866845795 -34.6275256539342,-58.4648581648947 -34.6275463576163,-58.464858529729 -34.6275464681111,-58.464913029076 -34.6274229979284,-58.4649129429171 -34.6274229721781,-58.4651765225888 -34.626828510342,-58.4638378374546 -34.6264397141475,-58.4637061251436 -34.6264071085622,-58.4627607132163 -34.6261728793725,-58.4622680313262 -34.626000900933,-58.4621763618782 -34.6259689276532,-58.4611094742282 -34.6256055961533,-58.4608090648434 -34.6262139224669,-58.4607438023295 -34.6263459681855,-58.460818603099 -34.6263730125357,-58.4610248595137 -34.6264335105581,-58.461358738306 -34.626528095367,-58.4618913783463 -34.6266800066315,-58.4618993016989 -34.6266625413017,-58.4619690268235 -34.6266834430084,-58.461969076644 -34.6266834579433,-58.4620329730218 -34.6267179665238,-58.4622026823132 -34.6267668422329,-58.4625552216267 -34.6268691001533,-58.4627015026929 -34.6269079043729,-58.4633204513433 -34.627095444367,-58.4633316970455 -34.6270737534331,-58.4634003731581 -34.6270956035423,-58.4634005355471 -34.6270956552082,-58.4634744006537 -34.6271181907368)))";;"3099";7_6_6;COMUNA 7;"6";"6";"908";"414";"494";"83,81%";"435";"435";"100,00%";"0";"0,00%";"394";"13";"3.3";"381";"96,70%";"3.3";3.300
"MULTIPOLYGON (((-58.4634005355471 -34.6270956552082,-58.4634003731581 -34.6270956035423,-58.4633316970455 -34.6270737534331,-58.4633204513433 -34.627095444367,-58.4627015026929 -34.6269079043729,-58.4625552216267 -34.6268691001533,-58.4622026823132 -34.6267668422329,-58.4620329730218 -34.6267179665238,-58.461969076644 -34.6266834579433,-58.4619690268235 -34.6266834430084,-58.4618993016989 -34.6266625413017,-58.4618913783463 -34.6266800066315,-58.461358738306 -34.626528095367,-58.4610248595137 -34.6264335105581,-58.460818603099 -34.6263730125357,-58.4607438023295 -34.6263459681855,-58.4607314484376 -34.6263708984124,-58.460576981568 -34.6266825261337,-58.4605050731109 -34.6268125292757,-58.4606813414707 -34.6268737315805,-58.4617416837549 -34.6272050233592,-58.46191505725 -34.6272592517874,-58.4631756213646 -34.6276479285113,-58.4633871648723 -34.6277131409752,-58.4646442479344 -34.6280287014543,-58.4648581648947 -34.6275463576163,-58.4647866845795 -34.6275256539342,-58.4642159506299 -34.627345867545,-58.4639683693653 -34.6272760792747,-58.4638840248083 -34.6272497412022,-58.4638295842793 -34.6272342482359,-58.4634744006537 -34.6271181907368,-58.4634005355471 -34.6270956552082)))";;"3100";7_6_7;COMUNA 7;"6";"7";"869";"390";"479";"81,42%";"499";"499";"100,00%";"0";"0,00%";"379";"2";"0.53";"377";"99,47%";"0.53";0.530
"MULTIPOLYGON (((-58.4646442479344 -34.6280287014543,-58.4633871648723 -34.6277131409752,-58.4631756213646 -34.6276479285113,-58.46191505725 -34.6272592517874,-58.4617416837549 -34.6272050233592,-58.4616754845374 -34.6273571406496,-58.461206971522 -34.6284156926904,-58.4613869073369 -34.6284729502096,-58.4627118968538 -34.6288497305166,-58.4632425094463 -34.6290014245487,-58.4635405325935 -34.6290872003875,-58.4641120435356 -34.6292517076738,-58.464168186535 -34.6291046598226,-58.4646442479344 -34.6280287014543)))";;"3101";7_6_8;COMUNA 7;"6";"8";"439";"202";"237";"85,23%";"239";"239";"100,00%";"0";"0,00%";"185";"1";"0.54";"184";"99,46%";"0.54";0.540
"MULTIPOLYGON (((-58.4617416837549 -34.6272050233592,-58.4606813414707 -34.6268737315805,-58.4605050731109 -34.6268125292757,-58.4604192768273 -34.6269676033867,-58.4598574618367 -34.6279555827691,-58.4600185671035 -34.6280163631165,-58.4609886974402 -34.6283463212891,-58.461206971522 -34.6284156926904,-58.4616754845374 -34.6273571406496,-58.4617416837549 -34.6272050233592)))";;"3102";7_6_9;COMUNA 7;"6";"9";"687";"282";"405";"69,63%";"352";"351";"99,72%";"1";"0,28%";"289";"22";"7.61";"267";"92,39%";"7.61";7.610
"MULTIPOLYGON (((-58.4697877545489 -34.6270098145915,-58.469333486978 -34.6280402975354,-58.470415346657 -34.6283548923997,-58.4706595285694 -34.6284240339693,-58.4711044134203 -34.6274250267384,-58.4714472477121 -34.6266551173761,-58.4715756921294 -34.6263695350099,-58.4704363436878 -34.6260161498537,-58.4702512952103 -34.6259582017278,-58.4697877545489 -34.6270098145915)))";;"3103";7_7_1;COMUNA 7;"7";"1";"641";"285";"356";"80,06%";"314";"313";"99,68%";"1";"0,32%";"245";"3";"1.22";"242";"98,78%";"1.22";1.220
"MULTIPOLYGON (((-58.4680219339969 -34.6288810239231,-58.4674569793235 -34.6287380142867,-58.4660752298532 -34.628388189416,-58.465519871528 -34.6296516966579,-58.4669095635261 -34.6300096263348,-58.467081497309 -34.63005384711,-58.4674445354182 -34.6301458788573,-58.4680219339969 -34.6288810239231)))";;"3104";7_7_10;COMUNA 7;"7";"10";"789";"354";"435";"81,38%";"430";"430";"100,00%";"0";"0,00%";"355";"3";"0.85";"352";"99,15%";"0.85";0.850
"MULTIPOLYGON (((-58.4660752298532 -34.628388189416,-58.4659004885316 -34.6283439672839,-58.4646442479344 -34.6280287014543,-58.464168186535 -34.6291046598226,-58.4641120435356 -34.6292517076738,-58.4653436794389 -34.6296062765476,-58.465519871528 -34.6296516966579,-58.4660752298532 -34.628388189416)))";;"3105";7_7_11;COMUNA 7;"7";"11";"613";"244";"369";"66,12%";"354";"354";"100,00%";"0";"0,00%";"282";"0";"0";"282";"100,00%";"0";0.000
"MULTIPOLYGON (((-58.4702512952103 -34.6259582017278,-58.4688678700319 -34.625524884455,-58.4684070404286 -34.6265743088375,-58.4685801614155 -34.6266293024839,-58.4697877545489 -34.6270098145915,-58.4702512952103 -34.6259582017278)))";;"3106";7_7_2;COMUNA 7;"7";"2";"586";"268";"318";"84,28%";"239";"237";"99,16%";"2";"0,84%";"204";"2";"0.98";"202";"99,02%";"0.98";0.980
"MULTIPOLYGON (((-58.4688678700319 -34.625524884455,-58.4677323782063 -34.6251692201989,-58.4675249270972 -34.6251045784812,-58.4670674904461 -34.6261489975715,-58.4672646350592 -34.6262111051446,-58.4684070404286 -34.6265743088375,-58.4688678700319 -34.625524884455)))";;"3107";7_7_3;COMUNA 7;"7";"3";"958";"425";"533";"79,74%";"464";"464";"100,00%";"0";"0,00%";"409";"1";"0.24";"408";"99,76%";"0.24";0.240
"MULTIPOLYGON (((-58.4675249270972 -34.6251045784812,-58.4661152052222 -34.6246651744191,-58.4656640576013 -34.6257064190239,-58.4670674904461 -34.6261489975715,-58.4675249270972 -34.6251045784812)))";;"3108";7_7_4;COMUNA 7;"7";"4";"639";"301";"338";"89,05%";"287";"285";"99,30%";"2";"0,70%";"266";"51";"19.17";"215";"80,83%";"19.17";19.170
"MULTIPOLYGON (((-58.4670674904461 -34.6261489975715,-58.4656640576013 -34.6257064190239,-58.4652387111672 -34.6266882226098,-58.4651765225888 -34.626828510342,-58.4653321765385 -34.6268737903096,-58.4665854232912 -34.6272496146421,-58.4670674904461 -34.6261489975715)))";;"3109";7_7_5;COMUNA 7;"7";"5";"637";"302";"335";"90,15%";"292";"291";"99,66%";"1";"0,34%";"287";"113";"39.37";"174";"60,63%";"39.37";39.370
"MULTIPOLYGON (((-58.4697877545489 -34.6270098145915,-58.4685801614155 -34.6266293024839,-58.4684070404286 -34.6265743088375,-58.4672646350592 -34.6262111051446,-58.4670674904461 -34.6261489975715,-58.4665854232912 -34.6272496146421,-58.4667209722737 -34.6272902454283,-58.4679392993021 -34.6276395772022,-58.4690775497195 -34.6279658720535,-58.469333486978 -34.6280402975354,-58.4697877545489 -34.6270098145915)))";;"3110";7_7_6;COMUNA 7;"7";"6";"959";"455";"504";"90,28%";"451";"450";"99,78%";"1";"0,22%";"365";"22";"6.03";"343";"93,97%";"6.03";6.030
"MULTIPOLYGON (((-58.4649458320911 -34.6275493138802,-58.4653574199088 -34.6276714928383,-58.4657861336471 -34.627798599717,-58.4661999397187 -34.6279368326511,-58.4662644344911 -34.6279550708359,-58.4666587302668 -34.6280693767175,-58.4668816091706 -34.6281301275699,-58.4675542512936 -34.6283305319483,-58.4676273516674 -34.6283501071417,-58.467627824971 -34.6283502408459,-58.4677011337297 -34.6283709499117,-58.467873406106 -34.6284274939275,-58.4680459341591 -34.6284817136663,-58.4681584823332 -34.6285189634572,-58.4683328850007 -34.6285716333575,-58.4684126315832 -34.6285971938894,-58.4687933879125 -34.6287165456759,-58.4688721121215 -34.6287383030131,-58.4689359265438 -34.6287568919418,-58.4690080904522 -34.6287766072041,-58.4690643965122 -34.6286508254009,-58.469133408049 -34.6286705407538,-58.4698564126591 -34.6288805779634,-58.469845169341 -34.6289131149271,-58.4703721322247 -34.6290693557745,-58.4704378061731 -34.6289218818843,-58.4706595285694 -34.6284240339693,-58.470415346657 -34.6283548923997,-58.469333486978 -34.6280402975354,-58.4690775497195 -34.6279658720535,-58.4679392993021 -34.6276395772022,-58.4667209722737 -34.6272902454283,-58.4665854232912 -34.6272496146421,-58.4653321765385 -34.6268737903096,-58.4651765225888 -34.626828510342,-58.4649129429171 -34.6274229721781,-58.464913029076 -34.6274229979284,-58.464858529729 -34.6275464681111,-58.4649362906472 -34.6275700189812,-58.4649458320911 -34.6275493138802)))";;"3111";7_7_7;COMUNA 7;"7";"7";"665";"301";"364";"82,69%";"277";"275";"99,28%";"2";"0,73%";"248";"12";"4.84";"236";"95,16%";"4.84";4.840
"MULTIPOLYGON (((-58.4649458320911 -34.6275493138802,-58.4649362906472 -34.6275700189812,-58.464858529729 -34.6275464681111,-58.4648581648947 -34.6275463576163,-58.4646442479344 -34.6280287014543,-58.4659004885316 -34.6283439672839,-58.4660752298532 -34.628388189416,-58.4674569793235 -34.6287380142867,-58.4676273516674 -34.6283501071417,-58.4675542512936 -34.6283305319483,-58.4668816091706 -34.6281301275699,-58.4666587302668 -34.6280693767175,-58.4662644344911 -34.6279550708359,-58.4661999397187 -34.6279368326511,-58.4657861336471 -34.627798599717,-58.4653574199088 -34.6276714928383,-58.4649458320911 -34.6275493138802)))";;"3112";7_7_8;COMUNA 7;"7";"8";"506";"231";"275";"84,00%";"282";"282";"100,00%";"0";"0,00%";"220";"9";"4.09";"211";"95,91%";"4.09";4.090
"MULTIPOLYGON (((-58.4702094370163 -34.6294348006928,-58.4703177018923 -34.6291916168106,-58.4703721322247 -34.6290693557745,-58.469845169341 -34.6289131149271,-58.4698564126591 -34.6288805779634,-58.469133408049 -34.6286705407538,-58.4690643965122 -34.6286508254009,-58.4690080904522 -34.6287766072041,-58.4689359265438 -34.6287568919418,-58.4688721121215 -34.6287383030131,-58.4687933879125 -34.6287165456759,-58.4684126315832 -34.6285971938894,-58.4683328850007 -34.6285716333575,-58.4681584823332 -34.6285189634572,-58.4680459341591 -34.6284817136663,-58.467873406106 -34.6284274939275,-58.4677011337297 -34.6283709499117,-58.467627824971 -34.6283502408459,-58.4676273516674 -34.6283501071417,-58.4674569793235 -34.6287380142867,-58.4680219339969 -34.6288810239231,-58.4674445354182 -34.6301458788573,-58.4683036123636 -34.6303636665884,-58.469639651188 -34.6307070600452,-58.4702094370163 -34.6294348006928)))";;"3113";7_7_9;COMUNA 7;"7";"9";"936";"418";"518";"80,69%";"521";"521";"100,00%";"0";"0,00%";"410";"80";"19.51";"330";"80,49%";"19.51";19.510
"MULTIPOLYGON (((-58.469639651188 -34.6307070600452,-58.4683036123636 -34.6303636665884,-58.4676920494571 -34.6317471194319,-58.4687917601306 -34.6320897568673,-58.4689913059796 -34.6321553827115,-58.469639651188 -34.6307070600452)))";;"3114";7_8_1;COMUNA 7;"8";"1";"682";"295";"387";"76,23%";"404";"403";"99,75%";"1";"0,25%";"326";"24";"7.36";"302";"92,64%";"7.36";7.360
"MULTIPOLYGON (((-58.4663302680012 -34.6313240549379,-58.4657915049836 -34.6324984748656,-58.4671771596192 -34.6329249952365,-58.4676382098168 -34.6318688157957,-58.4676920494571 -34.6317471194319,-58.4683036123636 -34.6303636665884,-58.4674445354182 -34.6301458788573,-58.467081497309 -34.63005384711,-58.4669095635261 -34.6300096263348,-58.4668248832163 -34.6301598455142,-58.4663302680012 -34.6313240549379)))";;"3115";7_8_2;COMUNA 7;"8";"2";"879";"388";"491";"79,02%";"458";"456";"99,56%";"2";"0,44%";"356";"18";"5.06";"338";"94,94%";"5.06";5.060
"MULTIPOLYGON (((-58.4689913059796 -34.6321553827115,-58.4687917601306 -34.6320897568673,-58.4676920494571 -34.6317471194319,-58.4676382098168 -34.6318688157957,-58.4671771596192 -34.6329249952365,-58.4684847785926 -34.6332868535482,-58.4689913059796 -34.6321553827115)))";;"3116";7_8_3;COMUNA 7;"8";"3";"583";"239";"344";"69,48%";"311";"310";"99,68%";"1";"0,32%";"247";"2";"0.81";"245";"99,19%";"0.81";0.810
"MULTIPOLYGON (((-58.4705276100017 -34.632606858004,-58.4703870248068 -34.632579049126,-58.4691964755592 -34.6322227685508,-58.4689913059796 -34.6321553827115,-58.4684847785926 -34.6332868535482,-58.4700098554711 -34.6337554490468,-58.4711960855744 -34.6341199615986,-58.4712800764799 -34.6339316396906,-58.4717449155615 -34.6328868534636,-58.4706654687914 -34.632634173924,-58.4705276100017 -34.632606858004)))";;"3117";7_8_4;COMUNA 7;"8";"4";"821";"358";"463";"77,32%";"458";"457";"99,78%";"1";"0,22%";"358";"13";"3.63";"345";"96,37%";"3.63";3.630
"MULTIPOLYGON (((-58.4728742987558 -34.6331512098091,-58.4717449155615 -34.6328868534636,-58.4712800764799 -34.6339316396906,-58.4711960855744 -34.6341199615986,-58.470669728223 -34.6352998948046,-58.4696333608884 -34.6349771307032,-58.4694846761801 -34.6349317150484,-58.4690224385816 -34.6359748019828,-58.4702104843707 -34.6363292531431,-58.4713029364562 -34.6366551774409,-58.4717559507473 -34.6356449710597,-58.4722802512497 -34.6344758083955,-58.4728742987558 -34.6331512098091)))";;"3118";7_8_5;COMUNA 7;"8";"5";"1040";"485";"555";"87,39%";"471";"470";"99,79%";"1";"0,21%";"392";"20";"5.1";"372";"94,90%";"5.1";5.100
"MULTIPOLYGON (((-58.4700098554711 -34.6337554490468,-58.4684847785926 -34.6332868535482,-58.468396181735 -34.6334846811214,-58.467963244181 -34.634458464878,-58.4681474583093 -34.6345225433913,-58.4694846761801 -34.6349317150484,-58.4696333608884 -34.6349771307032,-58.470669728223 -34.6352998948046,-58.4711960855744 -34.6341199615986,-58.4700098554711 -34.6337554490468)))";;"3119";7_8_6;COMUNA 7;"8";"6";"896";"414";"482";"85,89%";"466";"466";"100,00%";"0";"0,00%";"373";"24";"6.43";"349";"93,57%";"6.43";6.430
"MULTIPOLYGON (((-58.4684847785926 -34.6332868535482,-58.4671771596192 -34.6329249952365,-58.4666824462197 -34.6340579369342,-58.467753383568 -34.6343855136215,-58.467963244181 -34.634458464878,-58.468396181735 -34.6334846811214,-58.4684847785926 -34.6332868535482)))";;"3120";7_8_7;COMUNA 7;"8";"7";"678";"297";"381";"77,95%";"390";"390";"100,00%";"0";"0,00%";"319";"33";"10.34";"286";"89,66%";"10.34";10.340
"MULTIPOLYGON (((-58.4694846761801 -34.6349317150484,-58.4681474583093 -34.6345225433913,-58.467963244181 -34.634458464878,-58.467753383568 -34.6343855136215,-58.4666824462197 -34.6340579369342,-58.4662817755938 -34.634975655408,-58.466218305593 -34.6351412260322,-58.4674919594615 -34.6355186597166,-58.4677514120469 -34.6355956235804,-58.4690224385816 -34.6359748019828,-58.4694846761801 -34.6349317150484)))";;"3121";7_8_8;COMUNA 7;"8";"8";"818";"373";"445";"83,82%";"501";"500";"99,80%";"1";"0,20%";"368";"22";"5.98";"346";"94,02%";"5.98";5.980
"MULTIPOLYGON (((-58.4612465187024 -34.6324046290448,-58.4595434475792 -34.6318923263971,-58.4590250379316 -34.6329715728737,-58.4607652757064 -34.6335055741183,-58.4608371899303 -34.6333578239037,-58.4612465187024 -34.6324046290448)))";;"3122";7_9_1;COMUNA 7;"9";"1";"667";"309";"358";"86,31%";"293";"292";"99,66%";"1";"0,34%";"259";"10";"3.86";"249";"96,14%";"3.86";3.860
"MULTIPOLYGON (((-58.4669095635261 -34.6300096263348,-58.465519871528 -34.6296516966579,-58.4649630478712 -34.6309116798928,-58.4663302680012 -34.6313240549379,-58.4668248832163 -34.6301598455142,-58.4669095635261 -34.6300096263348)))";;"3123";7_9_10;COMUNA 7;"9";"10";"692";"303";"389";"77,89%";"387";"387";"100,00%";"0";"0,00%";"307";"14";"4.56";"293";"95,44%";"4.56";4.560
"MULTIPOLYGON (((-58.4663302680012 -34.6313240549379,-58.4649630478712 -34.6309116798928,-58.4644436941105 -34.6320869386836,-58.4645950121805 -34.6321301772935,-58.4657915049836 -34.6324984748656,-58.4663302680012 -34.6313240549379)))";;"3124";7_9_11;COMUNA 7;"9";"11";"577";"257";"320";"80,31%";"292";"292";"100,00%";"0";"0,00%";"263";"26";"9.89";"237";"90,11%";"9.89";9.890
"MULTIPOLYGON (((-58.462621327894 -34.6328205668968,-58.4625270947531 -34.6327898615621,-58.4612465187024 -34.6324046290448,-58.4608371899303 -34.6333578239037,-58.4607652757064 -34.6335055741183,-58.4609258813951 -34.6335548035292,-58.4621522846553 -34.6339252498919,-58.4625880990814 -34.6328993018599,-58.462621327894 -34.6328205668968)))";;"3125";7_9_2;COMUNA 7;"9";"2";"625";"290";"335";"86,57%";"345";"344";"99,71%";"1";"0,29%";"276";"2";"0.72";"274";"99,28%";"0.72";0.720
"MULTIPOLYGON (((-58.4639412803789 -34.6332237428963,-58.4638019742357 -34.6331855035398,-58.4627805701317 -34.6328724700146,-58.462621327894 -34.6328205668968,-58.4625880990814 -34.6328993018599,-58.4621522846553 -34.6339252498919,-58.4634570860899 -34.634319346185,-58.4639412803789 -34.6332237428963)))";;"3126";7_9_3;COMUNA 7;"9";"3";"543";"225";"318";"70,75%";"276";"275";"99,64%";"1";"0,36%";"226";"1";"0.44";"225";"99,56%";"0.44";0.440
"MULTIPOLYGON (((-58.4652885958246 -34.6336314816218,-58.4640782861771 -34.633261277871,-58.4639412803789 -34.6332237428963,-58.4634570860899 -34.634319346185,-58.4642005745213 -34.6345438536871,-58.4646354566164 -34.6346751898803,-58.4648053540751 -34.6347251886986,-58.4660525814748 -34.6350920741689,-58.466218305593 -34.6351412260322,-58.4662817755938 -34.634975655408,-58.4666824462197 -34.6340579369342,-58.4652885958246 -34.6336314816218)))";;"3127";7_9_4;COMUNA 7;"9";"4";"826";"374";"452";"82,74%";"478";"478";"100,00%";"0";"0,00%";"415";"10";"2.41";"405";"97,59%";"2.41";2.410
"MULTIPOLYGON (((-58.4671771596192 -34.6329249952365,-58.4657915049836 -34.6324984748656,-58.4657311871112 -34.6326298187424,-58.4652885958246 -34.6336314816218,-58.4666824462197 -34.6340579369342,-58.4671771596192 -34.6329249952365)))";;"3128";7_9_5;COMUNA 7;"9";"5";"494";"221";"273";"80,95%";"292";"291";"99,66%";"1";"0,34%";"197";"1";"0.51";"196";"99,49%";"0.51";0.510
"MULTIPOLYGON (((-58.4644436941105 -34.6320869386836,-58.4643091608918 -34.6320485589811,-58.4631049278133 -34.6316746128767,-58.462621327894 -34.6328205668968,-58.4627805701317 -34.6328724700146,-58.4638019742357 -34.6331855035398,-58.4639412803789 -34.6332237428963,-58.4640782861771 -34.633261277871,-58.4652885958246 -34.6336314816218,-58.4657311871112 -34.6326298187424,-58.4657915049836 -34.6324984748656,-58.4645950121805 -34.6321301772935,-58.4644436941105 -34.6320869386836)))";;"3129";7_9_6;COMUNA 7;"9";"6";"893";"404";"489";"82,62%";"446";"445";"99,78%";"1";"0,22%";"356";"39";"10.96";"317";"89,04%";"10.96";10.960
"MULTIPOLYGON (((-58.4631049278133 -34.6316746128767,-58.4629710774714 -34.6316330625743,-58.4617372066929 -34.6312619904228,-58.4612465187024 -34.6324046290448,-58.4625270947531 -34.6327898615621,-58.462621327894 -34.6328205668968,-58.4631049278133 -34.6316746128767)))";;"3130";7_9_7;COMUNA 7;"9";"7";"753";"333";"420";"79,29%";"413";"412";"99,76%";"1";"0,24%";"329";"8";"2.43";"321";"97,57%";"2.43";2.430
"MULTIPOLYGON (((-58.4641120435356 -34.6292517076738,-58.4635405325935 -34.6290872003875,-58.4632425094463 -34.6290014245487,-58.4627118968538 -34.6288497305166,-58.4622937409303 -34.6299477243955,-58.4622373384925 -34.6300886443974,-58.4621846846868 -34.6302199161763,-58.4617372066929 -34.6312619904228,-58.4629710774714 -34.6316330625743,-58.4631049278133 -34.6316746128767,-58.4643091608918 -34.6320485589811,-58.4644436941105 -34.6320869386836,-58.4649630478712 -34.6309116798928,-58.4635941372765 -34.6304987261073,-58.4638424854426 -34.6299007463199,-58.4641120435356 -34.6292517076738)))";;"3131";7_9_8;COMUNA 7;"9";"8";"972";"441";"531";"83,05%";"472";"470";"99,58%";"2";"0,43%";"397";"19";"4.79";"378";"95,21%";"4.79";4.790
"MULTIPOLYGON (((-58.465519871528 -34.6296516966579,-58.4653436794389 -34.6296062765476,-58.4641120435356 -34.6292517076738,-58.4638424854426 -34.6299007463199,-58.4635941372765 -34.6304987261073,-58.4649630478712 -34.6309116798928,-58.465519871528 -34.6296516966579)))";;"3132";7_9_9;COMUNA 7;"9";"9";"685";"318";"367";"86,65%";"361";"361";"100,00%";"0";"0,00%";"298";"48";"16.11";"250";"83,89%";"16.11";16.110
"MULTIPOLYGON (((-58.4963996327114 -34.6767341698655,-58.495639897693 -34.676048021828,-58.4946184313012 -34.676811200535,-58.4947347445001 -34.6769060316144,-58.4953904443103 -34.6775069996951,-58.4961153153349 -34.6781713975644,-58.496117350949 -34.6781697873578,-58.4964057677767 -34.6784214624408,-58.4968200221722 -34.6787829406236,-58.497845956176 -34.6780077459609,-58.4974402309086 -34.6776416473688,-58.4971494741866 -34.6773792856614,-58.497130129458 -34.6773939122225,-58.4965414501877 -34.6768623028825,-58.4964588156718 -34.6767876759913,-58.4963996327114 -34.6767341698655)))";;"3133";8_1_1;COMUNA 8;"1";"1";"1147";"578";"569";"101,58%";"271";"271";"100,00%";"0";"0,00%";"331";"21";"6.34";"310";"93,66%";"6.34";6.340
"MULTIPOLYGON (((-58.4893610516446 -34.6708437863138,-58.4892807798116 -34.6711886721893,-58.4892320038188 -34.6713992517976,-58.4892020379588 -34.6715219376329,-58.4891810966315 -34.6716101135398,-58.4895684977331 -34.6718073579525,-58.4897167571333 -34.6718814820818,-58.4898688282624 -34.6716197512014,-58.4898845038886 -34.6715927751597,-58.4901129964722 -34.671213066012,-58.4901947007033 -34.6710860019756,-58.4903184131529 -34.6709129412305,-58.4902961554983 -34.6708833680173,-58.4903365413497 -34.6708283574013,-58.4904049559383 -34.6707271419886,-58.4905221890985 -34.6705539416502,-58.4905731564763 -34.6705348449906,-58.4906450633541 -34.6704275721399,-58.4906839992436 -34.6703712940977,-58.4908029362896 -34.6701985860592,-58.4908972429798 -34.6700390529665,-58.4910309000206 -34.6697912688532,-58.4911029671315 -34.6696575865221,-58.4911407174473 -34.6696260275775,-58.490568350395 -34.6691648093164,-58.4905339757601 -34.66909509698,-58.4905175987987 -34.6690619308093,-58.4902820987891 -34.6685930279895,-58.4901733033766 -34.6684985429561,-58.4900269258368 -34.6686870316565,-58.4899531483816 -34.6688064175945,-58.4898825328529 -34.6689512260022,-58.489375428315 -34.6694237451149,-58.4894953934951 -34.6695278765383,-58.4894861138515 -34.6695634429143,-58.4897311588826 -34.6697695915515,-58.4896722098642 -34.6698831287826,-58.4896416200865 -34.669917995637,-58.4895518103668 -34.6700202717155,-58.4894680506816 -34.6703819899651,-58.4894274473857 -34.6705572852514,-58.4893966331225 -34.6706906054242,-58.4893610516446 -34.6708437863138)))";;"3134";8_1_10;COMUNA 8;"1";"10";"1514";"758";"756";"100,26%";"396";"396";"100,00%";"0";"0,00%";"440";"81";"18.41";"359";"81,59%";"18.41";18.410
"MULTIPOLYGON (((-58.4898688282624 -34.6716197512014,-58.4897167571333 -34.6718814820818,-58.4903237794142 -34.6721850160578,-58.4904281466459 -34.6720219598791,-58.4909098316026 -34.6722226997529,-58.4911471788409 -34.6723196189937,-58.491708408166 -34.6725482251737,-58.4915981894966 -34.6723023293622,-58.4915121832919 -34.6720653716196,-58.4914855520823 -34.6719621357401,-58.4914682188154 -34.6718777713989,-58.4914196344287 -34.6716407343132,-58.4913979741795 -34.6713677744159,-58.4914061075591 -34.6712234728878,-58.4914386594366 -34.6709470494053,-58.4914551658329 -34.6708592966942,-58.4914816269103 -34.6707182303478,-58.4914906457948 -34.6706701987668,-58.4915864307035 -34.6703512943453,-58.4917248388983 -34.6700440701457,-58.4917943534107 -34.6699260926661,-58.4911407174473 -34.6696260275775,-58.4911029671315 -34.6696575865221,-58.4910309000206 -34.6697912688532,-58.4908972429798 -34.6700390529665,-58.4908029362896 -34.6701985860592,-58.4906839992436 -34.6703712940977,-58.4906450633541 -34.6704275721399,-58.4905731564763 -34.6705348449906,-58.4905221890985 -34.6705539416502,-58.4904049559383 -34.6707271419886,-58.4903365413497 -34.6708283574013,-58.4902961554983 -34.6708833680173,-58.4903184131529 -34.6709129412305,-58.4901947007033 -34.6710860019756,-58.4901129964722 -34.671213066012,-58.4898845038886 -34.6715927751597,-58.4898688282624 -34.6716197512014)))";;"3135";8_1_11;COMUNA 8;"1";"11";"665";"338";"327";"103,36%";"71";"71";"100,00%";"0";"0,00%";"182";"57";"31.32";"125";"68,68%";"31.32";31.320
"MULTIPOLYGON (((-58.4891810966315 -34.6716101135398,-58.489162368585 -34.67168899294,-58.4891430447513 -34.6717708302906,-58.48891763332 -34.6727499893808,-58.4888845590976 -34.6727497852162,-58.4888147475927 -34.6730285399295,-58.488776105712 -34.6732149615564,-58.4887184828908 -34.6734925163711,-58.4886609297896 -34.6737215487329,-58.4885986889805 -34.6736800115869,-58.488592473998 -34.6737050839869,-58.4884973194431 -34.6736320740767,-58.4883620805998 -34.6742552021747,-58.4882179665504 -34.6743986412443,-58.4880979815015 -34.6745248662671,-58.4880052674019 -34.6746285498038,-58.4879180046117 -34.6747187107164,-58.4878551872378 -34.6747852665747,-58.4880196682637 -34.6749294616281,-58.4881507739125 -34.6749261243812,-58.4886451610554 -34.6753660315907,-58.4883091654398 -34.6768857897607,-58.4882818942253 -34.6769111482509,-58.4883382776726 -34.6770254351148,-58.4883314683451 -34.6770593106556,-58.4883553523188 -34.6771072646083,-58.4883793180891 -34.6771439506441,-58.4886217644038 -34.6771546742533,-58.488749172624 -34.6770386582021,-58.4893541651315 -34.6764879498819,-58.4899711641821 -34.675921601619,-58.4910673165054 -34.6748481546212,-58.4912797428421 -34.6746325083458,-58.4917088124882 -34.6741969303425,-58.4921065048621 -34.6737948527119,-58.4922732669575 -34.673626286828,-58.4924303993465 -34.6734674416253,-58.4921688566896 -34.6731819342495,-58.4920509183423 -34.6730483676395,-58.4919733996752 -34.6729551443882,-58.491888455005 -34.6728332601375,-58.491836260448 -34.6727590453153,-58.4917567680626 -34.6726267368553,-58.491708408166 -34.6725482251737,-58.4911471788409 -34.6723196189937,-58.4909098316026 -34.6722226997529,-58.4904281466459 -34.6720219598791,-58.4903237794142 -34.6721850160578,-58.4897167571333 -34.6718814820818,-58.4895684977331 -34.6718073579525,-58.4891810966315 -34.6716101135398)))";;"3136";8_1_12;COMUNA 8;"1";"12";"3404";"1703";"1701";"100,12%";"902";"902";"100,00%";"0";"0,00%";"1019";"231";"22.67";"788";"77,33%";"22.67";22.670
"MULTIPOLYGON (((-58.495639897693 -34.676048021828,-58.4963996327114 -34.6767341698655,-58.4964588156718 -34.6767876759913,-58.4965414501877 -34.6768623028825,-58.497130129458 -34.6773939122225,-58.4971494741866 -34.6773792856614,-58.4974402309086 -34.6776416473688,-58.497845956176 -34.6780077459609,-58.5025226262793 -34.6744737653678,-58.5020043052407 -34.6741854046442,-58.501641882017 -34.6739837730027,-58.5016418715852 -34.6739837682795,-58.5006814503869 -34.6734686713258,-58.5001181114612 -34.6731668657876,-58.4997419291654 -34.6729652852327,-58.499127524728 -34.672636025083,-58.4989282600074 -34.6725146023877,-58.4987237941673 -34.6723887441643,-58.4982528564924 -34.6720507044679,-58.4979163895694 -34.6718093168641,-58.4974079410661 -34.6714444530014,-58.4972332490241 -34.6713190735763,-58.4970399304586 -34.6711803248457,-58.4958731844006 -34.6701956216328,-58.4957380259964 -34.6700623449071,-58.4945499104339 -34.6712900178051,-58.4934502076248 -34.6724261049038,-58.4929845333321 -34.6729072200779,-58.4926923421403 -34.6732026521986,-58.4924303993465 -34.6734674416253,-58.4922732669575 -34.673626286828,-58.4921065048621 -34.6737948527119,-58.4917088124882 -34.6741969303425,-58.4933242148546 -34.6756560097936,-58.4938483118415 -34.6761293399402,-58.4944622104763 -34.6766838437003,-58.4946184313012 -34.676811200535,-58.495639897693 -34.676048021828)))";;"3137";8_1_2;COMUNA 8;"1";"2";"1625";"808";"817";"98,90%";"475";"475";"100,00%";"0";"0,00%";"517";"91";"17.6";"426";"82,40%";"17.6";17.600
"MULTIPOLYGON (((-58.4919461301503 -34.6712808108488,-58.4914061075591 -34.6712234728878,-58.4913979741795 -34.6713677744159,-58.4914196344287 -34.6716407343132,-58.4914682188154 -34.6718777713989,-58.4914855520823 -34.6719621357401,-58.4915121832919 -34.6720653716196,-58.4915981894966 -34.6723023293622,-58.491708408166 -34.6725482251737,-58.4917567680626 -34.6726267368553,-58.491836260448 -34.6727590453153,-58.491888455005 -34.6728332601375,-58.4919733996752 -34.6729551443882,-58.4920509183423 -34.6730483676395,-58.4921688566896 -34.6731819342495,-58.4924303993465 -34.6734674416253,-58.4926923421403 -34.6732026521986,-58.4929845333321 -34.6729072200779,-58.4934502076248 -34.6724261049038,-58.4930501553664 -34.6721651419201,-58.4927107273451 -34.6719452201282,-58.4926433673331 -34.6718925592401,-58.4926038876544 -34.6718571454568,-58.4925437667079 -34.6717860315434,-58.4924849186904 -34.6716987196757,-58.4924444933324 -34.6716404181394,-58.4923810395955 -34.6715450085364,-58.4922812553948 -34.6713995359667,-58.4922172072892 -34.6713096195226,-58.4919461301503 -34.6712808108488)))";;"3138";8_1_3;COMUNA 8;"1";"3";"1321";"702";"619";"113,41%";"266";"266";"100,00%";"0";"0,00%";"351";"58";"16.52";"293";"83,48%";"16.52";16.520
"MULTIPOLYGON (((-58.4923909818323 -34.6690690947893,-58.4923307439106 -34.6691420691583,-58.492264290113 -34.6692338483277,-58.4921117865831 -34.6694443838398,-58.4919070585491 -34.6697349338259,-58.4917943534107 -34.6699260926661,-58.4917248388983 -34.6700440701457,-58.4915864307035 -34.6703512943453,-58.4914906457948 -34.6706701987668,-58.4914816269103 -34.6707182303478,-58.4914551658329 -34.6708592966942,-58.4914386594366 -34.6709470494053,-58.4914061075591 -34.6712234728878,-58.4919461301503 -34.6712808108488,-58.4922172072892 -34.6713096195226,-58.4922812553948 -34.6713995359667,-58.4923810395955 -34.6715450085364,-58.4924444933324 -34.6716404181394,-58.4924849186904 -34.6716987196757,-58.4925437667079 -34.6717860315434,-58.4926038876544 -34.6718571454568,-58.4926433673331 -34.6718925592401,-58.4927107273451 -34.6719452201282,-58.4930501553664 -34.6721651419201,-58.4934502076248 -34.6724261049038,-58.4945499104339 -34.6712900178051,-58.4937707292862 -34.6701712453621,-58.4936407914048 -34.6703142399827,-58.4935833279509 -34.6702830565355,-58.4934022274468 -34.6703774005765,-58.4933755522893 -34.6703910696287,-58.4931532822887 -34.6704910576041,-58.4930293638894 -34.6705489069427,-58.4929638251797 -34.6705796282759,-58.4928941940611 -34.6706080970061,-58.4928181418698 -34.6705592412737,-58.4927762716917 -34.670511855978,-58.4927414575418 -34.670411932313,-58.4926948494664 -34.6704628606438,-58.4924017370237 -34.6707830818051,-58.4921835535444 -34.6706345392517,-58.4920311844108 -34.6705087275739,-58.4921788100738 -34.6702379804992,-58.4922341907402 -34.6701664158834,-58.4922525941312 -34.670142607969,-58.4923849191138 -34.669994754957,-58.4925170731973 -34.6698470426885,-58.4926511865608 -34.6696972170592,-58.4927828284921 -34.6695501384414,-58.4928823477921 -34.6694389840942,-58.4929156635377 -34.6694036932021,-58.4930558279068 -34.669255133257,-58.4931913907051 -34.669111574433,-58.4933317244899 -34.6689628028482,-58.4934683088094 -34.6688181870864,-58.4936059150714 -34.6686723736938,-58.4937297176759 -34.6685411415157,-58.4939590064766 -34.6683078371913,-58.4936086346845 -34.6679622833505,-58.4934587267281 -34.6678000633372,-58.4933354403719 -34.6679425630377,-58.4930088673267 -34.6683358947634,-58.4927070800973 -34.66868619016,-58.4925175918739 -34.668915679469,-58.4923909818323 -34.6690690947893)))";;"3139";8_1_4;COMUNA 8;"1";"4";"1894";"966";"928";"104,09%";"403";"403";"100,00%";"0";"0,00%";"482";"124";"25.73";"358";"74,27%";"25.73";25.730
"MULTIPOLYGON (((-58.4925170731973 -34.6698470426885,-58.4923849191138 -34.669994754957,-58.4922525941312 -34.670142607969,-58.4922341907402 -34.6701664158834,-58.4921788100738 -34.6702379804992,-58.4920311844108 -34.6705087275739,-58.4921835535444 -34.6706345392517,-58.4924017370237 -34.6707830818051,-58.4926948494664 -34.6704628606438,-58.4927414575418 -34.670411932313,-58.4927762716917 -34.670511855978,-58.4928181418698 -34.6705592412737,-58.4928941940611 -34.6706080970061,-58.4929638251797 -34.6705796282759,-58.4930293638894 -34.6705489069427,-58.4931532822887 -34.6704910576041,-58.4933755522893 -34.6703910696287,-58.4934022274468 -34.6703774005765,-58.4935833279509 -34.6702830565355,-58.4936407914048 -34.6703142399827,-58.4937707292862 -34.6701712453621,-58.4945499104339 -34.6712900178051,-58.4957380259964 -34.6700623449071,-58.4950934499806 -34.669426655746,-58.4947407664482 -34.6690788522575,-58.4943530396683 -34.6686964784326,-58.4939590064766 -34.6683078371913,-58.4937297176759 -34.6685411415157,-58.4936059150714 -34.6686723736938,-58.4934683088094 -34.6688181870864,-58.4933317244899 -34.6689628028482,-58.4931913907051 -34.669111574433,-58.4930558279068 -34.669255133257,-58.4929156635377 -34.6694036932021,-58.4928823477921 -34.6694389840942,-58.4927828284921 -34.6695501384414,-58.4926511865608 -34.6696972170592,-58.4925170731973 -34.6698470426885)))";;"3140";8_1_5;COMUNA 8;"1";"5";"1762";"838";"924";"90,69%";"411";"411";"100,00%";"0";"0,00%";"449";"65";"14.48";"384";"85,52%";"14.48";14.480
"MULTIPOLYGON (((-58.4916827110382 -34.6682753001041,-58.4916055058812 -34.668334474966,-58.4910802223854 -34.6686994674065,-58.4907839909497 -34.6688703856929,-58.4905339757601 -34.66909509698,-58.490568350395 -34.6691648093164,-58.4911407174473 -34.6696260275775,-58.4917943534107 -34.6699260926661,-58.4919070585491 -34.6697349338259,-58.4921117865831 -34.6694443838398,-58.492264290113 -34.6692338483277,-58.4923307439106 -34.6691420691583,-58.4923909818323 -34.6690690947893,-58.4925175918739 -34.668915679469,-58.4927070800973 -34.66868619016,-58.4930088673267 -34.6683358947634,-58.4933354403719 -34.6679425630377,-58.4934587267281 -34.6678000633372,-58.4928961081916 -34.6671914550226,-58.4923208631303 -34.6677247092506,-58.4919911044533 -34.6680388115379,-58.4916827110382 -34.6682753001041)))";;"3141";8_1_6;COMUNA 8;"1";"6";"2255";"1097";"1158";"94,73%";"429";"429";"100,00%";"0";"0,00%";"627";"126";"20.1";"501";"79,90%";"20.1";20.100
"MULTIPOLYGON (((-58.4928961081916 -34.6671914550226,-58.492598089122 -34.6668690548809,-58.4925661135532 -34.6668361040711,-58.4921883774834 -34.6664470304434,-58.4912119557476 -34.6673229908603,-58.4905732074942 -34.6678878018215,-58.4905653849865 -34.6679456220814,-58.4901733033766 -34.6684985429561,-58.4902820987891 -34.6685930279895,-58.4905175987987 -34.6690619308093,-58.4905339757601 -34.66909509698,-58.4907839909497 -34.6688703856929,-58.4910802223854 -34.6686994674065,-58.4916055058812 -34.668334474966,-58.4916827110382 -34.6682753001041,-58.4919911044533 -34.6680388115379,-58.4923208631303 -34.6677247092506,-58.4928961081916 -34.6671914550226)))";;"3142";8_1_7;COMUNA 8;"1";"7";"1451";"645";"806";"80,02%";"360";"360";"100,00%";"0";"0,00%";"460";"32";"6.96";"428";"93,04%";"6.96";6.960
"MULTIPOLYGON (((-58.4917617019572 -34.6660074729508,-58.4911350932598 -34.6653897868028,-58.4910000378318 -34.6652634062898,-58.4898699420327 -34.6661543921152,-58.4887108486687 -34.6670682614799,-58.4886221383633 -34.6671365216737,-58.4873691859562 -34.6681017374841,-58.4874833491931 -34.6682013649204,-58.4881697852213 -34.668805042606,-58.4888876932007 -34.6694363864094,-58.4901302466306 -34.6684639742507,-58.4901733033766 -34.6684985429561,-58.4905653849865 -34.6679456220814,-58.4905732074942 -34.6678878018215,-58.4912119557476 -34.6673229908603,-58.4921883774834 -34.6664470304434,-58.4919353900874 -34.6661864504235,-58.4917617019572 -34.6660074729508)))";;"3143";8_1_8;COMUNA 8;"1";"8";"1183";"581";"602";"96,51%";"384";"384";"100,00%";"0";"0,00%";"374";"76";"20.32";"298";"79,68%";"20.32";20.320
"MULTIPOLYGON (((-58.4883616339987 -34.6742572599233,-58.4884130199585 -34.6742045012383,-58.4883620805998 -34.6742552021747,-58.4883616339987 -34.6742572599233)),((-58.4888876932007 -34.6694363864094,-58.4887894364263 -34.6695133109541,-58.4882720176057 -34.6700163214183,-58.4878018018741 -34.6704734736396,-58.4877106213185 -34.6705620158739,-58.4873371041557 -34.6708716072402,-58.4862804521974 -34.6717471916136,-58.4853343126547 -34.6725311241005,-58.485514985081 -34.6726903904016,-58.4858859703085 -34.6730299068225,-58.4864506819937 -34.6735467835298,-58.4866299962617 -34.6737109076978,-58.4872201201246 -34.6742283391849,-58.4878551872378 -34.6747852665747,-58.4879180046117 -34.6747187107164,-58.4880052674019 -34.6746285498038,-58.4880979815015 -34.6745248662671,-58.4882179665504 -34.6743986412443,-58.4883620805998 -34.6742552021747,-58.4884973194431 -34.6736320740767,-58.488592473998 -34.6737050839869,-58.4885986889805 -34.6736800115869,-58.4886609297896 -34.6737215487329,-58.4887184828908 -34.6734925163711,-58.488776105712 -34.6732149615564,-58.4888147475927 -34.6730285399295,-58.4888845590976 -34.6727497852162,-58.48891763332 -34.6727499893808,-58.4891430447513 -34.6717708302906,-58.489162368585 -34.67168899294,-58.4891810966315 -34.6716101135398,-58.4892020379588 -34.6715219376329,-58.4892320038188 -34.6713992517976,-58.4892807798116 -34.6711886721893,-58.4893610516446 -34.6708437863138,-58.4893966331225 -34.6706906054242,-58.4894274473857 -34.6705572852514,-58.4894680506816 -34.6703819899651,-58.4895518103668 -34.6700202717155,-58.4896416200865 -34.669917995637,-58.4896722098642 -34.6698831287826,-58.4897311588826 -34.6697695915515,-58.4894861138515 -34.6695634429143,-58.4894953934951 -34.6695278765383,-58.489375428315 -34.6694237451149,-58.4898825328529 -34.6689512260022,-58.4899531483816 -34.6688064175945,-58.4900269258368 -34.6686870316565,-58.4901733033766 -34.6684985429561,-58.4901302466306 -34.6684639742507,-58.4888876932007 -34.6694363864094)))";;"3144";8_1_9;COMUNA 8;"1";"9";"2671";"1325";"1346";"98,44%";"629";"629";"100,00%";"0";"0,00%";"810";"183";"22.59";"627";"77,41%";"22.59";22.590
"MULTIPOLYGON (((-58.4664907012322 -34.6893702080573,-58.4666045187654 -34.6892811178472,-58.4669049618009 -34.6890463839768,-58.467099600922 -34.6888943312428,-58.4675827427872 -34.6885169095021,-58.4680581221379 -34.6881455426471,-58.4686721191007 -34.6876659251737,-58.4687618053618 -34.6875957077961,-58.4688113373511 -34.6875569719998,-58.4695628367922 -34.6869688192834,-58.4690927823576 -34.6865627787188,-58.4689437628075 -34.686687930308,-58.4686097906578 -34.6863976582613,-58.4674023521097 -34.6873101975954,-58.4670110019558 -34.6869674573462,-58.4668966669312 -34.6868673180801,-58.4664846881921 -34.6865111962196,-58.4669373838242 -34.6861603277698,-58.4668352441379 -34.6861101892191,-58.4664180140202 -34.686435844339,-58.4657771578789 -34.6869359446866,-58.4646827313473 -34.6877900019907,-58.4641077583666 -34.6882386826829,-58.4635854688139 -34.6886463029435,-58.4636801925046 -34.6887289802417,-58.464353409697 -34.689317015094,-58.4653955680047 -34.6902272292596,-58.4658780432615 -34.6898496735249,-58.4664236894444 -34.6894226057296,-58.4664907012322 -34.6893702080573)))";;"3145";8_10_1;COMUNA 8;"10";"1";"876";"424";"452";"93,81%";"257";"257";"100,00%";"0";"0,00%";"278";"5";"1.8";"273";"98,20%";"1.8";1.800
"MULTIPOLYGON (((-58.4705156018213 -34.6862239552084,-58.4710961526975 -34.6857703140602,-58.4712133703475 -34.685678683987,-58.4717411448442 -34.685265185224,-58.4721291081784 -34.6849612047588,-58.4723019052065 -34.6848291457924,-58.4723764114968 -34.6847721666778,-58.471241051847 -34.6837585647054,-58.4706276826628 -34.6832109165909,-58.4704674191393 -34.6833486767868,-58.4704224017334 -34.6833105801159,-58.4699386209794 -34.6836881543197,-58.4696320679407 -34.6839274033739,-58.4692990859185 -34.6841872873905,-58.4682361892914 -34.6850168676334,-58.4680360199878 -34.6851730775519,-58.4676052442334 -34.685509301015,-58.4668352441379 -34.6861101892191,-58.4669373838242 -34.6861603277698,-58.4664846881921 -34.6865111962196,-58.4668966669312 -34.6868673180801,-58.4670110019558 -34.6869674573462,-58.4674023521097 -34.6873101975954,-58.4686097906578 -34.6863976582613,-58.4689437628075 -34.686687930308,-58.4690927823576 -34.6865627787188,-58.4695628367922 -34.6869688192834,-58.4698087875001 -34.6867762653381,-58.4699292475305 -34.6866821010533,-58.470038368915 -34.686596881209,-58.4705156018213 -34.6862239552084)))";;"3146";8_10_2;COMUNA 8;"10";"2";"759";"372";"387";"96,12%";"233";"232";"99,57%";"1";"0,43%";"237";"8";"3.38";"229";"96,62%";"3.38";3.380
"MULTIPOLYGON (((-58.467021206058 -34.6815295771832,-58.4663856835832 -34.6821786987331,-58.4665518453614 -34.6822859497818,-58.4665009520043 -34.6823375019555,-58.4666423867847 -34.6823560190497,-58.4675506740903 -34.6824749329024,-58.4680501546589 -34.6835721926458,-58.4682805442964 -34.6840782510958,-58.4675885765296 -34.684780621955,-58.4680360199878 -34.6851730775519,-58.4682361892914 -34.6850168676334,-58.4692990859185 -34.6841872873905,-58.4696320679407 -34.6839274033739,-58.4699386209794 -34.6836881543197,-58.4704224017334 -34.6833105801159,-58.4704674191393 -34.6833486767868,-58.4706276826628 -34.6832109165909,-58.470595113104 -34.6831818334797,-58.4702283280899 -34.6829053709795,-58.4691152843442 -34.682066258897,-58.4681886228736 -34.6812321988332,-58.4674650572836 -34.6805826355192,-58.4670800418333 -34.680140737437,-58.4670448287012 -34.6800492575187,-58.4670140568932 -34.6801167251007,-58.4669760389809 -34.6801884888114,-58.4669312848515 -34.6802332802333,-58.4668810740895 -34.6802669447852,-58.466780736205 -34.6803039209471,-58.466723704489 -34.6803207542525,-58.4666678650838 -34.6803130094092,-58.4664719520764 -34.6801470959586,-58.46629394302 -34.6799962524647,-58.4661602653912 -34.6798648445669,-58.4661175588805 -34.6799554818613,-58.4660890882349 -34.680026047816,-58.4660321457295 -34.6801404888897,-58.4659391410043 -34.6802252118402,-58.46572226692 -34.6803016277845,-58.4657988257136 -34.6804068397768,-58.467021206058 -34.6815295771832)))";;"3147";8_10_3;COMUNA 8;"10";"3";"1009";"448";"561";"79,86%";"446";"444";"99,55%";"2";"0,45%";"380";"0";"0";"380";"100,00%";"0";0.000
"MULTIPOLYGON (((-58.4659307510466 -34.6837029042671,-58.4665110775949 -34.6837734526198,-58.4667549169208 -34.684039225931,-58.4667206567788 -34.6842888106533,-58.4665560059861 -34.6856025100035,-58.4664785293026 -34.6860621714674,-58.4668352441379 -34.6861101892191,-58.4676052442334 -34.685509301015,-58.4680360199878 -34.6851730775519,-58.4675885765296 -34.684780621955,-58.4682805442964 -34.6840782510958,-58.4680501546589 -34.6835721926458,-58.4675506740903 -34.6824749329024,-58.4666423867847 -34.6823560190497,-58.4665009520043 -34.6823375019555,-58.4652388278058 -34.6836188340663,-58.4653877668081 -34.6836369299102,-58.4659307510466 -34.6837029042671)))";;"3148";8_10_4;COMUNA 8;"10";"4";"2202";"1020";"1182";"86,29%";"830";"830";"100,00%";"0";"0,00%";"719";"7";"0.97";"712";"99,03%";"0.97";0.970
"MULTIPOLYGON (((-58.4653877668081 -34.6836369299102,-58.4652388278058 -34.6836188340663,-58.4650197315687 -34.683836519845,-58.464666958645 -34.6841871684619,-58.464576164745 -34.684277383373,-58.4645478618122 -34.6843475263695,-58.4645696897811 -34.6844721065526,-58.4646954468915 -34.6847405618292,-58.4652393468145 -34.6858972692701,-58.4664785293026 -34.6860621714674,-58.4665560059861 -34.6856025100035,-58.4667206567788 -34.6842888106533,-58.4667549169208 -34.684039225931,-58.4665110775949 -34.6837734526198,-58.4659307510466 -34.6837029042671,-58.4653877668081 -34.6836369299102)))";;"3149";8_10_5;COMUNA 8;"10";"5";"2401";"1105";"1296";"85,26%";"958";"958";"100,00%";"0";"0,00%";"842";"7";"0.83";"835";"99,17%";"0.83";0.830
"MULTIPOLYGON (((-58.4657988257136 -34.6804068397768,-58.4656568012088 -34.6804875495591,-58.4650393435588 -34.6809319403238,-58.4646039738006 -34.6812560405229,-58.464298778174 -34.6814832336842,-58.4635192430063 -34.6820635375702,-58.4625621935749 -34.6827805169309,-58.4638631632172 -34.6829749658298,-58.4639360550398 -34.6830001065791,-58.463979790514 -34.6830385577825,-58.4640112498055 -34.6830926432918,-58.4644353187589 -34.684010618351,-58.4644903955519 -34.6841299162575,-58.4645243259159 -34.6840905485911,-58.464666958645 -34.6841871684619,-58.4650197315687 -34.683836519845,-58.4652388278058 -34.6836188340663,-58.4665009520043 -34.6823375019555,-58.4665518453614 -34.6822859497818,-58.4663856835832 -34.6821786987331,-58.467021206058 -34.6815295771832,-58.4657988257136 -34.6804068397768)))";;"3150";8_10_6;COMUNA 8;"10";"6";"1601";"732";"869";"84,23%";"655";"655";"100,00%";"0";"0,00%";"579";"7";"1.21";"572";"98,79%";"1.21";1.210
"MULTIPOLYGON (((-58.4644353187589 -34.684010618351,-58.4640112498055 -34.6830926432918,-58.463979790514 -34.6830385577825,-58.4639360550398 -34.6830001065791,-58.4638631632172 -34.6829749658298,-58.4625621935749 -34.6827805169309,-58.4602875172404 -34.6844689983502,-58.4612254016121 -34.6846072561247,-58.4620592781553 -34.6847301536891,-58.4621247538814 -34.6847417035938,-58.4621886948824 -34.6847782540676,-58.4623469267277 -34.6851184037746,-58.4624914346648 -34.6850735438589,-58.4627556412754 -34.6856891928077,-58.4627119902656 -34.6859034937943,-58.4628362089345 -34.6861757538353,-58.4628924784688 -34.6862990666017,-58.4629754337268 -34.6864866061859,-58.4633457861434 -34.6861089195968,-58.463241943398 -34.6860340591348,-58.4637388106353 -34.6855189025663,-58.4638544184409 -34.6855901708639,-58.4642162374868 -34.6852211438378,-58.4642446270262 -34.685192692084,-58.4646954468915 -34.6847405618292,-58.4645696897811 -34.6844721065526,-58.4645478618122 -34.6843475263695,-58.464576164745 -34.684277383373,-58.464666958645 -34.6841871684619,-58.4645243259159 -34.6840905485911,-58.4644903955519 -34.6841299162575,-58.4644353187589 -34.684010618351)))";;"3151";8_10_7;COMUNA 8;"10";"7";"1627";"739";"888";"83,22%";"644";"644";"100,00%";"0";"0,00%";"543";"8";"1.47";"535";"98,53%";"1.47";1.470
"MULTIPOLYGON (((-58.4643612790868 -34.6777888436952,-58.4642964043239 -34.677728631754,-58.4639182405699 -34.6774143322944,-58.4631843416538 -34.6768042513234,-58.4623614567562 -34.6761215581477,-58.4619787043722 -34.6758039426304,-58.4611972677635 -34.6751556088132,-58.4610855131858 -34.6750625767948,-58.4609783620068 -34.6749733476534,-58.460685289157 -34.6750017946071,-58.4606097637822 -34.6749348197604,-58.4606673094884 -34.6747143220283,-58.4603205422778 -34.6744278294002,-58.4599633777303 -34.6741396453541,-58.459611499092 -34.6738967432597,-58.4594251579132 -34.6738488498165,-58.4590036314304 -34.6737558775786,-58.4586985426647 -34.6737876997671,-58.4584507354031 -34.6738602284949,-58.4584197911552 -34.6738746644107,-58.4583549190222 -34.6739048741754,-58.457936012351 -34.6742250781783,-58.4577271546998 -34.6743821161976,-58.4550513971447 -34.6764828068699,-58.4538251948229 -34.6774377483194,-58.4535193005702 -34.6776759712037,-58.4530851800788 -34.6780140449703,-58.4529300996532 -34.6781348103705,-58.4514784246713 -34.679276122845,-58.4509397593038 -34.6796996743291,-58.4507758040552 -34.6798383942976,-58.4507121924678 -34.6799433907071,-58.450641165406 -34.6800383860962,-58.4508242536408 -34.6802420711727,-58.451197857846 -34.6805899326452,-58.4513732815699 -34.6807532630306,-58.4517311217581 -34.681079360266,-58.4517915575807 -34.6811349304604,-58.4521717339756 -34.6814846909417,-58.4526579552715 -34.681931926216,-58.4528136085637 -34.6820751115166,-58.4532984728463 -34.6825212172945,-58.4540234774161 -34.6831881185447,-58.4546609454749 -34.6837745147315,-58.4554233956762 -34.6844758474459,-58.4562264397264 -34.6851847128686,-58.4563127140534 -34.6852388736689,-58.4564697472609 -34.6853374053223,-58.4569052094737 -34.6856715194322,-58.4570002648295 -34.6857444130079,-58.4575076795063 -34.6862090244032,-58.4577743472086 -34.6864545343643,-58.4577904647287 -34.6863867868989,-58.4578117828577 -34.6863193213363,-58.4578721480968 -34.6862577025338,-58.4591899142525 -34.685277794248,-58.4592802876285 -34.6852163164465,-58.4593542063679 -34.6851601199457,-58.4599619216487 -34.68471012413,-58.4602875172404 -34.6844689983502,-58.4625621935749 -34.6827805169309,-58.4635192430063 -34.6820635375702,-58.464298778174 -34.6814832336842,-58.4646039738006 -34.6812560405229,-58.4650393435588 -34.6809319403238,-58.4656568012088 -34.6804875495591,-58.4657988257136 -34.6804068397768,-58.46572226692 -34.6803016277845,-58.4659391410043 -34.6802252118402,-58.4660321457295 -34.6801404888897,-58.4660890882349 -34.680026047816,-58.4661175588805 -34.6799554818613,-58.4661602653912 -34.6798648445669,-58.4658843008495 -34.6795933663574,-58.465837838044 -34.6795476621813,-58.4654599985259 -34.6791529430167,-58.465111827432 -34.6786976571517,-58.4650551348887 -34.6786231493228,-58.4646254685421 -34.6780651144746,-58.4644844646741 -34.6779033519244,-58.4643612790868 -34.6777888436952)))";;"3152";8_10_8;COMUNA 8;"10";"8";"1196";"579";"617";"93,84%";"369";"369";"100,00%";"0";"0,00%";"320";"9";"2.81";"311";"97,19%";"2.81";2.810
"MULTIPOLYGON (((-58.4638544184409 -34.6855901708639,-58.4637388106353 -34.6855189025663,-58.463241943398 -34.6860340591348,-58.4633457861434 -34.6861089195968,-58.4629754337268 -34.6864866061859,-58.46301976763 -34.6865880169766,-58.4634776920163 -34.687634871076,-58.4643017972457 -34.6877409923343,-58.4646827313473 -34.6877900019907,-58.4657771578789 -34.6869359446866,-58.4664180140202 -34.686435844339,-58.4668352441379 -34.6861101892191,-58.4664785293026 -34.6860621714674,-58.4652393468145 -34.6858972692701,-58.4646954468915 -34.6847405618292,-58.4642446270262 -34.685192692084,-58.4642162374868 -34.6852211438378,-58.4638544184409 -34.6855901708639)))";;"3153";8_11_1;COMUNA 8;"11";"1";"2885";"1326";"1559";"85,05%";"910";"910";"100,00%";"0";"0,00%";"910";"17";"1.87";"893";"98,13%";"1.87";1.870
"MULTIPOLYGON (((-58.4629754337268 -34.6864866061859,-58.4629552279388 -34.686507240531,-58.4626802747653 -34.6867861911881,-58.462574044301 -34.6868939401995,-58.4621978873455 -34.6872755681278,-58.4612905607383 -34.6881959351642,-58.4609288013739 -34.6885486149086,-58.460893673572 -34.688601432552,-58.4607326220129 -34.6884936810141,-58.4606944251284 -34.6885324841327,-58.4605385678947 -34.688688259824,-58.4604094843478 -34.6887391037463,-58.4602433995882 -34.6887424808739,-58.4600780821379 -34.6887461394886,-58.4606414612877 -34.6892633456814,-58.4610020173905 -34.6895943449871,-58.4617956090117 -34.6903228917657,-58.4620372360376 -34.6905447295188,-58.4626919545612 -34.6911458017447,-58.4633960497142 -34.6917921528666,-58.4640953610614 -34.6912448101566,-58.4652621383973 -34.6903316712145,-58.4653955680047 -34.6902272292596,-58.464353409697 -34.689317015094,-58.4636801925046 -34.6887289802417,-58.4635854688139 -34.6886463029435,-58.4641077583666 -34.6882386826829,-58.4646827313473 -34.6877900019907,-58.4643017972457 -34.6877409923343,-58.4634776920163 -34.687634871076,-58.46301976763 -34.6865880169766,-58.4629754337268 -34.6864866061859)))";;"3154";8_11_2;COMUNA 8;"11";"2";"2048";"912";"1136";"80,28%";"817";"817";"100,00%";"0";"0,00%";"718";"5";"0.7";"713";"99,30%";"0.7";0.700
"MULTIPOLYGON (((-58.4612254016121 -34.6846072561247,-58.4602875172404 -34.6844689983502,-58.4599619216487 -34.68471012413,-58.4593542063679 -34.6851601199457,-58.4592802876285 -34.6852163164465,-58.4597388614126 -34.6856461276366,-58.460324313808 -34.6856402952415,-58.4607969591214 -34.6862229937193,-58.4611919513652 -34.6862812400919,-58.4611425834611 -34.6865142732714,-58.461070875657 -34.68686385823,-58.4620273745204 -34.6869905604531,-58.460760677369 -34.6882704367051,-58.4609306825217 -34.6882923412225,-58.4607326220129 -34.6884936810141,-58.460893673572 -34.688601432552,-58.4609288013739 -34.6885486149086,-58.4612905607383 -34.6881959351642,-58.4621978873455 -34.6872755681278,-58.462574044301 -34.6868939401995,-58.4626802747653 -34.6867861911881,-58.4629552279388 -34.686507240531,-58.4629754337268 -34.6864866061859,-58.4628924784688 -34.6862990666017,-58.4628362089345 -34.6861757538353,-58.4627119902656 -34.6859034937943,-58.4627556412754 -34.6856891928077,-58.4624914346648 -34.6850735438589,-58.4623469267277 -34.6851184037746,-58.4621886948824 -34.6847782540676,-58.4621247538814 -34.6847417035938,-58.4620592781553 -34.6847301536891,-58.4612254016121 -34.6846072561247)))";;"3155";8_11_3;COMUNA 8;"11";"3";"2969";"1330";"1639";"81,15%";"1118";"1118";"100,00%";"0";"0,00%";"1057";"5";"0.47";"1052";"99,53%";"0.47";0.470
"MULTIPOLYGON (((-58.4620273745204 -34.6869905604531,-58.461070875657 -34.68686385823,-58.4611425834611 -34.6865142732714,-58.4611919513652 -34.6862812400919,-58.4607969591214 -34.6862229937193,-58.460324313808 -34.6856402952415,-58.4597388614126 -34.6856461276366,-58.4591189390329 -34.6862678162086,-58.4590819349468 -34.6863310560817,-58.4590770724584 -34.6863967617507,-58.45931756014 -34.6869221334473,-58.4593610381182 -34.6870017140265,-58.4593889148977 -34.6870608007157,-58.459526423866 -34.6873524311004,-58.4598846507649 -34.6881121764039,-58.4599179855525 -34.688149713277,-58.4599694810457 -34.6881685177074,-58.460760677369 -34.6882704367051,-58.4620273745204 -34.6869905604531)))";;"3156";8_11_4;COMUNA 8;"11";"4";"1915";"896";"1019";"87,93%";"711";"711";"100,00%";"0";"0,00%";"643";"6";"0.93";"637";"99,07%";"0.93";0.930
"MULTIPOLYGON (((-58.4597388614126 -34.6856461276366,-58.4592802876285 -34.6852163164465,-58.4591899142525 -34.685277794248,-58.4578721480968 -34.6862577025338,-58.4578117828577 -34.6863193213363,-58.4577904647287 -34.6863867868989,-58.4577743472086 -34.6864545343643,-58.4582881638948 -34.6869368191972,-58.4583647203349 -34.6870239367171,-58.4583832200739 -34.6870450646426,-58.4584972025629 -34.6871748604798,-58.458618515805 -34.6873404319603,-58.4587769149427 -34.6875426955357,-58.4590065045501 -34.6877622854351,-58.4593993593922 -34.6881230095574,-58.4594619368477 -34.6881804069726,-58.4600780821379 -34.6887461394886,-58.4602433995882 -34.6887424808739,-58.4604094843478 -34.6887391037463,-58.4605385678947 -34.688688259824,-58.4606944251284 -34.6885324841327,-58.4607326220129 -34.6884936810141,-58.4609306825217 -34.6882923412225,-58.460760677369 -34.6882704367051,-58.4599694810457 -34.6881685177074,-58.4599179855525 -34.688149713277,-58.4598846507649 -34.6881121764039,-58.459526423866 -34.6873524311004,-58.4593889148977 -34.6870608007157,-58.4593610381182 -34.6870017140265,-58.45931756014 -34.6869221334473,-58.4590770724584 -34.6863967617507,-58.4590819349468 -34.6863310560817,-58.4591189390329 -34.6862678162086,-58.4597388614126 -34.6856461276366)))";;"3157";8_11_5;COMUNA 8;"11";"5";"1290";"566";"724";"78,18%";"498";"498";"100,00%";"0";"0,00%";"449";"6";"1.34";"443";"98,66%";"1.34";1.340
"MULTIPOLYGON (((-58.4752120609276 -34.6914585470908,-58.4744534743421 -34.6907713530163,-58.4732705045256 -34.6916671865134,-58.4720838432274 -34.6925658256497,-58.472847116326 -34.693254794485,-58.4736067352805 -34.6939405192771,-58.4743371161637 -34.6945928610084,-58.4743460793618 -34.6945861099789,-58.4745863155904 -34.6947949870888,-58.4750676131935 -34.6952134541397,-58.4774267798657 -34.6934319846338,-58.4770061425492 -34.6930683755129,-58.476703336657 -34.6928066198579,-58.476707013106 -34.6928038382147,-58.4759740710606 -34.6921489050794,-58.4752120609276 -34.6914585470908)))";;"3158";8_12_1;COMUNA 8;"12";"1";"915";"427";"488";"87,50%";"354";"354";"100,00%";"0";"0,00%";"306";"10";"3.27";"296";"96,73%";"3.27";3.270
"MULTIPOLYGON (((-58.4705612573309 -34.6911912535068,-58.4706599987949 -34.6912806153833,-58.4713229703488 -34.6918790349347,-58.4720838432274 -34.6925658256497,-58.4732705045256 -34.6916671865134,-58.4744534743421 -34.6907713530163,-58.4736943886677 -34.6900836612171,-58.4729340365058 -34.6893947675061,-58.4721736116832 -34.6887058689781,-58.4711308032106 -34.6894949079474,-58.4709874922361 -34.6896034414691,-58.4698003242082 -34.6905028333766,-58.4705612573309 -34.6911912535068)))";;"3159";8_12_2;COMUNA 8;"12";"2";"1004";"461";"543";"84,90%";"378";"378";"100,00%";"0";"0,00%";"356";"3";"0.84";"353";"99,16%";"0.84";0.840
"MULTIPOLYGON (((-58.4706499017097 -34.6873346775159,-58.4699292475305 -34.6866821010533,-58.4698087875001 -34.6867762653381,-58.4695628367922 -34.6869688192834,-58.4688113373511 -34.6875569719998,-58.4687618053618 -34.6875957077961,-58.4686721191007 -34.6876659251737,-58.4680581221379 -34.6881455426471,-58.4675827427872 -34.6885169095021,-58.4682795189415 -34.689126964518,-58.4690400858149 -34.6898150421985,-58.4698003242082 -34.6905028333766,-58.4709874922361 -34.6896034414691,-58.4711308032106 -34.6894949079474,-58.4721736116832 -34.6887058689781,-58.4715582378604 -34.6881482963361,-58.4714111535406 -34.6880196418923,-58.4712707204177 -34.6878968320111,-58.4706499017097 -34.6873346775159)))";;"3160";8_12_3;COMUNA 8;"12";"3";"1003";"488";"515";"94,76%";"361";"361";"100,00%";"0";"0,00%";"331";"13";"3.93";"318";"96,07%";"3.93";3.930
"MULTIPOLYGON (((-58.4666612423952 -34.6916162413131,-58.4674254848154 -34.6923020046705,-58.4686092086707 -34.6914052420201,-58.4698003242082 -34.6905028333766,-58.4690400858149 -34.6898150421985,-58.4682795189415 -34.689126964518,-58.4675827427872 -34.6885169095021,-58.467099600922 -34.6888943312428,-58.4669049618009 -34.6890463839768,-58.4666045187654 -34.6892811178472,-58.4664907012322 -34.6893702080573,-58.4664236894444 -34.6894226057296,-58.4658780432615 -34.6898496735249,-58.4653955680047 -34.6902272292596,-58.4652621383973 -34.6903316712145,-58.4640953610614 -34.6912448101566,-58.4633960497142 -34.6917921528666,-58.4640142948694 -34.6923596961646,-58.4647668413223 -34.6930505467753,-58.4654837185447 -34.6925077734838,-58.4666612423952 -34.6916162413131)))";;"3161";8_12_4;COMUNA 8;"12";"4";"979";"488";"491";"99,39%";"270";"270";"100,00%";"0";"0,00%";"302";"12";"3.97";"290";"96,03%";"3.97";3.970
"MULTIPOLYGON (((-58.4686092086707 -34.6914052420201,-58.4674254848154 -34.6923020046705,-58.4681891429612 -34.6929871997907,-58.4683011006033 -34.6930876899733,-58.468953154814 -34.6936732351199,-58.4696059003799 -34.6942594104991,-58.4697174351353 -34.6943600402316,-58.4708966447425 -34.6934649461065,-58.4710211206004 -34.6933704988786,-58.4720838432274 -34.6925658256497,-58.4713229703488 -34.6918790349347,-58.4706599987949 -34.6912806153833,-58.4705612573309 -34.6911912535068,-58.4698003242082 -34.6905028333766,-58.4686092086707 -34.6914052420201)))";;"3162";8_12_5;COMUNA 8;"12";"5";"978";"475";"503";"94,43%";"397";"397";"100,00%";"0";"0,00%";"341";"5";"1.47";"336";"98,53%";"1.47";1.470
"MULTIPOLYGON (((-58.4701431690927 -34.6981409665552,-58.4706306780172 -34.6985635700337,-58.4726956654222 -34.6970044514834,-58.4750676131935 -34.6952134541397,-58.4745863155904 -34.6947949870888,-58.4743460793618 -34.6945861099789,-58.4743371161637 -34.6945928610084,-58.4736067352805 -34.6939405192771,-58.472847116326 -34.693254794485,-58.4720838432274 -34.6925658256497,-58.4710211206004 -34.6933704988786,-58.4708966447425 -34.6934649461065,-58.4697174351353 -34.6943600402316,-58.4704752476599 -34.6950442351918,-58.4692939652087 -34.6959454520202,-58.4700539203195 -34.6966289450644,-58.4692974755338 -34.6972013251475,-58.4700154024767 -34.6978582706708,-58.4699129535681 -34.6979413990389,-58.4701431690927 -34.6981409665552)))";;"3163";8_12_6;COMUNA 8;"12";"6";"744";"349";"395";"88,35%";"285";"284";"99,65%";"1";"0,35%";"249";"8";"3.21";"241";"96,79%";"3.21";3.210
"MULTIPOLYGON (((-58.468953154814 -34.6936732351199,-58.4683011006033 -34.6930876899733,-58.4681891429612 -34.6929871997907,-58.4674254848154 -34.6923020046705,-58.4666612423952 -34.6916162413131,-58.4654837185447 -34.6925077734838,-58.4647668413223 -34.6930505467753,-58.4640142948694 -34.6923596961646,-58.4633960497142 -34.6917921528666,-58.4626919545612 -34.6911458017447,-58.4620372360376 -34.6905447295188,-58.4617956090117 -34.6903228917657,-58.4610020173905 -34.6895943449871,-58.4606414612877 -34.6892633456814,-58.4600780821379 -34.6887461394886,-58.4594619368477 -34.6881804069726,-58.4593993593922 -34.6881230095574,-58.4590065045501 -34.6877622854351,-58.4587769149427 -34.6875426955357,-58.458618515805 -34.6873404319603,-58.4584972025629 -34.6871748604798,-58.4583832200739 -34.6870450646426,-58.4583647203349 -34.6870239367171,-58.4582881638948 -34.6869368191972,-58.4577743472086 -34.6864545343643,-58.4575076795063 -34.6862090244032,-58.4570002648295 -34.6857444130079,-58.4569052094737 -34.6856715194322,-58.4564697472609 -34.6853374053223,-58.4563127140534 -34.6852388736689,-58.4562264397264 -34.6851847128686,-58.4554233956762 -34.6844758474459,-58.4546609454749 -34.6837745147315,-58.4540234774161 -34.6831881185447,-58.4532984728463 -34.6825212172945,-58.4528136085637 -34.6820751115166,-58.4526579552715 -34.681931926216,-58.4521717339756 -34.6814846909417,-58.4517915575807 -34.6811349304604,-58.4517311217581 -34.681079360266,-58.4513732815699 -34.6807532630306,-58.451197857846 -34.6805899326452,-58.4511636576215 -34.6806958475651,-58.4511155614284 -34.680801620305,-58.4510476104214 -34.6808445726518,-58.450931492979 -34.6808842808017,-58.450808049272 -34.6808859590042,-58.4503188617981 -34.6804284340257,-58.450133270405 -34.6804347532208,-58.449935052672 -34.6805012131681,-58.4497832896309 -34.6806102844275,-58.4492956788069 -34.6809943259195,-58.4445196001539 -34.6847555607127,-58.4442953404777 -34.6849321510845,-58.4442953015758 -34.6849321503822,-58.4441819215472 -34.6850202330119,-58.4442535330857 -34.6850780638144,-58.4442830222524 -34.6851194777332,-58.4443597321739 -34.6852097027642,-58.4443980906917 -34.6852389345935,-58.4444747981937 -34.6853412725206,-58.4445425598803 -34.6854168478516,-58.4445927558353 -34.6855069983547,-58.4446546287707 -34.6856117988081,-58.4447711490972 -34.6857251286125,-58.4448537417323 -34.6858202134617,-58.4449038639674 -34.6858591653962,-58.4449540621286 -34.6859420620475,-58.4449687989879 -34.6860005163121,-58.4450720370716 -34.6860346870435,-58.445116261902 -34.6861443439724,-58.4452578487686 -34.6862588741275,-58.4453463302813 -34.6863295926915,-58.445400879045 -34.6864038980152,-58.4454421306309 -34.6864648208267,-58.445471609268 -34.6865622921378,-58.4455305853598 -34.6866670917192,-58.4456131843129 -34.6867402036799,-58.4457164136274 -34.6868231074283,-58.4458108591978 -34.686918122839,-58.4458919203151 -34.6870095446943,-58.4459833798403 -34.687116742948,-58.4460217309951 -34.687189918974,-58.446104321174 -34.6873117641588,-58.4462016693963 -34.6873922018398,-58.446269524882 -34.6874409445692,-58.4463255267453 -34.6875042634827,-58.4463786275216 -34.6875798357961,-58.4464390527151 -34.6876956212932,-58.4465570294345 -34.6878004282161,-58.4466426097468 -34.6878979066404,-58.4467133553154 -34.6879953830582,-58.4467783039506 -34.6880903938287,-58.4468460639284 -34.6881976587423,-58.4469169012639 -34.6882634441528,-58.446992084827 -34.6883402162589,-58.447051073266 -34.6883962815208,-58.4471248051675 -34.6884864339573,-58.4471867683087 -34.6885936979337,-58.4472693737938 -34.6886497660914,-58.4473283599446 -34.6887204090274,-58.4474315885132 -34.6888300724958,-58.447474377675 -34.6888897975767,-58.4475303836409 -34.6889410029588,-58.4475834855459 -34.6890214340001,-58.4476070900006 -34.6890896779805,-58.4476513286165 -34.6891506003878,-58.4477309557141 -34.6891798362382,-58.447769314188 -34.6892261096451,-58.4477575378523 -34.6892846307147,-58.4478165392503 -34.689274919394,-58.4478696507763 -34.6893041519124,-58.4478607746496 -34.6893552788029,-58.4478725300522 -34.6894138027451,-58.4479462702311 -34.6894674045108,-58.4480628008665 -34.6895783366765,-58.4481041408164 -34.6896416529892,-58.448183765556 -34.6896880016214,-58.4482368685699 -34.6897684323684,-58.4482958529568 -34.6898585823255,-58.4484138384363 -34.6899438799135,-58.4484580710053 -34.6900462114451,-58.4484875561068 -34.6901339634322,-58.4485436575113 -34.6901339699614,-58.448609975509 -34.6902205289789,-58.4486601021556 -34.6902594793417,-58.448701441654 -34.6903301899848,-58.4487633217257 -34.6904447068097,-58.4487987735168 -34.6905446427825,-58.4488961301524 -34.6906128948862,-58.4489639073999 -34.6906445934281,-58.4490524812055 -34.6907200981068,-58.4491099302518 -34.6908236985035,-58.4491601356131 -34.6909065229326,-58.4491896245294 -34.6909772320856,-58.4492633669438 -34.6910308330411,-58.4493341245095 -34.691089363317,-58.4493694982547 -34.6911502841085,-58.4494403404946 -34.6912136031752,-58.4494815954883 -34.6912867079556,-58.4495524394554 -34.6913403788434,-58.4496187587119 -34.6914317261394,-58.4497043459646 -34.6915316672036,-58.449766318492 -34.6916145630518,-58.4498223284678 -34.6916608376663,-58.4498754328272 -34.6917509862099,-58.4499403057285 -34.6918265581578,-58.4500140445449 -34.6919118495292,-58.4500730338546 -34.6919922800597,-58.4501305751044 -34.6920641890866,-58.4502013356313 -34.69211292989,-58.4502338151726 -34.6921494833608,-58.4502691903962 -34.6922079390349,-58.4502780547944 -34.6922274474335,-58.4503576796049 -34.6922981613885,-58.4503990215705 -34.6923688010085,-58.4504845276147 -34.6924540932749,-58.4504992709406 -34.6925028282747,-58.4505523808415 -34.6925637504831,-58.4506232227008 -34.6926441819196,-58.4507573996399 -34.6928330727472,-58.4508783712261 -34.692952523919,-58.450975728952 -34.6930451410944,-58.4510347152135 -34.6931596564371,-58.4511468226243 -34.6932619934172,-58.4511999321306 -34.6933327042936,-58.4512736742425 -34.6934131356157,-58.4513769128423 -34.6935301197722,-58.4515169781212 -34.6937043620597,-58.4515671944653 -34.6937360575256,-58.4515937008937 -34.6938164139005,-58.4516615651006 -34.6938627591572,-58.451714680267 -34.6938968492451,-58.4517471566708 -34.6939675580141,-58.4517839846612 -34.6940150976188,-58.4518193652798 -34.6940467212252,-58.45184007818 -34.6940955270072,-58.4519019742389 -34.6941418011717,-58.451949201377 -34.6942149056112,-58.4520318159743 -34.6942685056459,-58.452070177001 -34.6943318907286,-58.4520996640214 -34.6944464029553,-58.4521586574501 -34.6945244380228,-58.4522382891348 -34.6945707135461,-58.4522677838059 -34.6946267736913,-58.452331215719 -34.6946694561342,-58.4523872237379 -34.6947596037862,-58.4524255873769 -34.6948058756863,-58.4524728210443 -34.6948327112562,-58.4525288352888 -34.6948741253376,-58.4525524505173 -34.694900958903,-58.4525376921599 -34.6949618745526,-58.4525966902252 -34.6950081481161,-58.4526409356455 -34.6950690686544,-58.4526822835591 -34.6951178759865,-58.4527619062036 -34.695246969945,-58.4528342001249 -34.6953432456097,-58.4528725657139 -34.695377404414,-58.4529463146944 -34.6954285382589,-58.4529964416707 -34.6955089666189,-58.4530613194916 -34.6955918609694,-58.4531085529739 -34.6956259499749,-58.4531469146061 -34.6956966588141,-58.4531911635829 -34.6957332123976,-58.4532324280064 -34.6957721601533,-58.4532766792641 -34.6957892766461,-58.453359303949 -34.6957746347883,-58.4534066258916 -34.6957821737878,-58.4534318615642 -34.6958104157849,-58.4534642591263 -34.6958431654638,-58.4534804561088 -34.6958758434852,-58.4534498400157 -34.6959249267816,-58.4534065207628 -34.6959598538525,-58.4534094154626 -34.695998869039,-58.4533873272083 -34.6960366146843,-58.4534285943168 -34.6960536604691,-58.4534640614134 -34.6960878188627,-58.4535170897088 -34.6961559934222,-58.4535643226227 -34.6961998712011,-58.4536026867723 -34.6962535372527,-58.4536764335393 -34.6963363615033,-58.453673446026 -34.6963655872925,-58.453711815066 -34.6963753790812,-58.4537354305787 -34.6964070716752,-58.4537471932207 -34.6964460170787,-58.4538136116268 -34.6964886989567,-58.4538372248755 -34.6965422934314,-58.453893243018 -34.6965641993935,-58.4539079911261 -34.6965934968918,-58.4539699739246 -34.6966544182102,-58.453975854803 -34.6966787853762,-58.454011238147 -34.6967031546488,-58.454028970176 -34.6967372411845,-58.4540732213588 -34.6967616110695,-58.4541174677835 -34.6968323200065,-58.4542738305909 -34.6970053629688,-58.4543151787143 -34.6970711419429,-58.4543210580056 -34.6971125517257,-58.4543844933555 -34.6971503738192,-58.4544405081757 -34.6972112944853,-58.4544493665931 -34.6973062972113,-58.4545024834152 -34.6973574991241,-58.4545673682383 -34.6973989128479,-58.4546322483964 -34.6974890600199,-58.4547237323451 -34.6975792793243,-58.4548240839339 -34.6976742879713,-58.4548594642704 -34.6977376719481,-58.4549125818517 -34.6977864088349,-58.4549465133119 -34.6978436657956,-58.455020267324 -34.6978778261563,-58.4550674158488 -34.6979314218613,-58.4550733799525 -34.6979825501335,-58.455173650685 -34.698038613953,-58.4551795291471 -34.698094671901,-58.4552001624026 -34.6981141806486,-58.4552680323488 -34.6981580590215,-58.4553063978566 -34.6982189782021,-58.4553742623587 -34.6983262382041,-58.4554451148624 -34.69839441297,-58.4554406782131 -34.6984249063402,-58.4555468267893 -34.6985565352543,-58.4555734261642 -34.6986101295497,-58.4556117929391 -34.6986612596805,-58.4556795801297 -34.698683235922,-58.4556795784821 -34.6987027433962,-58.455744545927 -34.6987953548051,-58.4558211980569 -34.6988562759965,-58.4558241788582 -34.6989001503743,-58.4558714137507 -34.6989537457642,-58.4558743105152 -34.6989829719245,-58.455937748996 -34.6990085394063,-58.4559849830334 -34.6990743885428,-58.4560646157592 -34.6991889024745,-58.4561177332344 -34.6992596111399,-58.4561738360159 -34.6993205309932,-58.4562239711224 -34.699366802293,-58.4562563672834 -34.69944969316,-58.4563213402562 -34.6994862466787,-58.4563567236234 -34.6995349819925,-58.4563979912302 -34.6995763934954,-58.4564334601367 -34.6996226639478,-58.4564732774077 -34.699675061507,-58.4565440481314 -34.6997237985681,-58.4565853981444 -34.6998066897947,-58.4566680200513 -34.699877329266,-58.4568420416576 -34.7000967087638,-58.4569836649164 -34.7002624233437,-58.457079589141 -34.7003440493097,-58.4571414922792 -34.7003976448704,-58.4571356049909 -34.7004512373225,-58.457194609507 -34.7004975790432,-58.4572654669429 -34.7005414564216,-58.4573008519486 -34.7005804025069,-58.4573273656229 -34.7006681520729,-58.4573568669846 -34.7007071683057,-58.457436594764 -34.7007217495581,-58.4574542423965 -34.7007778078795,-58.457513247779 -34.7008168253402,-58.4575279961031 -34.700875277945,-58.4575782159161 -34.7009581691953,-58.4577094469294 -34.7009910626801,-58.4577478149506 -34.7010617700094,-58.4577773126119 -34.701168956634,-58.4578481710716 -34.7012103688266,-58.4579395769189 -34.7013078393376,-58.458013417346 -34.7013980554257,-58.4580251816011 -34.7014565078499,-58.4581195747359 -34.7015125689882,-58.4581195732573 -34.7015394005558,-58.4582051850923 -34.7015661648871,-58.4581801102225 -34.7016551095486,-58.4582272629233 -34.7017087744223,-58.4583217426548 -34.7017477223584,-58.4583895313113 -34.7018037823261,-58.4583954960911 -34.7018866716536,-58.4584278964058 -34.7019499840214,-58.4584840047968 -34.7019694934393,-58.4585636464061 -34.7020304129775,-58.4586315203706 -34.7020937969127,-58.4587022932473 -34.7021668994241,-58.4587982210137 -34.7022558481136,-58.4588336053118 -34.7023411327697,-58.4588867287239 -34.7023776845268,-58.4589723377308 -34.7024922671074,-58.459046097739 -34.7025214953224,-58.4591346065123 -34.7026336130316,-58.4592112631323 -34.7027310821336,-58.4592614866542 -34.7027920003624,-58.459298320658 -34.7028931303273,-58.4594075516785 -34.703005177984,-58.4594842099014 -34.7030783506133,-58.4595727216023 -34.7031441289738,-58.4596288307975 -34.7031709619612,-58.4596759837896 -34.7032659651737,-58.4597615960942 -34.7033439266821,-58.4597615939405 -34.7034048434772,-58.4598530898857 -34.7034974532614,-58.459957803832 -34.703581541965,-58.4600640522723 -34.7036863352777,-58.4601083074045 -34.703759436377,-58.4601820681986 -34.7038130306147,-58.4602351924198 -34.7038740189153,-58.4602351909745 -34.7039227523472,-58.4602469573656 -34.7039738804333,-58.460326603509 -34.7039885302096,-58.4604181008598 -34.7040762803025,-58.4605833598784 -34.7042151594757,-58.4607121220615 -34.7043395304816,-58.4608729488864 -34.7044282672756,-58.4609457724797 -34.704494185236,-58.461084256706 -34.7046351056287,-58.4612318661991 -34.7047580678448,-58.4612799606728 -34.7048110977051,-58.4613325747303 -34.7048692685505,-58.4617154571994 -34.7052930840034,-58.461752211484 -34.7052659710477,-58.4706306780172 -34.6985635700337,-58.4701431690927 -34.6981409665552,-58.4699129535681 -34.6979413990389,-58.4700154024767 -34.6978582706708,-58.4692974755338 -34.6972013251475,-58.4700539203195 -34.6966289450644,-58.4692939652087 -34.6959454520202,-58.4704752476599 -34.6950442351918,-58.4697174351353 -34.6943600402316,-58.4696059003799 -34.6942594104991,-58.468953154814 -34.6936732351199)))";;"3164";8_12_7;COMUNA 8;"12";"7";"826";"408";"418";"97,61%";"272";"272";"100,00%";"0";"0,00%";"278";"11";"3.96";"267";"96,04%";"3.96";3.960
"MULTIPOLYGON (((-58.4503188617981 -34.6804284340257,-58.450808049272 -34.6808859590042,-58.450931492979 -34.6808842808017,-58.4510476104214 -34.6808445726518,-58.4511155614284 -34.680801620305,-58.4511636576215 -34.6806958475651,-58.451197857846 -34.6805899326452,-58.4508242536408 -34.6802420711727,-58.450641165406 -34.6800383860962,-58.4507121924678 -34.6799433907071,-58.4507758040552 -34.6798383942976,-58.4509397593038 -34.6796996743291,-58.4514784246713 -34.679276122845,-58.4529300996532 -34.6781348103705,-58.4530851800788 -34.6780140449703,-58.4535193005702 -34.6776759712037,-58.4538251948229 -34.6774377483194,-58.4550513971447 -34.6764828068699,-58.4577271546998 -34.6743821161976,-58.457936012351 -34.6742250781783,-58.4583549190222 -34.6739048741754,-58.4584197911552 -34.6738746644107,-58.4584507354031 -34.6738602284949,-58.4586985426647 -34.6737876997671,-58.4590036314304 -34.6737558775786,-58.458782681749 -34.673713123078,-58.4586122847205 -34.6736101570335,-58.4584571496942 -34.6734483164942,-58.458401150537 -34.6733369735758,-58.4583972340077 -34.6732468302203,-58.45839357291 -34.6731626025211,-58.4583159308457 -34.6728892826897,-58.4582109240345 -34.6726604700103,-58.4581536457569 -34.6725737050314,-58.4540574633124 -34.6687078166671,-58.4535609869546 -34.6683606583791,-58.4525298313537 -34.6679030290812,-58.4523006476495 -34.6677389207751,-58.452109740455 -34.6675431947846,-58.4519952082512 -34.6673349396658,-58.4519417046236 -34.6671392958113,-58.4519426599804 -34.6670019681983,-58.4521650305242 -34.6670986804008,-58.4520775292374 -34.6668088057247,-58.4519326348218 -34.6667485800977,-58.4518381539827 -34.6667089360616,-58.4517890583459 -34.6665043097042,-58.4516783206659 -34.6662586373625,-58.4515938060007 -34.6661068970408,-58.4515557875997 -34.666047398886,-58.4514568303482 -34.6658925320028,-58.451280508999 -34.665636015162,-58.4510619026986 -34.6655155717385,-58.451024010441 -34.66549870893,-58.4509161630158 -34.6654529379074,-58.4507062970642 -34.6653710299692,-58.4504818556498 -34.6652963455741,-58.4502836467693 -34.6652385226256,-58.4501326971972 -34.6651881788303,-58.4501213363841 -34.6652032937421,-58.450077694532 -34.6652135712059,-58.449957339624 -34.6652341226346,-58.4498432094551 -34.665237561452,-58.4497913018864 -34.6652341051675,-58.4497415294617 -34.6652032539646,-58.4497002827873 -34.6651581779052,-58.4491704818959 -34.6655640469637,-58.4491489999132 -34.6655805239056,-58.44900416566 -34.6656985391438,-58.4489653783105 -34.6657301553699,-58.4469743186588 -34.6673158033566,-58.4463344286953 -34.6678253809101,-58.4455728761088 -34.6684318420653,-58.4444829165251 -34.6692929749519,-58.4443216266502 -34.6693718965333,-58.4441184922316 -34.6694138387028,-58.4439554369891 -34.669380714258,-58.4437496089156 -34.6692724400832,-58.4435082447377 -34.6691293702992,-58.4434382822442 -34.6690485824375,-58.4434151034861 -34.6690217470628,-58.4430883866249 -34.6686444312243,-58.4426853780545 -34.6682944970955,-58.4426474550374 -34.6682615322234,-58.44261779839 -34.6682358224192,-58.4424458243258 -34.6680865645675,-58.4419836792276 -34.6676847154282,-58.4414615450104 -34.6672306695531,-58.441337127362 -34.6671200109922,-58.4409470887006 -34.6667731015562,-58.4403568812834 -34.6662480508558,-58.4401551847395 -34.666037233288,-58.4399324285029 -34.6661655052764,-58.4397519517134 -34.666282728179,-58.4378482172457 -34.6673818216636,-58.4368562196101 -34.6679545183226,-58.4354876394717 -34.6687445236217,-58.4341446954811 -34.6695197303257,-58.4340855276212 -34.6695538723005,-58.4340301962392 -34.6695858319913,-58.432291626998 -34.6705893812969,-58.4323660091818 -34.6706791909579,-58.4323659889224 -34.6706791949499,-58.4321802721426 -34.6708116489853,-58.4321804771188 -34.6708117538243,-58.4322219714035 -34.6708607091726,-58.4322603943897 -34.6709169878784,-58.4323018008831 -34.6709731968912,-58.43236689814 -34.6710465953428,-58.4324290067479 -34.6711346412939,-58.4325074822133 -34.6712214940519,-58.432557751427 -34.6712850997326,-58.4326287308247 -34.6713584290706,-58.4326672166045 -34.6714783008983,-58.4327530405916 -34.6715174075567,-58.4328003249489 -34.6715859421094,-58.4329053913501 -34.6716874493999,-58.4329527638146 -34.6717485893509,-58.4330060154127 -34.6718170548529,-58.4330651470255 -34.6718904514685,-58.4331154153417 -34.6719589161959,-58.4331746358672 -34.6720225237868,-58.4332160409079 -34.6720861270407,-58.4332545547103 -34.6721301515988,-58.4332988701905 -34.672159529269,-58.433298854638 -34.6722035445141,-58.4333669544673 -34.6722279981852,-58.4334127979535 -34.6722756865245,-58.4334483181457 -34.6723490772741,-58.4335459903503 -34.6723931159191,-58.43357555915 -34.6724224899599,-58.4336555190388 -34.6724151144752,-58.4337146738022 -34.6724249175456,-58.4337620464238 -34.6724885220288,-58.4337338938769 -34.6725533057856,-58.4337279124122 -34.6725949251808,-58.4337575555426 -34.6726560605954,-58.4338166909812 -34.6727220622765,-58.4338610752537 -34.6728003847079,-58.4339084431322 -34.6728786374024,-58.4339587152689 -34.6729397776357,-58.4340089874794 -34.6730009178477,-58.4340089714521 -34.6730473979404,-58.4340415334187 -34.6730498704533,-58.434082955619 -34.6730669933104,-58.4341732943344 -34.6731220159306,-58.4342294443945 -34.6731954112686,-58.43427979804 -34.6732687348042,-58.4343300631694 -34.6733519177114,-58.4343684995699 -34.6733763639118,-58.4344306972772 -34.6734644088313,-58.4345253712167 -34.6735573909347,-58.4346023114189 -34.6736600874417,-58.4346688549497 -34.6737542601583,-58.4347428168999 -34.6738423076177,-58.4348256443699 -34.6739303570585,-58.434890737174 -34.674030656239,-58.434991380178 -34.6741211744806,-58.4350534962904 -34.6742018949182,-58.4351037733144 -34.6742532456795,-58.4351289865574 -34.674310717674,-58.4351733834433 -34.6743572077938,-58.4352443620956 -34.6744477191198,-58.4353006056865 -34.6745015359946,-58.4353686123072 -34.6745577499095,-58.4354071179501 -34.6746336055838,-58.4354633617719 -34.674687422382,-58.4355136361437 -34.6747485619569,-58.4355343410212 -34.6747779335345,-58.4355343274546 -34.6748194839088,-58.4355905842427 -34.6748341447011,-58.4356349769007 -34.6748952829164,-58.4356630053665 -34.6749478961382,-58.435674838535 -34.6749967732725,-58.4357429381546 -34.675031085017,-58.4357932192709 -34.6750726465013,-58.4358494573209 -34.6751460410896,-58.4359086672596 -34.6752560569733,-58.4359737757533 -34.6753148051839,-58.4360299398749 -34.6753539030057,-58.4360713550212 -34.6753979272858,-58.4360980164925 -34.675461526305,-58.4361394348534 -34.6754957615758,-58.4361779494455 -34.67554710932,-58.436186796264 -34.6756058451604,-58.4361926727578 -34.6756229595576,-58.4362178182634 -34.6756290919421,-58.4362888983548 -34.6756755874397,-58.4363361965335 -34.6757171480495,-58.436419115115 -34.6757978722679,-58.4364693993416 -34.6758321093359,-58.4365167806402 -34.6758809940254,-58.4366025917816 -34.675981296709,-58.4366498841605 -34.6760424351643,-58.4367209434713 -34.6761573828739,-58.4368067635166 -34.6762307833088,-58.4368733191837 -34.6763005175361,-58.4369028799336 -34.6763641169843,-58.4369354243758 -34.6764276466311,-58.4369649889871 -34.6764790626514,-58.437068629887 -34.6765402128224,-58.4370923133851 -34.6765890922976,-58.4371691802979 -34.6766722795754,-58.4372698222592 -34.6767847682937,-58.4373142097133 -34.6768704135494,-58.4373719051141 -34.6769254269639,-58.4374311346523 -34.6769817083069,-58.4374458631014 -34.6770452341167,-58.4374932448964 -34.6770966536937,-58.4375465110408 -34.6771406799104,-58.4375849405483 -34.6771968864586,-58.4376707594828 -34.677280075256,-58.4377121823365 -34.6773045210003,-58.4377743901677 -34.6773803807498,-58.4378512585145 -34.677463497163,-58.4379356138551 -34.6775968275999,-58.4379711468589 -34.6776481741546,-58.4380421349935 -34.6777264299716,-58.4381486614933 -34.6778389895599,-58.4381990105957 -34.6779490024986,-58.4382936981669 -34.6780272629266,-58.4383883816149 -34.6781202419644,-58.4384593719606 -34.6781936382542,-58.4384697512424 -34.678265754831,-58.4385437340054 -34.67830978472,-58.4386029596508 -34.6783856434435,-58.4386679766682 -34.6784810108177,-58.4387420491949 -34.6785103923427,-58.4387774915192 -34.6785837110265,-58.4388455876608 -34.6786448526855,-58.4388632976595 -34.678720703147,-58.4389579874374 -34.6787964981986,-58.4390216359675 -34.6789102458592,-58.4390897256199 -34.6789958246167,-58.4391311386511 -34.6790594257921,-58.4391962551623 -34.6791083832673,-58.4392583777073 -34.6791939607771,-58.4392583494475 -34.6792942450001,-58.4393086355894 -34.6793333401561,-58.4394004266067 -34.6794140640023,-58.4394329713907 -34.6794874523553,-58.4395706185164 -34.6795987489679,-58.4396416084531 -34.6796819335313,-58.4397511328284 -34.6797601956114,-58.4398221264535 -34.6798311262381,-58.4398990950736 -34.6798751558539,-58.4399168002763 -34.679972978531,-58.4399079248908 -34.680007203086,-58.4400174472757 -34.6800952539012,-58.4400765902854 -34.6801711118716,-58.4401624234037 -34.6802224670916,-58.4403573919276 -34.6802187000719,-58.4404124434289 -34.680294134582,-58.4405891130207 -34.6804991719076,-58.4405553429228 -34.6805399414488,-58.4405155181893 -34.6805874706115,-58.4405272717484 -34.6806288822397,-58.4405774695288 -34.6806849491046,-58.4405922010723 -34.6807483336481,-58.4405892043378 -34.6807970667203,-58.4406156908604 -34.6808969331785,-58.4406717621412 -34.6809871568506,-58.4407204228297 -34.6810541391416,-58.4407587710746 -34.6811102037906,-58.4408147651111 -34.681171130873,-58.4408177309544 -34.6812393725476,-58.440832457021 -34.6813246590109,-58.4408736957019 -34.6814124150717,-58.4409651559659 -34.6814684891514,-58.4410418728948 -34.6815050530144,-58.4411686320083 -34.6815440201048,-58.4412247125069 -34.681602552584,-58.4412276868826 -34.6816391033148,-58.4411952078475 -34.6816317734628,-58.4411568344444 -34.6816707817435,-58.4411951908418 -34.6816975497467,-58.4412394270991 -34.6817341781735,-58.441345651573 -34.6817317319793,-58.4413972130502 -34.6817938552244,-58.4414444245567 -34.6818645694516,-58.4415240393942 -34.6819059927901,-58.4415889069315 -34.6819425542471,-58.4415948603541 -34.6819986130102,-58.4415977465634 -34.6820473471158,-58.4416744593733 -34.6821034181036,-58.4417599514311 -34.6821668146767,-58.4418838790337 -34.6822838106388,-58.4419679091017 -34.6823995320561,-58.4420239060995 -34.6824555992956,-58.4421006087072 -34.6825555443364,-58.4421890830055 -34.6826286596585,-58.4422215493226 -34.6826895821184,-58.4422716648408 -34.6827431834035,-58.4423483703892 -34.6828334097341,-58.4423954891357 -34.6829406033404,-58.4424279521554 -34.683016173991,-58.4425149776352 -34.6830904860428,-58.442582820382 -34.6831684569293,-58.4426506691126 -34.6832221314042,-58.4427125455178 -34.6832952419606,-58.4427715257562 -34.6833585630376,-58.4427773977415 -34.683402438318,-58.4427478953199 -34.6834219410151,-58.4427331376711 -34.6834584887945,-58.4427361151084 -34.6834853209288,-58.442800979743 -34.6835413892536,-58.4429071937261 -34.6835925345662,-58.4429926899894 -34.6836486061365,-58.4430960044331 -34.6837046805135,-58.4431534515265 -34.6837644095174,-58.443197687483 -34.6838106853459,-58.4432419229121 -34.6838594260071,-58.4432802701537 -34.6839326029337,-58.4433038730504 -34.6839861995567,-58.443368737329 -34.6840471268489,-58.4434012050635 -34.684108048981,-58.4434543139866 -34.6841275648989,-58.4435074145003 -34.6841836309839,-58.4435516475042 -34.6842445549266,-58.443551631793 -34.6843127960322,-58.4436592918107 -34.6843846456424,-58.4436740341541 -34.6844139444362,-58.4437035166684 -34.6844821901409,-58.4437359051191 -34.6845187453741,-58.4437654779784 -34.6845650187087,-58.4437949633906 -34.6846210809937,-58.4438155873223 -34.6846551695307,-58.4438420921829 -34.6846966535209,-58.4438893156976 -34.6847307461575,-58.4439453139083 -34.684794136616,-58.4440102749551 -34.6848087244148,-58.4440545048232 -34.6848867612619,-58.4440551712589 -34.6848871185976,-58.444113494294 -34.6849183907611,-58.4441222635868 -34.6849720553785,-58.4441819215472 -34.6850202330119,-58.4442953015758 -34.6849321503822,-58.4442953404777 -34.6849321510845,-58.4445196001539 -34.6847555607127,-58.4492956788069 -34.6809943259195,-58.4497832896309 -34.6806102844275,-58.449935052672 -34.6805012131681,-58.450133270405 -34.6804347532208,-58.4503188617981 -34.6804284340257)))";;"3165";8_13_1;COMUNA 8;"13";"1";"45";"29";"16";"181,25%";"11";"11";"100,00%";"0";"0,00%";"20";"14";"70";"6";"30,00%";"70";70.000
"MULTIPOLYGON (((-58.4259464599304 -34.6614100576709,-58.425797602315 -34.6613174748864,-58.4250287065924 -34.6608125775992,-58.4249419787505 -34.6609194552037,-58.4246979359646 -34.6612211809477,-58.4246123756264 -34.6613342006985,-58.4241246931952 -34.6619440271361,-58.4240111499906 -34.6620873240296,-58.4240861328985 -34.6621206998784,-58.4241259958473 -34.662175784465,-58.4241910869656 -34.6622320038012,-58.4242561713741 -34.6623029418226,-58.4243804988994 -34.6623592501447,-58.4244366420659 -34.6624130721022,-58.424519532494 -34.6625011287233,-58.4245461036236 -34.6625476172163,-58.4246200650461 -34.662591655656,-58.4247355491957 -34.6626038751102,-58.4248065420966 -34.6626161510597,-58.4248775272425 -34.6626455401204,-58.424972264555 -34.6627360649628,-58.4250890811725 -34.662818004754,-58.4251778581546 -34.6628962737318,-58.4252755027922 -34.6629672212181,-58.4253761351306 -34.6630283805343,-58.4254322750094 -34.6630919910325,-58.4255565968729 -34.6631654113005,-58.4256305463005 -34.663238816136,-58.4256808076322 -34.6632974950152,-58.4257784586048 -34.6633561882336,-58.4258465327381 -34.6634173372938,-58.4259249185353 -34.6634822219246,-58.4259811519533 -34.6635286486167,-58.4260225483292 -34.6635898599641,-58.4260728112338 -34.6636460738217,-58.4261409008536 -34.6636729964151,-58.426197122692 -34.663746395584,-58.4262029887916 -34.6637806236441,-58.4261881356462 -34.6638319586525,-58.4262296336355 -34.6638564787965,-58.426241467187 -34.6638882437818,-58.4263064726064 -34.6639518565197,-58.4263479482988 -34.6640276456458,-58.4264219077233 -34.6640814719861,-58.4265180274904 -34.6641365725003,-58.4265387234032 -34.6641731993749,-58.4266097851268 -34.6642270247405,-58.4266925975944 -34.6643077556896,-58.4267725080378 -34.6643982747299,-58.4268493607497 -34.6644643555209,-58.4269736901453 -34.6645279149028,-58.4270506315079 -34.6645866714452,-58.4270860418778 -34.6646967552623,-58.4271836934095 -34.664760306632,-58.4272621688472 -34.6648202607019,-58.4273154081894 -34.6648961233317,-58.4273804900812 -34.6649841728037,-58.4274603115286 -34.6650868747926,-58.4275431308526 -34.6651553512959,-58.4276940170229 -34.6653094834688,-58.4277827929367 -34.6654024692346,-58.4278167735681 -34.6654697343353,-58.4278966996602 -34.6655284207647,-58.427955899393 -34.66562132753,-58.4280623998071 -34.6657265719955,-58.4281600309635 -34.6658439268627,-58.4282339739256 -34.6659442322336,-58.4283053942787 -34.6660475194495,-58.4283862911412 -34.6661485061557,-58.4284750677384 -34.6662438858371,-58.4285016171531 -34.6663515018699,-58.428528259911 -34.6664395399204,-58.428605193146 -34.6665251271821,-58.4286436056919 -34.6665960553518,-58.4286761469796 -34.6666425445821,-58.4287782148433 -34.6667538436718,-58.4288758491866 -34.6668688035159,-58.4289704955467 -34.6669960163087,-58.4290532942954 -34.6671231553318,-58.4291183728323 -34.667228387411,-58.4291894211093 -34.6673262265271,-58.4293078036981 -34.667355555582,-58.4293832077225 -34.6674326205628,-58.4294217065871 -34.6675035485006,-58.4294838172506 -34.6675720180052,-58.429554786847 -34.6676552085962,-58.4296140064611 -34.6677065641056,-58.4297382178265 -34.6678704754426,-58.4298181359756 -34.6679585275823,-58.4299201877287 -34.6681187002529,-58.4299822992335 -34.6681872399215,-58.4301006450087 -34.6683143877438,-58.4301627615992 -34.6683706734669,-58.4302603959351 -34.66849542117,-58.43025737446 -34.6685932399125,-58.4303491543502 -34.6686495334283,-58.4304289914951 -34.6687302609937,-58.4305030401426 -34.6687914089838,-58.4305429124364 -34.6688415617062,-58.4305665804762 -34.6689148797845,-58.4306228116297 -34.6689834175681,-58.4306612345661 -34.6690347670843,-58.4307085963461 -34.6691154859227,-58.4307736982562 -34.6691693072556,-58.4308328335167 -34.6692231269938,-58.4308683464146 -34.6693062371005,-58.4309097446024 -34.6693796301593,-58.4310059512696 -34.6694542346797,-58.4310592072156 -34.6695031934915,-58.4310650682762 -34.6695569992757,-58.4310680312031 -34.6696108043073,-58.4311094371773 -34.6696645488817,-58.4311153807146 -34.6697257492482,-58.4311266156107 -34.669769837849,-58.4311800630087 -34.669764147301,-58.4312455248708 -34.6697698685871,-58.4313178948959 -34.6697656617724,-58.4313905990358 -34.6697796245024,-58.4314705556524 -34.6697747153011,-58.4314823067783 -34.6698065501511,-58.4314793847978 -34.669870072234,-58.431470492328 -34.6699434522062,-58.4314201119319 -34.6699532282849,-58.4314200917073 -34.670007032539,-58.4314586035976 -34.6700510576785,-58.4315000210273 -34.6700755055598,-58.4315414311506 -34.6701195314144,-58.4316021078248 -34.6701575056706,-58.4316583589548 -34.6701770275713,-58.4317056471315 -34.6702308438604,-58.431764861711 -34.6703042411463,-58.4318091629874 -34.6703678456304,-58.4318624952874 -34.6704436358069,-58.4319039048735 -34.6704901263902,-58.431933465179 -34.6705390788239,-58.4319808425935 -34.6705831060318,-58.4320251460006 -34.670641780726,-58.4320606750853 -34.6706858049203,-58.4320976555511 -34.6707237025443,-58.4321183483351 -34.6707799768441,-58.4321802721426 -34.6708116489853,-58.4323659889224 -34.6706791949499,-58.4323660091818 -34.6706791909579,-58.432291626998 -34.6705893812969,-58.4340301962392 -34.6695858319913,-58.4340855276212 -34.6695538723005,-58.4341446954811 -34.6695197303257,-58.4354876394717 -34.6687445236217,-58.4368562196101 -34.6679545183226,-58.4378482172457 -34.6673818216636,-58.4397519517134 -34.666282728179,-58.4399324285029 -34.6661655052764,-58.4398006880947 -34.6660406884426,-58.4396637446513 -34.6659305187711,-58.4394738716155 -34.6658155500077,-58.4392254489839 -34.6656770479127,-58.4388406644721 -34.6654905596302,-58.4378076631349 -34.6650391434571,-58.4365738009623 -34.6645073212834,-58.4363589547618 -34.6644147372771,-58.4352664953393 -34.6639384267926,-58.4351554527049 -34.6638876256958,-58.4347105861277 -34.6649979072802,-58.4335539204749 -34.6643542381563,-58.4324344269537 -34.6637312720307,-58.4323113744878 -34.6636638451792,-58.431059471546 -34.6629786484516,-58.4303555391381 -34.6638452484701,-58.4301996803961 -34.6637596412617,-58.4292890763634 -34.6632594516132,-58.4282213504399 -34.6626728703493,-58.4271560254569 -34.6620876888732,-58.4261270151981 -34.6615223686503,-58.4259464599304 -34.6614100576709)))";;"3166";8_13_2;COMUNA 8;"13";"2";"365";"174";"191";"91,10%";"100";"100";"100,00%";"0";"0,00%";"118";"7";"5.93";"111";"94,07%";"5.93";5.930
"MULTIPOLYGON (((-58.4357453144317 -34.6616423425327,-58.4348683056238 -34.6623435032486,-58.4337474263949 -34.6618332278914,-58.4325390431566 -34.661283060295,-58.4318067876585 -34.6620705752028,-58.4317301336522 -34.662153022862,-58.431059471546 -34.6629786484516,-58.4323113744878 -34.6636638451792,-58.4324344269537 -34.6637312720307,-58.4335539204749 -34.6643542381563,-58.4347105861277 -34.6649979072802,-58.4351554527049 -34.6638876256958,-58.4352664953393 -34.6639384267926,-58.4363589547618 -34.6644147372771,-58.4365738009623 -34.6645073212834,-58.4378076631349 -34.6650391434571,-58.4388406644721 -34.6654905596302,-58.4392254489839 -34.6656770479127,-58.4394738716155 -34.6658155500077,-58.4396637446513 -34.6659305187711,-58.4398006880947 -34.6660406884426,-58.4399324285029 -34.6661655052764,-58.4401551847395 -34.666037233288,-58.4403568812834 -34.6662480508558,-58.4409470887006 -34.6667731015562,-58.4421584526354 -34.6658099049556,-58.4413360265499 -34.6650993919079,-58.4403841738417 -34.6642771563692,-58.4402628289022 -34.6641722720302,-58.4394307213953 -34.6634517438842,-58.4386989218027 -34.6628180631827,-58.4375363991035 -34.6618113216483,-58.4365751641105 -34.6609789128756,-58.4357453144317 -34.6616423425327)))";;"3167";8_13_3;COMUNA 8;"13";"3";"998";"489";"509";"96,07%";"341";"340";"99,71%";"1";"0,29%";"311";"9";"2.89";"302";"97,11%";"2.89";2.890
"MULTIPOLYGON (((-58.4445631090208 -34.6638976278107,-58.4435620513039 -34.6634789419896,-58.4434421403123 -34.6634266681284,-58.4432441553197 -34.663377198695,-58.4421174928896 -34.6628965777297,-58.442022780738 -34.6629720567751,-58.4407129838346 -34.6624273757238,-58.4406430786955 -34.6624832801599,-58.4405521460276 -34.662445516137,-58.4405132490669 -34.662242475193,-58.4404765200362 -34.6622202847816,-58.4400645532531 -34.6620578100612,-58.4397965302423 -34.6619459962983,-58.4399013807463 -34.6618607466781,-58.4400727132184 -34.6617188196531,-58.4399818107154 -34.661681516468,-58.438445700782 -34.6610466956014,-58.4371566648216 -34.6605140229079,-58.435577392449 -34.6598613393331,-58.434420649937 -34.6593833164236,-58.4343734169314 -34.6594307716035,-58.4342437390214 -34.6595610972402,-58.435424426957 -34.6600560994873,-58.4355889829935 -34.6601250818116,-58.4369365461361 -34.6606899675019,-58.4382519994767 -34.6612413807314,-58.4375363991035 -34.6618113216483,-58.4386989218027 -34.6628180631827,-58.4394307213953 -34.6634517438842,-58.4402628289022 -34.6641722720302,-58.4403841738417 -34.6642771563692,-58.4413360265499 -34.6650993919079,-58.4421584526354 -34.6658099049556,-58.4431302345753 -34.6650371561686,-58.4443393315444 -34.6640755570147,-58.4445631090208 -34.6638976278107)))";;"3168";8_13_4;COMUNA 8;"13";"4";"1064";"502";"562";"89,32%";"317";"317";"100,00%";"0";"0,00%";"333";"35";"10.51";"298";"89,49%";"10.51";10.510
"MULTIPOLYGON (((-58.433658094572 -34.6601495674631,-58.4335898867998 -34.6602180742718,-58.4329797639997 -34.6608288598997,-58.4327151132261 -34.661093732175,-58.4325390431566 -34.661283060295,-58.4337474263949 -34.6618332278914,-58.4348683056238 -34.6623435032486,-58.4357453144317 -34.6616423425327,-58.4365751641105 -34.6609789128756,-58.4375363991035 -34.6618113216483,-58.4382519994767 -34.6612413807314,-58.4369365461361 -34.6606899675019,-58.4355889829935 -34.6601250818116,-58.435424426957 -34.6600560994873,-58.4342437390214 -34.6595610972402,-58.433658094572 -34.6601495674631)))";;"3169";8_13_5;COMUNA 8;"13";"5";"963";"457";"506";"90,32%";"315";"315";"100,00%";"0";"0,00%";"315";"5";"1.59";"310";"98,41%";"1.59";1.590
"MULTIPOLYGON (((-58.4323577382939 -34.658060599514,-58.4321670135114 -34.6582530222253,-58.4314793055874 -34.6589470229092,-58.4309160688817 -34.6595153443328,-58.4307964462866 -34.65963573906,-58.4306584893491 -34.6595598556511,-58.4297248375958 -34.6590443103144,-58.4290733389907 -34.659704292064,-58.4292556973047 -34.6597849783205,-58.4301342555222 -34.6601859317665,-58.4302138459994 -34.6602222216348,-58.4312622481011 -34.6607006086217,-58.4313500202451 -34.6607407027794,-58.4323072535394 -34.6611775772224,-58.4325390431566 -34.661283060295,-58.4327151132261 -34.661093732175,-58.4329797639997 -34.6608288598997,-58.4335898867998 -34.6602180742718,-58.433658094572 -34.6601495674631,-58.4342437390214 -34.6595610972402,-58.4341358656052 -34.6594832528941,-58.4336976208901 -34.6592292689475,-58.4332620328885 -34.6589414802727,-58.4332792552479 -34.6589239487164,-58.4332162068038 -34.6588656219578,-58.4331310915743 -34.6587867962718,-58.4326316677726 -34.6585107507286,-58.4323577382939 -34.658060599514)))";;"3170";8_13_6;COMUNA 8;"13";"6";"657";"302";"355";"85,07%";"224";"223";"99,55%";"1";"0,45%";"221";"4";"1.81";"217";"98,19%";"1.81";1.810
"MULTIPOLYGON (((-58.4296335097783 -34.6565900599712,-58.4294838068092 -34.6567050930401,-58.4289058888334 -34.6571221294101,-58.4287947208606 -34.6572016783132,-58.4286654792917 -34.6572941801911,-58.4279694784684 -34.6577948434436,-58.4278288962134 -34.657895932991,-58.4272805478013 -34.6582846593517,-58.4271373204325 -34.6583889868542,-58.4268783299996 -34.6585775162524,-58.4267799957424 -34.6586916402794,-58.4267813889436 -34.6586922556612,-58.4277058327588 -34.6591005801715,-58.4277421340862 -34.6591150980417,-58.4290733389907 -34.659704292064,-58.4297248375958 -34.6590443103144,-58.4306584893491 -34.6595598556511,-58.4307964462866 -34.65963573906,-58.4309160688817 -34.6595153443328,-58.4314793055874 -34.6589470229092,-58.4321670135114 -34.6582530222253,-58.4323577382939 -34.658060599514,-58.4326316677726 -34.6585107507286,-58.4331310915743 -34.6587867962718,-58.4332162068038 -34.6588656219578,-58.4332792552479 -34.6589239487164,-58.4332620328885 -34.6589414802727,-58.4336976208901 -34.6592292689475,-58.4341358656052 -34.6594832528941,-58.4342437390214 -34.6595610972402,-58.4343734169314 -34.6594307716035,-58.4342811297137 -34.6593844107767,-58.4342483220682 -34.6593682759043,-58.434125023944 -34.6592861320486,-58.4338549053504 -34.6591216975483,-58.4336092505567 -34.6589511413487,-58.4334760704687 -34.6588596280079,-58.433402879956 -34.6588007355175,-58.4333447764995 -34.6587374802936,-58.433294852531 -34.6586813398943,-58.4332082025098 -34.6586047674754,-58.4331357005381 -34.6585281280007,-58.4330229000788 -34.6584115479563,-58.4327731277568 -34.6580884494538,-58.4327689831496 -34.6580006994328,-58.432636790716 -34.6577770689223,-58.4320174035439 -34.6567295604195,-58.4316308055629 -34.6560755702963,-58.4313137979985 -34.655539417152,-58.4312776003991 -34.6554783497093,-58.4312882726779 -34.6554275763288,-58.4309584455876 -34.655668413437,-58.429784917327 -34.6564738299585,-58.4296335097783 -34.6565900599712)))";;"3171";8_13_7;COMUNA 8;"13";"7";"728";"332";"396";"83,84%";"272";"271";"99,63%";"1";"0,37%";"253";"27";"10.67";"226";"89,33%";"10.67";10.670
"MULTIPOLYGON (((-58.4301342555222 -34.6601859317665,-58.4292556973047 -34.6597849783205,-58.4290733389907 -34.659704292064,-58.4277421340862 -34.6591150980417,-58.4277058327588 -34.6591005801715,-58.4267813889436 -34.6586922556612,-58.426440334231 -34.6590722959665,-58.4264411362897 -34.6590727450609,-58.4257180868058 -34.6599633279367,-58.4250287065924 -34.6608125775992,-58.425797602315 -34.6613174748864,-58.4259464599304 -34.6614100576709,-58.4261270151981 -34.6615223686503,-58.4271560254569 -34.6620876888732,-58.4282213504399 -34.6626728703493,-58.4292890763634 -34.6632594516132,-58.4301996803961 -34.6637596412617,-58.4303555391381 -34.6638452484701,-58.431059471546 -34.6629786484516,-58.4317301336522 -34.662153022862,-58.4318067876585 -34.6620705752028,-58.4325390431566 -34.661283060295,-58.4323072535394 -34.6611775772224,-58.4313500202451 -34.6607407027794,-58.4312622481011 -34.6607006086217,-58.4302138459994 -34.6602222216348,-58.4301342555222 -34.6601859317665)))";;"3172";8_13_8;COMUNA 8;"13";"8";"893";"425";"468";"90,81%";"316";"316";"100,00%";"0";"0,00%";"297";"24";"8.08";"273";"91,92%";"8.08";8.080
"MULTIPOLYGON (((-58.4555871468489 -34.6585922195758,-58.4567085953003 -34.6595791745829,-58.4567282167149 -34.6595622997844,-58.4571218251683 -34.6592618168768,-58.4574072704983 -34.6590437951887,-58.4576629682346 -34.6588485891553,-58.457715727056 -34.658808238053,-58.4580223920017 -34.6585740181256,-58.4582301867727 -34.658415429812,-58.4583496811883 -34.6583243047519,-58.4586548084117 -34.6580912803779,-58.4587073958071 -34.6580511401094,-58.4589513256555 -34.6578649453008,-58.4592469037644 -34.6576391728641,-58.4595198092283 -34.6574308644071,-58.4595959190971 -34.6573727660962,-58.4598500724496 -34.6571786821762,-58.4599578856532 -34.6571365707525,-58.4602606176693 -34.6569039648079,-58.4596458132739 -34.6563799216498,-58.4596178600551 -34.6563561174369,-58.4592663770429 -34.6566335104774,-58.4590211727851 -34.6568271004965,-58.4589035561586 -34.6569199164854,-58.4587790356629 -34.6570181548301,-58.4585307608556 -34.6572141381874,-58.4582860645614 -34.6574073041796,-58.4581075062936 -34.6575482171523,-58.458031991733 -34.6576077934711,-58.457481283986 -34.6571254332457,-58.4572319828457 -34.6573250055641,-58.4569857488544 -34.65752211265,-58.4561251855183 -34.656765427647,-58.4558445170281 -34.6569871087621,-58.4561235301929 -34.6572214971179,-58.4558760154331 -34.6574191652934,-58.4556285847251 -34.6576168329649,-58.455332399339 -34.6578533715527,-58.4551805984863 -34.6579730840482,-58.4554863604154 -34.6582503941878,-58.4557334276178 -34.6584744693497,-58.4555871468489 -34.6585922195758)))";;"3173";8_14_1;COMUNA 8;"14";"1";"1805";"876";"929";"94,29%";"330";"330";"100,00%";"0";"0,00%";"464";"97";"20.91";"367";"79,09%";"20.91";20.910
"MULTIPOLYGON (((-58.4351804347495 -34.6569006019585,-58.4341863317367 -34.6562176072458,-58.4331394720595 -34.6555871987463,-58.4319925969456 -34.6548965430208,-58.4313887878262 -34.6553346417201,-58.4312882726779 -34.6554275763288,-58.4312776003991 -34.6554783497093,-58.4313137979985 -34.655539417152,-58.4316308055629 -34.6560755702963,-58.4320174035439 -34.6567295604195,-58.432636790716 -34.6577770689223,-58.4327689831496 -34.6580006994328,-58.4327731277568 -34.6580884494538,-58.4330229000788 -34.6584115479563,-58.4331357005381 -34.6585281280007,-58.4332082025098 -34.6586047674754,-58.433294852531 -34.6586813398943,-58.4333447764995 -34.6587374802936,-58.433402879956 -34.6588007355175,-58.4334760704687 -34.6588596280079,-58.4336092505567 -34.6589511413487,-58.4338549053504 -34.6591216975483,-58.434125023944 -34.6592861320486,-58.4342483220682 -34.6593682759043,-58.4342811297137 -34.6593844107767,-58.4343734169314 -34.6594307716035,-58.434420649937 -34.6593833164236,-58.4345730911279 -34.65923010787,-58.4352282066927 -34.6585717876733,-58.4353668329589 -34.6584338571218,-58.4362020764104 -34.6576025386903,-58.4351804347495 -34.6569006019585)))";;"3174";8_14_10;COMUNA 8;"14";"10";"979";"477";"502";"95,02%";"287";"287";"100,00%";"0";"0,00%";"313";"44";"14.06";"269";"85,94%";"14.06";14.060
"MULTIPOLYGON (((-58.4585307608556 -34.6572141381874,-58.4587790356629 -34.6570181548301,-58.4582615635987 -34.6565743918174,-58.4582154582476 -34.6565376989232,-58.4573529327897 -34.6557956002811,-58.4571136074142 -34.6559846795746,-58.4568574053332 -34.6561869974072,-58.4566193561679 -34.6563750898353,-58.4563716748048 -34.6565707167235,-58.4561251855183 -34.656765427647,-58.4569857488544 -34.65752211265,-58.4572319828457 -34.6573250055641,-58.457481283986 -34.6571254332457,-58.458031991733 -34.6576077934711,-58.4581075062936 -34.6575482171523,-58.4582860645614 -34.6574073041796,-58.4585307608556 -34.6572141381874)))";;"3175";8_14_2;COMUNA 8;"14";"2";"1473";"708";"765";"92,55%";"255";"255";"100,00%";"0";"0,00%";"382";"78";"20.42";"304";"79,58%";"20.42";20.420
"MULTIPOLYGON (((-58.4596178600551 -34.6563561174369,-58.4596458132739 -34.6563799216498,-58.4602606176693 -34.6569039648079,-58.4603926303233 -34.6570165058523,-58.4605392167751 -34.6571414417361,-58.4613360750515 -34.6578321774498,-58.4614894824449 -34.6579648589528,-58.4615803361609 -34.6578785193027,-58.4603553912461 -34.6568413592169,-58.459655363212 -34.6562531576359,-58.4590719296238 -34.6557451691146,-58.4589260313857 -34.655581568358,-58.4583699608929 -34.655134142421,-58.4583374064496 -34.6551080137345,-58.4580167906115 -34.6548321061307,-58.4571129701805 -34.6540503974868,-58.4569833379049 -34.6541565213661,-58.4567368573378 -34.6543492617152,-58.4566872542683 -34.6543879928133,-58.4564192093758 -34.6545974925035,-58.4561847435659 -34.6547807250194,-58.456124230597 -34.6548279766791,-58.453716099479 -34.6567094272527,-58.4545992278154 -34.6574423272601,-58.4549143702191 -34.6577315814992,-58.4551805984863 -34.6579730840482,-58.455332399339 -34.6578533715526,-58.4556285847251 -34.6576168329649,-58.4558760154331 -34.6574191652934,-58.4561235301929 -34.6572214971179,-58.4558445170282 -34.6569871087621,-58.4561251855183 -34.656765427647,-58.4563716748048 -34.6565707167235,-58.4566193561679 -34.6563750898353,-58.4568574053332 -34.6561869974072,-58.4571136074142 -34.6559846795746,-58.4573529327897 -34.6557956002811,-58.4582154582476 -34.6565376989232,-58.4582615635987 -34.6565743918174,-58.4587790356629 -34.6570181548301,-58.4589035561586 -34.6569199164854,-58.4590211727851 -34.6568271004965,-58.4592663770429 -34.6566335104774,-58.4596178600551 -34.6563561174369)))";;"3176";8_14_3;COMUNA 8;"14";"3";"2033";"981";"1052";"93,25%";"331";"330";"99,70%";"1";"0,30%";"518";"119";"22.97";"399";"77,03%";"22.97";22.970
"MULTIPOLYGON (((-58.4517870951925 -34.658006848608,-58.4522547786472 -34.6576399715788,-58.4523888540342 -34.6575350503818,-58.4524948867107 -34.6574520991579,-58.4526302146061 -34.6575562683495,-58.4527359058492 -34.6574759225972,-58.453716099479 -34.6567094272527,-58.456124230597 -34.6548279766791,-58.4561847435659 -34.6547807250194,-58.4564192093758 -34.6545974925035,-58.4566872542683 -34.6543879928133,-58.4567368573378 -34.6543492617152,-58.4569833379049 -34.6541565213661,-58.4571129701805 -34.6540503974868,-58.4569951994309 -34.6539311631662,-58.4553124902758 -34.6525231755173,-58.4550618004388 -34.6522993188987,-58.4549419912211 -34.6521646594388,-58.4548605357747 -34.6519904236854,-58.4547982595854 -34.6517725962668,-58.4547647944445 -34.6514914589354,-58.4546998885119 -34.6511541910819,-58.4546362608147 -34.6508230502041,-58.4538210355988 -34.6509029959693,-58.4533385982729 -34.6509488767566,-58.4519747150075 -34.6510784866211,-58.4488281880571 -34.6511750735818,-58.4458047581417 -34.6510466601541,-58.4449506864848 -34.6510103405613,-58.4446202152324 -34.6509480366245,-58.4446199477548 -34.6509481173021,-58.4447905715726 -34.6512037355885,-58.4470072750327 -34.653009132827,-58.4476561487021 -34.6535371175532,-58.4489540911994 -34.6545929356857,-58.4488524063709 -34.6546680672323,-58.4487683649442 -34.6547302425834,-58.4462784079515 -34.6566920321969,-58.4461745009331 -34.6567738515194,-58.4451984110275 -34.6575509209201,-58.4451607116099 -34.6576887363839,-58.4450503241655 -34.6577743567289,-58.4448916897718 -34.6578973653799,-58.4440131791293 -34.6585940145142,-58.4447351794529 -34.659233718827,-58.4448703267394 -34.6593534603985,-58.4456696294017 -34.660062045581,-58.4445308477256 -34.6609707802503,-58.4455376834509 -34.6617660894474,-58.4462567540214 -34.66233416228,-58.4472964824003 -34.6615043451122,-58.4481383428837 -34.6608323872934,-58.4482043976755 -34.6608256344094,-58.4483851112056 -34.6606805812228,-58.4484099165881 -34.6606610061123,-58.4489760900502 -34.6602131711029,-58.4491706948104 -34.6600591039586,-58.4497067698954 -34.659638657316,-58.4497612380185 -34.6595959858333,-58.4517870951925 -34.658006848608)))";;"3177";8_14_4;COMUNA 8;"14";"4";"2705";"1310";"1395";"93,91%";"671";"669";"99,70%";"2";"0,30%";"793";"247";"31.15";"546";"68,85%";"31.15";31.150
"MULTIPOLYGON (((-58.4387840327423 -34.6564178268736,-58.4388640420019 -34.6564803795687,-58.4389879330421 -34.6565772375226,-58.4396246049257 -34.657073852942,-58.4400307941361 -34.6573900650421,-58.4401884308072 -34.6575127738486,-58.4405605375765 -34.6578130619129,-58.4411586236868 -34.6582956477254,-58.4415519549238 -34.658613049642,-58.4418132969155 -34.6588238753854,-58.442770145809 -34.6595798318135,-58.4435365577658 -34.6601852536215,-58.4445308477256 -34.6609707802503,-58.4456696294017 -34.660062045581,-58.4448703267394 -34.6593534603985,-58.4447351794529 -34.659233718827,-58.4440131791293 -34.6585940145142,-58.4448916897718 -34.6578973653799,-58.4450503241655 -34.6577743567289,-58.4451607116099 -34.6576887363839,-58.4451984110275 -34.6575509209201,-58.4461745009331 -34.6567738515194,-58.4462784079515 -34.6566920321969,-58.4487683649442 -34.6547302425834,-58.4488524063709 -34.6546680672323,-58.4489540911994 -34.6545929356857,-58.4476561487021 -34.6535371175532,-58.4470072750327 -34.653009132827,-58.4447905715726 -34.6512037355885,-58.4446199477548 -34.6509481173021,-58.4444062010791 -34.6510656842872,-58.443638685318 -34.6511538088057,-58.4435215039486 -34.6511672415388,-58.4433239573799 -34.6511898870441,-58.4432953728194 -34.6513429152455,-58.4432661211784 -34.6514325611544,-58.4432430122271 -34.6514929113854,-58.4432047288976 -34.6515746682764,-58.4431571561477 -34.6516574800354,-58.4431117175265 -34.6517245874237,-58.4430601437019 -34.6517883134237,-58.4430054175938 -34.6518478838386,-58.4429516311637 -34.6518976653565,-58.4429084151156 -34.6519348425567,-58.4428229219197 -34.6520025771482,-58.4427480830607 -34.6520628484116,-58.4426521908941 -34.6521375532185,-58.44163154668 -34.6529324751821,-58.4415331805756 -34.6530090801353,-58.4404034916516 -34.653889045655,-58.4394861186206 -34.6546035433682,-58.4388456871086 -34.6551023076253,-58.4384180869404 -34.6554916712301,-58.4380019251827 -34.6558061742899,-58.4380743499574 -34.6558628103073,-58.4387840327423 -34.6564178268736)))";;"3178";8_14_5;COMUNA 8;"14";"5";"1173";"595";"578";"102,94%";"358";"358";"100,00%";"0";"0,00%";"385";"53";"13.77";"332";"86,23%";"13.77";13.770
"MULTIPOLYGON (((-58.4424799721029 -34.6626073345011,-58.4422942706781 -34.6627544914184,-58.4422037429489 -34.6628253894905,-58.4421174928896 -34.6628965777297,-58.4432441553197 -34.663377198695,-58.4434421403123 -34.6634266681284,-58.4435620513039 -34.6634789419896,-58.4445631090208 -34.6638976278107,-58.4447426430115 -34.6637492699712,-58.4447861198039 -34.6637133598731,-58.4449815932246 -34.6635574685965,-58.4453698948271 -34.6632496284871,-58.4458493218658 -34.6628695442086,-58.4463908884481 -34.6624400987651,-58.4462567540214 -34.66233416228,-58.4455376834509 -34.6617660894474,-58.4445308477256 -34.6609707802503,-58.4435365577658 -34.6601852536215,-58.4424862388437 -34.6610189809206,-58.4414830414584 -34.6618152414186,-58.4423229195512 -34.6624825161196,-58.4424799721029 -34.6626073345011)))";;"3179";8_14_6;COMUNA 8;"14";"6";"793";"391";"402";"97,26%";"220";"219";"99,55%";"1";"0,46%";"250";"8";"3.2";"242";"96,80%";"3.2";3.200
"MULTIPOLYGON (((-58.4399818107154 -34.661681516468,-58.4400727132184 -34.6617188196531,-58.4399013807463 -34.6618607466781,-58.4397965302423 -34.6619459962983,-58.4400645532531 -34.6620578100612,-58.4404765200362 -34.6622202847816,-58.4405132490669 -34.662242475193,-58.4405521460276 -34.662445516137,-58.4406430786955 -34.6624832801599,-58.4407129838346 -34.6624273757238,-58.442022780738 -34.6629720567751,-58.4421174928896 -34.6628965777297,-58.4422037429489 -34.6628253894905,-58.4422942706781 -34.6627544914184,-58.4424799721029 -34.6626073345011,-58.4423229195512 -34.6624825161196,-58.4414830414584 -34.6618152414186,-58.4424862388437 -34.6610189809206,-58.4435365577658 -34.6601852536215,-58.442770145809 -34.6595798318135,-58.4418132969155 -34.6588238753854,-58.4415519549238 -34.658613049642,-58.4411586236868 -34.6582956477254,-58.4405605375765 -34.6578130619129,-58.4401884308072 -34.6575127738486,-58.4400307941361 -34.6573900650421,-58.4396246049257 -34.657073852942,-58.4389879330421 -34.6565772375226,-58.4388640420019 -34.6564803795687,-58.4387840327423 -34.6564178268736,-58.4380743499574 -34.6558628103073,-58.4380019251827 -34.6558061742899,-58.4376439553638 -34.6561673089592,-58.4370228955032 -34.6567855779968,-58.4383458177615 -34.6578169355579,-58.4390518568256 -34.6583627240463,-58.4394645267264 -34.6586816857812,-58.4403438999146 -34.6593614471136,-58.4404801529022 -34.6594668271429,-58.4395053421551 -34.6602431465971,-58.4389283751833 -34.6607026964101,-58.438445700782 -34.6610466956014,-58.4399818107154 -34.661681516468)))";;"3180";8_14_7;COMUNA 8;"14";"7";"949";"434";"515";"84,27%";"302";"301";"99,67%";"1";"0,33%";"297";"15";"5.05";"282";"94,95%";"5.05";5.050
"MULTIPOLYGON (((-58.4395053421551 -34.6602431465971,-58.4404801529022 -34.6594668271429,-58.4403438999146 -34.6593614471136,-58.4394645267264 -34.6586816857812,-58.4390518568256 -34.6583627240463,-58.4383458177615 -34.6578169355579,-58.4370228955032 -34.6567855779968,-58.4362020764104 -34.6576025386903,-58.4353668329589 -34.6584338571218,-58.4352282066927 -34.6585717876733,-58.4345730911279 -34.65923010787,-58.434420649937 -34.6593833164236,-58.435577392449 -34.6598613393331,-58.4371566648216 -34.6605140229079,-58.438445700782 -34.6610466956014,-58.4389283751833 -34.6607026964101,-58.4395053421551 -34.6602431465971)))";;"3181";8_14_8;COMUNA 8;"14";"8";"798";"377";"421";"89,55%";"298";"298";"100,00%";"0";"0,00%";"259";"15";"5.79";"244";"94,21%";"5.79";5.790
"MULTIPOLYGON (((-58.4351804347495 -34.6569006019585,-58.4362020764104 -34.6576025386903,-58.4370228955032 -34.6567855779968,-58.4376439553638 -34.6561673089592,-58.4380019251827 -34.6558061742899,-58.437097901142 -34.6551016010512,-58.4360212372233 -34.6543707854286,-58.43506101685 -34.6536101970544,-58.4344335176544 -34.6531130666909,-58.43308272965 -34.6541004512761,-58.4321177397101 -34.6548057267402,-58.4319925969456 -34.6548965430208,-58.4331394720595 -34.6555871987463,-58.4341863317367 -34.6562176072458,-58.4351804347495 -34.6569006019585)))";;"3182";8_14_9;COMUNA 8;"14";"9";"1011";"499";"512";"97,46%";"257";"257";"100,00%";"0";"0,00%";"336";"72";"21.43";"264";"78,57%";"21.43";21.430
"MULTIPOLYGON (((-58.4583935729099 -34.6731626025211,-58.4583972340076 -34.6732468302203,-58.458401150537 -34.6733369735758,-58.4584571496942 -34.6734483164942,-58.4586122847205 -34.6736101570335,-58.458782681749 -34.673713123078,-58.4590036314303 -34.6737558775786,-58.4592269711006 -34.6737282777879,-58.4594053038844 -34.6736524356766,-58.4595465569949 -34.6735347602649,-58.4596369205336 -34.6733868009326,-58.4596652268574 -34.6732349666592,-58.4597659944899 -34.6729457361527,-58.4598095569699 -34.672848762804,-58.4598651384224 -34.6727560151819,-58.4599321420799 -34.6726686200471,-58.4600297481218 -34.6725667181225,-58.4617875486654 -34.6711863551905,-58.4617343584573 -34.6711670584916,-58.4617668356049 -34.671139874921,-58.4616618192191 -34.6710948024471,-58.4616215850608 -34.6711267747817,-58.4615660081814 -34.671107477988,-58.461504123534 -34.6710855049795,-58.4615675434892 -34.671036208495,-58.4615669571664 -34.6710359483385,-58.4618457721063 -34.6708176133749,-58.4618982801307 -34.6708431777949,-58.4621539183657 -34.6706451457444,-58.4623775903404 -34.670427394233,-58.4625133784928 -34.6702689395655,-58.4627050835452 -34.670004988963,-58.4628289368414 -34.6698564637773,-58.4629532158825 -34.6697043468154,-58.4630445922265 -34.6695925125953,-58.4630812450385 -34.6695599763988,-58.4633720798257 -34.6693020808677,-58.4634143582479 -34.6692794039593,-58.4636342323552 -34.6691616163811,-58.463667687345 -34.6691436943239,-58.4636886695155 -34.6691480359113,-58.4647957517762 -34.6688718452184,-58.4648217303502 -34.6688453617807,-58.4650095063831 -34.6686732410343,-58.4652914683035 -34.6684469616304,-58.4677520100794 -34.666525775771,-58.4679405435088 -34.6663785102509,-58.4686448972851 -34.6658495197344,-58.4688923223132 -34.6656620374643,-58.4691307966095 -34.6654756115259,-58.4697349039693 -34.6650031707421,-58.4701624114739 -34.6646689107132,-58.4701621625989 -34.6646668812201,-58.4703603059319 -34.6644535403513,-58.4704119497995 -34.664366703698,-58.4704432140087 -34.6642831073998,-58.470460703501 -34.6641139097413,-58.4704579432308 -34.6640128881239,-58.4704251136496 -34.6638556323076,-58.470393862487 -34.6637686368204,-58.4701842518805 -34.6636095409518,-58.4699789774558 -34.6635846662869,-58.4696553218113 -34.6636426531948,-58.4696413222982 -34.6636516603097,-58.4693826026502 -34.6638181167131,-58.4692683298137 -34.6638564422753,-58.4688902247942 -34.6638186061894,-58.4686556582386 -34.6637643910096,-58.4684820317259 -34.663679115299,-58.4682991104444 -34.6635240490865,-58.4673560448981 -34.6627177985777,-58.4668305646219 -34.6622642132215,-58.46561537621 -34.6612175990861,-58.4645410167788 -34.6601167437171,-58.464425103268 -34.6600654059216,-58.4640612527432 -34.6597604018296,-58.4615803361609 -34.6578785193026,-58.4614894824449 -34.6579648589528,-58.4613360750515 -34.6578321774498,-58.4605392167751 -34.6571414417361,-58.4603926303233 -34.6570165058523,-58.4602606176693 -34.6569039648079,-58.4599578856532 -34.6571365707525,-58.4598500724496 -34.6571786821762,-58.4595959190971 -34.6573727660962,-58.4595198092283 -34.6574308644071,-58.4592469037644 -34.6576391728641,-58.4589513256555 -34.6578649453008,-58.4587073958071 -34.6580511401094,-58.4586548084117 -34.6580912803779,-58.4583496811883 -34.6583243047519,-58.4582301867727 -34.658415429812,-58.4580223920017 -34.6585740181256,-58.457715727056 -34.658808238053,-58.4576629682346 -34.6588485891553,-58.4574072704983 -34.6590437951887,-58.4571218251683 -34.6592618168768,-58.4567282167149 -34.6595622997844,-58.4559161814785 -34.6602606575027,-58.455470495032 -34.6606254449064,-58.4560932184429 -34.6611182630079,-58.4555901343754 -34.6614729717788,-58.4553030632168 -34.6618017276786,-58.4552746694326 -34.6619064477508,-58.4552180201148 -34.6620023487284,-58.4551722310444 -34.6621606354398,-58.4549318173558 -34.6624176668376,-58.4546181287874 -34.6620318961197,-58.4545740663632 -34.6620076671565,-58.4545245433359 -34.6620425239826,-58.4544914759737 -34.6620167463869,-58.4544529444911 -34.662084985145,-58.4544327343253 -34.6621880852697,-58.4544153360072 -34.6622987914281,-58.4544095306026 -34.6623954838924,-58.4544382321772 -34.6626134497088,-58.4544855199635 -34.6627769786183,-58.4545441479468 -34.6628989578043,-58.4545086030328 -34.6629286745639,-58.4543237179271 -34.6630832437955,-58.4543562729511 -34.6631221203552,-58.4541588567076 -34.6632881676679,-58.4539749878137 -34.663491751886,-58.4539173733542 -34.6634616060626,-58.4538311172269 -34.6634631491576,-58.4536048208786 -34.6634841189876,-58.4530608518231 -34.6635778122055,-58.4528751479014 -34.6634134265955,-58.4525351054695 -34.6631047281172,-58.4523668380029 -34.6632490842078,-58.4520572379947 -34.6635145579507,-58.4516859383435 -34.6636940370246,-58.4512912892281 -34.6638287227992,-58.450839255346 -34.6641123495314,-58.4505447335914 -34.6643123017129,-58.4505219835119 -34.6643277467773,-58.4499526349028 -34.6647872787932,-58.4499581534546 -34.664928973435,-58.450246486207 -34.6650367526888,-58.4501436724236 -34.6651735769132,-58.4501326971972 -34.6651881788303,-58.4502836467693 -34.6652385226256,-58.4504818556498 -34.6652963455741,-58.4507062970642 -34.6653710299692,-58.4509161630158 -34.6654529379074,-58.451024010441 -34.66549870893,-58.4510619026986 -34.6655155717384,-58.451280508999 -34.665636015162,-58.4514568303482 -34.6658925320029,-58.4515557875997 -34.666047398886,-58.4515938060007 -34.6661068970408,-58.4516783206659 -34.6662586373625,-58.4517890583459 -34.6665043097042,-58.4518381539827 -34.6667089360616,-58.4519326348218 -34.6667485800976,-58.4520775292374 -34.6668088057247,-58.4521650305242 -34.6670986804008,-58.4519426599804 -34.6670019681983,-58.4519417046236 -34.6671392958112,-58.4519952082512 -34.6673349396658,-58.452109740455 -34.6675431947846,-58.4523006476495 -34.6677389207751,-58.4525298313536 -34.6679030290812,-58.4535609869546 -34.6683606583791,-58.4540574633124 -34.6687078166671,-58.4581536457569 -34.6725737050313,-58.4582109240345 -34.6726604700103,-58.4583159308457 -34.6728892826897,-58.4583935729099 -34.6731626025211)))";;"3183";8_15_1;COMUNA 8;"15";"1";"2797";"1401";"1396";"100,36%";"499";"499";"100,00%";"0";"0,00%";"852";"403";"47.3";"449";"52,70%";"47.3";47.300
"MULTIPOLYGON (((-58.4505447335915 -34.6643123017129,-58.450839255346 -34.6641123495314,-58.4512912892281 -34.6638287227993,-58.4516859383435 -34.6636940370246,-58.4508735889593 -34.6630225337208,-58.4507846298907 -34.6629489963549,-58.4504952015687 -34.6627097411871,-58.4493595451274 -34.661771004269,-58.4494792252472 -34.6616753808047,-58.4501397609479 -34.661157900804,-58.4491093720156 -34.6603203721799,-58.4489760900502 -34.6602131711029,-58.4484099165881 -34.6606610061123,-58.4483851112056 -34.6606805812228,-58.4482043976755 -34.6608256344094,-58.4481383428837 -34.6608323872934,-58.4472964824003 -34.6615043451122,-58.4462567540214 -34.66233416228,-58.4463908884481 -34.6624400987651,-58.4458493218658 -34.6628695442086,-58.4453698948271 -34.6632496284871,-58.4449815932246 -34.6635574685965,-58.4447861198039 -34.6637133598731,-58.4447426430115 -34.6637492699712,-58.4445631090208 -34.6638976278107,-58.4452782419288 -34.6641953460103,-58.4468875014531 -34.6648652318117,-58.4477275960138 -34.6652149250099,-58.4489653783105 -34.6657301553699,-58.44900416566 -34.6656985391438,-58.4491489999132 -34.6655805239056,-58.4491704818959 -34.6655640469637,-58.4497002827873 -34.6651581779052,-58.4497415294617 -34.6652032539646,-58.4497913018864 -34.6652341051675,-58.4498432094551 -34.665237561452,-58.449957339624 -34.6652341226346,-58.450077694532 -34.6652135712059,-58.4501213363841 -34.6652032937421,-58.4501326971972 -34.6651881788303,-58.4501436724236 -34.6651735769133,-58.450246486207 -34.6650367526888,-58.4499581534546 -34.664928973435,-58.4499526349028 -34.6647872787932,-58.4505219835119 -34.6643277467773,-58.4505447335915 -34.6643123017129)))";;"3184";8_15_10;COMUNA 8;"15";"10";"1264";"596";"668";"89,22%";"379";"377";"99,47%";"2";"0,53%";"389";"56";"14.4";"333";"85,60%";"14.4";14.400
"MULTIPOLYGON (((-58.4549635797951 -34.6610403412264,-58.4546682321505 -34.6612820191105,-58.4537664065923 -34.6620487385712,-58.4536353079632 -34.6621611968495,-58.4534474390857 -34.6623223844544,-58.4532522388111 -34.6624897685548,-58.4531455176268 -34.6625813121047,-58.4525351054695 -34.6631047281172,-58.4528751479014 -34.6634134265955,-58.4530608518231 -34.6635778122055,-58.4536048208786 -34.6634841189876,-58.4538311172269 -34.6634631491576,-58.4539173733542 -34.6634616060626,-58.4539749878137 -34.663491751886,-58.4541588567076 -34.6632881676679,-58.4543562729511 -34.6631221203552,-58.4543237179271 -34.6630832437955,-58.4545086030328 -34.6629286745639,-58.4545441479468 -34.6628989578043,-58.4544855199635 -34.6627769786183,-58.4544382321772 -34.6626134497088,-58.4544095306026 -34.6623954838924,-58.4544153360072 -34.6622987914281,-58.4544327343253 -34.6621880852697,-58.4544529444911 -34.662084985145,-58.4544914759737 -34.6620167463869,-58.4545245433359 -34.6620425239826,-58.4545740663632 -34.6620076671565,-58.4546181287874 -34.6620318961197,-58.4549318173558 -34.6624176668376,-58.4551722310444 -34.6621606354398,-58.4552180201148 -34.6620023487284,-58.4552753468441 -34.66190394937,-58.4553030632168 -34.6618017276786,-58.4555901343754 -34.6614729717788,-58.4560932184429 -34.6611182630079,-58.455470495032 -34.6606254449064,-58.4549635797951 -34.6610403412264)))";;"3185";8_15_2;COMUNA 8;"15";"2";"2428";"1201";"1227";"97,88%";"495";"495";"100,00%";"0";"0,00%";"655";"242";"36.95";"413";"63,05%";"36.95";36.950
"MULTIPOLYGON (((-58.4525513775687 -34.6610679115687,-58.4520657660167 -34.6614763324384,-58.4524185004559 -34.6617776388037,-58.4532522388111 -34.6624897685548,-58.4534474390857 -34.6623223844544,-58.4536353079632 -34.6621611968495,-58.4537664065923 -34.6620487385712,-58.4546682321505 -34.6612820191105,-58.4549635797951 -34.6610403412264,-58.455470495032 -34.6606254449064,-58.4559161814785 -34.6602606575027,-58.4557879170476 -34.6601817748144,-58.455441994684 -34.6598901971104,-58.4547024329201 -34.6592666119041,-58.4537904018205 -34.6600345987696,-58.4533709470999 -34.6603878168874,-58.4525513775687 -34.6610679115687)))";;"3186";8_15_3;COMUNA 8;"15";"3";"2431";"1184";"1247";"94,95%";"147";"147";"100,00%";"0";"0,00%";"667";"128";"19.19";"539";"80,81%";"19.19";19.190
"MULTIPOLYGON (((-58.4547024329201 -34.6592666119041,-58.4544759910432 -34.6590790909534,-58.4541594859186 -34.6588169847346,-58.4535623447462 -34.6583223497706,-58.4526347994555 -34.6591101866712,-58.4521463863618 -34.6595250163969,-58.4533709470999 -34.6603878168874,-58.4537904018205 -34.6600345987696,-58.4547024329201 -34.6592666119041)))";;"3187";8_15_4;COMUNA 8;"15";"4";"931";"476";"455";"104,62%";"101";"101";"100,00%";"0";"0,00%";"231";"52";"22.51";"179";"77,49%";"22.51";22.510
"MULTIPOLYGON (((-58.4557879170476 -34.6601817748144,-58.4559161814785 -34.6602606575027,-58.4567085953003 -34.6595791745829,-58.4555871468489 -34.6585922195758,-58.4557334276178 -34.6584744693497,-58.4554863604154 -34.6582503941878,-58.4551805984863 -34.6579730840482,-58.4549143702191 -34.6577315814992,-58.4545992278154 -34.6574423272601,-58.453716099479 -34.6567094272527,-58.4527359058492 -34.6574759225972,-58.4526302146061 -34.6575562683494,-58.4535623447462 -34.6583223497706,-58.4541594859186 -34.6588169847346,-58.4544759910432 -34.6590790909534,-58.4547024329201 -34.6592666119041,-58.455441994684 -34.6598901971104,-58.4557879170476 -34.6601817748144)))";;"3188";8_15_5;COMUNA 8;"15";"5";"3385";"1673";"1712";"97,72%";"639";"639";"100,00%";"0";"0,00%";"877";"188";"21.44";"689";"78,56%";"21.44";21.440
"MULTIPOLYGON (((-58.4535623447462 -34.6583223497706,-58.4526302146061 -34.6575562683495,-58.4511170975221 -34.6587441963788,-58.4510030503953 -34.6588268639198,-58.4513720491498 -34.6591230340089,-58.4514637453304 -34.6591965657255,-58.4516483499131 -34.6592040476005,-58.4521463863618 -34.6595250163969,-58.4526347994555 -34.6591101866712,-58.4535623447462 -34.6583223497706)))";;"3189";8_15_6;COMUNA 8;"15";"6";"881";"477";"404";"118,07%";"188";"188";"100,00%";"0";"0,00%";"233";"38";"16.31";"195";"83,69%";"16.31";16.310
"MULTIPOLYGON (((-58.4513720491498 -34.6591230340089,-58.4510030503953 -34.6588268639198,-58.4511170975221 -34.6587441963788,-58.4526302146061 -34.6575562683495,-58.4524948867107 -34.6574520991579,-58.4523888540342 -34.6575350503818,-58.4522547786472 -34.6576399715788,-58.4517870951925 -34.658006848608,-58.4497612380185 -34.6595959858333,-58.4498962241387 -34.6597061440727,-58.4502494565612 -34.6599943578866,-58.4507589847868 -34.660410124909,-58.4509179205887 -34.6605388764235,-58.4510899342264 -34.6604015650785,-58.4513736119053 -34.6601653878587,-58.4519339728661 -34.6596989464556,-58.4521463863618 -34.6595250163969,-58.4516483499131 -34.6592040476005,-58.4514637453304 -34.6591965657255,-58.4513720491498 -34.6591230340089)))";;"3190";8_15_7;COMUNA 8;"15";"7";"929";"455";"474";"95,99%";"225";"225";"100,00%";"0";"0,00%";"259";"58";"22.39";"201";"77,61%";"22.39";22.390
"MULTIPOLYGON (((-58.4513736119053 -34.6601653878587,-58.4510899342264 -34.6604015650785,-58.4509179205887 -34.6605388764235,-58.4511029344213 -34.660688687147,-58.4519430467299 -34.6613715299792,-58.4520657660167 -34.6614763324384,-58.4525513775688 -34.6610679115687,-58.4533709470999 -34.6603878168874,-58.4521463863618 -34.6595250163969,-58.4519339728661 -34.6596989464556,-58.4513736119053 -34.6601653878587)))";;"3191";8_15_8;COMUNA 8;"15";"8";"1357";"648";"709";"91,40%";"298";"298";"100,00%";"0";"0,00%";"358";"79";"22.07";"279";"77,93%";"22.07";22.070
"MULTIPOLYGON (((-58.4524185004559 -34.6617776388037,-58.4520657660167 -34.6614763324384,-58.4519430467299 -34.6613715299792,-58.4511029344213 -34.660688687147,-58.4509179205887 -34.6605388764235,-58.4507589847868 -34.660410124909,-58.4502494565612 -34.6599943578866,-58.4498962241387 -34.6597061440727,-58.4497612380185 -34.6595959858333,-58.4497067698954 -34.659638657316,-58.4491706948104 -34.6600591039586,-58.4489760900502 -34.6602131711029,-58.4491093720156 -34.6603203721799,-58.4501397609479 -34.661157900804,-58.4494792252472 -34.6616753808047,-58.4493595451274 -34.661771004269,-58.4504952015687 -34.6627097411871,-58.4507846298907 -34.6629489963549,-58.4508735889593 -34.6630225337208,-58.4516859383435 -34.6636940370246,-58.4520572379947 -34.6635145579507,-58.4523668380029 -34.6632490842078,-58.4525351054695 -34.6631047281172,-58.4531455176268 -34.6625813121047,-58.4532522388111 -34.6624897685548,-58.4524185004559 -34.6617776388037)))";;"3192";8_15_9;COMUNA 8;"15";"9";"1722";"800";"922";"86,77%";"272";"272";"100,00%";"0";"0,00%";"519";"95";"18.3";"424";"81,70%";"18.3";18.300
"MULTIPOLYGON (((-58.4477275960138 -34.6652149250099,-58.4466438051615 -34.6653618334099,-58.4467061297295 -34.6657132597437,-58.4468625403239 -34.6656948289498,-58.4469239303527 -34.6660363251814,-58.4467172282125 -34.6660640455005,-58.4468051078874 -34.6665023084583,-58.4469743186588 -34.6673158033566,-58.4489653783105 -34.6657301553699,-58.4477275960138 -34.6652149250099)))";;"3193";8_16_1;COMUNA 8;"16";"1";"1045";"501";"544";"92,10%";"309";"309";"100,00%";"0";"0,00%";"299";"9";"3.01";"290";"96,99%";"3.01";3.010
"MULTIPOLYGON (((-58.4452321141571 -34.6664000666373,-58.4454063408388 -34.6661453050736,-58.444123094477 -34.6655983128993,-58.4434849138462 -34.665326987822,-58.4431302345753 -34.6650371561686,-58.4421584526354 -34.6658099049556,-58.4409470887006 -34.6667731015562,-58.441337127362 -34.6671200109922,-58.4427566184716 -34.6669495425732,-58.4427621533253 -34.6669726427014,-58.4428292357618 -34.6669680056392,-58.4428013034828 -34.6668618714208,-58.4439185376489 -34.6666959173466,-58.4447851133438 -34.6670747138589,-58.4452321141571 -34.6664000666373)))";;"3194";8_16_10;COMUNA 8;"16";"10";"934";"440";"494";"89,07%";"272";"272";"100,00%";"0";"0,00%";"279";"28";"10.04";"251";"89,96%";"10.04";10.040
"MULTIPOLYGON (((-58.4468875014531 -34.6648652318117,-58.4452782419288 -34.6641953460103,-58.4453852334572 -34.6649043950029,-58.4452601034442 -34.6649309271984,-58.4452744061627 -34.6650107201835,-58.4453494139738 -34.6650048152246,-58.4454208222909 -34.6655039940833,-58.4461590574425 -34.6654405735981,-58.4461805132548 -34.6655587487808,-58.4463307007785 -34.6655439798981,-58.4463020884848 -34.6654081272351,-58.4466438051615 -34.6653618334099,-58.4477275960138 -34.6652149250099,-58.4468875014531 -34.6648652318117)))";;"3195";8_16_2;COMUNA 8;"16";"2";"617";"281";"336";"83,63%";"185";"185";"100,00%";"0";"0,00%";"183";"10";"5.46";"173";"94,54%";"5.46";5.460
"MULTIPOLYGON (((-58.4431302345753 -34.6650371561686,-58.4434849138462 -34.665326987822,-58.444123094477 -34.6655983128993,-58.4454208222909 -34.6655039940833,-58.4453494139738 -34.6650048152246,-58.4452744061627 -34.6650107201835,-58.4452601034442 -34.6649309271984,-58.4453852334572 -34.6649043950029,-58.4452782419288 -34.6641953460103,-58.4445631090208 -34.6638976278107,-58.4443393315444 -34.6640755570147,-58.4431302345753 -34.6650371561686)))";;"3196";8_16_3;COMUNA 8;"16";"3";"1118";"519";"599";"86,64%";"316";"316";"100,00%";"0";"0,00%";"289";"1";"0.35";"288";"99,65%";"0.35";0.350
"MULTIPOLYGON (((-58.444123094477 -34.6655983128993,-58.4454063408388 -34.6661453050736,-58.4452321141571 -34.6664000666373,-58.4461333979754 -34.6663154533461,-58.4461724718441 -34.6665646908374,-58.4468051078874 -34.6665023084583,-58.4467172282125 -34.6660640455005,-58.4469239303527 -34.6660363251814,-58.4468625403239 -34.6656948289498,-58.4467061297295 -34.6657132597437,-58.4466438051615 -34.6653618334099,-58.4463020884848 -34.6654081272351,-58.4463307007785 -34.6655439798981,-58.4461805132548 -34.6655587487808,-58.4461590574425 -34.6654405735981,-58.4454208222909 -34.6655039940833,-58.444123094477 -34.6655983128993)))";;"3197";8_16_4;COMUNA 8;"16";"4";"942";"438";"504";"86,90%";"309";"309";"100,00%";"0";"0,00%";"266";"2";"0.75";"264";"99,25%";"0.75";0.750
"MULTIPOLYGON (((-58.4468051078874 -34.6665023084583,-58.4461724718441 -34.6665646908374,-58.4461333979754 -34.6663154533461,-58.4452321141571 -34.6664000666373,-58.4447851133438 -34.6670747138589,-58.4447322739433 -34.6671478392066,-58.4452562423517 -34.667086126753,-58.4452841623921 -34.6672660652354,-58.4457031110015 -34.6672246443581,-58.4457756428413 -34.6676676946959,-58.4460717651822 -34.6676308330313,-58.4463344286953 -34.6678253809101,-58.4469743186588 -34.6673158033566,-58.4468051078874 -34.6665023084583)))";;"3198";8_16_5;COMUNA 8;"16";"5";"976";"461";"515";"89,51%";"348";"348";"100,00%";"0";"0,00%";"294";"2";"0.68";"292";"99,32%";"0.68";0.680
"MULTIPOLYGON (((-58.4446408584991 -34.6673542498345,-58.4446964640098 -34.6676945629743,-58.444752133445 -34.6677405742719,-58.4455728761088 -34.6684318420653,-58.4463344286953 -34.6678253809101,-58.4460717651822 -34.6676308330313,-58.4457756428413 -34.6676676946959,-58.4457031110015 -34.6672246443581,-58.4452841623921 -34.6672660652354,-58.4452562423517 -34.667086126753,-58.4447322739433 -34.6671478392066,-58.4446323047713 -34.6672976293765,-58.4446408584991 -34.6673542498345)))";;"3199";8_16_6;COMUNA 8;"16";"6";"830";"378";"452";"83,63%";"271";"271";"100,00%";"0";"0,00%";"267";"3";"1.12";"264";"98,88%";"1.12";1.120
"MULTIPOLYGON (((-58.444752133445 -34.6677405742719,-58.4440579017081 -34.6678266738186,-58.4440825037638 -34.6679680194486,-58.4439345275391 -34.6679832788666,-58.4438959627164 -34.6677712953302,-58.4431697191004 -34.6678542115781,-58.44261779839 -34.6682358224192,-58.4426474550374 -34.6682615322234,-58.4426853780545 -34.6682944970955,-58.4430883866249 -34.6686444312243,-58.4434151034861 -34.6690217470628,-58.4434382822442 -34.6690485824375,-58.4435082447377 -34.6691293702992,-58.4437496089156 -34.6692724400832,-58.4439554369891 -34.669380714258,-58.4441184922316 -34.6694138387028,-58.4443216266502 -34.6693718965333,-58.4444829165251 -34.6692929749519,-58.4455728761088 -34.6684318420653,-58.444752133445 -34.6677405742719)))";;"3200";8_16_7;COMUNA 8;"16";"7";"1041";"481";"560";"85,89%";"287";"287";"100,00%";"0";"0,00%";"276";"4";"1.45";"272";"98,55%";"1.45";1.450
"MULTIPOLYGON (((-58.444752133445 -34.6677405742719,-58.4446964640098 -34.6676945629743,-58.4446408584991 -34.6673542498345,-58.444034805824 -34.6674309552846,-58.4440468932835 -34.667503353474,-58.4438367779602 -34.6675270541859,-58.4438289508657 -34.6674620512032,-58.4436110780875 -34.6674896940947,-58.4435887713576 -34.6673789129323,-58.4428514478004 -34.6674711215807,-58.4428737557713 -34.667572677273,-58.4419836792276 -34.6676847154282,-58.4424458243258 -34.6680865645675,-58.44261779839 -34.6682358224192,-58.4431697191004 -34.6678542115781,-58.4438959627164 -34.6677712953302,-58.4439345275391 -34.6679832788666,-58.4440825037638 -34.6679680194486,-58.4440579017081 -34.6678266738186,-58.444752133445 -34.6677405742719)))";;"3201";8_16_8;COMUNA 8;"16";"8";"804";"359";"445";"80,67%";"237";"237";"100,00%";"0";"0,00%";"236";"4";"1.69";"232";"98,31%";"1.69";1.690
"MULTIPOLYGON (((-58.4446408584991 -34.6673542498345,-58.4446323047713 -34.6672976293765,-58.4447322739433 -34.6671478392066,-58.4447851133438 -34.6670747138589,-58.4439185376489 -34.6666959173466,-58.4428013034828 -34.6668618714208,-58.4428292357618 -34.6669680056392,-58.4427621533253 -34.6669726427014,-58.4427566184716 -34.6669495425732,-58.441337127362 -34.6671200109922,-58.4414615450104 -34.6672306695531,-58.4419836792276 -34.6676847154282,-58.4428737557713 -34.667572677273,-58.4428514478004 -34.6674711215807,-58.4435887713576 -34.6673789129323,-58.4436110780875 -34.6674896940947,-58.4438289508657 -34.6674620512032,-58.4438367779602 -34.6675270541859,-58.4440468932835 -34.667503353474,-58.444034805824 -34.6674309552846,-58.4446408584991 -34.6673542498345)))";;"3202";8_16_9;COMUNA 8;"16";"9";"915";"440";"475";"92,63%";"318";"318";"100,00%";"0";"0,00%";"280";"3";"1.07";"277";"98,93%";"1.07";1.070
"MULTIPOLYGON (((-58.496117350949 -34.6781697873578,-58.4961153153349 -34.6781713975644,-58.4953904443103 -34.6775069996951,-58.4947347445001 -34.6769060316144,-58.4946184313012 -34.676811200535,-58.493586889747 -34.6775819085493,-58.4942168853414 -34.6780732387071,-58.4941983092516 -34.6787698105122,-58.4952848975842 -34.6787866380022,-58.4952993703452 -34.6787759155405,-58.4955771989627 -34.6790446373899,-58.4959703714665 -34.6794249182699,-58.4968200221722 -34.6787829406236,-58.4964057677767 -34.6784214624408,-58.496117350949 -34.6781697873578)))";;"3203";8_2_1;COMUNA 8;"2";"1";"1282";"573";"709";"80,82%";"411";"411";"100,00%";"0";"0,00%";"387";"9";"2.33";"378";"97,67%";"2.33";2.330
"MULTIPOLYGON (((-58.4897552689138 -34.681264391107,-58.4902597576766 -34.6816914014117,-58.490837417839 -34.6821768448833,-58.4911193604043 -34.6824161070874,-58.4915394306783 -34.6827725834969,-58.4923325706393 -34.6821733820002,-58.4918884380468 -34.6818314099685,-58.4915609391478 -34.6815792403865,-58.4915529913267 -34.6815855361415,-58.4914510193865 -34.6815540805791,-58.4913680624536 -34.6815336770741,-58.490801265462 -34.6814038762457,-58.4907308357083 -34.6813683281949,-58.4906111119769 -34.6812770857849,-58.4905498858578 -34.6812304789068,-58.4898319321582 -34.6810712002262,-58.4900340253145 -34.6804383927443,-58.4901089684303 -34.6802035812846,-58.4893379124707 -34.6800407903785,-58.4895572319006 -34.67942227595,-58.4897946625922 -34.6786702325244,-58.4885165279156 -34.678394587415,-58.4882883026632 -34.6783454089323,-58.4878596096865 -34.67813387306,-58.4878312178065 -34.678119864475,-58.4876582236355 -34.6780344753046,-58.4875827986912 -34.6781000557765,-58.4870207300111 -34.6785889140511,-58.4868153320385 -34.6787658607611,-58.4875491669311 -34.6793797430151,-58.4878851349338 -34.679660807925,-58.4883151602237 -34.6800205161191,-58.4896720402379 -34.6811925063478,-58.4897552689138 -34.681264391107)))";;"3204";8_2_10;COMUNA 8;"2";"10";"540";"251";"289";"86,85%";"191";"191";"100,00%";"0";"0,00%";"188";"1";"0.53";"187";"99,47%";"0.53";0.530
"MULTIPOLYGON (((-58.4938483118415 -34.6761293399402,-58.4933242148546 -34.6756560097936,-58.4923860565991 -34.676527954509,-58.4924108042394 -34.6768398579083,-58.4917873112515 -34.6773348801268,-58.4920194222879 -34.6775269421124,-58.4923199207914 -34.6772898211444,-58.4930695777492 -34.6779683864218,-58.493586889747 -34.6775819085493,-58.4946184313012 -34.676811200535,-58.4944622104763 -34.6766838437003,-58.4938483118415 -34.6761293399402)))";;"3205";8_2_2;COMUNA 8;"2";"2";"535";"259";"276";"93,84%";"184";"183";"99,46%";"1";"0,55%";"168";"1";"0.6";"167";"99,40%";"0.6";0.600
"MULTIPOLYGON (((-58.493586889747 -34.6775819085493,-58.4930695777492 -34.6779683864218,-58.4929085722678 -34.6787498547557,-58.4941983092516 -34.6787698105122,-58.4942168853414 -34.6780732387071,-58.493586889747 -34.6775819085493)))";;"3206";8_2_3;COMUNA 8;"2";"3";"515";"238";"277";"85,92%";"182";"182";"100,00%";"0";"0,00%";"161";"2";"1.24";"159";"98,76%";"1.24";1.240
"MULTIPOLYGON (((-58.4923199207914 -34.6772898211444,-58.4920194222879 -34.6775269421124,-58.491667787415 -34.6778043572123,-58.4912679980381 -34.6781197412947,-58.4916443083524 -34.6784362098747,-58.4919854033552 -34.6787231075258,-58.4922449917914 -34.6787395945995,-58.4929085722678 -34.6787498547557,-58.4930695777492 -34.6779683864218,-58.4923199207914 -34.6772898211444)))";;"3207";8_2_4;COMUNA 8;"2";"4";"800";"385";"415";"92,77%";"292";"292";"100,00%";"0";"0,00%";"249";"7";"2.81";"242";"97,19%";"2.81";2.810
"MULTIPOLYGON (((-58.4933242148546 -34.6756560097936,-58.4917088124882 -34.6741969303425,-58.4912797428421 -34.6746325083458,-58.4910673165054 -34.6748481546212,-58.4899711641821 -34.675921601619,-58.490359027937 -34.676162365521,-58.4907119584884 -34.6761962294684,-58.490867887545 -34.6762368283881,-58.4911058607311 -34.6763859319413,-58.491204373737 -34.6765418284537,-58.4912126775051 -34.6766435192693,-58.4911880946125 -34.6767994445186,-58.4909912321095 -34.6769690017628,-58.4908845258287 -34.6770367746989,-58.490654798678 -34.6770775328678,-58.4903649641008 -34.6773507045821,-58.4908806894162 -34.6777908793963,-58.4911239724676 -34.677998574691,-58.4912679980381 -34.6781197412947,-58.491667787415 -34.6778043572123,-58.4920194222879 -34.6775269421124,-58.4917873112515 -34.6773348801268,-58.4924108042394 -34.6768398579083,-58.4923860565991 -34.676527954509,-58.4933242148546 -34.6756560097936)))";;"3208";8_2_5;COMUNA 8;"2";"5";"561";"268";"293";"91,47%";"194";"194";"100,00%";"0";"0,00%";"174";"3";"1.72";"171";"98,28%";"1.72";1.720
"MULTIPOLYGON (((-58.4899711641821 -34.675921601619,-58.4893541651315 -34.6764879498819,-58.4903649641008 -34.6773507045821,-58.490654798678 -34.6770775328678,-58.4908845258287 -34.6770367746989,-58.4909912321095 -34.6769690017628,-58.4911880946125 -34.6767994445186,-58.4912126775051 -34.6766435192693,-58.491204373737 -34.6765418284537,-58.4911058607311 -34.6763859319413,-58.490867887545 -34.6762368283881,-58.4907119584884 -34.6761962294684,-58.490359027937 -34.676162365521,-58.4899711641821 -34.675921601619)))";;"3209";8_2_6;COMUNA 8;"2";"6";"698";"313";"385";"81,30%";"261";"261";"100,00%";"0";"0,00%";"249";"1";"0.4";"248";"99,60%";"0.4";0.400
"MULTIPOLYGON (((-58.488749172624 -34.6770386582021,-58.4886217644038 -34.6771546742533,-58.4879640936778 -34.6777534192061,-58.4878364294395 -34.6778757726665,-58.4877423428896 -34.6779660056019,-58.4876582236355 -34.6780344753046,-58.4878312178065 -34.678119864475,-58.4878596096865 -34.67813387306,-58.4882883026632 -34.6783454089323,-58.4885165279156 -34.678394587415,-58.4897946625922 -34.6786702325244,-58.489971907249 -34.6787084334059,-58.4900857490492 -34.6782958621841,-58.4898111338825 -34.67820317473,-58.4897861440316 -34.677904158577,-58.4900793223243 -34.6776772563001,-58.4900792968753 -34.6775999303854,-58.4903649641008 -34.6773507045821,-58.4893541651315 -34.6764879498819,-58.488749172624 -34.6770386582021)))";;"3210";8_2_7;COMUNA 8;"2";"7";"1226";"567";"659";"86,04%";"456";"456";"100,00%";"0";"0,00%";"404";"2";"0.5";"402";"99,50%";"0.5";0.500
"MULTIPOLYGON (((-58.4908806894162 -34.6777908793963,-58.4903649641008 -34.6773507045821,-58.4900792968753 -34.6775999303854,-58.4900793223243 -34.6776772563001,-58.4897861440316 -34.677904158577,-58.4898111338825 -34.67820317473,-58.4900857490492 -34.6782958621841,-58.489971907249 -34.6787084334059,-58.4904280210063 -34.678806783709,-58.4905162599497 -34.678825778172,-58.491975748251 -34.6791450923711,-58.4922343292383 -34.6792016511444,-58.4922935949237 -34.6792506520948,-58.4928666420026 -34.6797236925869,-58.4929930876836 -34.679779155585,-58.4935936362512 -34.6799095715274,-58.4937925450914 -34.6799645927615,-58.4938008590242 -34.6799583929015,-58.494004180345 -34.6801195743484,-58.4945150064264 -34.6805245236069,-58.4959703714665 -34.6794249182699,-58.4955771989627 -34.6790446373899,-58.4952993703452 -34.6787759155405,-58.4952848975842 -34.6787866380022,-58.4941983092516 -34.6787698105122,-58.4929085722678 -34.6787498547557,-58.4922449917914 -34.6787395945995,-58.4919854033552 -34.6787231075258,-58.4916443083524 -34.6784362098747,-58.4912679980381 -34.6781197412947,-58.4911239724676 -34.677998574691,-58.4908806894162 -34.6777908793963)))";;"3211";8_2_8;COMUNA 8;"2";"8";"910";"412";"498";"82,73%";"337";"337";"100,00%";"0";"0,00%";"307";"4";"1.3";"303";"98,70%";"1.3";1.300
"MULTIPOLYGON (((-58.4918884380468 -34.6818314099685,-58.4923325706393 -34.6821733820002,-58.4945150064264 -34.6805245236069,-58.494004180345 -34.6801195743484,-58.4938008590242 -34.6799583929015,-58.4937925450914 -34.6799645927615,-58.4935936362512 -34.6799095715274,-58.4929930876836 -34.679779155585,-58.4928666420026 -34.6797236925869,-58.4922935949237 -34.6792506520948,-58.4922343292383 -34.6792016511444,-58.491975748251 -34.6791450923711,-58.4905162599497 -34.678825778172,-58.4904280210063 -34.678806783709,-58.489971907249 -34.6787084334059,-58.4897946625922 -34.6786702325244,-58.4895572319006 -34.67942227595,-58.4893379124707 -34.6800407903785,-58.4901089684303 -34.6802035812846,-58.4900340253145 -34.6804383927443,-58.4898319321582 -34.6810712002262,-58.4905498858578 -34.6812304789068,-58.4906111119769 -34.6812770857849,-58.4907308357083 -34.6813683281949,-58.490801265462 -34.6814038762457,-58.4913680624536 -34.6815336770741,-58.4914510193865 -34.6815540805791,-58.4915529913267 -34.6815855361415,-58.4915609391478 -34.6815792403865,-58.4918884380468 -34.6818314099685)))";;"3212";8_2_9;COMUNA 8;"2";"9";"829";"410";"419";"97,85%";"302";"302";"100,00%";"0";"0,00%";"271";"0";"0";"271";"100,00%";"0";0.000
"MULTIPOLYGON (((-58.4878018018741 -34.6704734736396,-58.4882720176057 -34.6700163214183,-58.4887894364263 -34.6695133109541,-58.4888876932007 -34.6694363864094,-58.4881697852213 -34.668805042606,-58.4874833491931 -34.6682013649204,-58.4873691859562 -34.6681017374841,-58.4866267576588 -34.6686735910836,-58.4861749212915 -34.6690215756478,-58.4855603087114 -34.6694950150623,-58.485184481438 -34.6697845293596,-58.4845873282743 -34.6702445095258,-58.4844979294265 -34.6703133302034,-58.4836006940338 -34.6710030128016,-58.4843656508449 -34.6716773338221,-58.4853343126547 -34.6725311241005,-58.4862804521974 -34.6717471916136,-58.4873371041557 -34.6708716072402,-58.4877106213185 -34.6705620158739,-58.4878018018741 -34.6704734736396)))";;"3213";8_3_1;COMUNA 8;"3";"1";"951";"452";"499";"90,58%";"317";"317";"100,00%";"0";"0,00%";"334";"32";"9.58";"302";"90,42%";"9.58";9.580
"MULTIPOLYGON (((-58.4903948477282 -34.6836372639991,-58.4896971623411 -34.6834731207113,-58.4892730957485 -34.6833724439268,-58.4892455391459 -34.6833649073792,-58.4888709360058 -34.6836389387886,-58.4887357970921 -34.6836019245654,-58.4882118709224 -34.6834663277878,-58.4878125120913 -34.6833646476522,-58.4874734336436 -34.6832804896129,-58.4872926026385 -34.6832520748264,-58.4869482490351 -34.6832007340992,-58.4868248005265 -34.6831951950777,-58.486726753945 -34.6834723339476,-58.4866632051568 -34.6836474211872,-58.4866292157825 -34.6837409512902,-58.4865192395568 -34.6840433746202,-58.4864595886447 -34.6841381068944,-58.486204351157 -34.6841877350602,-58.4857886735532 -34.6842699996205,-58.4854959394234 -34.6843785785036,-58.4848982339743 -34.6844329155026,-58.4848522825462 -34.68443602253,-58.4848071807784 -34.6844282840502,-58.4846929927474 -34.684307034134,-58.4846817477505 -34.6843395721703,-58.4842662939392 -34.6846360620863,-58.4845540734068 -34.6848047473419,-58.4848777322267 -34.6849199733828,-58.4851971988524 -34.6849775922982,-58.485572152202 -34.684981043727,-58.4851424916742 -34.6850764076076,-58.4847260508279 -34.6851947258894,-58.4843115821725 -34.6853611421577,-58.4841156967826 -34.6854853346794,-58.4852290741003 -34.6868282650355,-58.4852280266338 -34.6868290370421,-58.4856076740509 -34.6872534247964,-58.4903948477282 -34.6836372639991)))";;"3214";8_3_10;COMUNA 8;"3";"10";"1696";"828";"868";"95,39%";"308";"308";"100,00%";"0";"0,00%";"478";"86";"17.99";"392";"82,01%";"17.99";17.990
"MULTIPOLYGON (((-58.4810808840842 -34.6729139623921,-58.4798694919719 -34.6728847016306,-58.4804574327892 -34.6733830812329,-58.4812060955387 -34.6740174935662,-58.4823585691568 -34.6749943104909,-58.4825678894739 -34.6748211734576,-58.4833916109882 -34.6741397510363,-58.4842259721391 -34.6734494476244,-58.4843135834824 -34.6733768245811,-58.4847649329276 -34.6730028606463,-58.4853343126547 -34.6725311241005,-58.4843656508449 -34.6716773338221,-58.4836006940338 -34.6710030128016,-58.4826907451223 -34.6717024797988,-58.4825763714514 -34.6717885571233,-58.48153864542 -34.6725695172267,-58.4810808840842 -34.6729139623921)))";;"3215";8_3_2;COMUNA 8;"3";"2";"791";"386";"405";"95,31%";"292";"292";"100,00%";"0";"0,00%";"256";"8";"3.13";"248";"96,88%";"3.13";3.130
"MULTIPOLYGON (((-58.4864506819937 -34.6735467835298,-58.4858859703085 -34.6730299068225,-58.485514985081 -34.6726903904016,-58.4853343126547 -34.6725311241005,-58.4847649329276 -34.6730028606463,-58.4843135834824 -34.6733768245811,-58.4842259721391 -34.6734494476244,-58.4833916109882 -34.6741397510363,-58.4825678894739 -34.6748211734576,-58.4823585691568 -34.6749943104909,-58.4826052328881 -34.6752033604064,-58.4835312769766 -34.675986465412,-58.4843279907023 -34.6766602877069,-58.4851171285534 -34.6773275566472,-58.485716898865 -34.6778347817978,-58.4859010778329 -34.6779908776283,-58.4868153320385 -34.6787658607611,-58.4870207300111 -34.6785889140511,-58.4875827986912 -34.6781000557765,-58.4876582236355 -34.6780344753046,-58.4877423428896 -34.6779660056019,-58.4878364294395 -34.6778757726665,-58.4879640936778 -34.6777534192061,-58.4886217644038 -34.6771546742533,-58.4883793180891 -34.6771439506441,-58.4883553523188 -34.6771072646083,-58.4883314683451 -34.6770593106556,-58.4883382776726 -34.6770254351148,-58.4882818942253 -34.6769111482509,-58.4883091654398 -34.6768857897607,-58.4886451610554 -34.6753660315907,-58.4881507739125 -34.6749261243812,-58.4880196682637 -34.6749294616281,-58.4878551872378 -34.6747852665747,-58.4872201201246 -34.6742283391849,-58.4866299962617 -34.6737109076978,-58.4864506819937 -34.6735467835298)))";;"3216";8_3_3;COMUNA 8;"3";"3";"580";"286";"294";"97,28%";"202";"202";"100,00%";"0";"0,00%";"187";"9";"4.81";"178";"95,19%";"4.81";4.810
"MULTIPOLYGON (((-58.4811067368019 -34.6780320490074,-58.4818874219232 -34.6786980723464,-58.4822770017722 -34.6790304132042,-58.4826642825426 -34.6793608517183,-58.4841918812943 -34.6780945738805,-58.4851171285534 -34.6773275566472,-58.4843279907023 -34.6766602877069,-58.4835312769766 -34.675986465412,-58.4826052328881 -34.6752033604064,-58.4823585691568 -34.6749943104909,-58.4814387766778 -34.6757548976249,-58.4799148433192 -34.6770150844366,-58.4811067368019 -34.6780320490074)))";;"3217";8_3_4;COMUNA 8;"3";"4";"791";"380";"411";"92,46%";"261";"261";"100,00%";"0";"0,00%";"250";"56";"22.4";"194";"77,60%";"22.4";22.400
"MULTIPOLYGON (((-58.476773720144 -34.6723311386703,-58.4771010929364 -34.6730689381904,-58.4771031249408 -34.6730735905994,-58.4775109378498 -34.6740072940144,-58.478289609997 -34.6758031099603,-58.478952537794 -34.6761824842239,-58.4789690398706 -34.6762073766257,-58.4799148433192 -34.6770150844366,-58.4814387766778 -34.6757548976249,-58.4823585691568 -34.6749943104909,-58.4812060955387 -34.6740174935662,-58.4804574327892 -34.6733830812329,-58.4798694919719 -34.6728847016306,-58.4794567610546 -34.6725348906711,-58.4784941336043 -34.6717190116534,-58.478364631035 -34.6716098705327,-58.4771475451875 -34.6705843596936,-58.4765679138994 -34.6700958927925,-58.4764920397389 -34.6700319560219,-58.4763597249306 -34.6698949249854,-58.4761760876901 -34.6697046586179,-58.4760838465741 -34.6696305822792,-58.4752603333116 -34.6689689619226,-58.4754029873556 -34.669293392519,-58.4766726699405 -34.6721033991545,-58.476773720144 -34.6723311386703)))";;"3218";8_3_5;COMUNA 8;"3";"5";"728";"324";"404";"80,20%";"263";"263";"100,00%";"0";"0,00%";"238";"3";"1.26";"235";"98,74%";"1.26";1.260
"MULTIPOLYGON (((-58.4833796094657 -34.681714338898,-58.483435853179 -34.6816659216323,-58.4844023941895 -34.6808436201584,-58.4838890717902 -34.6804056713127,-58.4834441399106 -34.6800260904057,-58.4830560855591 -34.6796950911413,-58.4826642825426 -34.6793608517183,-58.4822770017722 -34.6790304132042,-58.4818874219232 -34.6786980723464,-58.4811067368019 -34.6780320490074,-58.4799148433192 -34.6770150844366,-58.4789690398706 -34.6762073766257,-58.478952537794 -34.6761824842239,-58.4782671226203 -34.6757518924916,-58.4783449002511 -34.6759306201849,-58.4784042572584 -34.6760659304235,-58.4784265157811 -34.6761166708317,-58.4790944633054 -34.6776383121004,-58.479739808206 -34.6791230299938,-58.4797454606266 -34.6791360340294,-58.4800623187767 -34.6798649952235,-58.4805178241502 -34.6809056074943,-58.4805430557567 -34.6809609585335,-58.4807013896348 -34.6813085700299,-58.4807000450325 -34.6813079671126,-58.4808786669371 -34.681695807965,-58.4809387774921 -34.6818263248356,-58.4818280533528 -34.6829854761558,-58.4821966767092 -34.6827143613903,-58.482200849028 -34.6827176540957,-58.4822023358118 -34.6827188274338,-58.4831128911258 -34.6819552907896,-58.4831649469518 -34.6819099249814,-58.4833788154663 -34.6817150623394,-58.4833797928777 -34.681714384064,-58.4833796094657 -34.681714338898)))";;"3219";8_3_6;COMUNA 8;"3";"6";"397";"198";"199";"99,50%";"137";"137";"100,00%";"0";"0,00%";"144";"3";"2.08";"141";"97,92%";"2.08";2.080
"MULTIPOLYGON (((-58.4841918812943 -34.6780945738805,-58.4826642825426 -34.6793608517183,-58.4830560855591 -34.6796950911413,-58.4834441399106 -34.6800260904057,-58.4838890717902 -34.6804056713127,-58.4844023941895 -34.6808436201584,-58.4845210370416 -34.6807426105307,-58.485900149901 -34.679554368204,-58.4863160664567 -34.6791960398372,-58.4868153320385 -34.6787658607611,-58.4859010778329 -34.6779908776283,-58.485716898865 -34.6778347817978,-58.4851171285534 -34.6773275566472,-58.4841918812943 -34.6780945738805)))";;"3220";8_3_7;COMUNA 8;"3";"7";"764";"370";"394";"93,91%";"245";"245";"100,00%";"0";"0,00%";"245";"7";"2.86";"238";"97,14%";"2.86";2.860
"MULTIPOLYGON (((-58.4869214542683 -34.6828214342871,-58.4868769033095 -34.6829465166452,-58.4869176585249 -34.6829610159551,-58.4868393720474 -34.6831717409102,-58.4868248005265 -34.6831951950777,-58.4869482490351 -34.6832007340992,-58.4872926026385 -34.6832520748264,-58.4874734336436 -34.6832804896129,-58.4878125120913 -34.6833646476522,-58.4882118709224 -34.6834663277878,-58.4887357970921 -34.6836019245654,-58.4888709360058 -34.6836389387886,-58.4892455391459 -34.6833649073792,-58.4892730957485 -34.6833724439268,-58.4896971623411 -34.6834731207113,-58.4903948477282 -34.6836372639991,-58.4905375265687 -34.6835294823689,-58.4915394306783 -34.682772583497,-58.4911193604043 -34.6824161070874,-58.490837417839 -34.6821768448833,-58.4902597576766 -34.6816914014117,-58.4897552689138 -34.681264391107,-58.4896720402379 -34.6811925063478,-58.4883151602237 -34.6800205161191,-58.4878851349339 -34.679660807925,-58.4875491669311 -34.6793797430151,-58.4868153320385 -34.6787658607611,-58.4863160664567 -34.6791960398372,-58.485900149901 -34.679554368204,-58.4845210370416 -34.6807426105307,-58.4844023941895 -34.6808436201584,-58.483435853179 -34.6816659216323,-58.4833796094657 -34.681714338898,-58.4833785762186 -34.6817152283655,-58.4833786213746 -34.6817152391833,-58.4831649469518 -34.6819099249814,-58.4855038540071 -34.6824614875587,-58.4855260211387 -34.6824667652306,-58.485564647336 -34.682491336065,-58.4856149448498 -34.6824856926772,-58.4858680738701 -34.6825355756415,-58.4859724359031 -34.6825810498449,-58.4864860351971 -34.6827094750095,-58.4866736906637 -34.682757608451,-58.4868818087403 -34.6828115123359,-58.4869214542683 -34.6828214342871)))";;"3221";8_3_8;COMUNA 8;"3";"8";"1901";"986";"915";"107,76%";"448";"448";"100,00%";"0";"0,00%";"547";"186";"34";"361";"66,00%";"34";34.000
"MULTIPOLYGON (((-58.481841641377 -34.6830031875406,-58.4818704352395 -34.6830407190287,-58.4823163391692 -34.6835055004785,-58.4823497394899 -34.6835403145387,-58.482998792912 -34.6842168328812,-58.4841156967826 -34.6854853346794,-58.4843115821725 -34.6853611421577,-58.4847260508279 -34.6851947258894,-58.4851424916742 -34.6850764076076,-58.485572152202 -34.684981043727,-58.4851971988524 -34.6849775922982,-58.4848777322267 -34.6849199733828,-58.4845540734068 -34.6848047473419,-58.4842662939392 -34.6846360620863,-58.4846817477505 -34.6843395721703,-58.4846929927474 -34.684307034134,-58.4848071807784 -34.6844282840502,-58.4848522825462 -34.68443602253,-58.4848982339743 -34.6844329155026,-58.4854959394234 -34.6843785785036,-58.4857886735532 -34.6842699996205,-58.486204351157 -34.6841877350602,-58.4864595886447 -34.6841381068944,-58.4865192395568 -34.6840433746202,-58.4866292157825 -34.6837409512902,-58.4866632051568 -34.6836474211872,-58.486726753945 -34.6834723339476,-58.4868248005265 -34.6831951950777,-58.4868393720474 -34.6831717409102,-58.4869176585249 -34.6829610159551,-58.4868769033095 -34.6829465166452,-58.4869214542683 -34.6828214342871,-58.4868818087403 -34.6828115123359,-58.4866736906637 -34.682757608451,-58.4864860351971 -34.6827094750095,-58.4859724359031 -34.6825810498449,-58.4858680738701 -34.6825355756415,-58.4856149448498 -34.6824856926772,-58.485564647336 -34.682491336065,-58.4855260211387 -34.6824667652306,-58.4855038540071 -34.6824614875587,-58.4831649469518 -34.6819099249814,-58.4831128911258 -34.6819552907896,-58.4822023358118 -34.6827188274338,-58.482200849028 -34.6827176540957,-58.4821966767092 -34.6827143613903,-58.4818280533528 -34.6829854761558,-58.481841641377 -34.6830031875406)))";;"3222";8_3_9;COMUNA 8;"3";"9";"2007";"988";"1019";"96,96%";"374";"374";"100,00%";"0";"0,00%";"569";"97";"17.05";"472";"82,95%";"17.05";17.050
"MULTIPOLYGON (((-58.4889524298822 -34.663348388693,-58.4887122998906 -34.6635299240986,-58.4877378006958 -34.6642880365301,-58.4864893148399 -34.66525929933,-58.4863892711005 -34.6653371378593,-58.4858694506322 -34.6657449954723,-58.4852376488776 -34.6662407613321,-58.4864280955822 -34.6672800709357,-58.4873691859562 -34.6681017374841,-58.4886221383633 -34.6671365216737,-58.4887108486687 -34.6670682614799,-58.4898699420327 -34.6661543921152,-58.4910000378318 -34.6652634062898,-58.4900770849757 -34.6644002832914,-58.4889524298822 -34.663348388693)))";;"3223";8_4_1;COMUNA 8;"4";"1";"899";"426";"473";"90,06%";"299";"299";"100,00%";"0";"0,00%";"287";"25";"8.71";"262";"91,29%";"8.71";8.710
"MULTIPOLYGON (((-58.4802785066348 -34.6681355021767,-58.4804370227707 -34.6680113913404,-58.4807818373065 -34.6677458405098,-58.4812790277306 -34.6673630792733,-58.4811582234382 -34.667258306032,-58.4804981970233 -34.6666917689663,-58.4797166119059 -34.6660210170835,-58.4789308621529 -34.6653465985958,-58.4784102369982 -34.6657494243802,-58.4778982144098 -34.6661455565185,-58.477767736501 -34.6662464909794,-58.4768973377732 -34.6669306282779,-58.4776834251367 -34.6675949185337,-58.4784673085127 -34.6682573728962,-58.4791222166101 -34.6688107521308,-58.4792667193916 -34.6689277075726,-58.4802785066348 -34.6681355021767)))";;"3224";8_4_10;COMUNA 8;"4";"10";"883";"409";"474";"86,29%";"347";"347";"100,00%";"0";"0,00%";"306";"5";"1.63";"301";"98,37%";"1.63";1.630
"MULTIPOLYGON (((-58.4750106520474 -34.6684009442648,-58.4752603333116 -34.6689689619226,-58.4760838465741 -34.6696305822792,-58.4761760876901 -34.6697046586179,-58.4763597249306 -34.6698949249854,-58.4764920397389 -34.6700319560219,-58.4765679138994 -34.6700958927925,-58.4771475451875 -34.6705843596936,-58.4776296828697 -34.6702076013725,-58.4782130661756 -34.6697516712232,-58.4787998521503 -34.6692931320955,-58.4788744250728 -34.6692348812174,-58.4792667193916 -34.6689277075726,-58.4791222166101 -34.6688107521308,-58.4784673085127 -34.6682573728962,-58.4776834251367 -34.6675949185337,-58.4768973377732 -34.6669306282779,-58.4758377172378 -34.6677387268621,-58.4755846807285 -34.6679567879675,-58.4755838158366 -34.6679517198055,-58.4750106520474 -34.6684009442648)))";;"3225";8_4_11;COMUNA 8;"4";"11";"743";"362";"381";"95,01%";"259";"259";"100,00%";"0";"0,00%";"252";"3";"1.19";"249";"98,81%";"1.19";1.190
"MULTIPOLYGON (((-58.4857680575196 -34.6646488576648,-58.4864893148399 -34.66525929933,-58.4877378006958 -34.6642880365301,-58.4887122998906 -34.6635299240986,-58.4889524298822 -34.663348388693,-58.4871322887145 -34.6628035405122,-58.4859453270546 -34.6624481288185,-58.4853608745972 -34.6620771016577,-58.4852268672584 -34.6619919832501,-58.4850373649946 -34.6618716626145,-58.4837150876214 -34.6629029125676,-58.4845023861006 -34.6635729338936,-58.4852876511624 -34.664241189824,-58.4857680575196 -34.6646488576648)))";;"3226";8_4_2;COMUNA 8;"4";"2";"622";"289";"333";"86,79%";"218";"218";"100,00%";"0";"0,00%";"214";"39";"18.22";"175";"81,78%";"18.22";18.220
"MULTIPOLYGON (((-58.4845023861006 -34.6635729338936,-58.4837150876214 -34.6629029125676,-58.4824637639648 -34.6638787828769,-58.4826119302146 -34.6640053115864,-58.4832504649005 -34.6645485305789,-58.4839165447493 -34.6651151927392,-58.4840423761503 -34.66521172274,-58.4841786085367 -34.6653160678946,-58.4845229517844 -34.6656167192625,-58.4848310640252 -34.6658860373345,-58.4852376488776 -34.6662407613321,-58.4858694506322 -34.6657449954723,-58.4863892711005 -34.6653371378593,-58.4864893148399 -34.66525929933,-58.4857680575196 -34.6646488576648,-58.4852876511624 -34.664241189824,-58.4845023861006 -34.6635729338936)))";;"3227";8_4_3;COMUNA 8;"4";"3";"663";"312";"351";"88,89%";"245";"245";"100,00%";"0";"0,00%";"220";"3";"1.36";"217";"98,64%";"1.36";1.360
"MULTIPOLYGON (((-58.4850373649946 -34.6618716626145,-58.4841316318761 -34.6612965976904,-58.4832323878044 -34.6607175811149,-58.482144194271 -34.6615656004012,-58.4817150462186 -34.6618999732865,-58.4808950025526 -34.6625389896259,-58.4810940572363 -34.6627084715548,-58.4816792063676 -34.6632083958685,-58.4824637639648 -34.6638787828769,-58.4837150876214 -34.6629029125676,-58.4850373649946 -34.6618716626145)))";;"3228";8_4_4;COMUNA 8;"4";"4";"663";"333";"330";"100,91%";"254";"254";"100,00%";"0";"0,00%";"224";"26";"11.61";"198";"88,39%";"11.61";11.610
"MULTIPOLYGON (((-58.4812936253832 -34.6647913162255,-58.4824637639648 -34.6638787828769,-58.4816792063676 -34.6632083958685,-58.4805076197927 -34.6641216966684,-58.4797549547332 -34.6647083698582,-58.4796342819117 -34.6648024737928,-58.4789308621529 -34.6653465985958,-58.4797166119059 -34.6660210170835,-58.4804981970233 -34.6666917689663,-58.4811582234382 -34.667258306032,-58.4812790277306 -34.6673630792733,-58.481510321133 -34.6671850107792,-58.4828645662358 -34.6661296949935,-58.482079558386 -34.665460930651,-58.4812936253832 -34.6647913162255)))";;"3229";8_4_5;COMUNA 8;"4";"5";"960";"451";"509";"88,61%";"359";"359";"100,00%";"0";"0,00%";"332";"12";"3.61";"320";"96,39%";"3.61";3.610
"MULTIPOLYGON (((-58.4817080261089 -34.6677352063793,-58.4820641351886 -34.6680441023977,-58.4824805227518 -34.6684053833806,-58.4826149178639 -34.6682985276188,-58.4830986363881 -34.6679190007218,-58.4834669617471 -34.6676300574399,-58.4840714290612 -34.6671557851196,-58.4852376488776 -34.6662407613321,-58.4848310640252 -34.6658860373345,-58.4845229517844 -34.6656167192625,-58.4841786085367 -34.6653160678946,-58.4840423761503 -34.66521172274,-58.4839165447493 -34.6651151927392,-58.4832504649005 -34.6645485305789,-58.4826119302146 -34.6640053115864,-58.4824637639648 -34.6638787828769,-58.4812936253832 -34.6647913162255,-58.482079558386 -34.665460930651,-58.4828645662358 -34.6661296949935,-58.481510321133 -34.6671850107792,-58.4812790277306 -34.6673630792733,-58.4817080261089 -34.6677352063793)))";;"3230";8_4_6;COMUNA 8;"4";"6";"1084";"509";"575";"88,52%";"402";"402";"100,00%";"0";"0,00%";"350";"8";"2.29";"342";"97,71%";"2.29";2.290
"MULTIPOLYGON (((-58.4830986363881 -34.6679190007218,-58.4826149178639 -34.6682985276188,-58.4824805227518 -34.6684053833806,-58.4836793192545 -34.6694438730081,-58.483856059218 -34.6695969451774,-58.4845873282743 -34.6702445095258,-58.485184481438 -34.6697845293596,-58.4855603087114 -34.6694950150623,-58.4861749212915 -34.6690215756478,-58.4866267576588 -34.6686735910836,-58.4873691859562 -34.6681017374841,-58.4864280955822 -34.6672800709357,-58.4852376488776 -34.6662407613321,-58.4840714290612 -34.6671557851196,-58.4834669617471 -34.6676300574399,-58.4830986363881 -34.6679190007218)))";;"3231";8_4_7;COMUNA 8;"4";"7";"836";"394";"442";"89,14%";"300";"300";"100,00%";"0";"0,00%";"278";"19";"6.83";"259";"93,17%";"6.83";6.830
"MULTIPOLYGON (((-58.48153864542 -34.6725695172267,-58.4825763714514 -34.6717885571233,-58.4826907451223 -34.6717024797988,-58.4836006940338 -34.6710030128016,-58.4844979294265 -34.6703133302034,-58.4845873282743 -34.6702445095258,-58.483856059218 -34.6695969451774,-58.4836793192545 -34.6694438730081,-58.4824805227518 -34.6684053833806,-58.4816317034788 -34.6690799730083,-58.4815157136339 -34.6691698525449,-58.4804979579406 -34.6699579843292,-58.4800227373336 -34.6703260203963,-58.4794312624551 -34.6707839321562,-58.4805494822197 -34.6717313340081,-58.4796881594372 -34.6723640090566,-58.4794567610546 -34.6725348906711,-58.4798694919719 -34.6728847016306,-58.4810808840842 -34.6729139623921,-58.48153864542 -34.6725695172267)))";;"3232";8_4_8;COMUNA 8;"4";"8";"859";"416";"443";"93,91%";"317";"317";"100,00%";"0";"0,00%";"278";"9";"3.24";"269";"96,76%";"3.24";3.240
"MULTIPOLYGON (((-58.478364631035 -34.6716098705327,-58.4784941336043 -34.6717190116534,-58.4794567610546 -34.6725348906711,-58.4796881594372 -34.6723640090566,-58.4805494822197 -34.6717313340081,-58.4794312624551 -34.6707839321562,-58.4800227373336 -34.6703260203963,-58.4804979579406 -34.6699579843292,-58.4815157136339 -34.6691698525449,-58.4816317034788 -34.6690799730083,-58.4824805227518 -34.6684053833806,-58.4820641351886 -34.6680441023977,-58.4817080261089 -34.6677352063793,-58.4812790277306 -34.6673630792733,-58.4807818373065 -34.6677458405098,-58.4804370227707 -34.6680113913404,-58.4802785066348 -34.6681355021767,-58.4792667193916 -34.6689277075726,-58.4788744250728 -34.6692348812174,-58.4787998521503 -34.6692931320955,-58.4782130661756 -34.6697516712232,-58.4776296828697 -34.6702076013725,-58.4771475451875 -34.6705843596936,-58.478364631035 -34.6716098705327)))";;"3233";8_4_9;COMUNA 8;"4";"9";"770";"353";"417";"84,65%";"292";"291";"99,66%";"1";"0,34%";"258";"6";"2.33";"252";"97,67%";"2.33";2.330
"MULTIPOLYGON (((-58.4805723290907 -34.6602303805712,-58.4793247580916 -34.6612022043436,-58.4801101297639 -34.6618708460005,-58.4808950025526 -34.6625389896259,-58.4817150462186 -34.6618999732865,-58.482144194271 -34.6615656004012,-58.4832323878044 -34.6607175811149,-58.4823333267338 -34.6601386986694,-58.4814337666958 -34.6595593870664,-58.480841596564 -34.6591780572599,-58.4805335372724 -34.6589797167446,-58.4799111270779 -34.659460101624,-58.4797860309318 -34.6595581501876,-58.4804417325364 -34.6601158189194,-58.4805723290907 -34.6602303805712)))";;"3234";8_5_1;COMUNA 8;"5";"1";"807";"387";"420";"92,14%";"333";"333";"100,00%";"0";"0,00%";"277";"10";"3.61";"267";"96,39%";"3.61";3.610
"MULTIPOLYGON (((-58.4742025336118 -34.6653690384006,-58.4741999709557 -34.6653626816023,-58.4736735098031 -34.665370785366,-58.474045729813 -34.6662056958556,-58.4740561836537 -34.6662294795543,-58.4745411652043 -34.6662294334149,-58.4745435120881 -34.6662350859434,-58.4755760646621 -34.6662584326123,-58.4757363254141 -34.6663670805364,-58.4770053233391 -34.6663803188886,-58.4771319687266 -34.6662907240389,-58.4768767357955 -34.6660784242081,-58.476623037642 -34.6658615460693,-58.476361584979 -34.6656482599121,-58.4758952845245 -34.6652521735799,-58.4758361234673 -34.6652016856155,-58.4756029750284 -34.6650026205008,-58.4754088955011 -34.6650025000373,-58.4753987243233 -34.6653760325481,-58.4753062442141 -34.6653760421456,-58.4753055762206 -34.6654677348864,-58.4751058697173 -34.6654651496656,-58.4751129331382 -34.6653907102724,-58.4747297152314 -34.665385748549,-58.4747459495604 -34.6650708086657,-58.4745452215798 -34.6650708283331,-58.4745249785388 -34.6653723879276,-58.4742025336118 -34.6653690384006)))";;"3235";8_5_10;COMUNA 8;"5";"10";"1137";"495";"642";"77,10%";"472";"472";"100,00%";"0";"0,00%";"411";"0";"0";"411";"100,00%";"0";0.000
"MULTIPOLYGON (((-58.4748393830995 -34.6680113075478,-58.4750106520474 -34.6684009442648,-58.4755838158366 -34.6679517198055,-58.4755493603359 -34.6677498142341,-58.4754397215759 -34.6675978497709,-58.4755683313082 -34.6675105099403,-58.4756348078064 -34.6674551492836,-58.4763889743382 -34.6668597689852,-58.4766103904505 -34.6666881195059,-58.4768232830481 -34.6665225271117,-58.4769236769753 -34.6664380765047,-58.4770053233391 -34.6663803188886,-58.4757363254141 -34.6663670805364,-58.4755760646621 -34.6662584326123,-58.4745435120881 -34.6662350859434,-58.4745411652043 -34.6662294334149,-58.4740561836537 -34.6662294795543,-58.4748393830995 -34.6680113075478)))";;"3236";8_5_11;COMUNA 8;"5";"11";"927";"412";"515";"80,00%";"360";"360";"100,00%";"0";"0,00%";"319";"1";"0.31";"318";"99,69%";"0.31";0.310
"MULTIPOLYGON (((-58.4805723290907 -34.6602303805712,-58.4804417325364 -34.6601158189194,-58.4797860309318 -34.6595581501876,-58.4799111270779 -34.659460101624,-58.4805335372724 -34.6589797167446,-58.4803001496541 -34.6588293942348,-58.4801692211142 -34.6587451148713,-58.4798224660675 -34.6585205801471,-58.4796328085727 -34.6583978566269,-58.479462586097 -34.658287595286,-58.4793565480648 -34.6582147908213,-58.4788178367167 -34.6578444300165,-58.4783980694215 -34.6581782267934,-58.4782774050295 -34.658275005617,-58.4779011791781 -34.6585768927651,-58.4777001550046 -34.6587381898972,-58.4770430477366 -34.6592511005629,-58.4772166003265 -34.6594039012953,-58.4777568652468 -34.6598653278225,-58.4785406777031 -34.6605346841773,-58.4793247580916 -34.6612022043436,-58.4805723290907 -34.6602303805712)))";;"3237";8_5_2;COMUNA 8;"5";"2";"776";"378";"398";"94,97%";"299";"299";"100,00%";"0";"0,00%";"263";"4";"1.52";"259";"98,48%";"1.52";1.520
"MULTIPOLYGON (((-58.4777568652468 -34.6598653278225,-58.4772166003265 -34.6594039012953,-58.4770430477366 -34.6592511005629,-58.4758698469709 -34.6601667520145,-58.4757079301243 -34.660293181444,-58.4751320137907 -34.660744944499,-58.4758465967072 -34.6613567178554,-58.4766297262134 -34.6620273540463,-58.4772894332991 -34.6625921519231,-58.4774138057204 -34.6626969990738,-58.477567373273 -34.6625783151432,-58.478013244638 -34.662231419228,-58.4781548788251 -34.6621170319424,-58.4782805767134 -34.6620155342144,-58.4793247580916 -34.6612022043436,-58.4785406777031 -34.6605346841773,-58.4777568652468 -34.6598653278225)))";;"3238";8_5_3;COMUNA 8;"5";"3";"821";"389";"432";"90,05%";"290";"290";"100,00%";"0";"0,00%";"270";"27";"10";"243";"90,00%";"10";10.000
"MULTIPOLYGON (((-58.4816792063676 -34.6632083958685,-58.4810940572363 -34.6627084715548,-58.4808950025526 -34.6625389896259,-58.4801101297639 -34.6618708460005,-58.4793247580916 -34.6612022043436,-58.4782805767134 -34.6620155342144,-58.4781548788251 -34.6621170319424,-58.478013244638 -34.662231419228,-58.477567373273 -34.6625783151432,-58.4774138057204 -34.6626969990738,-58.4780842628386 -34.6632620729865,-58.4781991761165 -34.6633654416029,-58.4783420508974 -34.6634940184964,-58.478976548215 -34.664039302752,-58.4797229055482 -34.6634530577311,-58.4805076197927 -34.6641216966684,-58.4816792063676 -34.6632083958685)))";;"3239";8_5_4;COMUNA 8;"5";"4";"872";"398";"474";"83,97%";"327";"327";"100,00%";"0";"0,00%";"291";"10";"3.44";"281";"96,56%";"3.44";3.440
"MULTIPOLYGON (((-58.4781518597369 -34.664678019345,-58.4777502913279 -34.664988430286,-58.4776290191641 -34.6650823914568,-58.477108645101 -34.6654854229438,-58.476623037642 -34.6658615460693,-58.4768767357955 -34.6660784242081,-58.4771319687266 -34.6662907240389,-58.4770053233391 -34.6663803188886,-58.4769236769753 -34.6664380765047,-58.4768232830481 -34.6665225271117,-58.4766103904505 -34.6666881195059,-58.4763889743382 -34.6668597689852,-58.4756348078064 -34.6674551492836,-58.4755683313082 -34.6675105099403,-58.4754397215759 -34.6675978497709,-58.4755493603359 -34.6677498142341,-58.4755838158366 -34.6679517198055,-58.4755846807285 -34.6679567879675,-58.4758377172378 -34.6677387268621,-58.4768973377732 -34.6669306282779,-58.477767736501 -34.6662464909794,-58.4778982144098 -34.6661455565185,-58.4784102369982 -34.6657494243802,-58.4789308621529 -34.6653465985958,-58.4796342819117 -34.6648024737928,-58.4797549547332 -34.6647083698582,-58.4805076197927 -34.6641216966684,-58.4797229055482 -34.6634530577311,-58.478976548215 -34.664039302752,-58.4788733458767 -34.6641203046543,-58.4781518597369 -34.664678019345)))";;"3240";8_5_5;COMUNA 8;"5";"5";"617";"292";"325";"89,85%";"194";"194";"100,00%";"0";"0,00%";"201";"5";"2.49";"196";"97,51%";"2.49";2.490
"MULTIPOLYGON (((-58.4755224687234 -34.6641591548929,-58.4750458955132 -34.664527524174,-58.4753970210566 -34.6648267217603,-58.4756029750284 -34.6650026205008,-58.4758361234673 -34.6652016856155,-58.4758952845245 -34.6652521735799,-58.476361584979 -34.6656482599121,-58.476623037642 -34.6658615460693,-58.477108645101 -34.6654854229438,-58.4776290191641 -34.6650823914568,-58.4777502913279 -34.664988430286,-58.4781518597369 -34.664678019345,-58.4788733458767 -34.6641203046543,-58.478976548215 -34.664039302752,-58.4783420508974 -34.6634940184964,-58.4781991761165 -34.6633654416029,-58.4780842628386 -34.6632620729865,-58.4774138057204 -34.6626969990738,-58.4765853685822 -34.6633374662763,-58.4755224687234 -34.6641591548929)))";;"3241";8_5_6;COMUNA 8;"5";"6";"831";"389";"442";"88,01%";"318";"318";"100,00%";"0";"0,00%";"282";"5";"1.77";"277";"98,23%";"1.77";1.770
"MULTIPOLYGON (((-58.4729755549749 -34.6624525878814,-58.4725271878211 -34.6627836904745,-58.473300725018 -34.664534590005,-58.4733051181291 -34.6645444443189,-58.4737565402566 -34.6642159469195,-58.4737656383711 -34.6642370756442,-58.4742640336705 -34.6638563849947,-58.4744738189134 -34.6640361586549,-58.4749719893047 -34.6644725301091,-58.4750458955132 -34.664527524174,-58.4755224687234 -34.6641591548929,-58.4765853685822 -34.6633374662763,-58.4774138057204 -34.6626969990738,-58.4772894332991 -34.6625921519231,-58.4766297262134 -34.6620273540463,-58.4758465967072 -34.6613567178554,-58.4751320137907 -34.660744944499,-58.4750891479188 -34.660778611789,-58.4744422354044 -34.6612860845451,-58.4743193485755 -34.6614020150884,-58.4749694875211 -34.6619561923876,-58.475020121494 -34.6619993575117,-58.4753154875228 -34.6622520808997,-58.4742423653364 -34.6631046759182,-58.4739487143731 -34.6629273040316,-58.4738373873742 -34.6628286495155,-58.4732114549058 -34.6622735486556,-58.4729755549749 -34.6624525878814)))";;"3242";8_5_7;COMUNA 8;"5";"7";"1024";"492";"532";"92,48%";"368";"368";"100,00%";"0";"0,00%";"336";"9";"2.68";"327";"97,32%";"2.68";2.680
"MULTIPOLYGON (((-58.475020121494 -34.6619993575117,-58.4749694875211 -34.6619561923876,-58.4743193485755 -34.6614020150884,-58.4742160620215 -34.6614994924305,-58.4740111880013 -34.6616590231552,-58.4736287941706 -34.6619568129059,-58.4732114549058 -34.6622735486556,-58.4738373873742 -34.6628286495155,-58.4739487143731 -34.6629273040316,-58.4742423653364 -34.6631046759182,-58.4753154875228 -34.6622520808997,-58.475020121494 -34.6619993575117)))";;"3243";8_5_8;COMUNA 8;"5";"8";"624";"292";"332";"87,95%";"253";"253";"100,00%";"0";"0,00%";"254";"1";"0.39";"253";"99,61%";"0.39";0.390
"MULTIPOLYGON (((-58.4737656383711 -34.6642370756442,-58.4737565402566 -34.6642159469195,-58.4733051181291 -34.6645444443189,-58.4733213316057 -34.6645808132134,-58.4736735098031 -34.665370785366,-58.4741999709557 -34.6653626816023,-58.4742025336118 -34.6653690384006,-58.4745249785388 -34.6653723879276,-58.4745452215798 -34.6650708283331,-58.4747459495604 -34.6650708086657,-58.4747297152314 -34.665385748549,-58.4751129331382 -34.6653907102724,-58.4751058697173 -34.6654651496656,-58.4753055762206 -34.6654677348864,-58.4753062442141 -34.6653760421456,-58.4753987243233 -34.6653760325481,-58.4754088955011 -34.6650025000373,-58.4756029750284 -34.6650026205008,-58.4753970210566 -34.6648267217603,-58.4750458955132 -34.664527524174,-58.4749719893047 -34.6644725301091,-58.4744738189134 -34.6640361586549,-58.4742640336705 -34.6638563849947,-58.4737656383711 -34.6642370756442)))";;"3244";8_5_9;COMUNA 8;"5";"9";"910";"428";"482";"88,80%";"313";"313";"100,00%";"0";"0,00%";"298";"1";"0.34";"297";"99,66%";"0.34";0.340
"MULTIPOLYGON (((-58.4715025268481 -34.6644314203683,-58.4719744272369 -34.6648271005847,-58.4720363871076 -34.6647766719233,-58.4725111903275 -34.6651753076452,-58.4728527776742 -34.6648948493837,-58.4728456294482 -34.6648788073077,-58.4733051181291 -34.6645444443189,-58.473300725018 -34.664534590005,-58.4725271878211 -34.6627836904745,-58.4720266819613 -34.663156770849,-58.4714008490413 -34.6636786602384,-58.4710023309801 -34.6640120775989,-58.4715025268481 -34.6644314203683)))";;"3245";8_6_1;COMUNA 8;"6";"1";"926";"417";"509";"81,93%";"349";"349";"100,00%";"0";"0,00%";"302";"3";"0.99";"299";"99,01%";"0.99";0.990
"MULTIPOLYGON (((-58.4694569271312 -34.6728523751877,-58.4692351980389 -34.6729241872737,-58.4700031255138 -34.6736057109216,-58.4707743051173 -34.6742899759902,-58.4715379951538 -34.6749676871794,-58.4714271859677 -34.675055866472,-58.4710319367773 -34.6753760432961,-58.4721566967914 -34.6764129599045,-58.4726933583653 -34.6759970612767,-58.4732954767111 -34.6755303786216,-58.4734257188645 -34.6754294491196,-58.4741282368589 -34.6748850049296,-58.47252162912 -34.6741818871626,-58.4715250868556 -34.6737450845194,-58.4715271392323 -34.6737433886438,-58.4714915150331 -34.6737278773428,-58.4713016446724 -34.6736452047174,-58.4704121776347 -34.6732637049076,-58.4694569271312 -34.6728523751877)))";;"3246";8_6_10;COMUNA 8;"6";"10";"640";"293";"347";"84,44%";"241";"241";"100,00%";"0";"0,00%";"219";"18";"8.22";"201";"91,78%";"8.22";8.220
"MULTIPOLYGON (((-58.4709025381167 -34.6762793149008,-58.4715528608666 -34.6768809046312,-58.4721566967914 -34.6764129599045,-58.4710319367772 -34.6753760432961,-58.4714271859677 -34.675055866472,-58.4715379951538 -34.6749676871793,-58.4707743051173 -34.6742899759902,-58.4700031255138 -34.6736057109216,-58.4695312489553 -34.6739925794112,-58.4690549356413 -34.6743838830171,-58.4689470229486 -34.6744725528834,-58.4696989373009 -34.6751663329329,-58.4698274119012 -34.675284849697,-58.4704423390041 -34.6758536297645,-58.4709025381167 -34.6762793149008)))";;"3247";8_6_11;COMUNA 8;"6";"11";"651";"338";"313";"107,99%";"165";"165";"100,00%";"0";"0,00%";"203";"28";"13.79";"175";"86,21%";"13.79";13.790
"MULTIPOLYGON (((-58.4705842905104 -34.6643390158496,-58.4701621625989 -34.6646668812201,-58.4701624114739 -34.6646689107132,-58.4706711317425 -34.6651007918842,-58.4708622441798 -34.6652631076707,-58.4711459307242 -34.6655038696446,-58.4716157049478 -34.6659027204281,-58.4720304236189 -34.6655631025727,-58.4724010639175 -34.665881744397,-58.4725973620792 -34.6658857428143,-58.4729808834455 -34.6655696460294,-58.4725111903275 -34.6651753076452,-58.4720363871076 -34.6647766719233,-58.4719744272369 -34.6648271005847,-58.4715025268481 -34.6644314203683,-58.4710023309801 -34.6640120775989,-58.4709396038154 -34.6640611677276,-58.4705842905104 -34.6643390158496)))";;"3248";8_6_2;COMUNA 8;"6";"2";"1197";"531";"666";"79,73%";"441";"441";"100,00%";"0";"0,00%";"397";"5";"1.26";"392";"98,74%";"1.26";1.260
"MULTIPOLYGON (((-58.4725973620792 -34.6658857428143,-58.4724010639175 -34.665881744397,-58.4720304236189 -34.6655631025727,-58.4716157049478 -34.6659027204281,-58.4720887229467 -34.6663042452549,-58.4724317469722 -34.6665954939533,-58.4725584209614 -34.6667030219341,-58.4730299988812 -34.667103345956,-58.4732214615013 -34.6672659396583,-58.4734961255475 -34.6674990205959,-58.4740129789482 -34.6679378589189,-58.4744093818196 -34.6682743095031,-58.4752603333116 -34.6689689619226,-58.4750106520474 -34.6684009442648,-58.4748393830995 -34.6680113075478,-58.4740561836537 -34.6662294795543,-58.474045729813 -34.6662056958556,-58.4736735098031 -34.665370785366,-58.4733213316057 -34.6645808132134,-58.4733051181291 -34.6645444443189,-58.4728456294482 -34.6648788073077,-58.4728527776742 -34.6648948493837,-58.4725111903275 -34.6651753076452,-58.4729808834455 -34.6655696460294,-58.4725973620792 -34.6658857428143)))";;"3249";8_6_3;COMUNA 8;"6";"3";"1219";"568";"651";"87,25%";"435";"435";"100,00%";"0";"0,00%";"402";"5";"1.24";"397";"98,76%";"1.24";1.240
"MULTIPOLYGON (((-58.4730737259888 -34.6712107066257,-58.4738115803152 -34.6719041107531,-58.4746107331263 -34.6725752502515,-58.4760734307164 -34.6727093274626,-58.4761712054665 -34.6727182605953,-58.476364691175 -34.6726263352251,-58.476363870333 -34.6728186643385,-58.4763886057564 -34.672910002001,-58.4763993529286 -34.6729499314241,-58.4765584416919 -34.6731032977659,-58.4766898928746 -34.6731414527707,-58.4766979211386 -34.6731476131449,-58.4767776193921 -34.6732087683877,-58.4767780354356 -34.6732118596645,-58.4771031249408 -34.6730735905994,-58.4771010929364 -34.6730689381904,-58.476773720144 -34.6723311386703,-58.4766726699405 -34.6721033991545,-58.4754029873556 -34.669293392519,-58.4752603333116 -34.6689689619226,-58.4744093818196 -34.6682743095031,-58.4746113787587 -34.668748668985,-58.4735087577222 -34.6695991467921,-58.4723279557399 -34.6705098335892,-58.4730737259888 -34.6712107066257)))";;"3250";8_6_4;COMUNA 8;"6";"4";"742";"336";"406";"82,76%";"225";"225";"100,00%";"0";"0,00%";"233";"9";"3.86";"224";"96,14%";"3.86";3.860
"MULTIPOLYGON (((-58.471589188406 -34.6698155048701,-58.4723279557399 -34.6705098335892,-58.4735087577222 -34.6695991467921,-58.4746113787587 -34.668748668985,-58.4744093818196 -34.6682743095031,-58.4740129789482 -34.6679378589189,-58.4734961255475 -34.6674990205959,-58.4732214615013 -34.6672659396583,-58.4730299988812 -34.667103345956,-58.4725584209614 -34.6667030219341,-58.4724317469722 -34.6665954939533,-58.4712718579583 -34.6674965211464,-58.4700948973485 -34.6684106371563,-58.4702364049072 -34.6685441532367,-58.4708422497092 -34.6691134958765,-58.471589188406 -34.6698155048701)))";;"3251";8_6_5;COMUNA 8;"6";"5";"999";"484";"515";"93,98%";"352";"352";"100,00%";"0";"0,00%";"320";"14";"4.38";"306";"95,63%";"4.38";4.380
"MULTIPOLYGON (((-58.4720887229467 -34.6663042452549,-58.4716157049478 -34.6659027204281,-58.4711459307242 -34.6655038696446,-58.4708622441798 -34.6652631076707,-58.4706711317425 -34.6651007918842,-58.4701624114739 -34.6646689107132,-58.4697349039693 -34.6650031707421,-58.4691307966095 -34.665475611526,-58.4688923223132 -34.6656620374643,-58.4686448972851 -34.6658495197343,-58.4679405435088 -34.6663785102509,-58.4686094363027 -34.6670081448035,-58.4693524161051 -34.6677072101115,-58.4700948973485 -34.6684106371563,-58.4712718579583 -34.6674965211464,-58.4724317469722 -34.6665954939533,-58.4720887229467 -34.6663042452549)))";;"3252";8_6_6;COMUNA 8;"6";"6";"1003";"491";"512";"95,90%";"252";"252";"100,00%";"0";"0,00%";"320";"66";"20.63";"254";"79,38%";"20.63";20.630
"MULTIPOLYGON (((-58.4623775903405 -34.670427394233,-58.4621539183657 -34.6706451457444,-58.4618982801307 -34.6708431777949,-58.4618457721063 -34.6708176133749,-58.4615669571664 -34.6710359483385,-58.4615675434892 -34.671036208495,-58.461504123534 -34.6710855049795,-58.4615660081814 -34.671107477988,-58.4616215850608 -34.6711267747817,-58.4616618192192 -34.6710948024471,-58.4617668356049 -34.671139874921,-58.4617343584573 -34.6711670584916,-58.4617875486654 -34.6711863551905,-58.4618795234589 -34.6712196665915,-58.461783796656 -34.6713136824997,-58.4619289617796 -34.6713841079154,-58.4620009904147 -34.6714134049044,-58.4620315393447 -34.6713636089975,-58.4620702470987 -34.6713019352434,-58.4621283081591 -34.6712768091011,-58.4622140168495 -34.6713133570051,-58.4623024904427 -34.6713453364162,-58.4623771400971 -34.6713704630649,-58.4624711434287 -34.6714024423678,-58.4626757391627 -34.6714801060842,-58.4629273370256 -34.6715326429504,-58.463071107364 -34.6715600532455,-58.4630655777586 -34.6715646217035,-58.4630663127991 -34.6715648003107,-58.4631595815237 -34.6715874635919,-58.4632480557116 -34.6716103054328,-58.463306116931 -34.6716262947024,-58.4636130120683 -34.6716879667472,-58.4637706070493 -34.6717199445535,-58.4638480220813 -34.6717290807315,-58.4640222062923 -34.6717701949374,-58.4642323333497 -34.6718113084476,-58.4643346321345 -34.6718318651039,-58.4643899287095 -34.6718387170116,-58.4644507551784 -34.6718569899176,-58.4645115815247 -34.6718684101316,-58.4645875635158 -34.6718897429884,-58.4647152562997 -34.67191333312,-58.4657848162234 -34.6720932418563,-58.4657960534599 -34.6720950497901,-58.4663113356522 -34.6721779511932,-58.4668053455493 -34.6722717024535,-58.4668516051542 -34.6722805423432,-58.4678466490653 -34.6724702981511,-58.4678479580126 -34.6724705479941,-58.4690281182204 -34.6726958026154,-58.4685624205964 -34.6721674881896,-58.4685576960637 -34.6721656373261,-58.4685554181043 -34.6721654693658,-58.4685560391988 -34.6721649882394,-58.4685585217882 -34.6721630651191,-58.4692593894523 -34.671620137355,-58.4704457806408 -34.6707011700056,-58.471589188406 -34.6698155048701,-58.4708422497092 -34.6691134958765,-58.4702364049072 -34.6685441532367,-58.4700948973485 -34.6684106371563,-58.4693524161051 -34.6677072101115,-58.4686094363027 -34.6670081448035,-58.4679405435088 -34.6663785102509,-58.4677520100794 -34.666525775771,-58.4652914683035 -34.6684469616304,-58.4650095063831 -34.6686732410343,-58.4648217303502 -34.6688453617808,-58.4647957517762 -34.6688718452184,-58.4636886695155 -34.6691480359113,-58.463667687345 -34.6691436943239,-58.4636342323552 -34.6691616163811,-58.4634143582479 -34.6692794039593,-58.4633720798257 -34.6693020808678,-58.4630812450385 -34.6695599763988,-58.4630445922265 -34.6695925125953,-58.4629532158825 -34.6697043468154,-58.4628289368415 -34.6698564637773,-58.4627050835452 -34.670004988963,-58.4625133784929 -34.6702689395655,-58.4623775903405 -34.670427394233)))";;"3253";8_6_7;COMUNA 8;"6";"7";"612";"297";"315";"94,29%";"247";"246";"99,60%";"1";"0,41%";"208";"21";"10.1";"187";"89,90%";"10.1";10.100
"MULTIPOLYGON (((-58.4715851979209 -34.6723581786221,-58.4718202976627 -34.6723722461399,-58.4722592990112 -34.6724031288171,-58.4730961302519 -34.672462005546,-58.4742088951399 -34.6725402175009,-58.4746107331263 -34.6725752502515,-58.4738115803152 -34.6719041107531,-58.4730737259888 -34.6712107066257,-58.4723279557399 -34.6705098335892,-58.471589188406 -34.6698155048701,-58.4704457806408 -34.6707011700056,-58.4692593894523 -34.671620137355,-58.4685585217882 -34.6721630651191,-58.4685560391988 -34.6721649882394,-58.4685554181043 -34.6721654693658,-58.4685576960637 -34.6721656373261,-58.468561004115 -34.6721658812378,-58.4694154305645 -34.6722288774096,-58.4699418035389 -34.6722602565598,-58.4700498911908 -34.6722667291358,-58.4715851979209 -34.6723581786221)))";;"3254";8_6_8;COMUNA 8;"6";"8";"764";"374";"390";"95,90%";"271";"271";"100,00%";"0";"0,00%";"241";"5";"2.07";"236";"97,93%";"2.07";2.070
"MULTIPOLYGON (((-58.4761712054665 -34.6727182605953,-58.4760734307164 -34.6727093274626,-58.4746107331263 -34.6725752502515,-58.4742088951399 -34.6725402175009,-58.4730961302519 -34.672462005546,-58.4722592990112 -34.6724031288171,-58.4718202976627 -34.6723722461399,-58.4715851979209 -34.6723581786221,-58.4700498911908 -34.6722667291358,-58.4699418035389 -34.6722602565598,-58.4694154305645 -34.6722288774096,-58.468561004115 -34.6721658812378,-58.4685576960637 -34.6721656373261,-58.4685624205964 -34.6721674881896,-58.4690281182204 -34.6726958026154,-58.4690783344094 -34.6727053869899,-58.4693188927709 -34.6727512908717,-58.4694569271312 -34.6728523751877,-58.4704121776347 -34.6732637049076,-58.4713016446724 -34.6736452047174,-58.4714915150331 -34.6737278773428,-58.4715271392323 -34.6737433886438,-58.4715250868556 -34.6737450845194,-58.47252162912 -34.6741818871626,-58.4741282368589 -34.6748850049296,-58.4741652291802 -34.6748563387375,-58.4744041443975 -34.6746710999369,-58.4745488738383 -34.6745589703537,-58.4751249749402 -34.6741124224523,-58.4756928022283 -34.6736722812972,-58.4763261512796 -34.6731807773679,-58.4763602599988 -34.6731543073927,-58.4765584416919 -34.6731032977659,-58.4763993529286 -34.6729499314241,-58.4763886057564 -34.672910002001,-58.476363870333 -34.6728186643385,-58.476364691175 -34.6726263352251,-58.4761712054665 -34.6727182605953)))";;"3255";8_6_9;COMUNA 8;"6";"9";"869";"401";"468";"85,68%";"307";"307";"100,00%";"0";"0,00%";"284";"8";"2.82";"276";"97,18%";"2.82";2.820
"MULTIPOLYGON (((-58.4693308047717 -34.6767540002308,-58.4683360294259 -34.6775597752007,-58.4694372505678 -34.6785205184935,-58.4704102081021 -34.6777664979335,-58.4715528608666 -34.6768809046312,-58.4709025381167 -34.6762793149008,-58.4704423390041 -34.6758536297646,-58.4698274119012 -34.675284849697,-58.4696989373009 -34.6751663329329,-58.4695669866787 -34.6752738784445,-58.468582544689 -34.6760597953697,-58.4693308047717 -34.6767540002308)))";;"3256";8_7_1;COMUNA 8;"7";"1";"1339";"652";"687";"94,91%";"311";"311";"100,00%";"0";"0,00%";"359";"89";"24.79";"270";"75,21%";"24.79";24.790
"MULTIPOLYGON (((-58.4670611715525 -34.6746905279502,-58.4666043572778 -34.6749440007481,-58.4662263068881 -34.675200216121,-58.4661371473798 -34.6753686737499,-58.4660186614005 -34.6754958634342,-58.4667693694322 -34.6762365640911,-58.4667978405595 -34.6762138160708,-58.4672295086638 -34.675868651023,-58.4675587980959 -34.6756053216597,-58.4678476811553 -34.675374317892,-58.4673796628339 -34.6749964396057,-58.4670611715525 -34.6746905279502)))";;"3257";8_7_10;COMUNA 8;"7";"10";"1035";"518";"517";"100,19%";"161";"161";"100,00%";"0";"0,00%";"285";"60";"21.05";"225";"78,95%";"21.05";21.050
"MULTIPOLYGON (((-58.468582544689 -34.6760597953697,-58.4678476798233 -34.6753743178921,-58.4672295086638 -34.675868651023,-58.4667978405595 -34.6762138160708,-58.4667693694322 -34.6762365640911,-58.4658229087169 -34.676993372079,-58.4654491103829 -34.6772922619983,-58.4651677156122 -34.6775172737892,-58.4659480982048 -34.6781933995413,-58.4662258275461 -34.6779697945666,-58.4666898150941 -34.6776056864429,-58.4675921198791 -34.6768977480772,-58.4683360294259 -34.6775597752007,-58.4693308047717 -34.6767540002308,-58.468582544689 -34.6760597953697)))";;"3258";8_7_11;COMUNA 8;"7";"11";"1570";"759";"811";"93,59%";"324";"324";"100,00%";"0";"0,00%";"411";"92";"22.38";"319";"77,62%";"22.38";22.380
"MULTIPOLYGON (((-58.4666898150941 -34.6776056864429,-58.4662258275461 -34.6779697945666,-58.4659480982049 -34.6781933995413,-58.4651677156122 -34.6775172737893,-58.4647380763079 -34.6778607412249,-58.4652700413609 -34.6784453939774,-58.4654454878469 -34.6785982109441,-58.465920594713 -34.6790120830743,-58.4662228137385 -34.6792714474888,-58.4665151229377 -34.679034672124,-58.4667030771383 -34.6788824329436,-58.4669981242276 -34.678643448928,-58.4673526575834 -34.6783563159249,-58.4674748128941 -34.6782573650168,-58.467941267904 -34.6778795193049,-58.4683360294259 -34.6775597752007,-58.4675921198791 -34.6768977480772,-58.4666898150941 -34.6776056864429)))";;"3259";8_7_12;COMUNA 8;"7";"12";"1705";"819";"886";"92,44%";"322";"322";"100,00%";"0";"0,00%";"395";"46";"11.65";"349";"88,35%";"11.65";11.650
"MULTIPOLYGON (((-58.4683360294259 -34.6775597752007,-58.467941267904 -34.6778795193049,-58.4674748128941 -34.6782573650168,-58.4673526575834 -34.6783563159249,-58.4669981242276 -34.678643448928,-58.4667030771383 -34.6788824329436,-58.4665151229377 -34.679034672124,-58.4662228137385 -34.6792714474888,-58.4661281870091 -34.6792729290975,-58.466056322203 -34.6792830017751,-58.4659929828363 -34.6793061731036,-58.4659588840628 -34.6793313155019,-58.4659175398445 -34.679376599437,-58.4659041571102 -34.6794137838294,-58.4658858310879 -34.6794822367462,-58.4658858336313 -34.6795486468767,-58.4658843008495 -34.6795933663574,-58.4661602653912 -34.6798648445669,-58.46629394302 -34.6799962524647,-58.4664719520764 -34.6801470959586,-58.4666678650838 -34.6803130094092,-58.466723704489 -34.6803207542525,-58.466780736205 -34.6803039209471,-58.4668810740895 -34.6802669447852,-58.4669312848515 -34.6802332802333,-58.4669760389809 -34.6801884888114,-58.4670140568932 -34.6801167251007,-58.4670448287012 -34.6800492575187,-58.4670031357746 -34.6799410168317,-58.4671796076153 -34.6800198152783,-58.4673842082269 -34.6800252302595,-58.4675657886169 -34.6799843066218,-58.467691187905 -34.6799243704625,-58.4680834016793 -34.6795904016759,-58.4682256751555 -34.6794661668153,-58.4684281319785 -34.6793081253,-58.4690448746644 -34.6788268149434,-58.4694372505678 -34.6785205184935,-58.4683360294259 -34.6775597752007)))";;"3260";8_7_13;COMUNA 8;"7";"13";"1513";"742";"771";"96,24%";"254";"254";"100,00%";"0";"0,00%";"391";"78";"19.95";"313";"80,05%";"19.95";19.950
"MULTIPOLYGON (((-58.4673240542371 -34.6744769915611,-58.4670611715525 -34.6746905279502,-58.4673796628339 -34.6749964396057,-58.4678476811553 -34.675374317892,-58.468582544689 -34.6760597953697,-58.4695669866787 -34.6752738784444,-58.4696989373009 -34.6751663329329,-58.4689470229486 -34.6744725528834,-58.4690549356413 -34.6743838830171,-58.4695312489553 -34.6739925794112,-58.4700031255138 -34.6736057109216,-58.4692351980389 -34.6729241872737,-58.4687758515344 -34.6732973898789,-58.4681895799592 -34.6737736978098,-58.4677082264232 -34.6741656966044,-58.4673240542371 -34.6744769915611)))";;"3261";8_7_2;COMUNA 8;"7";"2";"1629";"815";"814";"100,12%";"383";"383";"100,00%";"0";"0,00%";"478";"170";"35.56";"308";"64,44%";"35.56";35.560
"MULTIPOLYGON (((-58.4645115815247 -34.6718684101316,-58.4644712947085 -34.6719369290843,-58.4645337776348 -34.6719665768345,-58.4646275452925 -34.6720353800302,-58.4646900291316 -34.6720977750471,-58.4647655567592 -34.6722269321434,-58.464854125796 -34.6723215810047,-58.4649947781039 -34.6724162992552,-58.4650416619342 -34.6724356650733,-58.4650624617411 -34.6724593272698,-58.4651849589629 -34.6725905959113,-58.4653646549394 -34.6727390467423,-58.4654011388011 -34.6727390459394,-58.4654948234732 -34.6728277785646,-58.4657225896547 -34.6727598135895,-58.4659595637527 -34.672745088785,-58.4662192103916 -34.672753655746,-58.4668724026207 -34.6733846065187,-58.4670203357532 -34.6735393999094,-58.4671423801103 -34.6736504023711,-58.4674308503983 -34.6739217981602,-58.4677082264231 -34.6741656966044,-58.4681895799592 -34.6737736978098,-58.4687758515344 -34.6732973898789,-58.4692351980389 -34.6729241872737,-58.4694569271312 -34.6728523751877,-58.4693188927709 -34.6727512908717,-58.4690783344094 -34.6727053869899,-58.4690281182204 -34.6726958026154,-58.4678479580126 -34.6724705479941,-58.4678466490653 -34.6724702981511,-58.4668516051542 -34.6722805423432,-58.4668053455493 -34.6722717024535,-58.4663113356522 -34.6721779511932,-58.4657960534599 -34.6720950497901,-58.4657848162234 -34.6720932418563,-58.4647152562997 -34.67191333312,-58.4645875635158 -34.6718897429884,-58.4645115815247 -34.6718684101316)))";;"3262";8_7_3;COMUNA 8;"7";"3";"1663";"798";"865";"92,25%";"363";"363";"100,00%";"0";"0,00%";"493";"95";"19.27";"398";"80,73%";"19.27";19.270
"MULTIPOLYGON (((-58.4677082264231 -34.6741656966044,-58.4674308503983 -34.6739217981602,-58.4671423801103 -34.6736504023711,-58.4670203357532 -34.6735393999094,-58.4668724026207 -34.6733846065187,-58.4662192103916 -34.672753655746,-58.4659595637527 -34.672745088785,-58.4657225896547 -34.6727598135895,-58.4654948234732 -34.6728277785646,-58.4654011388011 -34.6727390459394,-58.4653646549394 -34.6727390467423,-58.4651849589629 -34.6725905959113,-58.4650624617411 -34.6724593272698,-58.4650416619342 -34.6724356650733,-58.4649947781039 -34.6724162992552,-58.464854125796 -34.6723215810047,-58.4647655567592 -34.6722269321434,-58.4646900291316 -34.6720977750471,-58.4646275452925 -34.6720353800302,-58.4645337776348 -34.6719665768345,-58.4644712947085 -34.6719369290843,-58.464034951533 -34.672549838203,-58.4641011002179 -34.6725810354685,-58.464294176308 -34.6726757539096,-58.4644954363723 -34.6727813877043,-58.4647186046887 -34.6729008944095,-58.4647827083853 -34.6729442747572,-58.4648583200673 -34.6729924437263,-58.4649261745038 -34.6730323027119,-58.4650162780872 -34.6730957534096,-58.4650706638224 -34.6731196262326,-58.4651160989528 -34.6731396258674,-58.4652795134525 -34.6732531466353,-58.4653846204036 -34.6733180052279,-58.4655101855389 -34.6733716657817,-58.4656158899083 -34.6734475103642,-58.4657229586524 -34.6735312423515,-58.4658037719242 -34.6735970166967,-58.4658514245044 -34.6736349742176,-58.4659346243381 -34.6736888466923,-58.4660269459491 -34.6737575784061,-58.4661207106493 -34.6736753201309,-58.4662590555757 -34.6735472142143,-58.4663450626682 -34.6734651672631,-58.4665302615348 -34.6736508108009,-58.466603022174 -34.6737410820173,-58.4666809401128 -34.6738498147446,-58.466715891419 -34.6738777016535,-58.4668331063819 -34.673972136831,-58.4669179253745 -34.6739974162783,-58.4669245753114 -34.6740153038406,-58.4668639720263 -34.6741188297638,-58.4668256135971 -34.6741472120927,-58.4668741197463 -34.6741920707705,-58.4670163954723 -34.6742543209657,-58.4670620015286 -34.6742619251751,-58.4671197990415 -34.6742981916475,-58.4671521100621 -34.6743625583519,-58.467239915135 -34.6744250919592,-58.4672658296126 -34.674428400937,-58.4673240542371 -34.6744769915611,-58.4677082264231 -34.6741656966044)))";;"3263";8_7_4;COMUNA 8;"7";"4";"1521";"732";"789";"92,78%";"308";"308";"100,00%";"0";"0,00%";"446";"146";"32.74";"300";"67,26%";"32.74";32.740
"MULTIPOLYGON (((-58.4630663127991 -34.6715648003107,-58.463071107364 -34.6715600532455,-58.4629273370256 -34.6715326429504,-58.4626757391627 -34.6714801060842,-58.4624711434287 -34.6714024423678,-58.4623771400971 -34.6713704630649,-58.4623024904427 -34.6713453364162,-58.4622140168495 -34.6713133570051,-58.4621283081591 -34.6712768091011,-58.4620702470987 -34.6713019352434,-58.4620315393447 -34.6713636089975,-58.4620009904147 -34.6714134049044,-58.4618700585544 -34.6715346044923,-58.4623311266462 -34.6721713842318,-58.4632821817895 -34.6734847983476,-58.4638059087353 -34.672830411288,-58.4638845867942 -34.6727594931837,-58.464034951533 -34.672549838203,-58.4644712947085 -34.6719369290843,-58.4645115815247 -34.6718684101316,-58.4644507551784 -34.6718569899176,-58.4643899287095 -34.6718387170116,-58.4643346321345 -34.6718318651039,-58.4642323333497 -34.6718113084476,-58.4640222062923 -34.6717701949374,-58.4638480220813 -34.6717290807315,-58.4637706070493 -34.6717199445535,-58.4636130120683 -34.6716879667472,-58.463306116931 -34.6716262947024,-58.4632480557116 -34.6716103054328,-58.4631595815237 -34.6715874635919,-58.4630663127991 -34.6715648003107)))";;"3264";8_7_5;COMUNA 8;"7";"5";"1707";"874";"833";"104,92%";"464";"464";"100,00%";"0";"0,00%";"543";"187";"34.44";"356";"65,56%";"34.44";34.440
"MULTIPOLYGON (((-58.4650706638224 -34.6731196262326,-58.4650162780872 -34.6730957534096,-58.4649261745038 -34.6730323027119,-58.4648583200673 -34.6729924437263,-58.4647827083853 -34.6729442747572,-58.4647186046887 -34.6729008944095,-58.4644954363723 -34.6727813877043,-58.464294176308 -34.6726757539096,-58.4641011002179 -34.6725810354685,-58.464034951533 -34.672549838203,-58.4638845867942 -34.6727594931837,-58.4638059087353 -34.672830411288,-58.4632821817895 -34.6734847983476,-58.4637675664901 -34.6741551647604,-58.4640817728906 -34.6739492407172,-58.4642829456313 -34.6737978258499,-58.4643589817328 -34.6737313442211,-58.4644573514613 -34.673661129732,-58.4645914368088 -34.6735355610467,-58.464721089275 -34.6734173164212,-58.4649222591712 -34.6732511113641,-58.4650706638224 -34.6731196262326)))";;"3265";8_7_6;COMUNA 8;"7";"6";"1392";"717";"675";"106,22%";"238";"238";"100,00%";"0";"0,00%";"395";"133";"33.67";"262";"66,33%";"33.67";33.670
"MULTIPOLYGON (((-58.4660269459491 -34.6737575784061,-58.4659346243381 -34.6736888466923,-58.4658514245044 -34.6736349742176,-58.4658037719242 -34.6735970166967,-58.4657229586524 -34.6735312423515,-58.4656158899083 -34.6734475103642,-58.4655101855389 -34.6733716657817,-58.4653846204036 -34.6733180052279,-58.4652795134525 -34.6732531466353,-58.4651160989528 -34.6731396258674,-58.4650706638224 -34.6731196262326,-58.4649222591712 -34.6732511113641,-58.464721089275 -34.6734173164212,-58.4645914368088 -34.6735355610467,-58.4644573514613 -34.673661129732,-58.4643589817328 -34.6737313442211,-58.4642829456313 -34.6737978258499,-58.4640817728906 -34.6739492407172,-58.4637675664901 -34.6741551647604,-58.4641413708919 -34.6746713715872,-58.4643466456138 -34.674954897505,-58.4645791061954 -34.6748502435295,-58.4649502560769 -34.6746243158582,-58.4650681473147 -34.6745525511883,-58.4651562036496 -34.6745098722751,-58.4652220966498 -34.6744774052929,-58.4653499605658 -34.6743908510231,-58.4654867748241 -34.6743030991992,-58.4655831809196 -34.6741537972764,-58.4657134300506 -34.6740466786454,-58.4658704450758 -34.6739302631619,-58.465890050036 -34.6739006844103,-58.4660269459491 -34.6737575784061)))";;"3266";8_7_7;COMUNA 8;"7";"7";"2159";"1086";"1073";"101,21%";"494";"494";"100,00%";"0";"0,00%";"661";"252";"38.12";"409";"61,88%";"38.12";38.120
"MULTIPOLYGON (((-58.4649502560769 -34.6746243158582,-58.4645791061954 -34.6748502435295,-58.4643466456138 -34.674954897505,-58.4646092083414 -34.6753174383183,-58.4648473813322 -34.6752243333439,-58.4649617793465 -34.6751852457517,-58.4650688461097 -34.6751439750391,-58.4652466651171 -34.6750676314395,-58.465268315454 -34.6750058688141,-58.4654198778874 -34.674909243292,-58.4654354765262 -34.674873467363,-58.4655073348396 -34.6747816323497,-58.4656805486223 -34.6746819777514,-58.4657917894806 -34.6745899303252,-58.4661418256895 -34.6751224700344,-58.4662263068881 -34.675200216121,-58.4666043572778 -34.6749440007481,-58.4670611715525 -34.6746905279502,-58.4673240542371 -34.6744769915611,-58.4672658296126 -34.674428400937,-58.467239915135 -34.6744250919592,-58.4671521100621 -34.6743625583519,-58.4671197990415 -34.6742981916475,-58.4670620015286 -34.6742619251751,-58.4670163954723 -34.6742543209657,-58.4668741197463 -34.6741920707705,-58.4668256135971 -34.6741472120927,-58.4668639720263 -34.6741188297638,-58.4669245753114 -34.6740153038406,-58.4669179253745 -34.6739974162783,-58.4668331063819 -34.673972136831,-58.466715891419 -34.6738777016535,-58.4666809401128 -34.6738498147446,-58.466603022174 -34.6737410820173,-58.4665302615348 -34.6736508108009,-58.4663450626682 -34.6734651672631,-58.4662590555757 -34.6735472142143,-58.4661207106493 -34.6736753201309,-58.4660269459491 -34.6737575784061,-58.465890050036 -34.6739006844103,-58.4658704450758 -34.6739302631619,-58.4657134300506 -34.6740466786454,-58.4655831809196 -34.6741537972764,-58.4654867748241 -34.6743030991992,-58.4653499605658 -34.6743908510231,-58.4652220966498 -34.6744774052929,-58.4651562036496 -34.6745098722751,-58.4650681473147 -34.6745525511883,-58.4649502560769 -34.6746243158582)))";;"3267";8_7_8;COMUNA 8;"7";"8";"1885";"916";"969";"94,53%";"381";"381";"100,00%";"0";"0,00%";"457";"160";"35.01";"297";"64,99%";"35.01";35.010
"MULTIPOLYGON (((-58.4819123137411 -34.6838618594199,-58.480842380228 -34.6846664092725,-58.4806788880285 -34.6847898167929,-58.4796212917671 -34.6855895651388,-58.4803857570597 -34.6862795437508,-58.4811478473505 -34.6869673346963,-58.4819091827957 -34.687654557522,-58.4824446312916 -34.6881339200346,-58.4824459521177 -34.6881311177367,-58.4829261613335 -34.6885770147925,-58.4833429327398 -34.6889640013925,-58.4856076740509 -34.6872534247964,-58.4852280266338 -34.6868290370421,-58.4852290741003 -34.6868282650355,-58.4841156967826 -34.6854853346794,-58.482998792912 -34.6842168328812,-58.4823497394899 -34.6835403145387,-58.4823163391692 -34.6835055004785,-58.4819008002229 -34.6838514151896,-58.4819123137411 -34.6838618594199)))";;"3268";8_8_1;COMUNA 8;"8";"1";"864";"407";"457";"89,06%";"307";"307";"100,00%";"0";"0,00%";"281";"3";"1.07";"278";"98,93%";"1.07";1.070
"MULTIPOLYGON (((-58.4714436749018 -34.6802709987756,-58.4723492067912 -34.6795559124201,-58.4722233651239 -34.6794407785593,-58.4714109435749 -34.6786888484186,-58.4713030935697 -34.6785890648074,-58.4705183128321 -34.6778781840447,-58.4704102081021 -34.6777664979335,-58.4694372505678 -34.6785205184935,-58.4690448746644 -34.6788268149434,-58.4684281319785 -34.6793081253,-58.4682256751555 -34.6794661668153,-58.4680834016793 -34.6795904016759,-58.467691187905 -34.6799243704625,-58.4675657886169 -34.6799843066218,-58.4673842082269 -34.6800252302595,-58.4671796076153 -34.6800198152783,-58.4670031357746 -34.6799410168317,-58.4670448287012 -34.6800492575187,-58.4670800418333 -34.680140737437,-58.4674650572836 -34.6805826355192,-58.4681886228736 -34.6812321988332,-58.4691152843442 -34.682066258897,-58.4699649354597 -34.6814043637328,-58.4700716631493 -34.6813225947184,-58.4714436749018 -34.6802709987756)))";;"3269";8_8_10;COMUNA 8;"8";"10";"899";"431";"468";"92,09%";"293";"293";"100,00%";"0";"0,00%";"289";"13";"4.5";"276";"95,50%";"4.5";4.500
"MULTIPOLYGON (((-58.4715143362762 -34.6825788682339,-58.4713646188831 -34.6824486644717,-58.47109033712 -34.6822098044897,-58.4708606476084 -34.6820098151106,-58.4700716631493 -34.6813225947184,-58.4699649354597 -34.6814043637328,-58.4691152843442 -34.682066258897,-58.4702283280899 -34.6829053709795,-58.470595113104 -34.6831818334797,-58.4706276826628 -34.6832109165909,-58.471241051847 -34.6837585647054,-58.4723764114968 -34.6847721666778,-58.4725092268057 -34.6846706042842,-58.4732582032214 -34.6840948938062,-58.4727473910428 -34.683650841563,-58.4721697390354 -34.6831486219071,-58.4720993981273 -34.6830874990813,-58.4715143362762 -34.6825788682339)))";;"3270";8_8_11;COMUNA 8;"8";"11";"927";"433";"494";"87,65%";"382";"382";"100,00%";"0";"0,00%";"338";"21";"6.21";"317";"93,79%";"6.21";6.210
"MULTIPOLYGON (((-58.4785599697077 -34.6826059726992,-58.4783835216005 -34.6827393086909,-58.4773394830701 -34.6835299510307,-58.4781005850165 -34.6842169163748,-58.478863746029 -34.6849057780689,-58.4796212917671 -34.6855895651388,-58.4806788880285 -34.6847898167929,-58.480842380228 -34.6846664092725,-58.4819123137411 -34.6838618594199,-58.4819008002229 -34.6838514151896,-58.4823163391692 -34.6835055004785,-58.4818704352395 -34.6830407190287,-58.481841641377 -34.6830031875406,-58.4818280533528 -34.6829854761558,-58.4809387774921 -34.6818263248356,-58.4808786669371 -34.681695807965,-58.4807000450325 -34.6813079671126,-58.4803608824761 -34.6811558298227,-58.480034331606 -34.6809714354635,-58.4801739028865 -34.6814497373528,-58.4804380070447 -34.6818247789792,-58.4800382754173 -34.6814872224441,-58.4785599697077 -34.6826059726992)))";;"3271";8_8_2;COMUNA 8;"8";"2";"924";"437";"487";"89,73%";"319";"319";"100,00%";"0";"0,00%";"309";"6";"1.94";"303";"98,06%";"1.94";1.940
"MULTIPOLYGON (((-58.4784254792239 -34.6801034628219,-58.4783053795398 -34.6801986919216,-58.4778142359023 -34.6805765097861,-58.477003097549 -34.681200426114,-58.4768361120016 -34.6813288290849,-58.4766736442971 -34.6814573721553,-58.476509556518 -34.6815871828273,-58.4757972797404 -34.6821378385327,-58.476578223167 -34.6828428400245,-58.4773394830701 -34.6835299510307,-58.4783835216005 -34.6827393086909,-58.4785599697077 -34.6826059726992,-58.4800382754173 -34.6814872224441,-58.4804380070447 -34.6818247789792,-58.4801739028865 -34.6814497373528,-58.480034331606 -34.6809714354635,-58.4803608824761 -34.6811558298227,-58.4807000450325 -34.6813079671126,-58.4807013896348 -34.6813085700299,-58.4805430557567 -34.6809609585335,-58.4805178241502 -34.6809056074943,-58.4800623187767 -34.6798649952235,-58.4797454606266 -34.6791360340294,-58.4793099350202 -34.6794145053319,-58.4793142476272 -34.6794247362451,-58.4790536767998 -34.6796126635562,-58.4790565765814 -34.6796166451553,-58.4788952374741 -34.6797499694793,-58.4789013638557 -34.6797578988305,-58.4786254458812 -34.6799449821633,-58.4785333897034 -34.6800178833168,-58.4784254792239 -34.6801034628219)))";;"3272";8_8_3;COMUNA 8;"8";"3";"682";"313";"369";"84,82%";"264";"264";"100,00%";"0";"0,00%";"235";"6";"2.55";"229";"97,45%";"2.55";2.550
"MULTIPOLYGON (((-58.4761711004102 -34.6810192487608,-58.4766736442971 -34.6814573721553,-58.4768361120016 -34.6813288290849,-58.477003097549 -34.681200426114,-58.4778142359023 -34.6805765097861,-58.4783053795398 -34.6801986919216,-58.4784254792239 -34.6801034628219,-58.4785333897034 -34.6800178833168,-58.4786254458812 -34.6799449821633,-58.4789013638557 -34.6797578988305,-58.4788952374741 -34.6797499694793,-58.4785422881921 -34.6792931455445,-58.4784934258573 -34.679217093621,-58.4784449050219 -34.6791432247867,-58.4782626000424 -34.6789180312185,-58.4780908653985 -34.6786847372377,-58.4780385956397 -34.6786181928383,-58.4779858143305 -34.6785508738123,-58.4779704604523 -34.6785011561617,-58.4778496366699 -34.6783553224539,-58.4778383810592 -34.6783398304998,-58.4777238661389 -34.6781941367284,-58.4776769687082 -34.6781336479988,-58.4775840261287 -34.6780104168009,-58.4775276642284 -34.6779378866062,-58.4772235401398 -34.6781713094592,-58.4765645607657 -34.6775965827721,-58.4761347962102 -34.6779313577654,-58.4760218567153 -34.6780193301535,-58.4758943413436 -34.6781186423317,-58.4754140248334 -34.6784914493544,-58.4742808529331 -34.6793711620718,-58.4749368464392 -34.6799431546892,-58.4755908879296 -34.6805133833204,-58.4761711004102 -34.6810192487608)))";;"3273";8_8_4;COMUNA 8;"8";"4";"809";"378";"431";"87,70%";"372";"372";"100,00%";"0";"0,00%";"300";"2";"0.67";"298";"99,33%";"0.67";0.670
"MULTIPOLYGON (((-58.4765530258527 -34.6764136663614,-58.4763717286618 -34.6765473522479,-58.4765810463616 -34.6767713484461,-58.4767518268597 -34.6769558406672,-58.4769517683555 -34.6771736399518,-58.4770586894924 -34.6772960953354,-58.4772276786702 -34.6774619246347,-58.4775250021383 -34.6778290109086,-58.4774736897807 -34.6778676800983,-58.4775276642284 -34.6779378866062,-58.4775840261287 -34.6780104168009,-58.4776769687082 -34.6781336479988,-58.4777238661389 -34.6781941367284,-58.4778383810592 -34.6783398304998,-58.4778496366699 -34.6783553224539,-58.4779704604523 -34.6785011561617,-58.4779858143305 -34.6785508738123,-58.4780385956397 -34.6786181928383,-58.4780908653985 -34.6786847372377,-58.4782626000424 -34.6789180312185,-58.4784449050219 -34.6791432247867,-58.4784934258573 -34.679217093621,-58.4785422881921 -34.6792931455445,-58.4788952374741 -34.6797499694793,-58.4790565765814 -34.6796166451553,-58.4790536767998 -34.6796126635562,-58.4793142476272 -34.6794247362451,-58.4793099350202 -34.6794145053319,-58.4797454606266 -34.6791360340294,-58.479739808206 -34.6791230299938,-58.4790944633054 -34.6776383121004,-58.4784265157811 -34.6761166708317,-58.4784042572584 -34.6760659304235,-58.4783449002511 -34.6759306201849,-58.478289609997 -34.6758031099603,-58.4775109378498 -34.6740072940144,-58.4771031249408 -34.6730735905994,-58.4767780354356 -34.6732118596645,-58.4767776193921 -34.6732087683877,-58.4766979211386 -34.6731476131449,-58.4766898928746 -34.6731414527707,-58.4765584416919 -34.6731032977659,-58.4763602599988 -34.6731543073927,-58.4763261512796 -34.6731807773679,-58.4756928022283 -34.6736722812972,-58.4751249749402 -34.6741124224523,-58.4745488738383 -34.6745589703537,-58.4753763760165 -34.6753384144514,-58.4755440772462 -34.6754917107362,-58.4764733936432 -34.6763409270292,-58.4765530258527 -34.6764136663614)))";;"3274";8_8_5;COMUNA 8;"8";"5";"613";"287";"326";"88,04%";"299";"298";"99,67%";"1";"0,34%";"240";"16";"6.67";"224";"93,33%";"6.67";6.670
"MULTIPOLYGON (((-58.4725507001321 -34.677805006712,-58.4734765186643 -34.6786699504373,-58.4742808529331 -34.6793711620718,-58.4754140248334 -34.6784914493544,-58.4758943413436 -34.6781186423317,-58.4760218567153 -34.6780193301535,-58.4761347962102 -34.6779313577654,-58.4765645607657 -34.6775965827721,-58.4772235401398 -34.6781713094592,-58.4775276642284 -34.6779378866062,-58.4774736897807 -34.6778676800983,-58.4775250021383 -34.6778290109086,-58.4772276786702 -34.6774619246347,-58.4770586894924 -34.6772960953354,-58.4769517683555 -34.6771736399518,-58.4767518268597 -34.6769558406672,-58.4765810463616 -34.6767713484461,-58.4763717286618 -34.6765473522479,-58.4765530258527 -34.6764136663614,-58.4764733936432 -34.6763409270292,-58.4755440772462 -34.6754917107362,-58.4753763760165 -34.6753384144514,-58.4745488738383 -34.6745589703537,-58.4744041443975 -34.6746710999369,-58.4741652291802 -34.6748563387375,-58.4741282368589 -34.6748850049296,-58.4734257188645 -34.6754294491196,-58.4732954767111 -34.6755303786216,-58.4726933583653 -34.6759970612767,-58.4721566967914 -34.6764129599045,-58.4715528608666 -34.6768809046312,-58.4724292086593 -34.6776914924385,-58.4725507001321 -34.677805006712)))";;"3275";8_8_6;COMUNA 8;"8";"6";"945";"393";"552";"71,20%";"417";"414";"99,28%";"3";"0,72%";"321";"3";"0.93";"318";"99,07%";"0.93";0.930
"MULTIPOLYGON (((-58.4715528608666 -34.6768809046312,-58.4704102081021 -34.6777664979335,-58.4705183128321 -34.6778781840447,-58.4713030935697 -34.6785890648074,-58.4714109435749 -34.6786888484186,-58.4722233651239 -34.6794407785593,-58.4723492067912 -34.6795559124201,-58.4714436749018 -34.6802709987756,-58.4722305293517 -34.6809574359049,-58.472884645574 -34.6815281015029,-58.4729877903159 -34.6814490063596,-58.4736624031807 -34.680931258549,-58.4737970859229 -34.6808268071244,-58.4749368464392 -34.6799431546892,-58.4742808529331 -34.6793711620718,-58.4734765186643 -34.6786699504373,-58.4725507001321 -34.677805006712,-58.4724292086593 -34.6776914924385,-58.4715528608666 -34.6768809046312)))";;"3276";8_8_7;COMUNA 8;"8";"7";"856";"394";"462";"85,28%";"333";"333";"100,00%";"0";"0,00%";"308";"10";"3.25";"298";"96,75%";"3.25";3.250
"MULTIPOLYGON (((-58.4737970859229 -34.6808268071244,-58.4736624031807 -34.680931258549,-58.4729877903159 -34.6814490063596,-58.472884645574 -34.6815281015029,-58.4735374065798 -34.6820975664441,-58.4741172766169 -34.6826034415599,-58.4744726540577 -34.6829134154286,-58.4746211841114 -34.6830471366926,-58.4755361831154 -34.6823397727318,-58.4757972797404 -34.6821378385327,-58.476509556518 -34.6815871828273,-58.4766736442971 -34.6814573721553,-58.4761711004102 -34.6810192487608,-58.4755908879296 -34.6805133833204,-58.4749368464392 -34.6799431546892,-58.4737970859229 -34.6808268071244)))";;"3277";8_8_8;COMUNA 8;"8";"8";"640";"299";"341";"87,68%";"222";"222";"100,00%";"0";"0,00%";"206";"2";"0.97";"204";"99,03%";"0.97";0.970
"MULTIPOLYGON (((-58.4741172766169 -34.6826034415599,-58.4735374065798 -34.6820975664441,-58.472884645574 -34.6815281015029,-58.4722305293517 -34.6809574359049,-58.4714436749018 -34.6802709987756,-58.4700716631493 -34.6813225947184,-58.4708606476084 -34.6820098151106,-58.47109033712 -34.6822098044897,-58.4713646188831 -34.6824486644717,-58.4715143362762 -34.6825788682339,-58.4720993981273 -34.6830874990813,-58.4721697390354 -34.6831486219071,-58.4727473910428 -34.683650841563,-58.4732582032214 -34.6840948938062,-58.4734463407874 -34.68395029635,-58.4746211841114 -34.6830471366926,-58.4744726540577 -34.6829134154286,-58.4741172766169 -34.6826034415599)))";;"3278";8_8_9;COMUNA 8;"8";"9";"735";"358";"377";"94,96%";"243";"243";"100,00%";"0";"0,00%";"232";"2";"0.86";"230";"99,14%";"0.86";0.860
"MULTIPOLYGON (((-58.4819091827957 -34.687654557522,-58.4811478473505 -34.6869673346963,-58.4799621905803 -34.687864783426,-58.4787753147679 -34.6887631361689,-58.4795351973447 -34.6894488949051,-58.479398886613 -34.6895468737198,-58.478577696638 -34.6901678431785,-58.4783813699189 -34.6903178017009,-58.479106809771 -34.690972727091,-58.4791225928392 -34.6909864001034,-58.4794150352752 -34.6912396479032,-58.4798410501069 -34.6916087781182,-58.4821202942456 -34.6898874227573,-58.4833429327398 -34.6889640013925,-58.4829261613335 -34.6885770147925,-58.4824459521177 -34.6881311177367,-58.4824446312916 -34.6881339200346,-58.4819091827957 -34.687654557522)))";;"3279";8_9_1;COMUNA 8;"9";"1";"801";"354";"447";"79,19%";"301";"301";"100,00%";"0";"0,00%";"271";"16";"5.9";"255";"94,10%";"5.9";5.900
"MULTIPOLYGON (((-58.4781005850165 -34.6842169163748,-58.4773394830701 -34.6835299510307,-58.4761545162284 -34.6844274335677,-58.4769151048328 -34.6851129977848,-58.4775553903333 -34.6856901889878,-58.4776763029468 -34.6857995430415,-58.4784384520262 -34.6864891115845,-58.4790843018097 -34.6870733363266,-58.4791994198192 -34.6871770556846,-58.4799621905803 -34.687864783426,-58.4811478473505 -34.6869673346963,-58.4803857570597 -34.6862795437508,-58.4796212917671 -34.6855895651388,-58.478863746029 -34.6849057780689,-58.4781005850165 -34.6842169163748)))";;"3280";8_9_2;COMUNA 8;"9";"2";"883";"418";"465";"89,89%";"319";"319";"100,00%";"0";"0,00%";"298";"6";"2.01";"292";"97,99%";"2.01";2.010
"MULTIPOLYGON (((-58.4730553035847 -34.6855093823765,-58.4738174114905 -34.6861974305229,-58.4749685861049 -34.6853256087948,-58.4761545162284 -34.6844274335677,-58.4773394830701 -34.6835299510307,-58.476578223167 -34.6828428400245,-58.4757972797404 -34.6821378385327,-58.4755361831154 -34.6823397727318,-58.4746211841114 -34.6830471366926,-58.4734463407874 -34.68395029635,-58.4732582032214 -34.6840948938062,-58.4725092268057 -34.6846706042842,-58.4723764114968 -34.6847721666778,-58.4723019052065 -34.6848291457924,-58.4730553035847 -34.6855093823765)))";;"3281";8_9_3;COMUNA 8;"9";"3";"1028";"490";"538";"91,08%";"429";"429";"100,00%";"0";"0,00%";"352";"14";"3.98";"338";"96,02%";"3.98";3.980
"MULTIPOLYGON (((-58.4776763029468 -34.6857995430415,-58.4775553903333 -34.6856901889878,-58.4769151048328 -34.6851129977848,-58.4761545162284 -34.6844274335677,-58.4749685861049 -34.6853256087948,-58.4738174114905 -34.6861974305229,-58.474578423523 -34.6868844879927,-58.4753404713746 -34.6875725264637,-58.4755196625028 -34.6874368706933,-58.4764900290716 -34.6867001273362,-58.4771422619844 -34.6872892913238,-58.4772513236518 -34.687387731419,-58.4783071749536 -34.6865868068784,-58.4784384520262 -34.6864891115845,-58.4776763029468 -34.6857995430415)))";;"3282";8_9_4;COMUNA 8;"9";"4";"513";"240";"273";"87,91%";"193";"193";"100,00%";"0";"0,00%";"186";"0";"0";"186";"100,00%";"0";0.000
"MULTIPOLYGON (((-58.4799621905803 -34.687864783426,-58.4791994198192 -34.6871770556846,-58.4790843018097 -34.6870733363266,-58.4784384520262 -34.6864891115845,-58.4783071749536 -34.6865868068784,-58.4772513236518 -34.687387731419,-58.4771422619844 -34.6872892913238,-58.4764900290716 -34.6867001273362,-58.4755196625028 -34.6874368706933,-58.4753404713746 -34.6875725264637,-58.4761015938558 -34.6882597151021,-58.4768627289046 -34.6889468284827,-58.4776241323628 -34.6896342186949,-58.4778115932971 -34.6894924316824,-58.4787753147679 -34.6887631361689,-58.4799621905803 -34.687864783426)))";;"3283";8_9_5;COMUNA 8;"9";"5";"940";"428";"512";"83,59%";"436";"436";"100,00%";"0";"0,00%";"385";"15";"3.9";"370";"96,10%";"3.9";3.900
"MULTIPOLYGON (((-58.4795351973447 -34.6894488949051,-58.4787753147679 -34.6887631361689,-58.4778115932971 -34.6894924316824,-58.4776241323628 -34.6896342186949,-58.4783813699189 -34.6903178017009,-58.478577696638 -34.6901678431785,-58.479398886613 -34.6895468737198,-58.4795351973447 -34.6894488949051)))";;"3284";8_9_6;COMUNA 8;"9";"6";"1020";"469";"551";"85,12%";"305";"305";"100,00%";"0";"0,00%";"294";"6";"2.04";"288";"97,96%";"2.04";2.040
"MULTIPOLYGON (((-58.4770061425492 -34.6930683755129,-58.4774267798657 -34.6934319846338,-58.4798410501069 -34.6916087781182,-58.4794150352752 -34.6912396479032,-58.4791225928392 -34.6909864001034,-58.479106809771 -34.690972727091,-58.4783813699189 -34.6903178017009,-58.4776241323628 -34.6896342186949,-58.4768627289046 -34.6889468284827,-58.4756424714321 -34.6898709296953,-58.4744534743421 -34.6907713530163,-58.4752120609276 -34.6914585470908,-58.4759740710606 -34.6921489050794,-58.476707013106 -34.6928038382147,-58.476703336657 -34.6928066198579,-58.4770061425492 -34.6930683755129)))";;"3285";8_9_7;COMUNA 8;"9";"7";"772";"330";"442";"74,66%";"298";"297";"99,66%";"1";"0,34%";"260";"16";"6.15";"244";"93,85%";"6.15";6.150
"MULTIPOLYGON (((-58.4753404713746 -34.6875725264637,-58.474578423523 -34.6868844879927,-58.473516735528 -34.6876896061688,-58.47335996129 -34.6878082143694,-58.4721736116832 -34.6887058689781,-58.4729340365058 -34.6893947675061,-58.4736943886677 -34.6900836612171,-58.4744534743421 -34.6907713530163,-58.4756424714321 -34.6898709296953,-58.4768627289046 -34.6889468284827,-58.4761015938558 -34.6882597151021,-58.4753404713746 -34.6875725264637)))";;"3286";8_9_8;COMUNA 8;"9";"8";"756";"364";"392";"92,86%";"286";"285";"99,65%";"1";"0,35%";"258";"5";"1.94";"253";"98,06%";"1.94";1.940
"MULTIPOLYGON (((-58.4710961526975 -34.6857703140602,-58.4705156018213 -34.6862239552084,-58.470038368915 -34.686596881209,-58.4699292475305 -34.6866821010533,-58.4706499017097 -34.6873346775159,-58.4712707204177 -34.6878968320111,-58.4714111535406 -34.6880196418923,-58.4715582378604 -34.6881482963361,-58.4721736116832 -34.6887058689781,-58.47335996129 -34.6878082143694,-58.473516735528 -34.6876896061688,-58.474578423523 -34.6868844879927,-58.4738174114905 -34.6861974305229,-58.4730553035847 -34.6855093823765,-58.4723019052065 -34.6848291457924,-58.4721291081784 -34.6849612047588,-58.4717411448442 -34.685265185224,-58.4712133703475 -34.685678683987,-58.4710961526975 -34.6857703140602)))";;"3287";8_9_9;COMUNA 8;"9";"9";"922";"418";"504";"82,94%";"328";"328";"100,00%";"0";"0,00%";"315";"14";"4.44";"301";"95,56%";"4.44";4.440
"MULTIPOLYGON (((-58.5177630497537 -34.6345710123055,-58.517802443841 -34.634358734089,-58.5178420073423 -34.6341452585538,-58.517881231229 -34.633933895897,-58.5179211339256 -34.6337185891223,-58.5179691868 -34.6334594743854,-58.5180129096799 -34.633223883479,-58.5181720913083 -34.6330038039818,-58.5170929294324 -34.6330137269439,-58.5170622947681 -34.63298586278,-58.5168333086193 -34.6330950701922,-58.5168208462029 -34.6330937097492,-58.5159327886532 -34.6330995232832,-58.5153693838328 -34.6331573753983,-58.5149118777418 -34.6332043341983,-58.5140736096968 -34.6334014571649,-58.5139131230102 -34.6334577941036,-58.5133229662282 -34.6336648782254,-58.5126230332772 -34.633960880609,-58.5125329965063 -34.6339989468392,-58.5118646685666 -34.6342952840641,-58.5114466817436 -34.6344761619495,-58.5113275121671 -34.6345277604941,-58.5106707596029 -34.6348174666058,-58.5099778738435 -34.6351035210903,-58.5095422443848 -34.6352893994284,-58.5088305084002 -34.6355534116465,-58.5085456338081 -34.6356435219764,-58.5090119062873 -34.6355485540145,-58.5097585022659 -34.635305866013,-58.5104140550941 -34.6351406763878,-58.5111303842911 -34.635024545219,-58.5117221736487 -34.6349599405074,-58.512547552197 -34.6349724937104,-58.5138247299535 -34.6350621088117,-58.5151174499384 -34.6352031139754,-58.5162388531645 -34.635382843979,-58.5163700836282 -34.6354071532887,-58.516416643986 -34.6352029008226,-58.517646989199 -34.6351969300323,-58.5176833272671 -34.6350009213859,-58.5177228913762 -34.6347874459112,-58.5177630497537 -34.6345710123055)))";;"3288";9_1_1;COMUNA 9;"1";"1";"530";"234";"296";"79,05%";"238";"238";"100,00%";"0";"0,00%";"206";"1";"0.49";"205";"99,51%";"0.49";0.490
"MULTIPOLYGON (((-58.5178420073423 -34.6341452585538,-58.517802443841 -34.634358734089,-58.5177630497537 -34.6345710123055,-58.5177228913762 -34.6347874459112,-58.5176833272671 -34.6350009213859,-58.517646989199 -34.6351969300323,-58.516416643986 -34.6352029008226,-58.5163700836282 -34.6354071532887,-58.5162388531645 -34.635382843979,-58.5151174499384 -34.6352031139754,-58.5138247299535 -34.6350621088117,-58.512547552197 -34.6349724937104,-58.5117221736487 -34.6349599405074,-58.5111303842911 -34.635024545219,-58.5104140550941 -34.6351406763878,-58.5097585022659 -34.635305866013,-58.5090119062873 -34.6355485540145,-58.5085456338081 -34.6356435219764,-58.5082759223893 -34.6357287666623,-58.5076516293724 -34.6358911162732,-58.5070924292531 -34.6358909689676,-58.5069617248584 -34.6358909460463,-58.5068193910146 -34.6358124035246,-58.506443367383 -34.6361092387041,-58.5058695748289 -34.63656213382,-58.5057355158279 -34.6366679592552,-58.5056715142955 -34.6367184603674,-58.5057812789466 -34.6367327852045,-58.5059776347357 -34.6367597626146,-58.5062307791243 -34.6367930834355,-58.5063542769057 -34.6368050059904,-58.5063703429418 -34.6368065570064,-58.5065946121302 -34.6368367054161,-58.506853533029 -34.6368724093583,-58.5071037907237 -34.6369057294114,-58.5073453856085 -34.6369374611265,-58.5075802434413 -34.6369691948421,-58.5077702079397 -34.6369943889751,-58.5078314641782 -34.6370025130469,-58.5080730604857 -34.6370358343149,-58.5083069568434 -34.6370683624858,-58.5085552907771 -34.6371016802783,-58.5087988125882 -34.6371349993839,-58.5090558095391 -34.6371691083799,-58.5091353315275 -34.6371804476558,-58.5092839318633 -34.6372016368706,-58.5095178287096 -34.6372333672201,-58.5097623146526 -34.6372682750263,-58.5099971752363 -34.6373015950797,-58.5102445480707 -34.6373349098035,-58.5104935649626 -34.637369858269,-58.5105140094471 -34.6372838926046,-58.511305662152 -34.6373839882735,-58.5119167259704 -34.6374656472507,-58.5125541219756 -34.6375508840681,-58.513416645337 -34.6376523626948,-58.5138267750109 -34.6377006437125,-58.514660328358 -34.637797688919,-58.5161539462617 -34.6379715560567,-58.5173470267307 -34.6381184263848,-58.5185920199519 -34.6382910367265,-58.5198958416567 -34.6383833929535,-58.5212632431437 -34.6384928883715,-58.5213261565098 -34.6379303049942,-58.5214717697973 -34.6365937836345,-58.5215055479422 -34.6362836165271,-58.5215364210252 -34.6362036694853,-58.5215778071269 -34.6361701977313,-58.5216418675818 -34.6361505886938,-58.5227022931605 -34.6359790097579,-58.5228734473629 -34.635947586397,-58.5229251240163 -34.6358884040527,-58.5223245268196 -34.6351912822357,-58.5215448884841 -34.6343188156498,-58.521082668193 -34.6338237016825,-58.5210163661614 -34.6338220727547,-58.5206868709371 -34.6338222298508,-58.5207069204924 -34.6337624370327,-58.5207329753879 -34.6336710890641,-58.5207690537954 -34.6335481840267,-58.5207883270721 -34.6334862219766,-58.5207883669932 -34.6334861393459,-58.5208143941617 -34.6334016977844,-58.5207481211079 -34.6332198659579,-58.5205285842098 -34.6330043484914,-58.5203889306522 -34.6329687986306,-58.5203406721281 -34.6329106988005,-58.520240990117 -34.6327972164433,-58.5202376799322 -34.6328033133341,-58.5201736161655 -34.632912449445,-58.5200677381262 -34.6329462453124,-58.5198962988276 -34.6329673022233,-58.519746695441 -34.63298371085,-58.5194253259584 -34.6330018190703,-58.5192540755709 -34.6330100678767,-58.5190825651118 -34.6330117670526,-58.5188882947028 -34.6329971379111,-58.5188034340802 -34.632997951648,-58.5183802384721 -34.6330018780921,-58.5181720913083 -34.6330038039818,-58.5180129096799 -34.633223883479,-58.5179691868 -34.6334594743854,-58.5179211339256 -34.6337185891223,-58.517881231229 -34.633933895897,-58.5178420073423 -34.6341452585538)))";;"3289";9_1_2;COMUNA 9;"1";"2";"444";"204";"240";"85,00%";"211";"211";"100,00%";"0";"0,00%";"184";"0";"0";"184";"100,00%";"0";0.000
"MULTIPOLYGON (((-58.5103155566499 -34.6381183460122,-58.510052663372 -34.6391167196365,-58.5114108465585 -34.6393463328974,-58.5129929660478 -34.6392942102237,-58.5132202770096 -34.6384097219242,-58.513416645337 -34.6376523626948,-58.5125541219756 -34.6375508840681,-58.5119167259704 -34.6374656472507,-58.511305662152 -34.6373839882735,-58.5105140094471 -34.6372838926046,-58.5104935649626 -34.637369858269,-58.5103155566499 -34.6381183460122)))";;"3290";9_1_3;COMUNA 9;"1";"3";"613";"268";"345";"77,68%";"333";"333";"100,00%";"0";"0,00%";"261";"3";"1.15";"258";"98,85%";"1.15";1.150
"MULTIPOLYGON (((-58.5212632431437 -34.6384928883715,-58.5198958416567 -34.6383833929535,-58.5185920199519 -34.6382910367265,-58.5173470267307 -34.6381184263848,-58.5161539462617 -34.6379715560567,-58.514660328358 -34.637797688919,-58.5138267750109 -34.6377006437125,-58.513416645337 -34.6376523626948,-58.5132202770096 -34.6384097219242,-58.5129929660478 -34.6392942102237,-58.5142986696681 -34.6392454238255,-58.5144902988644 -34.639238300123,-58.5159123125433 -34.6391933907898,-58.5163017066453 -34.6391811072101,-58.5170528023688 -34.6391573937629,-58.5174120271858 -34.6391371620806,-58.5187702805125 -34.6390606272891,-58.5189671039249 -34.6390495503772,-58.5197569561352 -34.639009393418,-58.5205417804968 -34.6389695154273,-58.5209606485772 -34.6389482590445,-58.5212171136801 -34.6389323611114,-58.5225635140812 -34.638852831922,-58.5225905982647 -34.6385991485869,-58.5212632431437 -34.6384928883715)))";;"3291";9_1_4;COMUNA 9;"1";"4";"749";"350";"399";"87,72%";"326";"326";"100,00%";"0";"0,00%";"269";"0";"0";"269";"100,00%";"0";0.000
"MULTIPOLYGON (((-58.5239297814948 -34.63705618083,-58.5227641859259 -34.6369716168559,-58.5226599999329 -34.6379479669728,-58.522651959643 -34.6380235367176,-58.5213261565098 -34.6379303049942,-58.5212632431437 -34.6384928883715,-58.5225905982647 -34.6385991485869,-58.5225635140812 -34.638852831922,-58.522670956724 -34.6388464409073,-58.5237298986195 -34.6389319042465,-58.5251006437934 -34.6390501580455,-58.5264234059913 -34.6391493364021,-58.5277135403717 -34.6392534475397,-58.5287977183702 -34.639344064842,-58.528896091799 -34.6392907703651,-58.5289614429234 -34.6392860868423,-58.5292299561957 -34.6393131246204,-58.5292381480082 -34.6392212158329,-58.5292946445452 -34.6392254809074,-58.5298434183176 -34.6392652517115,-58.5300728959645 -34.6392818848782,-58.530072898 -34.6392818850029,-58.530085541966 -34.6390068705549,-58.5300050151533 -34.6390005063674,-58.5292085242361 -34.6389369976307,-58.529089033817 -34.6389009348275,-58.5290949719965 -34.6388678319532,-58.5277851599766 -34.638765154418,-58.5278277288939 -34.6383933593127,-58.5271710824113 -34.6383448334035,-58.5265098352747 -34.6382960246661,-58.5266283245225 -34.6372519856223,-58.5259696433097 -34.6372041585442,-58.5253182910567 -34.6371569579684,-58.5239297814948 -34.63705618083)))";;"3292";9_1_5;COMUNA 9;"1";"5";"737";"352";"385";"91,43%";"366";"365";"99,73%";"1";"0,27%";"294";"2";"0.68";"292";"99,32%";"0.68";0.680
"MULTIPOLYGON (((-58.5267476573522 -34.6362007625136,-58.5260900067918 -34.6361528651064,-58.5254449746053 -34.6361146058595,-58.525166549186 -34.6361005542141,-58.524448657012 -34.6360415872924,-58.5240440208651 -34.6359846805266,-58.5240693223557 -34.6357473361989,-58.5233226733842 -34.635865248611,-58.5228734473629 -34.635947586397,-58.5227022931605 -34.6359790097579,-58.5216418675818 -34.6361505886938,-58.5215778071269 -34.6361701977313,-58.5215364210252 -34.6362036694853,-58.5215055479422 -34.6362836165271,-58.5214717697973 -34.6365937836345,-58.5213261565098 -34.6379303049942,-58.522651959643 -34.6380235367176,-58.5226599999329 -34.6379479669728,-58.5227641859259 -34.6369716168559,-58.5239297814948 -34.63705618083,-58.5253182910567 -34.6371569579684,-58.5259696433097 -34.6372041585442,-58.5266283245225 -34.6372519856223,-58.5272876881365 -34.6372998087809,-58.5274050529924 -34.6362485860841,-58.5267476573522 -34.6362007625136)))";;"3293";9_1_6;COMUNA 9;"1";"6";"809";"409";"400";"102,25%";"295";"293";"99,32%";"2";"0,68%";"291";"51";"17.53";"240";"82,47%";"17.53";17.530
"MULTIPOLYGON (((-58.5268489003764 -34.6353151735253,-58.527383668184 -34.6352630022593,-58.5275157298494 -34.6352565939166,-58.5281821141266 -34.6351501781942,-58.5282066665269 -34.6348423381437,-58.5270770478121 -34.6347502605574,-58.5269207322236 -34.6346829464131,-58.5256048581313 -34.6345857416799,-58.5243003911798 -34.6344706995058,-58.5242316195141 -34.6344538322626,-58.5232745289547 -34.6342193741382,-58.5230379628642 -34.6341614613411,-58.5223448839622 -34.6339916558566,-58.5221685802326 -34.6339654030594,-58.521082668193 -34.6338237016825,-58.5215448884841 -34.6343188156498,-58.5223245268196 -34.6351912822357,-58.5229251240163 -34.6358884040527,-58.5228734473629 -34.635947586397,-58.5233226733842 -34.635865248611,-58.5240693223557 -34.6357473361989,-58.5240440208651 -34.6359846805266,-58.524448657012 -34.6360415872924,-58.525166549186 -34.6361005542141,-58.5254449746053 -34.6361146058595,-58.5260900067918 -34.6361528651064,-58.5267476573522 -34.6362007625136,-58.5268489003764 -34.6353151735253)))";;"3294";9_1_7;COMUNA 9;"1";"7";"683";"304";"379";"80,21%";"317";"316";"99,68%";"1";"0,32%";"257";"4";"1.56";"253";"98,44%";"1.56";1.560
"MULTIPOLYGON (((-58.5280658578703 -34.6362967564074,-58.5292303410062 -34.6363804956595,-58.5292298261234 -34.636389051118,-58.5301571676996 -34.6364301698783,-58.5301577090684 -34.6364301938808,-58.5301577424855 -34.6364296286267,-58.5301583546148 -34.6364302225021,-58.5302664160542 -34.6365350613532,-58.5303700369875 -34.6347945362188,-58.5302572009712 -34.6347978712735,-58.5299704671487 -34.634806345694,-58.5293364511795 -34.6348264694432,-58.5287532888529 -34.6348613941458,-58.5285644415964 -34.6348555061408,-58.5282967677861 -34.634849730915,-58.5282066665269 -34.6348423381437,-58.5281821141266 -34.6351501781942,-58.5275157298494 -34.6352565939166,-58.527383668184 -34.6352630022593,-58.5268489003764 -34.6353151735253,-58.5267476573522 -34.6362007625136,-58.5274050529924 -34.6362485860841,-58.5272876881365 -34.6372998087809,-58.5266283245225 -34.6372519856223,-58.5265098352747 -34.6382960246661,-58.5271710824113 -34.6383448334035,-58.5278277288939 -34.6383933593127,-58.5278432158574 -34.6382577833465,-58.5279474785335 -34.6373476281457,-58.5279596654002 -34.637241843593,-58.5280487257925 -34.6365066314884,-58.5280658578703 -34.6362967564074)))";;"3295";9_1_8;COMUNA 9;"1";"8";"683";"338";"345";"97,97%";"348";"346";"99,43%";"2";"0,58%";"278";"34";"12.23";"244";"87,77%";"12.23";12.230
"MULTIPOLYGON (((-58.5301583546148 -34.6364302225021,-58.5301577424855 -34.6364296286267,-58.5301577090684 -34.6364301938808,-58.5292298261234 -34.636389051118,-58.5292303410062 -34.6363804956595,-58.5280658578703 -34.6362967564074,-58.5280487257925 -34.6365066314884,-58.5279596654002 -34.637241843593,-58.5279474785335 -34.6373476281457,-58.5278432158574 -34.6382577833465,-58.5278277288939 -34.6383933593127,-58.5277851599766 -34.638765154418,-58.5290949719965 -34.6388678319532,-58.529089033817 -34.6389009348275,-58.5292085242361 -34.6389369976307,-58.5300050151533 -34.6390005063674,-58.530085541966 -34.6390068705549,-58.530072898 -34.6392818850029,-58.5300728980543 -34.6392818850062,-58.530073584795 -34.6392819270887,-58.5301027599324 -34.6392838528718,-58.5302664160542 -34.6365350613532,-58.5301583546148 -34.6364302225021)))";;"3296";9_1_9;COMUNA 9;"1";"9";"751";"359";"392";"91,58%";"489";"487";"99,59%";"2";"0,41%";"344";"5";"1.45";"339";"98,55%";"1.45";1.450
"MULTIPOLYGON (((-58.4895886282051 -34.6481008335547,-58.4903370553957 -34.648758010131,-58.4914154544013 -34.6479116084988,-58.4926298836893 -34.6469584705036,-58.4927656799707 -34.6468519549673,-58.493859704194 -34.6459920764972,-58.4948978221746 -34.6451761478899,-58.4952335458668 -34.6449036560052,-58.4948005160732 -34.6449778575564,-58.4931524576195 -34.6454029412344,-58.4918599532313 -34.6457372815212,-58.4916632094488 -34.6457881750432,-58.4914272699696 -34.6458492186442,-58.4895961506689 -34.6463259184994,-58.4901751016344 -34.6468305232213,-58.4890993451085 -34.6476749415714,-58.4895886282051 -34.6481008335547)))";;"3297";9_10_1;COMUNA 9;"10";"1";"825";"385";"440";"87,50%";"334";"334";"100,00%";"0";"0,00%";"298";"13";"4.36";"285";"95,64%";"4.36";4.360
"MULTIPOLYGON (((-58.4829791982834 -34.6422931998676,-58.4829455127855 -34.6421963143216,-58.4829730387309 -34.6421280203559,-58.4830182592222 -34.6420835388952,-58.4829390318627 -34.6418115716867,-58.4829154164349 -34.6417622078528,-58.4828887349104 -34.6417189010502,-58.4828576229771 -34.6416777781412,-58.4827960849324 -34.6416122932768,-58.4827398350983 -34.6415677940886,-58.4826689294203 -34.6415247057697,-58.4821960391085 -34.6412851268394,-58.4821020389105 -34.6412290837231,-58.4819925252547 -34.6411501549424,-58.4816889465488 -34.6408890675768,-58.481113408171 -34.6403695619154,-58.480157770584 -34.6411221910563,-58.4799288479445 -34.6413032152403,-58.481995354907 -34.6430659893327,-58.4829791982834 -34.6422931998676)))";;"3298";9_10_10;COMUNA 9;"10";"10";"760";"343";"417";"82,25%";"358";"358";"100,00%";"0";"0,00%";"304";"2";"0.66";"302";"99,34%";"0.66";0.660
"MULTIPOLYGON (((-58.4830182592222 -34.6420835388952,-58.4829730387309 -34.6421280203559,-58.4829455127855 -34.6421963143216,-58.4829791982834 -34.6422931998676,-58.481995354907 -34.6430659893327,-58.4836555663513 -34.6445020276847,-58.4842556298587 -34.6424808037289,-58.4832371271578 -34.6422675220977,-58.4832486122567 -34.6421927290826,-58.4832051348232 -34.6421130155869,-58.483110372064 -34.642081269922,-58.4830182592222 -34.6420835388952)))";;"3299";9_10_11;COMUNA 9;"10";"11";"586";"262";"324";"80,86%";"285";"285";"100,00%";"0";"0,00%";"245";"2";"0.82";"243";"99,18%";"0.82";0.820
"MULTIPOLYGON (((-58.4845815825013 -34.642549057681,-58.4842556298587 -34.6424808037289,-58.4836555663513 -34.6445020276847,-58.4845696062595 -34.6452925958954,-58.4847258685313 -34.6448900201137,-58.4849783071048 -34.6440622725256,-58.4851901312306 -34.6433712262077,-58.4853970120307 -34.6426892651559,-58.4845815825013 -34.642549057681)))";;"3300";9_10_12;COMUNA 9;"10";"12";"520";"233";"287";"81,18%";"261";"261";"100,00%";"0";"0,00%";"224";"1";"0.45";"223";"99,55%";"0.45";0.450
"MULTIPOLYGON (((-58.4871364976142 -34.6475240784799,-58.4876464828219 -34.6479674394389,-58.4881590306594 -34.6484129808616,-58.488769270612 -34.6489433609755,-58.4889124765373 -34.6490678410876,-58.4894037243037 -34.6494856344553,-58.4895472833289 -34.649377853201,-58.4903370553957 -34.648758010131,-58.4895886282051 -34.6481008335547,-58.4890993451085 -34.6476749415714,-58.4901751016344 -34.6468305232213,-58.4895961506689 -34.6463259184994,-58.4891560605704 -34.6459423410036,-58.4886364474863 -34.6454894104971,-58.4880847057424 -34.6450085258225,-58.4870083560745 -34.6458565177625,-58.4867960483191 -34.6460237481417,-58.4860688109645 -34.6465960199203,-58.4866231083513 -34.6470778286101,-58.4871364976142 -34.6475240784799)))";;"3301";9_10_2;COMUNA 9;"10";"2";"1068";"488";"580";"84,14%";"380";"377";"99,21%";"3";"0,80%";"336";"20";"5.95";"316";"94,05%";"5.95";5.950
"MULTIPOLYGON (((-58.4904391525955 -34.6449377995619,-58.489930355611 -34.6444685334985,-58.4893955666262 -34.6439752561362,-58.4888621477553 -34.6434831733136,-58.4884287253431 -34.6431083946711,-58.4873053788529 -34.6439997810276,-58.4871024478363 -34.6441599676254,-58.4861442655667 -34.6449164466503,-58.4860278884847 -34.6450074576982,-58.4853902806986 -34.6455061145275,-58.4851046633779 -34.6457552934119,-58.4853363179024 -34.6459603235504,-58.4860688109645 -34.6465960199203,-58.4867960483191 -34.6460237481417,-58.4870083560745 -34.6458565177625,-58.4880847057424 -34.6450085258225,-58.4886364474863 -34.6454894104971,-58.4891560605704 -34.6459423410036,-58.4895961506689 -34.6463259184994,-58.4914272699696 -34.6458492186442,-58.4904391525955 -34.6449377995619)))";;"3302";9_10_3;COMUNA 9;"10";"3";"1131";"486";"645";"75,35%";"363";"361";"99,45%";"2";"0,55%";"328";"18";"5.49";"310";"94,51%";"5.49";5.490
"MULTIPOLYGON (((-58.4910090424936 -34.6436174163562,-58.49044375401 -34.6431464752385,-58.4902046675468 -34.6429472978187,-58.490300583653 -34.6428483293929,-58.4904997610283 -34.642703209191,-58.4905860526609 -34.6426194544744,-58.4901762894019 -34.6424230624539,-58.4900631599899 -34.642519358512,-58.4896647342601 -34.6428576972817,-58.4891735225827 -34.6432388731471,-58.4888621477553 -34.6434831733136,-58.4893955666262 -34.6439752561362,-58.489930355611 -34.6444685334985,-58.4904391525955 -34.6449377995619,-58.4914272699696 -34.6458492186442,-58.4916632094488 -34.6457881750432,-58.4918599532313 -34.6457372815212,-58.4931524576195 -34.6454029412344,-58.4925923445319 -34.6449363752604,-58.4915500445466 -34.644068078243,-58.4910090424936 -34.6436174163562)))";;"3303";9_10_4;COMUNA 9;"10";"4";"626";"287";"339";"84,66%";"289";"288";"99,65%";"1";"0,35%";"237";"6";"2.53";"231";"97,47%";"2.53";2.530
"MULTIPOLYGON (((-58.4908788879667 -34.6427597436686,-58.4905860526609 -34.6426194544744,-58.4904997610283 -34.642703209191,-58.490300583653 -34.6428483293929,-58.4902046675468 -34.6429472978187,-58.49044375401 -34.6431464752385,-58.4910090424936 -34.6436174163562,-58.4915500445466 -34.644068078243,-58.4925923445319 -34.6449363752604,-58.4931524576195 -34.6454029412344,-58.4948005160732 -34.6449778575564,-58.4952335458668 -34.6449036560052,-58.495302206673 -34.6448479317207,-58.4950820569547 -34.6447407335372,-58.4949640150642 -34.6446878054385,-58.4948407842989 -34.6446582595984,-58.493665134119 -34.6440948843277,-58.4923317441451 -34.643455970361,-58.4916361224254 -34.64312267629,-58.4908788879667 -34.6427597436686)))";;"3304";9_10_5;COMUNA 9;"10";"5";"883";"408";"475";"85,89%";"406";"406";"100,00%";"0";"0,00%";"342";"7";"2.05";"335";"97,95%";"2.05";2.050
"MULTIPOLYGON (((-58.4864067652765 -34.6435600861748,-58.4853516328405 -34.6443985522299,-58.4852447978959 -34.644483433815,-58.4847258685313 -34.6448900201137,-58.4845696062595 -34.6452925958954,-58.4851011452383 -34.6457522510801,-58.4851046633779 -34.6457552934119,-58.4853902806986 -34.6455061145275,-58.4860278884847 -34.6450074576982,-58.4861442655667 -34.6449164466503,-58.4871024478363 -34.6441599676254,-58.4873053788529 -34.6439997810276,-58.4884287253431 -34.6431083946711,-58.4888621477553 -34.6434831733136,-58.4891735225827 -34.6432388731471,-58.4896647342601 -34.6428576972817,-58.4900631599899 -34.642519358512,-58.4901762894019 -34.6424230624539,-58.4899935669769 -34.6423354951038,-58.489623521843 -34.6421602901693,-58.4895440075076 -34.6421226304584,-58.4887115402422 -34.6417285026874,-58.4877326153516 -34.6425064784531,-58.4864067652765 -34.6435600861748)))";;"3305";9_10_6;COMUNA 9;"10";"6";"810";"403";"407";"99,02%";"273";"273";"100,00%";"0";"0,00%";"282";"9";"3.19";"273";"96,81%";"3.19";3.190
"MULTIPOLYGON (((-58.4878056190125 -34.6412999466441,-58.4869677996662 -34.6409048220683,-58.486065646452 -34.6404793509781,-58.4860037605693 -34.6406992993591,-58.4859284187264 -34.6409463637972,-58.4870392428749 -34.6419069520952,-58.4857102403819 -34.6429593557566,-58.4851901312306 -34.6433712262077,-58.4849783071048 -34.6440622725256,-58.4847258685313 -34.6448900201137,-58.4852447978959 -34.644483433815,-58.4853516328405 -34.6443985522299,-58.4864067652765 -34.6435600861748,-58.4877326153516 -34.6425064784531,-58.4887115402422 -34.6417285026874,-58.4880444982792 -34.6414126472684,-58.4878056190125 -34.6412999466441)))";;"3306";9_10_7;COMUNA 9;"10";"7";"669";"313";"356";"87,92%";"284";"284";"100,00%";"0";"0,00%";"249";"11";"4.42";"238";"95,58%";"4.42";4.420
"MULTIPOLYGON (((-58.4853970120307 -34.6426892651559,-58.4851901312306 -34.6433712262077,-58.4857102403819 -34.6429593557566,-58.4870392428749 -34.6419069520952,-58.4859284187264 -34.6409463637972,-58.4860037605693 -34.6406992993591,-58.486065646452 -34.6404793509781,-58.4855164845845 -34.6402203622352,-58.4853195404445 -34.6401272973761,-58.4848799756757 -34.6399196250345,-58.4846063353652 -34.6397903746092,-58.4839008057222 -34.6394569675567,-58.4834784302525 -34.6408377178688,-58.4842418677566 -34.6409963932448,-58.4841775828855 -34.6411857063355,-58.4841528873508 -34.6412457830005,-58.4841236761681 -34.6413079731959,-58.4840887540991 -34.6413634036088,-58.4840352600591 -34.6414344011326,-58.483966513808 -34.6415077253096,-58.483928433405 -34.6415421696489,-58.4835580961747 -34.6418369611386,-58.4834086651466 -34.6419541029636,-58.4833182734801 -34.6420242613291,-58.4832051348232 -34.6421130155869,-58.4832486122567 -34.6421927290826,-58.4832371271578 -34.6422675220977,-58.4842556298587 -34.6424808037289,-58.4845815825013 -34.642549057681,-58.4853970120307 -34.6426892651559)))";;"3307";9_10_8;COMUNA 9;"10";"8";"931";"434";"497";"87,32%";"367";"366";"99,73%";"1";"0,27%";"322";"1";"0.31";"321";"99,69%";"0.31";0.310
"MULTIPOLYGON (((-58.4839008057222 -34.6394569675567,-58.4828819361258 -34.638979730826,-58.482702350664 -34.6391181451102,-58.4819306746167 -34.6397258942217,-58.481113408171 -34.6403695619154,-58.4816889465488 -34.6408890675768,-58.4819925252547 -34.6411501549424,-58.4821020389105 -34.6412290837231,-58.4821960391085 -34.6412851268394,-58.4826689294203 -34.6415247057697,-58.4827398350983 -34.6415677940886,-58.4827960849324 -34.6416122932768,-58.4828576229771 -34.6416777781412,-58.4828887349104 -34.6417189010502,-58.4829154164349 -34.6417622078528,-58.4829390318627 -34.6418115716867,-58.4830182592222 -34.6420835388952,-58.483110372064 -34.642081269922,-58.4832051348232 -34.6421130155869,-58.4833182734801 -34.6420242613291,-58.4834086651466 -34.6419541029636,-58.4835580961747 -34.6418369611386,-58.483928433405 -34.6415421696489,-58.483966513808 -34.6415077253096,-58.4840352600591 -34.6414344011326,-58.4840887540991 -34.6413634036088,-58.4841236761681 -34.6413079731959,-58.4841528873508 -34.6412457830005,-58.4841775828855 -34.6411857063355,-58.4842418677566 -34.6409963932448,-58.4834784302525 -34.6408377178688,-58.4839008057222 -34.6394569675567)))";;"3308";9_10_9;COMUNA 9;"10";"9";"459";"214";"245";"87,35%";"221";"221";"100,00%";"0";"0,00%";"170";"0";"0";"170";"100,00%";"0";0.000
"MULTIPOLYGON (((-58.4804033319106 -34.6378448681736,-58.4800487519906 -34.6376825195425,-58.4790990987636 -34.6384282382356,-58.4805175173921 -34.6390783417445,-58.479703654585 -34.6397212953153,-58.4786755949259 -34.6405335023515,-58.4799288479445 -34.6413032152403,-58.480157770584 -34.6411221910563,-58.481113408171 -34.6403695619154,-58.4819306746167 -34.6397258942217,-58.482702350664 -34.6391181451102,-58.4828819361258 -34.638979730826,-58.4817453966261 -34.6384594040048,-58.4814640121903 -34.6383305702542,-58.4804033319106 -34.6378448681736)))";;"3309";9_11_1;COMUNA 9;"11";"1";"1151";"534";"617";"86,55%";"499";"499";"100,00%";"0";"0,00%";"430";"16";"3.72";"414";"96,28%";"3.72";3.720
"MULTIPOLYGON (((-58.471287627624 -34.6427150897232,-58.4700268342847 -34.6437111186067,-58.4712859464366 -34.6445921201978,-58.472327258702 -34.6453207269738,-58.4724814247336 -34.6454299434326,-58.4736585199161 -34.6462631788786,-58.4738081426318 -34.646144640569,-58.4749622513736 -34.6452318257757,-58.4737801292256 -34.6443918424561,-58.4737156935996 -34.6442851548382,-58.4734717901821 -34.6441129177495,-58.4728215561662 -34.6436514802057,-58.4726312598837 -34.6435181114092,-58.4713927704818 -34.6426320515028,-58.471287627624 -34.6427150897232)))";;"3310";9_11_10;COMUNA 9;"11";"10";"923";"432";"491";"87,98%";"327";"327";"100,00%";"0";"0,00%";"306";"41";"13.4";"265";"86,60%";"13.4";13.400
"MULTIPOLYGON (((-58.4700268342847 -34.6437111186067,-58.471287627624 -34.6427150897232,-58.4713927704818 -34.6426320515028,-58.4712061442496 -34.6425117087758,-58.4702564037392 -34.6418959773256,-58.4692929584004 -34.6412804504319,-58.4692423525276 -34.6413968652819,-58.467989821747 -34.6424171694158,-58.4668502461436 -34.643314213439,-58.4667082022474 -34.643426756916,-58.4676862247083 -34.6440409653474,-58.4687603020514 -34.6447153038474,-58.4698948484343 -34.6438154254898,-58.4700268342847 -34.6437111186067)))";;"3311";9_11_11;COMUNA 9;"11";"11";"969";"449";"520";"86,35%";"371";"369";"99,46%";"2";"0,54%";"329";"15";"4.56";"314";"95,44%";"4.56";4.560
"MULTIPOLYGON (((-58.4712859464366 -34.6445921201978,-58.4700268342847 -34.6437111186067,-58.4698948484343 -34.6438154254898,-58.4687603020514 -34.6447153038474,-58.4700129399697 -34.6455998399937,-58.4712057786811 -34.64644197166,-58.4723833864967 -34.6472733881979,-58.4727537024061 -34.6469800393929,-58.4730153759651 -34.6467726872408,-58.4736585199161 -34.6462631788786,-58.4724814247336 -34.6454299434326,-58.472327258702 -34.6453207269738,-58.4712859464366 -34.6445921201978)))";;"3312";9_11_12;COMUNA 9;"11";"12";"1260";"609";"651";"93,55%";"407";"406";"99,75%";"1";"0,25%";"414";"45";"10.87";"369";"89,13%";"10.87";10.870
"MULTIPOLYGON (((-58.477408730171 -34.6397554680024,-58.4786755949259 -34.6405335023515,-58.479703654585 -34.6397212953153,-58.4805175173921 -34.6390783417445,-58.4790990987636 -34.6384282382356,-58.4800487519906 -34.6376825195425,-58.4785455734409 -34.6369942512248,-58.4783567817334 -34.637127096792,-58.4775912269501 -34.637732845967,-58.4767783772176 -34.6383759913109,-58.4762905420792 -34.6387619744937,-58.4760723524005 -34.6389346801881,-58.477408730171 -34.6397554680024)))";;"3313";9_11_2;COMUNA 9;"11";"2";"1082";"526";"556";"94,60%";"411";"410";"99,76%";"1";"0,24%";"355";"12";"3.38";"343";"96,62%";"3.38";3.380
"MULTIPOLYGON (((-58.4760723524005 -34.6389346801881,-58.4753231333712 -34.6384744636215,-58.4750680212747 -34.6390446488372,-58.4757077921063 -34.6392229682547,-58.4769557352867 -34.6401110964758,-58.4781433678897 -34.6409540067497,-58.4771088026494 -34.6417712718241,-58.4782850401016 -34.642603547695,-58.4793171331815 -34.641787118188,-58.4799288479445 -34.6413032152403,-58.4786755949259 -34.6405335023515,-58.477408730171 -34.6397554680024,-58.4760723524005 -34.6389346801881)))";;"3314";9_11_3;COMUNA 9;"11";"3";"846";"398";"448";"88,84%";"338";"338";"100,00%";"0";"0,00%";"292";"5";"1.71";"287";"98,29%";"1.71";1.710
"MULTIPOLYGON (((-58.4734922971677 -34.6373083343032,-58.4724169549687 -34.6369874988765,-58.4713029364562 -34.6366551774409,-58.4712236279954 -34.6368318788599,-58.4708088533857 -34.6377872900384,-58.4719172616391 -34.6381218699418,-58.4728078802525 -34.6383906812419,-58.4729922761622 -34.6384462309806,-58.4738840093738 -34.6387147526141,-58.4740489780131 -34.6387607247609,-58.473616848806 -34.6397558663721,-58.4746700720911 -34.6400428189268,-58.4757077921063 -34.6392229682547,-58.4750680212747 -34.6390446488372,-58.4753231333712 -34.6384744636215,-58.4744154236864 -34.6379169306752,-58.4734922971677 -34.6373083343032)))";;"3315";9_11_4;COMUNA 9;"11";"4";"1055";"484";"571";"84,76%";"412";"411";"99,76%";"1";"0,24%";"370";"14";"3.78";"356";"96,22%";"3.78";3.780
"MULTIPOLYGON (((-58.4729922761622 -34.6384462309806,-58.4728078802525 -34.6383906812419,-58.4719172616391 -34.6381218699418,-58.4708088533857 -34.6377872900384,-58.4704420310264 -34.6386322001294,-58.4703750719849 -34.6387869276213,-58.469971097526 -34.6397203624351,-58.4699054997511 -34.6398712866227,-58.4710038765524 -34.640197353906,-58.4719014161252 -34.640463776819,-58.4720834296092 -34.6405145392081,-58.4731572796042 -34.6408141092351,-58.4735538612922 -34.6409247118878,-58.4746700720911 -34.6400428189268,-58.473616848806 -34.6397558663721,-58.4740489780131 -34.6387607247609,-58.4738840093738 -34.6387147526141,-58.4729922761622 -34.6384462309806)))";;"3316";9_11_5;COMUNA 9;"11";"5";"1224";"584";"640";"91,25%";"435";"434";"99,77%";"1";"0,23%";"397";"13";"3.27";"384";"96,73%";"3.27";3.270
"MULTIPOLYGON (((-58.4724405237705 -34.6418043406858,-58.4735538612922 -34.6409247118878,-58.4731572796042 -34.6408141092351,-58.4720834296092 -34.6405145392081,-58.4719014161252 -34.640463776819,-58.4710038765524 -34.640197353906,-58.4699054997511 -34.6398712866227,-58.4692929584004 -34.6412804504319,-58.4702564037392 -34.6418959773256,-58.4712061442496 -34.6425117087758,-58.4713927704818 -34.6426320515028,-58.4724405237705 -34.6418043406858)))";;"3317";9_11_6;COMUNA 9;"11";"6";"959";"449";"510";"88,04%";"358";"357";"99,72%";"1";"0,28%";"327";"10";"3.06";"317";"96,94%";"3.06";3.060
"MULTIPOLYGON (((-58.4724405237705 -34.6418043406858,-58.4713927704818 -34.6426320515028,-58.4726312598837 -34.6435181114092,-58.4727440701455 -34.6434233809043,-58.4735507804278 -34.6427851228265,-58.4736866806038 -34.6426867977201,-58.4738080106497 -34.6425990375,-58.4748041072616 -34.6418097629834,-58.4759169934947 -34.6409279294929,-58.4761043466313 -34.640779524069,-58.4769557352867 -34.6401110964758,-58.4757077921063 -34.6392229682547,-58.4746700720911 -34.6400428189268,-58.4735538612922 -34.6409247118878,-58.4724405237705 -34.6418043406858)))";;"3318";9_11_7;COMUNA 9;"11";"7";"1124";"537";"587";"91,48%";"401";"400";"99,75%";"1";"0,25%";"385";"20";"5.19";"365";"94,81%";"5.19";5.190
"MULTIPOLYGON (((-58.4748041072616 -34.6418097629834,-58.4738080106497 -34.6425990375,-58.4736866806038 -34.6426867977201,-58.4747006373079 -34.6434190490061,-58.4748710790204 -34.6435313595637,-58.4750327098678 -34.6434113395808,-58.4759938725193 -34.6426520599198,-58.4771088026494 -34.6417712718241,-58.4781433678897 -34.6409540067497,-58.4769557352867 -34.6401110964758,-58.4761043466313 -34.640779524069,-58.4759169934947 -34.6409279294929,-58.4748041072616 -34.6418097629834)))";;"3319";9_11_8;COMUNA 9;"11";"8";"908";"415";"493";"84,18%";"325";"322";"99,08%";"3";"0,93%";"311";"14";"4.5";"297";"95,50%";"4.5";4.500
"MULTIPOLYGON (((-58.4736866806038 -34.6426867977201,-58.4735507804278 -34.6427851228265,-58.4727440701455 -34.6434233809043,-58.4726312598837 -34.6435181114092,-58.4728215561662 -34.6436514802057,-58.4734717901821 -34.6441129177495,-58.4737156935996 -34.6442851548382,-58.4737801292256 -34.6443918424561,-58.4749622513736 -34.6452318257757,-58.4760584821462 -34.6443647823496,-58.4771707078876 -34.6434850505999,-58.4782850401016 -34.642603547695,-58.4771088026494 -34.6417712718241,-58.4759938725193 -34.6426520599198,-58.4750327098678 -34.6434113395808,-58.4748710790204 -34.6435313595637,-58.4747006373079 -34.6434190490061,-58.4736866806038 -34.6426867977201)))";;"3320";9_11_9;COMUNA 9;"11";"9";"1082";"457";"625";"73,12%";"332";"328";"98,80%";"4";"1,22%";"314";"12";"3.82";"302";"96,18%";"3.82";3.820
"MULTIPOLYGON (((-58.4845696062595 -34.6452925958954,-58.4834737916527 -34.6461552084342,-58.4836194566525 -34.6462818071439,-58.4836874735701 -34.6463408817794,-58.4838895637553 -34.6465134577655,-58.4840724770062 -34.6466697686697,-58.4841944388546 -34.6467386930094,-58.4850143161144 -34.6474258907139,-58.4850954607487 -34.6474939060847,-58.4861023641603 -34.6483378272234,-58.4862423247324 -34.6484550573661,-58.4866234256503 -34.6487757675761,-58.4871412536945 -34.6492115935778,-58.4877682803621 -34.6497392287042,-58.4884066521452 -34.6502764359204,-58.4892404840629 -34.6496082794272,-58.4894037243037 -34.6494856344553,-58.4889124765373 -34.6490678410876,-58.488769270612 -34.6489433609755,-58.4881590306594 -34.6484129808616,-58.4876464828219 -34.6479674394389,-58.4871364976142 -34.6475240784799,-58.4866231083513 -34.6470778286101,-58.4860688109645 -34.6465960199203,-58.4853363179024 -34.6459603235504,-58.4851046633779 -34.6457552934119,-58.4851011452383 -34.6457522510801,-58.4845696062595 -34.6452925958954)))";;"3321";9_12_1;COMUNA 9;"12";"1";"1042";"481";"561";"85,74%";"380";"380";"100,00%";"0";"0,00%";"338";"20";"5.92";"318";"94,08%";"5.92";5.920
"MULTIPOLYGON (((-58.4768696289345 -34.6513673690389,-58.4758899707845 -34.6521577842169,-58.4757250877263 -34.6522902706727,-58.4763381859942 -34.6528909257129,-58.4762885077706 -34.6529301577744,-58.4756910019801 -34.6534016453065,-58.4747123287845 -34.6541739515339,-58.4751683376001 -34.654589692636,-58.4761999615821 -34.6545062704768,-58.4772888531462 -34.6544181847266,-58.4777059271206 -34.6543442201278,-58.4780578019709 -34.6542746353775,-58.4794156162516 -34.6539963500191,-58.4792510990447 -34.6533869882742,-58.4791232782525 -34.6530232623954,-58.4790748497138 -34.6529105190876,-58.479018323178 -34.6527874948473,-58.4789507155438 -34.6526522181706,-58.478834518964 -34.6524516642618,-58.4787967543535 -34.6523931463862,-58.4787196070139 -34.6522809701103,-58.4788685620479 -34.6522164414885,-58.4789220762913 -34.652191011089,-58.4790076295886 -34.6521439560233,-58.4793023664382 -34.6519203180391,-58.4784738795156 -34.6512054770912,-58.4778022359639 -34.6506260377077,-58.477599015038 -34.6507871943037,-58.4769910517368 -34.651269394192,-58.4768696289345 -34.6513673690389)))";;"3322";9_12_10;COMUNA 9;"12";"10";"1063";"526";"537";"97,95%";"367";"367";"100,00%";"0";"0,00%";"343";"3";"0.87";"340";"99,13%";"0.87";0.870
"MULTIPOLYGON (((-58.4763381859942 -34.6528909257129,-58.4757250877263 -34.6522902706727,-58.4756252779006 -34.6521924614802,-58.4749243171403 -34.6515242743961,-58.4743737162476 -34.6509993126377,-58.4742519206955 -34.6508869265009,-58.4737310758737 -34.6504066786172,-58.4731766057537 -34.6508448392645,-58.4726338040094 -34.6512744046033,-58.4720449815236 -34.6517420003359,-58.4725679551181 -34.6522188747618,-58.4727073077831 -34.652345839015,-58.4732575632423 -34.6528475680857,-58.4736750322365 -34.6532282467344,-58.4740884990625 -34.6536052622235,-58.4747123287845 -34.6541739515339,-58.4756910019801 -34.6534016453065,-58.4762885077706 -34.6529301577744,-58.4763381859942 -34.6528909257129)))";;"3323";9_12_11;COMUNA 9;"12";"11";"859";"427";"432";"98,84%";"334";"333";"99,70%";"1";"0,30%";"310";"35";"11.29";"275";"88,71%";"11.29";11.290
"MULTIPOLYGON (((-58.470107155484 -34.6490710672057,-58.469971160563 -34.6492279815498,-58.4699446610231 -34.6492675617896,-58.4698930251971 -34.64934475028,-58.4698148050971 -34.6494697586486,-58.4697781784493 -34.6496751190965,-58.470026697137 -34.6499016605498,-58.4708166648895 -34.6506219843197,-58.4720449815236 -34.6517420003359,-58.4726338040094 -34.6512744046033,-58.4731766057537 -34.6508448392645,-58.4737310758737 -34.6504066786172,-58.4727362797877 -34.6494892016794,-58.4727351017122 -34.6494892989825,-58.4722358912164 -34.6490405900153,-58.472238294561 -34.6490402844019,-58.4721915045938 -34.6489958500867,-58.4717686094757 -34.6486135467282,-58.4712633055975 -34.6481607525904,-58.4702508239429 -34.6489627452532,-58.470107155484 -34.6490710672057)))";;"3324";9_12_12;COMUNA 9;"12";"12";"726";"353";"373";"94,64%";"237";"237";"100,00%";"0";"0,00%";"232";"5";"2.16";"227";"97,84%";"2.16";2.160
"MULTIPOLYGON (((-58.4799288479445 -34.6413032152403,-58.4793171331815 -34.641787118188,-58.4782850401016 -34.642603547695,-58.4771707078876 -34.6434850505999,-58.4760584821462 -34.6443647823496,-58.4749622513736 -34.6452318257757,-58.4738081426318 -34.646144640569,-58.4736585199161 -34.6462631788786,-58.4730153759651 -34.6467726872408,-58.4727537024061 -34.6469800393929,-58.4723833864967 -34.6472733881979,-58.4712633055975 -34.6481607525904,-58.4717686094757 -34.6486135467282,-58.4721915045938 -34.6489958500867,-58.472238294561 -34.6490402844019,-58.4722358912164 -34.6490405900153,-58.4727351017122 -34.6494892989825,-58.4727362797877 -34.6494892016794,-58.4727383903445 -34.6494889917903,-58.4735839407896 -34.6494049010702,-58.4739613698757 -34.6493688797954,-58.4741514903905 -34.6493507629508,-58.4745244784945 -34.6492505130546,-58.4754881852419 -34.6490512548402,-58.47565725283 -34.6490143344667,-58.4760623673875 -34.6489295698709,-58.4763746818067 -34.6488649558258,-58.4767456272094 -34.6488085035029,-58.4770433711269 -34.6487600166712,-58.4777314833689 -34.6486268311619,-58.478417887151 -34.6484835712588,-58.4788281062414 -34.6483825991348,-58.4793260912479 -34.6482453449861,-58.4798913913206 -34.6480835011168,-58.4804268639806 -34.64792553232,-58.4805661867044 -34.6478905813457,-58.481145535035 -34.6476937989522,-58.4815933969378 -34.6475228801022,-58.4817656041903 -34.647452992012,-58.4819966817809 -34.6473221770221,-58.4821325874676 -34.647258491523,-58.4823858254768 -34.6471499264603,-58.4826844792717 -34.6470252261815,-58.4823448257614 -34.6467437234499,-58.482586137297 -34.6466586113066,-58.4832091585725 -34.6463424420789,-58.4834737916527 -34.6461552084342,-58.4845696062595 -34.6452925958954,-58.4836555663513 -34.6445020276847,-58.481995354907 -34.6430659893327,-58.4799288479445 -34.6413032152403)))";;"3325";9_12_2;COMUNA 9;"12";"2";"546";"276";"270";"102,22%";"211";"211";"100,00%";"0";"0,00%";"191";"10";"5.24";"181";"94,76%";"5.24";5.240
"MULTIPOLYGON (((-58.4838895637553 -34.6465134577655,-58.4836874735701 -34.6463408817794,-58.4836194566525 -34.6462818071439,-58.4834737916527 -34.6461552084342,-58.4832091585725 -34.6463424420789,-58.482586137297 -34.6466586113066,-58.4823448257614 -34.6467437234499,-58.4826844792717 -34.6470252261815,-58.4823858254768 -34.6471499264603,-58.4821325874676 -34.647258491523,-58.4819966817809 -34.6473221770221,-58.4814314548024 -34.6477678421351,-58.4815545323162 -34.6478739531631,-58.4821014810064 -34.648345571866,-58.4810260493781 -34.6491911159752,-58.4808961134733 -34.6492936033213,-58.4817289489373 -34.6500110330701,-58.482490540132 -34.6506670583339,-58.4826806202256 -34.6508310463411,-58.4832973460947 -34.6497449955787,-58.4834363618299 -34.6494965138154,-58.4840808699709 -34.6481603761041,-58.4850143161144 -34.6474258907139,-58.4841944388546 -34.6467386930094,-58.4840724770062 -34.6466697686697,-58.4838895637553 -34.6465134577655)))";;"3326";9_12_3;COMUNA 9;"12";"3";"858";"401";"457";"87,75%";"297";"297";"100,00%";"0";"0,00%";"283";"4";"1.41";"279";"98,59%";"1.41";1.410
"MULTIPOLYGON (((-58.4850954607487 -34.6474939060847,-58.4850143161144 -34.6474258907139,-58.4840808699709 -34.6481603761041,-58.4834363618299 -34.6494965138154,-58.4840057494767 -34.6499874868104,-58.4850269135733 -34.6508678939541,-58.4861824156413 -34.6499627201453,-58.4871412536945 -34.6492115935778,-58.4866234256503 -34.6487757675761,-58.4862423247324 -34.6484550573661,-58.4861023641603 -34.6483378272234,-58.4850954607487 -34.6474939060847)))";;"3327";9_12_4;COMUNA 9;"12";"4";"810";"384";"426";"90,14%";"317";"317";"100,00%";"0";"0,00%";"296";"13";"4.39";"283";"95,61%";"4.39";4.390
"MULTIPOLYGON (((-58.4850849506167 -34.6529038174961,-58.485172804159 -34.6528357791624,-58.4855611060836 -34.6525360137593,-58.4856860149803 -34.6524399310858,-58.4859160647403 -34.6522630512605,-58.4862981140354 -34.6519638140889,-58.4863943075604 -34.651888511502,-58.4864700523586 -34.6518291287936,-58.4872988882643 -34.6511640853983,-58.4874590647825 -34.6510357392815,-58.4884066521452 -34.6502764359204,-58.4877682803621 -34.6497392287042,-58.4871412536945 -34.6492115935778,-58.4861824156413 -34.6499627201453,-58.4850269135733 -34.6508678939541,-58.4844167758349 -34.6513457649222,-58.483819837779 -34.651813348519,-58.4850375899918 -34.652863092318,-58.4850849506167 -34.6529038174961)))";;"3328";9_12_5;COMUNA 9;"12";"5";"803";"386";"417";"92,57%";"288";"288";"100,00%";"0";"0,00%";"290";"7";"2.41";"283";"97,59%";"2.41";2.410
"MULTIPOLYGON (((-58.4840057494767 -34.6499874868104,-58.4834363618299 -34.6494965138154,-58.4832973460947 -34.6497449955787,-58.4826806202256 -34.6508310463411,-58.4824764327302 -34.6511906678635,-58.4821695092534 -34.6517310855142,-58.4819352455526 -34.6521400785435,-58.4811505730794 -34.6535095361859,-58.4810615493165 -34.6536648359004,-58.4815951606275 -34.6535572880648,-58.4830648760824 -34.6532614072727,-58.4832065944199 -34.6532327911265,-58.4850375899918 -34.652863092318,-58.483819837779 -34.651813348519,-58.4844167758349 -34.6513457649222,-58.4850269135733 -34.6508678939541,-58.4840057494767 -34.6499874868104)))";;"3329";9_12_6;COMUNA 9;"12";"6";"1016";"478";"538";"88,85%";"360";"360";"100,00%";"0";"0,00%";"338";"11";"3.25";"327";"96,75%";"3.25";3.250
"MULTIPOLYGON (((-58.4816185003408 -34.6518678664644,-58.4819352455526 -34.6521400785435,-58.4821695092534 -34.6517310855142,-58.4824764327302 -34.6511906678635,-58.4826806202256 -34.6508310463411,-58.482490540132 -34.6506670583339,-58.4817289489373 -34.6500110330701,-58.4808961134733 -34.6492936033213,-58.4810260493781 -34.6491911159752,-58.4821014810064 -34.648345571866,-58.4815545323162 -34.6478739531631,-58.4814314548024 -34.6477678421351,-58.4802271961438 -34.648717345816,-58.4791460323877 -34.6495698461626,-58.4790392687505 -34.6496498629302,-58.4792011274587 -34.6497900566334,-58.4797114242335 -34.6502287321243,-58.4805434061492 -34.6509438459658,-58.4810810781171 -34.6514059630361,-58.4816185003408 -34.6518678664644)))";;"3330";9_12_7;COMUNA 9;"12";"7";"719";"355";"364";"97,53%";"288";"288";"100,00%";"0";"0,00%";"250";"8";"3.2";"242";"96,80%";"3.2";3.200
"MULTIPOLYGON (((-58.477599015038 -34.6507871943037,-58.4778022359639 -34.6506260377077,-58.4789253475599 -34.6497353032546,-58.4790392687505 -34.6496498629302,-58.4791460323877 -34.6495698461626,-58.4802271961438 -34.648717345816,-58.4814314548024 -34.6477678421351,-58.4819966817809 -34.6473221770221,-58.4817656041903 -34.647452992012,-58.4815933969378 -34.6475228801022,-58.481145535035 -34.6476937989522,-58.4805661867044 -34.6478905813457,-58.4804268639806 -34.64792553232,-58.4798913913206 -34.6480835011168,-58.4793260912479 -34.6482453449861,-58.4788281062414 -34.6483825991348,-58.478417887151 -34.6484835712588,-58.4777314833689 -34.6486268311619,-58.4770433711269 -34.6487600166712,-58.4767456272094 -34.6488085035029,-58.4763746818067 -34.6488649558258,-58.4760623673875 -34.6489295698709,-58.47565725283 -34.6490143344667,-58.4754881852419 -34.6490512548402,-58.4745244784945 -34.6492505130546,-58.4741514903905 -34.6493507629508,-58.4739613698757 -34.6493688797954,-58.4735839407896 -34.6494049010702,-58.4727383903445 -34.6494889917903,-58.4727362797877 -34.6494892016794,-58.4737310758737 -34.6504066786172,-58.4742519206955 -34.6508869265009,-58.4743737162476 -34.6509993126377,-58.4749243171403 -34.6515242743961,-58.4756252779006 -34.6521924614802,-58.4757250877263 -34.6522902706727,-58.4758899707845 -34.6521577842169,-58.4768696289345 -34.6513673690389,-58.4769910517368 -34.651269394192,-58.477599015038 -34.6507871943037)))";;"3331";9_12_8;COMUNA 9;"12";"8";"1017";"491";"526";"93,35%";"356";"355";"99,72%";"1";"0,28%";"320";"2";"0.63";"318";"99,38%";"0.63";0.630
"MULTIPOLYGON (((-58.4793023664382 -34.6519203180391,-58.4790076295886 -34.6521439560233,-58.4789220762913 -34.652191011089,-58.4788685620479 -34.6522164414885,-58.4787196070139 -34.6522809701103,-58.4787967543535 -34.6523931463862,-58.478834518964 -34.6524516642618,-58.4789507155438 -34.6526522181706,-58.479018323178 -34.6527874948473,-58.4790748497138 -34.6529105190876,-58.4791232782525 -34.6530232623954,-58.4792510990447 -34.6533869882742,-58.4794156162516 -34.6539963500191,-58.4810615493165 -34.6536648359004,-58.4811505730794 -34.6535095361859,-58.4819352455526 -34.6521400785435,-58.4816185003408 -34.6518678664644,-58.4810810781171 -34.6514059630361,-58.4805434061492 -34.6509438459658,-58.4797114242335 -34.6502287321243,-58.4792011274587 -34.6497900566334,-58.4790392687505 -34.6496498629302,-58.4789253475599 -34.6497353032546,-58.4778022359639 -34.6506260377077,-58.4784738795156 -34.6512054770912,-58.4793023664382 -34.6519203180391)))";;"3332";9_12_9;COMUNA 9;"12";"9";"871";"401";"470";"85,32%";"325";"324";"99,69%";"1";"0,31%";"292";"4";"1.37";"288";"98,63%";"1.37";1.370
"MULTIPOLYGON (((-58.4648661970986 -34.6448462138926,-58.4646959417976 -34.6449503045296,-58.4641188785639 -34.645387790931,-58.4634165438674 -34.6459201374494,-58.463332077284 -34.6459700348783,-58.4633304909565 -34.6459709299253,-58.4629989413109 -34.6461691790331,-58.4630002572372 -34.6461715967127,-58.4633574116754 -34.6468277713143,-58.4638832055309 -34.6475511697665,-58.4644095173298 -34.6481529424383,-58.4648664441841 -34.6477933467537,-58.4654250910997 -34.6483154800747,-58.4654277865842 -34.6483179993581,-58.466009720012 -34.6478650838354,-58.4665247542002 -34.6474606902286,-58.4670198435629 -34.6470718589848,-58.4675457750862 -34.646658868814,-58.4670998915942 -34.6460236549211,-58.4672185913832 -34.6459287885039,-58.4660026332314 -34.6453692327654,-58.4648661970986 -34.6448462138926)))";;"3333";9_13_1;COMUNA 9;"13";"1";"972";"481";"491";"97,96%";"310";"309";"99,68%";"1";"0,32%";"315";"20";"6.35";"295";"93,65%";"6.35";6.350
"MULTIPOLYGON (((-58.4698742564611 -34.6609743878169,-58.4691407160922 -34.6614857108459,-58.4688385872238 -34.6616962957579,-58.4691306120398 -34.6619834719016,-58.4695955026737 -34.6624326140624,-58.4696411055587 -34.6624770493429,-58.4706740502367 -34.6617561207989,-58.4700005790701 -34.6610979049443,-58.4698742564611 -34.6609743878169)))";;"3334";8_17_3;COMUNA 8;"17";"3";"666";"290";"376";"77,13%";"419";"419";"100,00%";"0";"0,00%";"327";"5";"1.53";"322";"98,47%";"1.53";1.530
"MULTIPOLYGON (((-58.470460703501 -34.6641139097414,-58.4704432140087 -34.6642831073998,-58.4704119497995 -34.664366703698,-58.4703603059319 -34.6644535403513,-58.4701621625989 -34.6646668812201,-58.4705842905104 -34.6643390158496,-58.4709396038154 -34.6640611677276,-58.4710023309801 -34.6640120775989,-58.4714008490413 -34.6636786602384,-58.4720266819613 -34.663156770849,-58.4720266818613 -34.6631558790351,-58.471838752164 -34.6626653604183,-58.4716468464055 -34.6622212072433,-58.4715702249514 -34.6622401570367,-58.4709922458565 -34.6620244874196,-58.4708632820935 -34.6619407613692,-58.4707696889475 -34.6618495678461,-58.4706740502367 -34.6617561207989,-58.4696411055587 -34.6624770493429,-58.4696826170099 -34.6625174706432,-58.4698235178687 -34.6626581002431,-58.4699153300595 -34.6628537341338,-58.4699800455438 -34.6631279633191,-58.4700422807927 -34.6633012742938,-58.4700910425361 -34.6633966261251,-58.470152503759 -34.6634877516898,-58.4701842518805 -34.6636095409518,-58.470393862487 -34.6637686368204,-58.4704251136496 -34.6638556323076,-58.4704579432308 -34.664012888124,-58.470460703501 -34.6641139097414)))";;"3335";8_17_2;COMUNA 8;"17";"2";"620";"295";"325";"90,77%";"265";"265";"100,00%";"0";"0,00%";"221";"0";"0";"221";"100,00%";"0";0.000
"MULTIPOLYGON (((-58.4689005252321 -34.6464804216971,-58.4700129399697 -34.6455998399937,-58.4687603020514 -34.6447153038474,-58.4676862247083 -34.6440409653474,-58.4667082022474 -34.643426756916,-58.4655964632967 -34.6443073087724,-58.4650856195918 -34.6447119802846,-58.4648661970986 -34.6448462138926,-58.4660026332314 -34.6453692327654,-58.4672185913832 -34.6459287885039,-58.4670998915942 -34.6460236549211,-58.4675457750862 -34.646658868814,-58.4679453887035 -34.6472297148428,-58.4681683040595 -34.6470600519704,-58.4689005252321 -34.6464804216971)))";;"3336";9_13_2;COMUNA 9;"13";"2";"1112";"530";"582";"91,07%";"452";"452";"100,00%";"0";"0,00%";"404";"16";"3.96";"388";"96,04%";"3.96";3.960
"MULTIPOLYGON (((-58.4693912494534 -34.6492457617655,-58.4695657113803 -34.6494813929971,-58.4697781784493 -34.6496751190965,-58.4698148050971 -34.6494697586486,-58.4698930251971 -34.64934475028,-58.4699446610231 -34.6492675617896,-58.469971160563 -34.6492279815498,-58.470107155484 -34.6490710672057,-58.4702508239429 -34.6489627452532,-58.4712633055975 -34.6481607525904,-58.4723833864967 -34.6472733881979,-58.4712057786811 -34.64644197166,-58.4700129399697 -34.6455998399937,-58.4689005252321 -34.6464804216971,-58.4681683040595 -34.6470600519704,-58.4679453887035 -34.6472297148428,-58.4681850401878 -34.6475720387068,-58.4684294662782 -34.6479211930504,-58.4687550300102 -34.648386191476,-58.469306959211 -34.6491318896747,-58.4693912494534 -34.6492457617655)))";;"3337";9_13_3;COMUNA 9;"13";"3";"1193";"606";"587";"103,24%";"418";"418";"100,00%";"0";"0,00%";"402";"43";"10.7";"359";"89,30%";"10.7";10.700
"MULTIPOLYGON (((-58.4670198435629 -34.6470718589848,-58.4665247542002 -34.6474606902286,-58.466009720012 -34.6478650838354,-58.4654277865842 -34.6483179993581,-58.4654250910997 -34.6483154800747,-58.4648664441841 -34.6477933467537,-58.4644095173298 -34.6481529424383,-58.4649141202025 -34.6487303186767,-58.4650403175107 -34.648874714459,-58.4657474065278 -34.649785641889,-58.4658927417898 -34.6499627551244,-58.4663383476857 -34.6505057882236,-58.4670088234769 -34.6514879084935,-58.4673984360422 -34.6511790820468,-58.4679817416661 -34.6507167203698,-58.4681546443091 -34.6505796663885,-58.4690394297601 -34.649875799597,-58.4693272831446 -34.6496588059137,-58.469315591068 -34.6494439409018,-58.4693912494534 -34.6492457617655,-58.469306959211 -34.6491318896747,-58.4687550300102 -34.648386191476,-58.4684294662782 -34.6479211930504,-58.4681850401878 -34.6475720387068,-58.4679453887035 -34.6472297148428,-58.4675457750862 -34.646658868814,-58.4670198435629 -34.6470718589848)))";;"3338";9_13_4;COMUNA 9;"13";"4";"822";"401";"421";"95,25%";"266";"266";"100,00%";"0";"0,00%";"250";"5";"2";"245";"98,00%";"2";2.000
"MULTIPOLYGON (((-58.4740884990625 -34.6536052622235,-58.4736750322365 -34.6532282467344,-58.4732575632423 -34.6528475680857,-58.4727073077831 -34.652345839015,-58.4725679551181 -34.6522188747618,-58.4720449815236 -34.6517420003359,-58.4708166648895 -34.6506219843197,-58.470026697137 -34.6499016605498,-58.4697781784493 -34.6496751190965,-58.4695657113803 -34.6494813929971,-58.4697340624858 -34.6500007652754,-58.4701150977657 -34.6511757780014,-58.4706553850752 -34.6528424133496,-58.4708470226079 -34.6534333336946,-58.4709488098639 -34.6537474206395,-58.4710699875763 -34.6536508602347,-58.4716093335415 -34.6541560481901,-58.4720256094524 -34.6545458876901,-58.4724376275703 -34.6549317118815,-58.4726084363715 -34.6550917028115,-58.4742337956579 -34.6547726068856,-58.4751683376001 -34.654589692636,-58.4747123287845 -34.6541739515339,-58.4740884990625 -34.6536052622235)))";;"3339";9_13_5;COMUNA 9;"13";"5";"976";"452";"524";"86,26%";"340";"340";"100,00%";"0";"0,00%";"303";"15";"4.95";"288";"95,05%";"4.95";4.950
"MULTIPOLYGON (((-58.4695657113803 -34.6494813929971,-58.4693912494534 -34.6492457617655,-58.469315591068 -34.6494439409018,-58.4693272831446 -34.6496588059137,-58.4690394297601 -34.649875799597,-58.4681546443091 -34.6505796663885,-58.4679817416661 -34.6507167203698,-58.4673984360422 -34.6511790820468,-58.4683455864184 -34.6525647170156,-58.4698929711152 -34.6556246553024,-58.4707659141204 -34.6554376233854,-58.4714258842011 -34.655323771796,-58.4721189171564 -34.6551877303348,-58.4726084363715 -34.6550917028115,-58.4724376275703 -34.6549317118815,-58.4720256094524 -34.6545458876901,-58.4716093335415 -34.6541560481901,-58.4710699875763 -34.6536508602347,-58.4709488098639 -34.6537474206395,-58.4708470226079 -34.6534333336946,-58.4706553850752 -34.6528424133496,-58.4701150977657 -34.6511757780014,-58.4697340624858 -34.6500007652754,-58.4695657113803 -34.6494813929971)))";;"3340";9_13_6;COMUNA 9;"13";"6";"977";"489";"488";"100,20%";"206";"206";"100,00%";"0";"0,00%";"300";"17";"5.67";"283";"94,33%";"5.67";5.670
"MULTIPOLYGON (((-58.4682991104444 -34.6635240490865,-58.4684706668784 -34.663669481104,-58.4684820317259 -34.663679115299,-58.4686556582386 -34.6637643910096,-58.4688902247942 -34.6638186061894,-58.4692683298137 -34.6638564422753,-58.4693826026502 -34.6638181167131,-58.4696413222982 -34.6636516603097,-58.4696553218113 -34.6636426531948,-58.4699789774558 -34.6635846662869,-58.4701842518805 -34.6636095409518,-58.470152503759 -34.6634877516897,-58.4700910425361 -34.6633966261251,-58.4700422807927 -34.6633012742938,-58.4699800455438 -34.6631279633191,-58.4699153300595 -34.6628537341338,-58.4698235178687 -34.6626581002431,-58.4698219790931 -34.6626565644335,-58.4696826170099 -34.6625174706432,-58.4696411055587 -34.6624770493429,-58.4695955026737 -34.6624326140624,-58.4691306120398 -34.6619834719016,-58.4688385872238 -34.6616962957579,-58.4676002743731 -34.6604785004244,-58.4678872316042 -34.6602770743754,-58.4684735847907 -34.6598653461507,-58.4686292912704 -34.6597560397852,-58.4690932549442 -34.6594302323861,-58.4695238734891 -34.6591279317295,-58.467620690422 -34.6575713286239,-58.464425103268 -34.6600654059216,-58.4645410167788 -34.6601167437171,-58.46561537621 -34.6612175990861,-58.4668305646219 -34.6622642132215,-58.4671648888316 -34.6625527968526,-58.4673560448981 -34.6627177985777,-58.4682991104444 -34.6635240490865)))";;"3341";8_17_5;COMUNA 8;"17";"5";"448";"206";"242";"85,12%";"246";"246";"100,00%";"0";"0,00%";"173";"0";"0";"173";"100,00%";"0";0.000
"MULTIPOLYGON (((-58.4695238734891 -34.6591279317295,-58.4690932549442 -34.6594302323861,-58.4686292912704 -34.6597560397852,-58.4690202674425 -34.6601386366862,-58.4693890003897 -34.6604994723497,-58.4695289595084 -34.6606365107373,-58.4698742564611 -34.6609743878169,-58.47000057907 -34.6610979049443,-58.4706740502367 -34.6617561207989,-58.4707696889475 -34.6618495678461,-58.4708632820935 -34.6619407613692,-58.4709922458565 -34.6620244874196,-58.4715702249514 -34.6622401570367,-58.4716468464054 -34.6622212072433,-58.4718387521639 -34.6626653604183,-58.4720266818613 -34.6631558790351,-58.4720266819613 -34.663156770849,-58.4725271878211 -34.6627836904745,-58.4719709418377 -34.6615861185019,-58.4712471556598 -34.6598897947347,-58.4705676484154 -34.6584079944346,-58.4695238734891 -34.6591279317295)))";;"3342";8_17_1;COMUNA 8;"17";"1";"576";"267";"309";"86,41%";"250";"250";"100,00%";"0";"0,00%";"223";"1";"0.45";"222";"99,55%";"0.45";0.450
"MULTIPOLYGON (((-58.4676002743731 -34.6604785004244,-58.4688385872238 -34.6616962957579,-58.4691407160922 -34.6614857108459,-58.4698742564611 -34.6609743878169,-58.4695289595084 -34.6606365107373,-58.4693890003897 -34.6604994723497,-58.4690202674425 -34.6601386366862,-58.4686292912704 -34.6597560397852,-58.4684735847907 -34.6598653461507,-58.4678872316042 -34.6602770743754,-58.4676002743731 -34.6604785004244)))";;"3343";8_17_4;COMUNA 8;"17";"4";"780";"362";"418";"86,60%";"324";"324";"100,00%";"0";"0,00%";"290";"0";"0";"290";"100,00%";"0";0.000
"MULTIPOLYGON (((-58.4785308617636 -34.6550801619105,-58.4789972205055 -34.6555657484805,-58.4794064716116 -34.655991832289,-58.4796117380644 -34.6562055426114,-58.4801603706712 -34.6567766790654,-58.4803981119149 -34.6565876252181,-58.4814000217405 -34.6557908327706,-58.4815545926025 -34.6556678476324,-58.4820962694939 -34.6552402853871,-58.4826560901895 -34.654798491969,-58.4837523671796 -34.6539332117642,-58.4838941510504 -34.6538236769319,-58.4846539324369 -34.6532367646098,-58.4849848119524 -34.6529812179701,-58.4850849506167 -34.6529038174961,-58.4850375899918 -34.652863092318,-58.4832065944199 -34.6532327911265,-58.4830648760824 -34.6532614072727,-58.4815951606275 -34.6535572880648,-58.4810615493165 -34.6536648359004,-58.4794156162516 -34.6539963500191,-58.4780578019709 -34.6542746353775,-58.4777059271206 -34.6543442201278,-58.4779002493172 -34.6544174762222,-58.4781017585645 -34.6546333727739,-58.4785308617636 -34.6550801619105)))";;"3344";9_14_1;COMUNA 9;"14";"1";"1109";"537";"572";"93,88%";"427";"427";"100,00%";"0";"0,00%";"388";"6";"1.55";"382";"98,45%";"1.55";1.550
"MULTIPOLYGON (((-58.4736287941706 -34.6619568129059,-58.4731962400975 -34.6605765301771,-58.473203270067 -34.6604936985917,-58.473208720499 -34.6602723628207,-58.4732087305143 -34.6602721542523,-58.4728251478163 -34.6598762599398,-58.4721998306009 -34.65923086929,-58.4717192647614 -34.659595916222,-58.4710473810912 -34.6580741902137,-58.4705676484154 -34.6584079944346,-58.4712471556598 -34.6598897947347,-58.4719709418377 -34.6615861185019,-58.4725271878211 -34.6627836904745,-58.4729755549749 -34.6624525878814,-58.4732114549058 -34.6622735486556,-58.4736287941706 -34.6619568129059)))";;"3345";9_14_10;COMUNA 9;"14";"10";"1804";"897";"907";"98,90%";"406";"406";"100,00%";"0";"0,00%";"489";"77";"15.75";"412";"84,25%";"15.75";15.750
"MULTIPOLYGON (((-58.4761999615821 -34.6545062704768,-58.4751683376001 -34.654589692636,-58.4755106455399 -34.6549018494158,-58.4765499442644 -34.6558492987225,-58.4770051190409 -34.6562642582631,-58.4775089704171 -34.6567235776587,-58.4779573354828 -34.6571323370482,-58.4781783657283 -34.6573337938946,-58.4784950383977 -34.6576224940228,-58.478721772563 -34.6577776097636,-58.4788178367167 -34.6578444300165,-58.4791142963911 -34.6576086090149,-58.4801603706712 -34.6567766790654,-58.4796117380644 -34.6562055426114,-58.4794064716116 -34.655991832289,-58.4789972205055 -34.6555657484805,-58.4785308617636 -34.6550801619105,-58.4781017585645 -34.6546333727739,-58.4779002493172 -34.6544174762222,-58.4777059271206 -34.6543442201278,-58.4772888531462 -34.6544181847266,-58.4761999615821 -34.6545062704768)))";;"3346";9_14_2;COMUNA 9;"14";"2";"917";"452";"465";"97,20%";"296";"296";"100,00%";"0";"0,00%";"307";"5";"1.63";"302";"98,37%";"1.63";1.630
"MULTIPOLYGON (((-58.4779011791781 -34.6585768927651,-58.4782774050295 -34.658275005617,-58.4783980694215 -34.6581782267934,-58.4788178367167 -34.6578444300165,-58.478721772563 -34.6577776097636,-58.4784950383977 -34.6576224940228,-58.4781783657283 -34.6573337938946,-58.4779573354828 -34.6571323370482,-58.4775089704171 -34.6567235776587,-58.4770051190409 -34.6562642582631,-58.4765499442644 -34.6558492987225,-58.4755106455399 -34.6549018494158,-58.4745898906836 -34.6555656945012,-58.4737470938368 -34.6561626221684,-58.4739485078243 -34.6563526797092,-58.474835403763 -34.657180013046,-58.4757192486958 -34.6580045231606,-58.4758304021265 -34.6581102185121,-58.4764463540363 -34.6586955899931,-58.4768787871148 -34.6591065381719,-58.4770430477366 -34.6592511005629,-58.4777001550046 -34.6587381898972,-58.4779011791781 -34.6585768927651)))";;"3347";9_14_3;COMUNA 9;"14";"3";"773";"363";"410";"88,54%";"258";"258";"100,00%";"0";"0,00%";"263";"26";"9.89";"237";"90,11%";"9.89";9.890
"MULTIPOLYGON (((-58.4755106455399 -34.6549018494157,-58.4751683376001 -34.6545896926359,-58.4742337956578 -34.6547726068856,-58.4726084363715 -34.6550917028115,-58.4721189171564 -34.6551877303348,-58.4714258842011 -34.655323771796,-58.4707659141204 -34.6554376233854,-58.4698929711152 -34.6556246553024,-58.4693940389283 -34.6557477472424,-58.4695304360777 -34.656080707233,-58.4705676484154 -34.6584079944346,-58.4710469945722 -34.6580733147831,-58.4715382261081 -34.657726231201,-58.4720133144934 -34.6573905490376,-58.4724961701508 -34.6570485998927,-58.4737470938368 -34.6561626221684,-58.4745898906836 -34.6555656945012,-58.4755106455399 -34.6549018494157)))";;"3348";9_14_4;COMUNA 9;"14";"4";"846";"408";"438";"93,15%";"197";"197";"100,00%";"0";"0,00%";"249";"27";"10.84";"222";"89,16%";"10.84";10.840
"MULTIPOLYGON (((-58.4737470938368 -34.6561626221684,-58.4724961701508 -34.6570485998927,-58.4729534728248 -34.6574712911245,-58.4733128922074 -34.6578035032292,-58.4736418400402 -34.6581075471467,-58.4747214677538 -34.6572640408491,-58.474835403763 -34.657180013046,-58.4739485078243 -34.6563526797092,-58.4737470938368 -34.6561626221684)))";;"3349";9_14_5;COMUNA 9;"14";"5";"1880";"907";"973";"93,22%";"333";"333";"100,00%";"0";"0,00%";"457";"71";"15.54";"386";"84,46%";"15.54";15.540
"MULTIPOLYGON (((-58.4724961701508 -34.6570485998927,-58.4720133144934 -34.6573905490376,-58.4715382261081 -34.657726231201,-58.4710469945722 -34.6580733147831,-58.4710473810912 -34.6580741902137,-58.4717192647614 -34.659595916222,-58.4721998306009 -34.65923086929,-58.4725325335683 -34.6589735115996,-58.4726349688528 -34.6588942756724,-58.4727673161919 -34.6587908815694,-58.4727679421317 -34.6587903924795,-58.4736418400403 -34.6581075471467,-58.4733128922074 -34.6578035032292,-58.4729534728248 -34.6574712911245,-58.4724961701508 -34.6570485998927)))";;"3350";9_14_6;COMUNA 9;"14";"6";"2558";"1261";"1297";"97,22%";"555";"555";"100,00%";"0";"0,00%";"659";"152";"23.07";"507";"76,93%";"23.07";23.070
"MULTIPOLYGON (((-58.4725325335683 -34.6589735115997,-58.4721998306009 -34.6592308692899,-58.4728251478163 -34.6598762599398,-58.4732087305143 -34.6602721542523,-58.4733362209536 -34.6601665768128,-58.4738633089157 -34.659731869417,-58.4746749369041 -34.6590624070691,-58.4741757742699 -34.6586010333852,-58.4736418400402 -34.6581075471467,-58.4727679421317 -34.6587903924796,-58.4727673161919 -34.6587908815694,-58.4726349688528 -34.6588942756724,-58.4725325335683 -34.6589735115997)))";;"3351";9_14_7;COMUNA 9;"14";"7";"1374";"676";"698";"96,85%";"262";"262";"100,00%";"0";"0,00%";"351";"62";"17.66";"289";"82,34%";"17.66";17.660
"MULTIPOLYGON (((-58.474835403763 -34.657180013046,-58.4747214677538 -34.6572640408491,-58.4736418400402 -34.6581075471467,-58.4741757742699 -34.6586010333852,-58.4746749369041 -34.6590624070691,-58.4748018271645 -34.6589577436546,-58.4758304021265 -34.6581102185121,-58.4757192486958 -34.6580045231606,-58.474835403763 -34.657180013046)))";;"3352";9_14_8;COMUNA 9;"14";"8";"1684";"829";"855";"96,96%";"341";"341";"100,00%";"0";"0,00%";"426";"83";"19.48";"343";"80,52%";"19.48";19.480
"MULTIPOLYGON (((-58.473208720499 -34.6602723628207,-58.473203270067 -34.6604936985917,-58.4731962400975 -34.6605765301771,-58.4736287941706 -34.6619568129059,-58.4740111880013 -34.6616590231552,-58.4742160620215 -34.6614994924305,-58.4743193485755 -34.6614020150884,-58.4744422354044 -34.6612860845451,-58.4750891479188 -34.660778611789,-58.4751320137907 -34.660744944499,-58.4757079301243 -34.660293181444,-58.4758698469709 -34.6601667520145,-58.4770430477366 -34.6592511005629,-58.4768787871148 -34.6591065381719,-58.4764463540363 -34.6586955899931,-58.4758304021265 -34.6581102185121,-58.4748018271645 -34.6589577436546,-58.4746749369041 -34.6590624070691,-58.4738633089157 -34.659731869417,-58.4733362209536 -34.6601665768128,-58.4732087305143 -34.6602721542523,-58.473208720499 -34.6602723628207)))";;"3353";9_14_9;COMUNA 9;"14";"9";"905";"435";"470";"92,55%";"202";"201";"99,50%";"1";"0,50%";"252";"31";"12.3";"221";"87,70%";"12.3";12.300
"MULTIPOLYGON (((-58.4933351800413 -34.6579720730229,-58.492343407068 -34.6587460727938,-58.4921954914153 -34.6588610415359,-58.4930268930233 -34.6595576180551,-58.4931713155769 -34.6596787826862,-58.4921208560027 -34.6606190674106,-58.493447956208 -34.6617185597656,-58.4944268919944 -34.6625295993575,-58.4955161520468 -34.6616456946636,-58.4964897694666 -34.6608557585416,-58.4965980615619 -34.6607676978212,-58.4978252045846 -34.6597710112866,-58.4979234505285 -34.6596920099035,-58.4980059241361 -34.6596251531599,-58.4988156560034 -34.6589641929139,-58.4978399569696 -34.6581505110187,-58.4972726552459 -34.6576774201394,-58.4968618045908 -34.6573347795759,-58.496355982939 -34.6569129362141,-58.496250778115 -34.6568251457638,-58.4959543480729 -34.656579867746,-58.4955417190188 -34.6562384907969,-58.4954117039165 -34.6563388103499,-58.4946345099874 -34.6569552314277,-58.4945215164599 -34.6570420267724,-58.4944067683185 -34.6571357890417,-58.4934364863789 -34.6578929607434,-58.4933351800413 -34.6579720730229)))";;"3354";9_15_1;COMUNA 9;"15";"1";"579";"279";"300";"93,00%";"238";"238";"100,00%";"0";"0,00%";"217";"5";"2.3";"212";"97,70%";"2.3";2.300
"MULTIPOLYGON (((-58.4921208560027 -34.6606190674106,-58.4919783106381 -34.6607465701252,-58.4909515106827 -34.661664021389,-58.4908011211341 -34.6615410949304,-58.4898061202851 -34.6607193955511,-58.4885606950201 -34.6616901864613,-58.4873169449556 -34.6626596260978,-58.4871322887145 -34.6628035405122,-58.4889524298822 -34.663348388693,-58.4900770849757 -34.6644002832914,-58.4910000378318 -34.6652634062898,-58.4919648011152 -34.6645027349649,-58.4930414261558 -34.6636539270839,-58.4932047699137 -34.6635213474204,-58.4944268919944 -34.6625295993575,-58.493447956208 -34.6617185597656,-58.4921208560027 -34.6606190674106)))";;"3355";9_15_10;COMUNA 9;"15";"10";"682";"345";"337";"102,37%";"251";"251";"100,00%";"0";"0,00%";"229";"15";"6.55";"214";"93,45%";"6.55";6.550
"MULTIPOLYGON (((-58.4849146561351 -34.6606861585691,-58.4841316318761 -34.6612965976904,-58.4850373649946 -34.6618716626145,-58.4852268672584 -34.6619919832501,-58.4853608745972 -34.6620771016577,-58.4859453270546 -34.6624481288185,-58.4871322887145 -34.6628035405122,-58.4873169449556 -34.6626596260978,-58.4885606950201 -34.6616901864613,-58.4898061202851 -34.6607193955511,-58.4890068771252 -34.6600593406003,-58.4882101188848 -34.6594012517032,-58.4869625641018 -34.6603725199161,-58.4861647954295 -34.6597114600544,-58.4849146561351 -34.6606861585691)))";;"3356";9_15_11;COMUNA 9;"15";"11";"928";"452";"476";"94,96%";"334";"334";"100,00%";"0";"0,00%";"311";"7";"2.25";"304";"97,75%";"2.25";2.250
"MULTIPOLYGON (((-58.4955417190188 -34.6562384907969,-58.4954047166626 -34.6561250736185,-58.4947468191245 -34.6555763590788,-58.4939554268139 -34.6549161930926,-58.4930523085274 -34.6556307378959,-58.492944412344 -34.6557148649384,-58.4928189077103 -34.6558116244856,-58.4918654455225 -34.6565535191897,-58.4917626906227 -34.656633053074,-58.4906056194817 -34.6575288422463,-58.4914011032386 -34.6581954373635,-58.4921954914153 -34.6588610415359,-58.492343407068 -34.6587460727938,-58.4933351800413 -34.6579720730229,-58.4934364863789 -34.6578929607434,-58.4944067683185 -34.6571357890417,-58.4945215164599 -34.6570420267724,-58.4946345099874 -34.6569552314277,-58.4954117039165 -34.6563388103499,-58.4955417190188 -34.6562384907969)))";;"3357";9_15_2;COMUNA 9;"15";"2";"875";"433";"442";"97,96%";"272";"272";"100,00%";"0";"0,00%";"290";"31";"10.69";"259";"89,31%";"10.69";10.690
"MULTIPOLYGON (((-58.4901922124906 -34.65529563185,-58.489747642147 -34.6549169877983,-58.4894068220548 -34.6546274065432,-58.488620080541 -34.6539588242655,-58.4874417134496 -34.6548775467512,-58.4862703072931 -34.6557908336777,-58.4856453139489 -34.6562781501777,-58.485155112941 -34.656660294792,-58.4850194611573 -34.6567659565661,-58.4858166804342 -34.6574244890688,-58.4866135713112 -34.6580826642268,-58.4877374606697 -34.6572067795542,-58.4878653559047 -34.6571071024544,-58.4890250052563 -34.6562043666278,-58.4898165422096 -34.6568676631309,-58.4906056194817 -34.6575288422463,-58.4917626906227 -34.656633053074,-58.4909769337534 -34.6559639226013,-58.4901922124906 -34.65529563185)))";;"3358";9_15_3;COMUNA 9;"15";"3";"863";"407";"456";"89,25%";"312";"312";"100,00%";"0";"0,00%";"290";"10";"3.45";"280";"96,55%";"3.45";3.450
"MULTIPOLYGON (((-58.4862981140354 -34.6519638140889,-58.4859160647403 -34.6522630512605,-58.4856860149803 -34.6524399310858,-58.4855611060836 -34.6525360137593,-58.485172804159 -34.6528357791624,-58.4850849506167 -34.6529038174961,-58.4849848119524 -34.6529812179701,-58.4846539324369 -34.6532367646098,-58.4838941510504 -34.6538236769319,-58.4840351414315 -34.6539448531003,-58.4846709616331 -34.6544705303123,-58.4854700316851 -34.6551311777391,-58.4848466579191 -34.6556186307448,-58.4856453139489 -34.6562781501777,-58.4862703072931 -34.6557908336777,-58.4874417134496 -34.6548775467512,-58.488620080541 -34.6539588242655,-58.4878320729805 -34.6532891103023,-58.4872866809791 -34.6528256162165,-58.4869880911072 -34.6525749620126,-58.486988074201 -34.6525748235476,-58.4871585932911 -34.6525402109723,-58.4870596258946 -34.6524558620803,-58.4863943075604 -34.651888511502,-58.4862981140354 -34.6519638140889)))";;"3359";9_15_4;COMUNA 9;"15";"4";"865";"413";"452";"91,37%";"304";"304";"100,00%";"0";"0,00%";"272";"12";"4.41";"260";"95,59%";"4.41";4.410
"MULTIPOLYGON (((-58.4832460333649 -34.6572995231763,-58.4837762545369 -34.6577345860919,-58.4843638628696 -34.6572767938282,-58.4850194611573 -34.6567659565661,-58.485155112941 -34.656660294792,-58.4856453139489 -34.6562781501777,-58.4848466579191 -34.6556186307448,-58.4854700316851 -34.6551311777391,-58.4846709616331 -34.6544705303123,-58.4840351414315 -34.6539448531003,-58.4838941510504 -34.6538236769319,-58.4837523671796 -34.6539332117642,-58.4826560901895 -34.654798491969,-58.4820962694939 -34.6552402853871,-58.4815545926025 -34.6556678476324,-58.4814000217405 -34.6557908327706,-58.482178021052 -34.6564230533288,-58.4827678161117 -34.656907056244,-58.4832460333649 -34.6572995231763)))";;"3360";9_15_5;COMUNA 9;"15";"5";"949";"468";"481";"97,30%";"375";"375";"100,00%";"0";"0,00%";"319";"9";"2.82";"310";"97,18%";"2.82";2.820
"MULTIPOLYGON (((-58.4793565480648 -34.6582147908213,-58.479462586097 -34.658287595286,-58.4796328085727 -34.6583978566269,-58.4798224660675 -34.6585205801471,-58.4801692211142 -34.6587451148713,-58.4803001496541 -34.6588293942348,-58.4805335372724 -34.6589797167446,-58.480841596564 -34.6591780572599,-58.4814337666958 -34.6595593870664,-58.4827031027868 -34.6585705655733,-58.4837762545369 -34.6577345860919,-58.4832460333649 -34.6572995231763,-58.4827678161117 -34.656907056244,-58.482178021052 -34.6564230533288,-58.4814000217405 -34.6557908327706,-58.4803981119149 -34.6565876252181,-58.4801603706712 -34.6567766790654,-58.4791142963911 -34.6576086090149,-58.4788178367167 -34.6578444300165,-58.4793565480648 -34.6582147908213)))";;"3361";9_15_6;COMUNA 9;"15";"6";"1049";"526";"523";"100,57%";"359";"359";"100,00%";"0";"0,00%";"336";"4";"1.19";"332";"98,81%";"1.19";1.190
"MULTIPOLYGON (((-58.4843638628696 -34.6572767938282,-58.4837762545369 -34.6577345860919,-58.4827031027868 -34.6585705655733,-58.4814337666958 -34.6595593870664,-58.4823333267338 -34.6601386986694,-58.4832323878044 -34.6607175811149,-58.4841316318761 -34.6612965976904,-58.4849146561351 -34.6606861585691,-58.4861647954295 -34.6597114600544,-58.4862860499922 -34.6596169973451,-58.4874108157854 -34.6587411157292,-58.4866135713112 -34.6580826642268,-58.4858166804342 -34.6574244890688,-58.4850194611573 -34.6567659565661,-58.4843638628696 -34.6572767938282)))";;"3362";9_15_7;COMUNA 9;"15";"7";"1059";"520";"539";"96,47%";"378";"378";"100,00%";"0";"0,00%";"348";"9";"2.59";"339";"97,41%";"2.59";2.590
"MULTIPOLYGON (((-58.4874108157854 -34.6587411157292,-58.4862860499922 -34.6596169973451,-58.4861647954295 -34.6597114600544,-58.4869625641018 -34.6603725199161,-58.4882101188848 -34.6594012517032,-58.4893105776008 -34.6585444426745,-58.4894594317637 -34.6584219417918,-58.4895798269744 -34.6583229688049,-58.4906056194817 -34.6575288422463,-58.4898165422096 -34.6568676631309,-58.4890250052563 -34.6562043666278,-58.4878653559047 -34.6571071024544,-58.4877374606697 -34.6572067795542,-58.4866135713112 -34.6580826642268,-58.4874108157854 -34.6587411157292)))";;"3363";9_15_8;COMUNA 9;"15";"8";"843";"413";"430";"96,05%";"290";"290";"100,00%";"0";"0,00%";"283";"25";"8.83";"258";"91,17%";"8.83";8.830
"MULTIPOLYGON (((-58.4898061202851 -34.6607193955511,-58.4908011211341 -34.6615410949304,-58.4909515106827 -34.661664021389,-58.4919783106381 -34.6607465701252,-58.4921208560027 -34.6606190674106,-58.4931713155769 -34.6596787826862,-58.4930268930233 -34.6595576180551,-58.4921954914153 -34.6588610415359,-58.4914011032386 -34.6581954373635,-58.4906056194817 -34.6575288422463,-58.4895798269744 -34.6583229688049,-58.4894594317637 -34.6584219417918,-58.4893105776008 -34.6585444426745,-58.4882101188848 -34.6594012517032,-58.4890068771252 -34.6600593406003,-58.4898061202851 -34.6607193955511)))";;"3364";9_15_9;COMUNA 9;"15";"9";"801";"366";"435";"84,14%";"318";"318";"100,00%";"0";"0,00%";"293";"12";"4.1";"281";"95,90%";"4.1";4.100
"MULTIPOLYGON (((-58.5096675900055 -34.6679436327665,-58.5088809963104 -34.6672935635072,-58.5079411765725 -34.666517486274,-58.5072307591475 -34.6659307599325,-58.5065339953583 -34.6653554332472,-58.5064251882612 -34.6652657515395,-58.5056269638853 -34.6646074959098,-58.5041387923934 -34.6658458618074,-58.5049298581235 -34.6665062422603,-58.5057313397927 -34.6671752760356,-58.5065360747877 -34.6678469794224,-58.507305091951 -34.668488900955,-58.5080743746599 -34.6691270849708,-58.5080721536264 -34.669128768979,-58.508369435249 -34.6693821408797,-58.5087877747443 -34.6697386860445,-58.5103845969076 -34.6685317002426,-58.5099648403345 -34.6681774348801,-58.5096781944895 -34.6679355094822,-58.5096675900055 -34.6679436327665)))";;"3365";9_16_1;COMUNA 9;"16";"1";"925";"442";"483";"91,51%";"359";"359";"100,00%";"0";"0,00%";"309";"9";"2.91";"300";"97,09%";"2.91";2.910
"MULTIPOLYGON (((-58.4966918744899 -34.6678006132345,-58.4965849133241 -34.667830150854,-58.4964785546629 -34.667874266073,-58.4964246103767 -34.6679018169661,-58.4963075266278 -34.6679831895337,-58.4968768894499 -34.6685434689616,-58.4970344739093 -34.6686984992954,-58.4971369685456 -34.668790163003,-58.4981941243859 -34.6696517139862,-58.4982682831727 -34.6697134415589,-58.4988802937033 -34.670219978216,-58.4996317907673 -34.6708423751273,-58.5004749954244 -34.6695356029435,-58.5013018826318 -34.6682061531538,-58.5004977022424 -34.6675442040687,-58.4997171478946 -34.6668967995022,-58.4996848350618 -34.6668699983827,-58.4988950041293 -34.6662173302474,-58.4985704803822 -34.6659491089419,-58.4973025959605 -34.6669662637856,-58.4972268985347 -34.6677707437687,-58.4971235869964 -34.667762040352,-58.4970453365386 -34.6677562876169,-58.4969432232888 -34.6677595558659,-58.4968205707253 -34.6677700130733,-58.4967451435205 -34.6677896825811,-58.4966918744899 -34.6678006132345)))";;"3366";9_16_10;COMUNA 9;"16";"10";"862";"385";"477";"80,71%";"323";"322";"99,69%";"1";"0,31%";"297";"7";"2.36";"290";"97,64%";"2.36";2.360
"MULTIPOLYGON (((-58.4980935895104 -34.6655550825562,-58.4973142709961 -34.6649110631902,-58.4950664156217 -34.6667619427867,-58.4963075266278 -34.6679831895337,-58.4964246103767 -34.6679018169661,-58.4964785546629 -34.667874266073,-58.4965849133241 -34.667830150854,-58.4966918744899 -34.6678006132345,-58.4967451435205 -34.6677896825811,-58.4968205707253 -34.6677700130733,-58.4969432232888 -34.6677595558659,-58.4970453365386 -34.6677562876169,-58.4971235869964 -34.667762040352,-58.4972268985347 -34.6677707437687,-58.4973025959605 -34.6669662637856,-58.4985704803822 -34.6659491089419,-58.4980935895104 -34.6655550825562)))";;"3367";9_16_11;COMUNA 9;"16";"11";"748";"369";"379";"97,36%";"255";"255";"100,00%";"0";"0,00%";"247";"2";"0.81";"245";"99,19%";"0.81";0.810
"MULTIPOLYGON (((-58.4950664156217 -34.6667619427867,-58.4936086346845 -34.6679622833505,-58.4939590064766 -34.6683078371913,-58.4943530396683 -34.6686964784326,-58.4947407664482 -34.6690788522575,-58.4950934499806 -34.669426655746,-58.4958441726733 -34.6688359450905,-58.4961603426019 -34.6690969925262,-58.4968768894499 -34.6685434689616,-58.4963075266278 -34.6679831895337,-58.4950664156217 -34.6667619427867)))";;"3368";9_16_12;COMUNA 9;"16";"12";"793";"376";"417";"90,17%";"284";"284";"100,00%";"0";"0,00%";"259";"4";"1.54";"255";"98,46%";"1.54";1.540
"MULTIPOLYGON (((-58.4982682831727 -34.6697134415589,-58.4981941243859 -34.6696517139862,-58.4971369685456 -34.668790163003,-58.4970344739093 -34.6686984992954,-58.4968768894499 -34.6685434689616,-58.4961603426019 -34.6690969925262,-58.4958441726733 -34.6688359450905,-58.4950934499806 -34.669426655746,-58.4957380259964 -34.6700623449071,-58.4958731844006 -34.6701956216328,-58.4970399304586 -34.6711803248457,-58.4972332490241 -34.6713190735763,-58.4974079410661 -34.6714444530014,-58.4988802937033 -34.670219978216,-58.4982682831727 -34.6697134415589)))";;"3369";9_16_13;COMUNA 9;"16";"13";"784";"392";"392";"100,00%";"329";"329";"100,00%";"0";"0,00%";"296";"2";"0.68";"294";"99,32%";"0.68";0.680
"MULTIPOLYGON (((-58.5054659434377 -34.6620942430634,-58.5051605989952 -34.6618403285671,-58.5045730875792 -34.6628356300629,-58.5042146468234 -34.6634429526741,-58.503337556164 -34.6649287823151,-58.5032363802714 -34.6650989615359,-58.5030204006728 -34.6654621417488,-58.5025864770178 -34.6661918819808,-58.5031541228096 -34.666665158603,-58.5041387923934 -34.6658458618074,-58.5056269638853 -34.6646074959098,-58.5064251882612 -34.6652657515395,-58.5078529990566 -34.6640811843109,-58.5071485690505 -34.6634938212091,-58.5070568174745 -34.663417514472,-58.5062644864803 -34.6627584859977,-58.5054659434377 -34.6620942430634)))";;"3370";9_16_2;COMUNA 9;"16";"2";"863";"404";"459";"88,02%";"360";"360";"100,00%";"0";"0,00%";"314";"10";"3.18";"304";"96,82%";"3.18";3.180
"MULTIPOLYGON (((-58.5032175307093 -34.662621645467,-58.501868915798 -34.6637418357294,-58.5017323399088 -34.6638555446613,-58.500757468557 -34.6646670725377,-58.5015585574883 -34.6653349368722,-58.5023623879277 -34.6660051189807,-58.5025864770178 -34.6661918819808,-58.5030204006728 -34.6654621417488,-58.5032363802714 -34.6650989615359,-58.503337556164 -34.6649287823151,-58.5042146468234 -34.6634429526741,-58.5045730875792 -34.6628356300629,-58.5051605989952 -34.6618403285671,-58.5046596538826 -34.6614235888566,-58.5032175307093 -34.662621645467)))";;"3371";9_16_3;COMUNA 9;"16";"3";"613";"268";"345";"77,68%";"217";"217";"100,00%";"0";"0,00%";"228";"9";"3.95";"219";"96,05%";"3.95";3.950
"MULTIPOLYGON (((-58.5032175307093 -34.662621645467,-58.5046596538826 -34.6614235888566,-58.5038636091778 -34.6607614471483,-58.5031121702194 -34.6601362582703,-58.5029378106236 -34.6600022980461,-58.5028539236 -34.6599585920644,-58.5027436136185 -34.6599109509313,-58.5026038123782 -34.6598591643057,-58.5025222342797 -34.6598309507374,-58.5023872929972 -34.6597825426532,-58.5023050331787 -34.6597542587365,-58.5021445194193 -34.6596975485911,-58.5020019068434 -34.6596468185509,-58.5018549466927 -34.6595938361542,-58.5016799422228 -34.6595320594811,-58.501558384752 -34.6594876603962,-58.5014884832258 -34.6594583156197,-58.5014267649794 -34.6594316443366,-58.5012462914167 -34.6593372622123,-58.5011001693459 -34.6592512495262,-58.5010534483056 -34.6592173196008,-58.5009580453665 -34.6591479109708,-58.4997888678956 -34.6581698639171,-58.4988156560034 -34.6589641929139,-58.4980059241361 -34.6596251531599,-58.4979234505285 -34.6596920099035,-58.4978252045846 -34.6597710112866,-58.4965980615619 -34.6607676978212,-58.4964897694666 -34.6608557585416,-58.4955161520468 -34.6616456946636,-58.4944268919944 -34.6625295993575,-58.4932047699137 -34.6635213474204,-58.4930414261558 -34.6636539270839,-58.4919648011152 -34.6645027349649,-58.4910000378318 -34.6652634062898,-58.4911350932598 -34.6653897868028,-58.4917617019572 -34.6660074729508,-58.4919353900874 -34.6661864504235,-58.4921883774834 -34.6664470304434,-58.4925661135532 -34.6668361040711,-58.492598089122 -34.6668690548809,-58.4928961081916 -34.6671914550226,-58.4934587267281 -34.6678000633372,-58.4936086346845 -34.6679622833505,-58.4950664156217 -34.6667619427867,-58.4973142709961 -34.6649110631902,-58.4982526300438 -34.6641383069882,-58.4991937833702 -34.6633632890515,-58.4999595472952 -34.6640018076,-58.500757468557 -34.6646670725377,-58.5017323399088 -34.6638555446613,-58.501868915798 -34.6637418357294,-58.5032175307093 -34.662621645467)))";;"3372";9_16_4;COMUNA 9;"16";"4";"729";"373";"356";"104,78%";"279";"276";"98,92%";"3";"1,09%";"247";"13";"5.26";"234";"94,74%";"5.26";5.260
"MULTIPOLYGON (((-58.4982526300438 -34.6641383069882,-58.4973142709961 -34.6649110631902,-58.4980935895104 -34.6655550825562,-58.4985704803822 -34.6659491089419,-58.4988950041293 -34.6662173302474,-58.4996848350618 -34.6668699983827,-58.4997171478946 -34.6668967995022,-58.5004977022424 -34.6675442040687,-58.5014158670968 -34.6667860079763,-58.5023623879277 -34.6660051189807,-58.5015585574883 -34.6653349368722,-58.500757468557 -34.6646670725377,-58.4999595472952 -34.6640018076,-58.4991937833702 -34.6633632890515,-58.4982526300438 -34.6641383069882)))";;"3373";9_16_5;COMUNA 9;"16";"5";"887";"425";"462";"91,99%";"253";"252";"99,60%";"1";"0,40%";"283";"11";"3.89";"272";"96,11%";"3.89";3.890
"MULTIPOLYGON (((-58.5047432617765 -34.6679967698481,-58.5055969785939 -34.667286805293,-58.5057313397927 -34.6671752760356,-58.5049298581235 -34.6665062422603,-58.5041387923934 -34.6658458618074,-58.5031541228096 -34.666665158603,-58.5025864770178 -34.6661918819808,-58.5023623879277 -34.6660051189807,-58.5014158670968 -34.6667860079763,-58.5004977022424 -34.6675442040687,-58.5013018826318 -34.6682061531538,-58.5020980614112 -34.6688639444023,-58.5029018421414 -34.6695280660674,-58.5037998110698 -34.6687813381088,-58.5047432617765 -34.6679967698481)))";;"3374";9_16_6;COMUNA 9;"16";"6";"986";"459";"527";"87,10%";"362";"362";"100,00%";"0";"0,00%";"326";"11";"3.37";"315";"96,63%";"3.37";3.370
"MULTIPOLYGON (((-58.5060629600339 -34.6706554097034,-58.5063602921652 -34.6708994214495,-58.5067878391912 -34.6712502929358,-58.5087877747443 -34.6697386860445,-58.508369435249 -34.6693821408797,-58.5080721536264 -34.669128768979,-58.5080743746599 -34.6691270849708,-58.507305091951 -34.668488900955,-58.5065360747877 -34.6678469794224,-58.5057313397927 -34.6671752760356,-58.5055969785939 -34.667286805293,-58.5047432617765 -34.6679967698481,-58.5037998110698 -34.6687813381088,-58.5029018421414 -34.6695280660674,-58.5036363926599 -34.6701350209948,-58.5043500612759 -34.6707246541627,-58.5052811252011 -34.6700210038734,-58.5060516024774 -34.6706640593604,-58.5060629600339 -34.6706554097034)))";;"3375";9_16_7;COMUNA 9;"16";"7";"968";"478";"490";"97,55%";"370";"370";"100,00%";"0";"0,00%";"336";"7";"2.08";"329";"97,92%";"2.08";2.080
"MULTIPOLYGON (((-58.5060516024774 -34.6706640593604,-58.5052811252011 -34.6700210038734,-58.5043500612759 -34.6707246541627,-58.5036363926599 -34.6701350209948,-58.5029018421414 -34.6695280660674,-58.5028055602242 -34.6696080999271,-58.5016846707256 -34.6705377137407,-58.5006517772492 -34.6713944004937,-58.5004736036075 -34.6715395301044,-58.5006345149432 -34.6716727935334,-58.501271597489 -34.6721965511508,-58.5001181114612 -34.6731668657876,-58.5006814503869 -34.6734686713258,-58.5016418715852 -34.6739837682795,-58.501641882017 -34.6739837730027,-58.5020043052407 -34.6741854046442,-58.5025226262793 -34.6744737653678,-58.5025734648713 -34.6744353459443,-58.5067878391912 -34.6712502929358,-58.5063602921652 -34.6708994214495,-58.5060629600339 -34.6706554097034,-58.5060516024774 -34.6706640593604)))";;"3376";9_16_8;COMUNA 9;"16";"8";"930";"417";"513";"81,29%";"309";"308";"99,68%";"1";"0,32%";"301";"9";"2.99";"292";"97,01%";"2.99";2.990
"MULTIPOLYGON (((-58.4996317907673 -34.6708423751273,-58.4988802937033 -34.670219978216,-58.4974079410661 -34.6714444530014,-58.4979163895694 -34.6718093168641,-58.4982528564924 -34.6720507044679,-58.4987237941673 -34.6723887441643,-58.4989282600074 -34.6725146023877,-58.499127524728 -34.672636025083,-58.4997419291654 -34.6729652852327,-58.5001181114612 -34.6731668657876,-58.501271597489 -34.6721965511508,-58.5006345149432 -34.6716727935334,-58.5004736036075 -34.6715395301044,-58.5006517772492 -34.6713944004937,-58.5016846707256 -34.6705377137407,-58.5028055602242 -34.6696080999271,-58.5029018421414 -34.6695280660674,-58.5020980614112 -34.6688639444023,-58.5013018826318 -34.6682061531538,-58.5004749954244 -34.6695356029435,-58.4996317907673 -34.6708423751273)))";;"3377";9_16_9;COMUNA 9;"16";"9";"1023";"462";"561";"82,35%";"382";"382";"100,00%";"0";"0,00%";"340";"11";"3.24";"329";"96,76%";"3.24";3.240
"MULTIPOLYGON (((-58.5186370509491 -34.6403833359754,-58.5185262487352 -34.6414832100794,-58.5187232561398 -34.6414837535612,-58.5194296320284 -34.6414537077828,-58.5209973757388 -34.6413871213095,-58.5211597768085 -34.6402796847882,-58.5212069274517 -34.6399581731524,-58.521229402665 -34.6398084393248,-58.5212256136605 -34.6396304777653,-58.5212156496501 -34.6391529321982,-58.5212171136801 -34.6389323611114,-58.5209606485772 -34.6389482590445,-58.5205417804968 -34.6389695154273,-58.5197569561352 -34.639009393418,-58.5189671039249 -34.6390495503772,-58.5187702805125 -34.6390606272891,-58.5186370509491 -34.6403833359754)))";;"3378";9_2_1;COMUNA 9;"2";"1";"824";"377";"447";"84,34%";"474";"474";"100,00%";"0";"0,00%";"349";"2";"0.57";"347";"99,43%";"0.57";0.570
"MULTIPOLYGON (((-58.5209973757388 -34.6413871213095,-58.5194296320284 -34.6414537077828,-58.5187232561398 -34.6414837535612,-58.5185262487352 -34.6414832100794,-58.5183418525531 -34.641482730951,-58.5175545127177 -34.6414928062454,-58.5170682194869 -34.6414990101093,-58.5168196620356 -34.6415022193525,-58.5166471304479 -34.6421910497616,-58.5155105431914 -34.6422657749125,-58.5164301445329 -34.6430572993342,-58.5165078113277 -34.6431167739851,-58.5168422912232 -34.6434120576678,-58.5183307077917 -34.6434233599875,-58.5189864223878 -34.6434282705389,-58.5191761938047 -34.6434324787115,-58.519289073528 -34.6425146513434,-58.5206506541541 -34.6426122544421,-58.5208162276245 -34.6426221759634,-58.5209973757388 -34.6413871213095)))";;"3379";9_2_10;COMUNA 9;"2";"10";"754";"356";"398";"89,45%";"389";"389";"100,00%";"0";"0,00%";"305";"6";"1.97";"299";"98,03%";"1.97";1.970
"MULTIPOLYGON (((-58.5193247093921 -34.6455486019354,-58.5198798710589 -34.6460263857171,-58.5200127186968 -34.6461458340544,-58.5202674079384 -34.6463639602005,-58.5203799576122 -34.6455964891524,-58.5205426294837 -34.6444873638883,-58.5206876569103 -34.6434990249951,-58.5208162276245 -34.6426221759634,-58.5206506541541 -34.6426122544421,-58.519289073528 -34.6425146513434,-58.5191761938047 -34.6434324787115,-58.5189864223878 -34.6434282705389,-58.5183307077917 -34.6434233599875,-58.5168422912232 -34.6434120576678,-58.5170822996553 -34.6436186474349,-58.5178513577137 -34.6442805056701,-58.51794957976 -34.6443650412894,-58.5186374807131 -34.6449570699142,-58.5193247093921 -34.6455486019354)))";;"3380";9_2_11;COMUNA 9;"2";"11";"1058";"449";"609";"73,73%";"431";"425";"98,61%";"6";"1,41%";"341";"7";"2.05";"334";"97,95%";"2.05";2.050
"MULTIPOLYGON (((-58.5200127186968 -34.6461458340544,-58.5198798710589 -34.6460263857171,-58.5193247093921 -34.6455486019354,-58.5186374807131 -34.6449570699142,-58.51794957976 -34.6443650412894,-58.5178513577137 -34.6442805056701,-58.5170822996553 -34.6436186474349,-58.5158832669542 -34.6445485007724,-58.5159815733013 -34.6446342351572,-58.5165407138285 -34.6451105535672,-58.5166500196515 -34.6452047335122,-58.5174378471428 -34.6458831356753,-58.5181611420403 -34.646505926531,-58.5182924498181 -34.6466189687877,-58.5188154677301 -34.6470694472041,-58.5194767940952 -34.647638876723,-58.5195955771927 -34.6477499514937,-58.5197333050024 -34.6476503770953,-58.5201210135283 -34.6473615948353,-58.5202674079384 -34.6463639602005,-58.5200127186968 -34.6461458340544)))";;"3381";9_2_12;COMUNA 9;"2";"12";"625";"292";"333";"87,69%";"288";"288";"100,00%";"0";"0,00%";"223";"0";"0";"223";"100,00%";"0";0.000
"MULTIPOLYGON (((-58.5155105431914 -34.6422657749125,-58.5166471304479 -34.6421910497616,-58.5168196620356 -34.6415022193525,-58.5170682194869 -34.6414990101093,-58.5175545127177 -34.6414928062454,-58.5183418525531 -34.641482730951,-58.5185262487352 -34.6414832100794,-58.5186370509491 -34.6403833359754,-58.5187702805125 -34.6390606272891,-58.5174120271858 -34.6391371620806,-58.5172450295634 -34.6398040185889,-58.5170833833192 -34.6404491815856,-58.5168563062097 -34.6404591420987,-58.5159953690005 -34.640491494207,-58.514658056109 -34.6415319631621,-58.5155105431914 -34.6422657749125)))";;"3382";9_2_2;COMUNA 9;"2";"2";"767";"353";"414";"85,27%";"375";"375";"100,00%";"0";"0,00%";"301";"5";"1.66";"296";"98,34%";"1.66";1.660
"MULTIPOLYGON (((-58.5163017066453 -34.6391811072101,-58.5159123125433 -34.6391933907898,-58.5144902988644 -34.639238300123,-58.5142986696681 -34.6392454238255,-58.513978637724 -34.6405086973884,-58.5134303783945 -34.6404752636451,-58.5140255424434 -34.6409875659905,-58.514658056109 -34.6415319631621,-58.5159953690005 -34.640491494207,-58.5168563062097 -34.6404591420987,-58.5170833833192 -34.6404491815856,-58.5172450295634 -34.6398040185889,-58.5174120271858 -34.6391371620806,-58.5170528023688 -34.6391573937629,-58.5163017066453 -34.6391811072101)))";;"3383";9_2_3;COMUNA 9;"2";"3";"819";"388";"431";"90,02%";"434";"434";"100,00%";"0";"0,00%";"330";"6";"1.82";"324";"98,18%";"1.82";1.820
"MULTIPOLYGON (((-58.5129929660478 -34.6392942102237,-58.5114108465585 -34.6393463328974,-58.510052663372 -34.6391167196365,-58.5098222533481 -34.640008316044,-58.5097885497402 -34.6400776974548,-58.5111543390902 -34.6403203391734,-58.5126425013566 -34.6404272070229,-58.5127004460123 -34.640430774943,-58.5134303783945 -34.6404752636451,-58.513978637724 -34.6405086973884,-58.5142986696681 -34.6392454238255,-58.5129929660478 -34.6392942102237)))";;"3384";9_2_4;COMUNA 9;"2";"4";"982";"436";"546";"79,85%";"545";"545";"100,00%";"0";"0,00%";"414";"4";"0.97";"410";"99,03%";"0.97";0.970
"MULTIPOLYGON (((-58.5097885497402 -34.6400776974548,-58.5097251813224 -34.6401259628685,-58.5092106509011 -34.6405178627024,-58.5093314543615 -34.640627467921,-58.5095870427788 -34.6408575180309,-58.5099702575911 -34.6412025218143,-58.510730984512 -34.6418871756716,-58.5114902745964 -34.6425705576309,-58.5117518413949 -34.642803347298,-58.512897218541 -34.6418840496875,-58.5130153490107 -34.6417892093037,-58.5140255424434 -34.6409875659905,-58.5134303783945 -34.6404752636451,-58.5127004460123 -34.640430774943,-58.5126425013566 -34.6404272070229,-58.5111543390902 -34.6403203391734,-58.5097885497402 -34.6400776974548)))";;"3385";9_2_5;COMUNA 9;"2";"5";"1143";"526";"617";"85,25%";"527";"527";"100,00%";"0";"0,00%";"428";"3";"0.7";"425";"99,30%";"0.7";0.700
"MULTIPOLYGON (((-58.5117518413949 -34.642803347298,-58.5114902745964 -34.6425705576309,-58.510730984512 -34.6418871756716,-58.5099702575911 -34.6412025218143,-58.5095870427788 -34.6408575180309,-58.5093314543615 -34.640627467921,-58.5092106509011 -34.6405178627024,-58.5080317523436 -34.6414156588212,-58.5084091662039 -34.6417556694792,-58.5087925509347 -34.6421010993974,-58.5095533620473 -34.6427865351403,-58.5103179369719 -34.6434753449717,-58.5111231926568 -34.6442008250571,-58.5123323600561 -34.643323762441,-58.5117518413949 -34.642803347298)))";;"3386";9_2_6;COMUNA 9;"2";"6";"716";"327";"389";"84,06%";"301";"301";"100,00%";"0";"0,00%";"255";"0";"0";"255";"100,00%";"0";0.000
"MULTIPOLYGON (((-58.5120218217113 -34.645010419529,-58.5129597737195 -34.6458553442612,-58.5140044422656 -34.6450516451051,-58.5141337323662 -34.6449460240104,-58.513196889773 -34.6441065304259,-58.5143682699444 -34.6432054484295,-58.5134989681181 -34.6424249442129,-58.5123323600561 -34.643323762441,-58.5111231926568 -34.6442008250571,-58.5120218217113 -34.645010419529)))";;"3387";9_2_7;COMUNA 9;"2";"7";"800";"382";"418";"91,39%";"379";"379";"100,00%";"0";"0,00%";"300";"2";"0.67";"298";"99,33%";"0.67";0.670
"MULTIPOLYGON (((-58.5168422912232 -34.6434120576678,-58.5165078113277 -34.6431167739851,-58.5153067341265 -34.6440463409335,-58.5151703180306 -34.6439275227814,-58.5145018724011 -34.6433253954847,-58.5143682699444 -34.6432054484295,-58.513196889773 -34.6441065304259,-58.5141337323662 -34.6449460240104,-58.5140044422656 -34.6450516451051,-58.5129597737195 -34.6458553442612,-58.5130803336587 -34.6459640302441,-58.51353469333 -34.6463697696158,-58.5147076302279 -34.6454602330684,-58.5158832669542 -34.6445485007724,-58.5170822996553 -34.6436186474349,-58.5168422912232 -34.6434120576678)))";;"3388";9_2_8;COMUNA 9;"2";"8";"686";"329";"357";"92,16%";"303";"303";"100,00%";"0";"0,00%";"245";"1";"0.41";"244";"99,59%";"0.41";0.410
"MULTIPOLYGON (((-58.5134989681181 -34.6424249442129,-58.5143682699444 -34.6432054484295,-58.5145018724011 -34.6433253954847,-58.5151703180306 -34.6439275227814,-58.5153067341265 -34.6440463409335,-58.5165078113277 -34.6431167739851,-58.5164301445329 -34.6430572993342,-58.5155105431914 -34.6422657749125,-58.514658056109 -34.6415319631621,-58.5140255424434 -34.6409875659905,-58.5130153490107 -34.6417892093037,-58.512897218541 -34.6418840496875,-58.5117518413949 -34.642803347298,-58.5123323600561 -34.643323762441,-58.5134989681181 -34.6424249442129)))";;"3389";9_2_9;COMUNA 9;"2";"9";"861";"388";"473";"82,03%";"442";"442";"100,00%";"0";"0,00%";"358";"3";"0.84";"355";"99,16%";"0.84";0.840
"MULTIPOLYGON (((-58.5292946445452 -34.6392254809074,-58.5292381480082 -34.6392212158329,-58.5292299561957 -34.6393131246204,-58.5289614429234 -34.6392860868423,-58.528896091799 -34.6392907703651,-58.5287977183702 -34.639344064842,-58.5277135403717 -34.6392534475397,-58.5276044866394 -34.6403638223854,-58.5275151870396 -34.6416779956312,-58.5274309405797 -34.642919064985,-58.5288804468649 -34.6429796269289,-58.5288797329034 -34.6429907009735,-58.5295440667888 -34.6430101832714,-58.5298802994212 -34.6430200422682,-58.5301027599324 -34.6392838528718,-58.530073584795 -34.6392819270887,-58.5300728980543 -34.6392818850062,-58.530072898 -34.6392818850029,-58.5300728959645 -34.6392818848782,-58.5298434183176 -34.6392652517115,-58.5292946445452 -34.6392254809074)))";;"3390";9_3_1;COMUNA 9;"3";"1";"646";"318";"328";"96,95%";"380";"380";"100,00%";"0";"0,00%";"263";"27";"10.27";"236";"89,73%";"10.27";10.270
"MULTIPOLYGON (((-58.5245424953057 -34.6427908415753,-58.5242450957323 -34.6427776817503,-58.5239470997164 -34.6427644510747,-58.523649189006 -34.6427512196282,-58.5233109718246 -34.64273617645,-58.5232117441403 -34.6436181545296,-58.5231004069934 -34.6446079586264,-58.5229759431641 -34.6457141809708,-58.5228862763984 -34.6465111510386,-58.5227767861191 -34.6474729244428,-58.5243529166853 -34.647535308707,-58.5244354788586 -34.6465981257571,-58.5245073079352 -34.6457836278633,-58.5246046545562 -34.6446788262422,-58.524691943154 -34.6436880470743,-58.52477010411 -34.6428010079529,-58.5245424953057 -34.6427908415753)))";;"3391";9_3_10;COMUNA 9;"3";"10";"809";"390";"419";"93,08%";"332";"332";"100,00%";"0";"0,00%";"283";"0";"0";"283";"100,00%";"0";0.000
"MULTIPOLYGON (((-58.526622419074 -34.6458794418931,-58.5266978371569 -34.645882923572,-58.526774022128 -34.6458863343766,-58.5268672507815 -34.645890581263,-58.5272311323022 -34.6459070799034,-58.5272573355211 -34.6455217021226,-58.5273058654796 -34.6448077812598,-58.5273637465171 -34.6439563158759,-58.5273728394132 -34.6438144756829,-58.5261251905205 -34.643755622063,-58.5257237378472 -34.6437366746685,-58.5253924181203 -34.6437210703053,-58.5250625471882 -34.6437055347257,-58.524691943154 -34.6436880470743,-58.5246046545562 -34.6446788262422,-58.5245073079352 -34.6457836278633,-58.5248939416835 -34.6458011078904,-58.5252360918526 -34.6458166376198,-58.5255794352119 -34.6458322361986,-58.525989504357 -34.6458507570363,-58.5263247522909 -34.6458660055941,-58.526622419074 -34.6458794418931)))";;"3392";9_3_11;COMUNA 9;"3";"11";"833";"394";"439";"89,75%";"327";"327";"100,00%";"0";"0,00%";"294";"7";"2.38";"287";"97,62%";"2.38";2.380
"MULTIPOLYGON (((-58.5253194744197 -34.6475729159556,-58.5258767226265 -34.6475926995655,-58.5264352494012 -34.6476125503852,-58.5265825936699 -34.6476180368353,-58.5271098461701 -34.6476379009443,-58.5271684710922 -34.6467515754372,-58.5272047750147 -34.6462038634816,-58.5268672507815 -34.645890581263,-58.526774022128 -34.6458863343766,-58.5266978371569 -34.645882923572,-58.526622419074 -34.6458794418931,-58.5263247522909 -34.6458660055941,-58.525989504357 -34.6458507570363,-58.5255794352119 -34.6458322361986,-58.5252360918526 -34.6458166376198,-58.5248939416835 -34.6458011078904,-58.5245073079352 -34.6457836278633,-58.5244354788586 -34.6465981257571,-58.5243529166853 -34.647535308707,-58.5251580693738 -34.6475672239076,-58.5253194744197 -34.6475729159556)))";;"3393";9_3_12;COMUNA 9;"3";"12";"585";"288";"297";"96,97%";"224";"224";"100,00%";"0";"0,00%";"213";"0";"0";"213";"100,00%";"0";0.000
"MULTIPOLYGON (((-58.5292656929079 -34.6477086925138,-58.5296005994564 -34.6477170867116,-58.5298802994212 -34.6430200422682,-58.5295440667888 -34.6430101832714,-58.5288797329034 -34.6429907009735,-58.5288804468649 -34.6429796269289,-58.5274309405797 -34.642919064985,-58.5274190609891 -34.6430932316293,-58.5273728394132 -34.6438144756829,-58.5273637465171 -34.6439563158759,-58.5273058654796 -34.6448077812598,-58.5272573355211 -34.6455217021226,-58.5272311323022 -34.6459070799034,-58.5268672507815 -34.645890581263,-58.5272047750147 -34.6462038634816,-58.5271684710922 -34.6467515754372,-58.5271098461701 -34.6476379009443,-58.5278578173318 -34.6476660255749,-58.5285753656418 -34.6476930352608,-58.52857536046 -34.6476913869076,-58.5292656929079 -34.6477086925138)))";;"3394";9_3_13;COMUNA 9;"3";"13";"946";"435";"511";"85,13%";"335";"333";"99,40%";"2";"0,60%";"313";"18";"5.75";"295";"94,25%";"5.75";5.750
"MULTIPOLYGON (((-58.5277135403717 -34.6392534475397,-58.5264234059913 -34.6391493364021,-58.5263519922475 -34.6402525071588,-58.5262633966041 -34.641621610453,-58.5261829668412 -34.6428636629237,-58.5251407886336 -34.6428174389594,-58.5250625471882 -34.6437055347257,-58.5253924181203 -34.6437210703053,-58.5257237378472 -34.6437366746685,-58.5261251905205 -34.643755622063,-58.5273728394132 -34.6438144756829,-58.5274190609891 -34.6430932316293,-58.5274309405797 -34.642919064985,-58.5275151870396 -34.6416779956312,-58.5276044866394 -34.6403638223854,-58.5277135403717 -34.6392534475397)))";;"3395";9_3_2;COMUNA 9;"3";"2";"676";"306";"370";"82,70%";"335";"334";"99,70%";"1";"0,30%";"255";"23";"9.02";"232";"90,98%";"9.02";9.020
"MULTIPOLYGON (((-58.5248795268344 -34.6415593641589,-58.5248598395878 -34.6417829727427,-58.524838039766 -34.6420304563769,-58.5248164933495 -34.6422751228788,-58.5247948622258 -34.6425206345071,-58.52477010411 -34.6428010079529,-58.524691943154 -34.6436880470743,-58.5250625471882 -34.6437055347257,-58.5251407886336 -34.6428174389594,-58.5261829668412 -34.6428636629237,-58.5262633966041 -34.641621610453,-58.5263519922475 -34.6402525071588,-58.5264234059913 -34.6391493364021,-58.5251006437934 -34.6390501580455,-58.5250065231448 -34.6401215076681,-58.524969090821 -34.6405434414924,-58.5249475447989 -34.6407876151033,-58.5249259145461 -34.6410332676634,-58.5249041991142 -34.6412791315274,-58.5248795268344 -34.6415593641589)))";;"3396";9_3_3;COMUNA 9;"3";"3";"601";"276";"325";"84,92%";"313";"313";"100,00%";"0";"0,00%";"239";"7";"2.93";"232";"97,07%";"2.93";2.930
"MULTIPOLYGON (((-58.5233424673713 -34.6424569267403,-58.5233109718246 -34.64273617645,-58.523649189006 -34.6427512196282,-58.5239470997164 -34.6427644510747,-58.5242450957323 -34.6427776817503,-58.5245424953057 -34.6427908415753,-58.52477010411 -34.6428010079529,-58.5247948622258 -34.6425206345071,-58.5248164933495 -34.6422751228788,-58.524838039766 -34.6420304563769,-58.5248598395878 -34.6417829727427,-58.5248795268344 -34.6415593641589,-58.5249041991142 -34.6412791315274,-58.5249259145461 -34.6410332676634,-58.5249475447989 -34.6407876151033,-58.524969090821 -34.6405434414924,-58.5250065231448 -34.6401215076681,-58.5251006437934 -34.6390501580455,-58.5237298986195 -34.6389319042465,-58.5235976303854 -34.6401794746414,-58.5235818902071 -34.6403282900103,-58.523565043123 -34.6404783031468,-58.5235374440284 -34.6407237471798,-58.5235097596136 -34.640969261664,-58.5234821603499 -34.6412149169391,-58.5234505818081 -34.6414959274012,-58.523425352188 -34.6417197497928,-58.523397667732 -34.6419661093087,-58.523370067299 -34.6422110602719,-58.5233424673713 -34.6424569267403)))";;"3397";9_3_4;COMUNA 9;"3";"4";"641";"306";"335";"91,34%";"323";"323";"100,00%";"0";"0,00%";"242";"7";"2.89";"235";"97,11%";"2.89";2.890
"MULTIPOLYGON (((-58.5237298986195 -34.6389319042465,-58.522670956724 -34.6388464409073,-58.5225635140812 -34.638852831922,-58.5224597317528 -34.639566919552,-58.5223596606058 -34.6402303697953,-58.5235976303854 -34.6401794746414,-58.5237298986195 -34.6389319042465)))";;"3398";9_3_5;COMUNA 9;"3";"5";"546";"223";"323";"69,04%";"404";"404";"100,00%";"0";"0,00%";"271";"2";"0.74";"269";"99,26%";"0.74";0.740
"MULTIPOLYGON (((-58.5225635140812 -34.638852831922,-58.5212171136801 -34.6389323611114,-58.5212156496501 -34.6391529321982,-58.5212256136605 -34.6396304777653,-58.521229402665 -34.6398084393248,-58.5212069274517 -34.6399581731524,-58.5211597768085 -34.6402796847882,-58.5209973757388 -34.6413871213095,-58.5215602090933 -34.6414120630233,-58.5218581146901 -34.6414252995808,-58.5221964966633 -34.6414402762894,-58.5234505818081 -34.6414959274012,-58.5234821603499 -34.6412149169391,-58.5235097596136 -34.640969261664,-58.5235374440284 -34.6407237471798,-58.523565043123 -34.6404783031468,-58.5235818902071 -34.6403282900103,-58.5235976303854 -34.6401794746414,-58.5223596606058 -34.6402303697953,-58.5224597317528 -34.639566919552,-58.5225635140812 -34.638852831922)))";;"3399";9_3_6;COMUNA 9;"3";"6";"749";"334";"415";"80,48%";"412";"412";"100,00%";"0";"0,00%";"298";"0";"0";"298";"100,00%";"0";0.000
"MULTIPOLYGON (((-58.5215602090933 -34.6414120630233,-58.5209973757388 -34.6413871213095,-58.5208162276245 -34.6426221759634,-58.5206876569103 -34.6434990249951,-58.5212741102979 -34.6435267033437,-58.5215722796489 -34.6435407855609,-58.5219110969808 -34.6435568192121,-58.5222487213623 -34.6435727116551,-58.522547317103 -34.6435867912798,-58.5228456573053 -34.6436008702994,-58.5232117441403 -34.6436181545296,-58.5233109718246 -34.64273617645,-58.5233424673713 -34.6424569267403,-58.523370067299 -34.6422110602719,-58.523397667732 -34.6419661093087,-58.523425352188 -34.6417197497928,-58.5234505818081 -34.6414959274012,-58.5221964966633 -34.6414402762894,-58.5218581146901 -34.6414252995808,-58.5215602090933 -34.6414120630233)))";;"3400";9_3_7;COMUNA 9;"3";"7";"819";"361";"458";"78,82%";"390";"390";"100,00%";"0";"0,00%";"316";"6";"1.9";"310";"98,10%";"1.9";1.900
"MULTIPOLYGON (((-58.522547317103 -34.6435867912798,-58.5222487213623 -34.6435727116551,-58.5219110969808 -34.6435568192121,-58.5215722796489 -34.6435407855609,-58.5212741102979 -34.6435267033437,-58.5206876569103 -34.6434990249951,-58.5205426294837 -34.6444873638883,-58.5203799576122 -34.6455964891524,-58.5208040001448 -34.6456156546412,-58.521190802833 -34.6456332167546,-58.5216279693265 -34.6456530773295,-58.5220092331886 -34.6456703578242,-58.5223082621319 -34.6456839448418,-58.5226063537568 -34.6456974611619,-58.5229759431641 -34.6457141809708,-58.5231004069934 -34.6446079586264,-58.5232117441403 -34.6436181545296,-58.5228456573053 -34.6436008702994,-58.522547317103 -34.6435867912798)))";;"3401";9_3_8;COMUNA 9;"3";"8";"778";"346";"432";"80,09%";"314";"314";"100,00%";"0";"0,00%";"279";"3";"1.08";"276";"98,92%";"1.08";1.080
"MULTIPOLYGON (((-58.5202674079384 -34.6463639602005,-58.5201210135283 -34.6473615948353,-58.5213900978128 -34.647415006382,-58.5219631974226 -34.647439096152,-58.522611205207 -34.6474663859846,-58.5227767861191 -34.6474729244428,-58.5228862763984 -34.6465111510386,-58.5229759431641 -34.6457141809708,-58.5226063537568 -34.6456974611619,-58.5223082621319 -34.6456839448418,-58.5220092331886 -34.6456703578242,-58.5216279693265 -34.6456530773295,-58.521190802833 -34.6456332167546,-58.5208040001448 -34.6456156546412,-58.5203799576122 -34.6455964891524,-58.5202674079384 -34.6463639602005)))";;"3402";9_3_9;COMUNA 9;"3";"9";"697";"306";"391";"78,26%";"289";"289";"100,00%";"0";"0,00%";"257";"0";"0";"257";"100,00%";"0";0.000
"MULTIPOLYGON (((-58.5269064166771 -34.6507112695994,-58.5268583153727 -34.6514373024255,-58.5267898269269 -34.65247166483,-58.5270015171508 -34.6526911373244,-58.527528576125 -34.6531872813121,-58.5278065101608 -34.6534347461358,-58.5278188306106 -34.6534186510505,-58.5282050956512 -34.6536697700262,-58.5291921484927 -34.6543114612118,-58.5292086055401 -34.6542990147602,-58.5296005994564 -34.6477170867116,-58.5292656929079 -34.6477086925138,-58.52857536046 -34.6476913869076,-58.5285753656418 -34.6476930352608,-58.5278578173318 -34.6476660255749,-58.5271098461701 -34.6476379009443,-58.5270352990361 -34.6487639602315,-58.526946682544 -34.6501029203729,-58.5269064166771 -34.6507112695994)))";;"3403";9_4_1;COMUNA 9;"4";"1";"926";"410";"516";"79,46%";"398";"398";"100,00%";"0";"0,00%";"361";"1";"0.28";"360";"99,72%";"0.28";0.280
"MULTIPOLYGON (((-58.5229561693491 -34.6508911781947,-58.5222100787889 -34.6501938476981,-58.5217923962954 -34.6498034053167,-58.5214628068172 -34.6494953159002,-58.5202423442715 -34.6504192354497,-58.5190598436828 -34.6513144622936,-58.5198235523014 -34.6520023667938,-58.5199338971776 -34.6521018250421,-58.5205844606717 -34.6526894930853,-58.521771137043 -34.6517898128828,-58.5229561693491 -34.6508911781947)))";;"3404";9_4_10;COMUNA 9;"4";"10";"771";"352";"419";"84,01%";"308";"308";"100,00%";"0";"0,00%";"290";"2";"0.69";"288";"99,31%";"0.69";0.690
"MULTIPOLYGON (((-58.5202027145751 -34.6483175008116,-58.5195955771927 -34.6477499514937,-58.518304394638 -34.6486830400909,-58.5177027004702 -34.6491160020739,-58.5171008323675 -34.649553186617,-58.5176603692181 -34.6500537253907,-58.5177735228483 -34.6501557196497,-58.5182689461067 -34.6506019871202,-58.5190598436828 -34.6513144622936,-58.5202423442715 -34.6504192354497,-58.5214628068172 -34.6494953159002,-58.5206868101979 -34.6487699613036,-58.5202027145751 -34.6483175008116)))";;"3405";9_4_11;COMUNA 9;"4";"11";"933";"452";"481";"93,97%";"403";"403";"100,00%";"0";"0,00%";"341";"20";"5.87";"321";"94,13%";"5.87";5.870
"MULTIPOLYGON (((-58.5256306754736 -34.6513926591307,-58.5258449093715 -34.6516026954629,-58.5260395230144 -34.6517858393984,-58.5267898269269 -34.65247166483,-58.5268583153727 -34.6514373024255,-58.5269064166771 -34.6507112695994,-58.526946682544 -34.6501029203729,-58.5270352990361 -34.6487639602315,-58.5271098461701 -34.6476379009443,-58.5265825936699 -34.6476180368353,-58.5264352494012 -34.6476125503852,-58.5258767226265 -34.6475926995655,-58.5258039472088 -34.6487171374328,-58.5252483947968 -34.6486959441353,-58.5251634997182 -34.6500354645005,-58.5251081661353 -34.6509102372555,-58.5256306754736 -34.6513926591307)))";;"3406";9_4_2;COMUNA 9;"4";"2";"923";"431";"492";"87,60%";"372";"372";"100,00%";"0";"0,00%";"325";"6";"1.85";"319";"98,15%";"1.85";1.850
"MULTIPOLYGON (((-58.5258767226265 -34.6475926995655,-58.5253194744197 -34.6475729159556,-58.5251580693738 -34.6475672239076,-58.5243529166853 -34.647535308707,-58.5227767861191 -34.6474729244428,-58.522611205207 -34.6474663859846,-58.5219631974226 -34.647439096152,-58.5213900978128 -34.647415006382,-58.5218741114106 -34.6478702792533,-58.5219736261476 -34.6479634027596,-58.5226488324568 -34.6485966833975,-58.5228745573566 -34.6488084800195,-58.5229833698989 -34.6489109645772,-58.5233921870042 -34.6492962663489,-58.5239190327489 -34.6497927080436,-58.524135980711 -34.6499966191315,-58.5248814915416 -34.6506972481128,-58.5251081661353 -34.6509102372555,-58.5251634997182 -34.6500354645005,-58.5252483947968 -34.6486959441353,-58.5258039472088 -34.6487171374328,-58.5258767226265 -34.6475926995655)))";;"3407";9_4_3;COMUNA 9;"4";"3";"910";"411";"499";"82,36%";"406";"405";"99,75%";"1";"0,25%";"342";"5";"1.46";"337";"98,54%";"1.46";1.460
"MULTIPOLYGON (((-58.5213900978128 -34.647415006382,-58.5201210135283 -34.6473615948353,-58.5197333050024 -34.6476503770953,-58.5195955771927 -34.6477499514937,-58.5202027145751 -34.6483175008116,-58.5206868101979 -34.6487699613036,-58.5214628068172 -34.6494953159002,-58.5217923962954 -34.6498034053167,-58.5222100787889 -34.6501938476981,-58.5229561693491 -34.6508911781947,-58.5236094466452 -34.6503959092881,-58.524135980711 -34.6499966191315,-58.5239190327489 -34.6497927080436,-58.5233921870042 -34.6492962663489,-58.5229833698989 -34.6489109645772,-58.5228745573566 -34.6488084800195,-58.5226488324568 -34.6485966833975,-58.5219736261476 -34.6479634027596,-58.5218741114106 -34.6478702792533,-58.5213900978128 -34.647415006382)))";;"3408";9_4_4;COMUNA 9;"4";"4";"931";"429";"502";"85,46%";"378";"378";"100,00%";"0";"0,00%";"329";"3";"0.91";"326";"99,09%";"0.91";0.910
"MULTIPOLYGON (((-58.5278188306106 -34.6534186510505,-58.5278065101608 -34.6534347461358,-58.527528576125 -34.6531872813121,-58.5270015171508 -34.6526911373244,-58.5267898269269 -34.65247166483,-58.5260395230144 -34.6517858393984,-58.5258449093715 -34.6516026954629,-58.5256306754736 -34.6513926591307,-58.5251081661353 -34.6509102372555,-58.5248814915416 -34.6506972481128,-58.524135980711 -34.6499966191315,-58.5236094466452 -34.6503959092881,-58.5229561693491 -34.6508911781947,-58.5231431843299 -34.6510660204266,-58.5235860258148 -34.651464896489,-58.523714794212 -34.6515807510599,-58.5244770935598 -34.652266796028,-58.5249005891038 -34.6526478596034,-58.5250209185259 -34.6527561816415,-58.5255472695135 -34.6532326860913,-58.5256620569364 -34.653335446798,-58.5258000410554 -34.6534590410755,-58.5264231111214 -34.6540228885197,-58.5269522873262 -34.654495230269,-58.5269608179499 -34.6544846399982,-58.5273963622235 -34.6548367539398,-58.5279286197861 -34.6552670491454,-58.5291921484927 -34.6543114612118,-58.5282050956512 -34.6536697700262,-58.5278188306106 -34.6534186510505)))";;"3409";9_4_5;COMUNA 9;"4";"5";"992";"469";"523";"89,67%";"370";"370";"100,00%";"0";"0,00%";"355";"3";"0.85";"352";"99,15%";"0.85";0.850
"MULTIPOLYGON (((-58.5232891415828 -34.6551303633983,-58.5231524311811 -34.6552338145426,-58.5228898275759 -34.6554333164466,-58.5234032259728 -34.6556718012627,-58.5238824403368 -34.6558945259587,-58.5245896293458 -34.6562231926662,-58.5249224663373 -34.6563780277517,-58.5249239210795 -34.6563769249447,-58.5253532593202 -34.6565800527646,-58.5258694699393 -34.6568242781801,-58.5279286197861 -34.6552670491454,-58.5273963622235 -34.6548367539398,-58.5269608179499 -34.6544846399982,-58.5269522873262 -34.654495230269,-58.5264231111214 -34.6540228885197,-58.5258000410554 -34.6534590410755,-58.5256620569364 -34.653335446798,-58.525069838509 -34.6537834403463,-58.5244765064275 -34.6542322766484,-58.5238824012937 -34.6546816033939,-58.5232891415828 -34.6551303633983)))";;"3410";9_4_6;COMUNA 9;"4";"6";"626";"292";"334";"87,43%";"275";"275";"100,00%";"0";"0,00%";"251";"2";"0.8";"249";"99,20%";"0.8";0.800
"MULTIPOLYGON (((-58.5221053767782 -34.6540625343919,-58.5219733514966 -34.6541625311445,-58.5212865632218 -34.6546881601053,-58.5218556223228 -34.6549524705388,-58.5223433537016 -34.6551791409589,-58.5228898275759 -34.6554333164466,-58.5231524311811 -34.6552338145426,-58.5232891415828 -34.6551303633983,-58.5238824012937 -34.6546816033939,-58.5244765064275 -34.6542322766484,-58.525069838509 -34.6537834403463,-58.5256620569364 -34.653335446798,-58.5255472695135 -34.6532326860913,-58.5250209185259 -34.6527561816415,-58.5249005891038 -34.6526478596034,-58.5244770935598 -34.652266796028,-58.5232925682412 -34.6531637548532,-58.523157053624 -34.6532664307695,-58.5221053767782 -34.6540625343919)))";;"3411";9_4_7;COMUNA 9;"4";"7";"680";"308";"372";"82,80%";"321";"321";"100,00%";"0";"0,00%";"271";"1";"0.37";"270";"99,63%";"0.37";0.370
"MULTIPOLYGON (((-58.521771137043 -34.6517898128828,-58.5205844606717 -34.6526894930853,-58.5213442731099 -34.6533757699763,-58.5214416596444 -34.6534637538568,-58.5221053767782 -34.6540625343919,-58.523157053624 -34.6532664307695,-58.5232925682412 -34.6531637548532,-58.5244770935598 -34.652266796028,-58.523714794212 -34.6515807510599,-58.5235860258148 -34.651464896489,-58.5231431843299 -34.6510660204266,-58.5229561693491 -34.6508911781947,-58.521771137043 -34.6517898128828)))";;"3412";9_4_8;COMUNA 9;"4";"8";"735";"319";"416";"76,68%";"298";"297";"99,66%";"1";"0,34%";"270";"1";"0.37";"269";"99,63%";"0.37";0.370
"MULTIPOLYGON (((-58.5221053767782 -34.6540625343919,-58.5214416596444 -34.6534637538568,-58.5213442731099 -34.6533757699763,-58.5205844606717 -34.6526894930853,-58.5199338971776 -34.6521018250421,-58.5198235523014 -34.6520023667938,-58.5190598436828 -34.6513144622936,-58.5178750178028 -34.6522113687947,-58.5171458815146 -34.6527633325676,-58.5181805438476 -34.6532443592637,-58.5191942009744 -34.6537154617716,-58.5191950990109 -34.6537158791327,-58.5197181949004 -34.653959023073,-58.5199089858243 -34.6540476687032,-58.5202453859403 -34.6542041347142,-58.5207629465405 -34.6544446006275,-58.5212865632218 -34.6546881601053,-58.5219733514966 -34.6541625311445,-58.5221053767782 -34.6540625343919)))";;"3413";9_4_9;COMUNA 9;"4";"9";"707";"342";"365";"93,70%";"285";"285";"100,00%";"0";"0,00%";"256";"5";"1.95";"251";"98,05%";"1.95";1.950
"MULTIPOLYGON (((-58.5147076302279 -34.6454602330684,-58.51353469333 -34.6463697696158,-58.5142627523746 -34.6470199767712,-58.5147545635144 -34.6466553200867,-58.5148690396394 -34.6465689305017,-58.5155315486968 -34.6471708467496,-58.5156363394307 -34.6472647478279,-58.5162280548249 -34.646822645082,-58.5169321803634 -34.6474535503819,-58.5170470811764 -34.6473668064519,-58.5181611420403 -34.646505926531,-58.5174378471428 -34.6458831356753,-58.5166500196515 -34.6452047335122,-58.5165407138285 -34.6451105535672,-58.5159815733013 -34.6446342351572,-58.5158832669542 -34.6445485007724,-58.5147076302279 -34.6454602330684)))";;"3414";9_5_1;COMUNA 9;"5";"1";"879";"414";"465";"89,03%";"331";"331";"100,00%";"0";"0,00%";"310";"4";"1.29";"306";"98,71%";"1.29";1.290
"MULTIPOLYGON (((-58.505659821047 -34.6432153061192,-58.5044707065339 -34.6441148316638,-58.5052341428422 -34.6448016313032,-58.5059998083133 -34.6454903267565,-58.5061492999438 -34.645374777072,-58.5071851746658 -34.6445873370602,-58.5083678758778 -34.6436882805012,-58.507608941391 -34.6430036818691,-58.5068474618778 -34.6423168961865,-58.505659821047 -34.6432153061192)))";;"3415";9_5_10;COMUNA 9;"5";"10";"847";"408";"439";"92,94%";"369";"369";"100,00%";"0";"0,00%";"319";"4";"1.25";"315";"98,75%";"1.25";1.250
"MULTIPOLYGON (((-58.5052341428422 -34.6448016313032,-58.5044707065339 -34.6441148316638,-58.5043493234065 -34.644206636588,-58.5038435999225 -34.6445887919171,-58.5033273091161 -34.6449789066397,-58.5028357309068 -34.6453797860025,-58.5022995130934 -34.6458181438034,-58.5033388703242 -34.6463188735913,-58.5043581177728 -34.6467970654461,-58.5053834287035 -34.6472779931804,-58.5057042222928 -34.647022168448,-58.5060928177097 -34.6467122325938,-58.5062053424625 -34.646624936312,-58.5067723069253 -34.6461851417988,-58.5059998083133 -34.6454903267565,-58.5052341428422 -34.6448016313032)))";;"3416";9_5_11;COMUNA 9;"5";"11";"900";"435";"465";"93,55%";"380";"380";"100,00%";"0";"0,00%";"317";"5";"1.58";"312";"98,42%";"1.58";1.580
"MULTIPOLYGON (((-58.5169824395006 -34.6484707419571,-58.5163901228417 -34.6489174261152,-58.5171008323675 -34.649553186617,-58.5177027004702 -34.6491160020739,-58.518304394638 -34.6486830400909,-58.5195955771927 -34.6477499514937,-58.5194767940952 -34.647638876723,-58.5188154677301 -34.6470694472041,-58.5182924498181 -34.6466189687877,-58.5181611420403 -34.646505926531,-58.5170470811764 -34.6473668064519,-58.5169321803634 -34.6474535503819,-58.5162280548249 -34.646822645082,-58.5156363394307 -34.6472647478279,-58.5163432779886 -34.647898120125,-58.5169824395006 -34.6484707419571)))";;"3417";9_5_2;COMUNA 9;"5";"2";"832";"386";"446";"86,55%";"385";"382";"99,22%";"3";"0,79%";"322";"2";"0.62";"320";"99,38%";"0.62";0.620
"MULTIPOLYGON (((-58.5171008323675 -34.649553186617,-58.5163901228417 -34.6489174261152,-58.5169824395006 -34.6484707419571,-58.5163432779886 -34.647898120125,-58.5156363394307 -34.6472647478279,-58.5155315486968 -34.6471708467496,-58.5148690396394 -34.6465689305017,-58.5147545635144 -34.6466553200867,-58.5142627523746 -34.6470199767712,-58.51353469333 -34.6463697696158,-58.5130803336587 -34.6459640302441,-58.5129597737195 -34.6458553442612,-58.5120218217113 -34.645010419529,-58.5108466430104 -34.6459144380799,-58.5117890225832 -34.6467560599838,-58.5130724731713 -34.6479024024852,-58.5138515302964 -34.6485981556087,-58.5139936667684 -34.6487250715724,-58.5145714261645 -34.6492416737548,-58.5152069186085 -34.6498098695754,-58.5158949450875 -34.6504250123579,-58.5171008323675 -34.649553186617)))";;"3418";9_5_3;COMUNA 9;"5";"3";"1061";"468";"593";"78,92%";"316";"312";"98,73%";"4";"1,28%";"261";"0";"0";"261";"100,00%";"0";0.000
"MULTIPOLYGON (((-58.5190598436828 -34.6513144622936,-58.5182689461067 -34.6506019871202,-58.5177735228483 -34.6501557196497,-58.5176603692181 -34.6500537253907,-58.5171008323675 -34.649553186617,-58.5158949450875 -34.6504250123579,-58.5146894584819 -34.6512965441917,-58.5144159376129 -34.6514942720175,-58.5154162885279 -34.6519423076823,-58.5160778143411 -34.6522668886837,-58.5165561370041 -34.6524891497353,-58.5171458815146 -34.6527633325676,-58.5178750178028 -34.6522113687947,-58.5190598436828 -34.6513144622936)))";;"3419";9_5_4;COMUNA 9;"5";"4";"848";"377";"471";"80,04%";"377";"377";"100,00%";"0";"0,00%";"303";"2";"0.66";"301";"99,34%";"0.66";0.660
"MULTIPOLYGON (((-58.5118722025891 -34.6487922150837,-58.5106754840536 -34.64967940864,-58.5106126191937 -34.6497259840519,-58.5106526961248 -34.649767589268,-58.5116780639877 -34.6502213503014,-58.5126460877314 -34.6506714640939,-58.5135175396456 -34.6510766091055,-58.5144159376129 -34.6514942720175,-58.5146894584819 -34.6512965441917,-58.5158949450875 -34.6504250123579,-58.5152069186085 -34.6498098695754,-58.5145714261645 -34.6492416737548,-58.5139936667684 -34.6487250715724,-58.5138515302964 -34.6485981556087,-58.5130724731713 -34.6479024024852,-58.5118722025891 -34.6487922150837)))";;"3420";9_5_5;COMUNA 9;"5";"5";"1006";"445";"561";"79,32%";"464";"464";"100,00%";"0";"0,00%";"384";"3";"0.78";"381";"99,22%";"0.78";0.780
"MULTIPOLYGON (((-58.5106071727793 -34.6476652196665,-58.5094280229973 -34.6485723244208,-58.5089411253723 -34.6489468875381,-58.5091265236553 -34.6490338619755,-58.5100990380226 -34.6494868113637,-58.5106126191937 -34.6497259840519,-58.5106754840536 -34.64967940864,-58.5118722025891 -34.6487922150837,-58.5130724731713 -34.6479024024852,-58.5117890225832 -34.6467560599838,-58.5108466430104 -34.6459144380799,-58.5096682871515 -34.6468208408461,-58.5106071727793 -34.6476652196665)))";;"3421";9_5_6;COMUNA 9;"5";"6";"841";"391";"450";"86,89%";"362";"362";"100,00%";"0";"0,00%";"315";"1";"0.32";"314";"99,68%";"0.32";0.320
"MULTIPOLYGON (((-58.5076758244088 -34.6483533287202,-58.5089411253723 -34.6489468875381,-58.5094280229973 -34.6485723244208,-58.5106071727793 -34.6476652196665,-58.5096682871515 -34.6468208408461,-58.5087694063765 -34.6460123561606,-58.5077391556385 -34.6468043145493,-58.5075925626736 -34.6469229637749,-58.5070311227789 -34.6473367733331,-58.5062053424625 -34.646624936312,-58.5060928177097 -34.6467122325938,-58.5057042222928 -34.647022168448,-58.5053834287035 -34.6472779931804,-58.5065045591214 -34.6478038792376,-58.5066997547519 -34.6478955018917,-58.5076758244088 -34.6483533287202)))";;"3422";9_5_7;COMUNA 9;"5";"7";"798";"393";"405";"97,04%";"382";"382";"100,00%";"0";"0,00%";"314";"3";"0.96";"311";"99,04%";"0.96";0.960
"MULTIPOLYGON (((-58.5099441829156 -34.6451082873626,-58.5097613058181 -34.644944972753,-58.5091317676242 -34.6443771683484,-58.5083678758778 -34.6436882805012,-58.5071851746658 -34.6445873370602,-58.5061492999438 -34.645374777072,-58.5059998083133 -34.6454903267565,-58.5067723069253 -34.6461851417988,-58.5062053424625 -34.646624936312,-58.5070311227789 -34.6473367733331,-58.5075925626736 -34.6469229637749,-58.5077391556385 -34.6468043145493,-58.5087694063765 -34.6460123561606,-58.5096682871515 -34.6468208408461,-58.5108466430104 -34.6459144380799,-58.5099441829156 -34.6451082873626)))";;"3423";9_5_8;COMUNA 9;"5";"8";"834";"398";"436";"91,28%";"324";"324";"100,00%";"0";"0,00%";"292";"1";"0.34";"291";"99,66%";"0.34";0.340
"MULTIPOLYGON (((-58.5084091662039 -34.6417556694792,-58.5080317523436 -34.6414156588212,-58.5069656027368 -34.6422274843675,-58.5068474618778 -34.6423168961865,-58.507608941391 -34.6430036818691,-58.5083678758778 -34.6436882805012,-58.5091317676242 -34.6443771683484,-58.5097613058181 -34.644944972753,-58.5099441829156 -34.6451082873626,-58.5108466430104 -34.6459144380799,-58.5120218217113 -34.645010419529,-58.5111231926568 -34.6442008250571,-58.5103179369719 -34.6434753449717,-58.5095533620473 -34.6427865351403,-58.5087925509347 -34.6421010993974,-58.5084091662039 -34.6417556694792)))";;"3424";9_5_9;COMUNA 9;"5";"9";"792";"361";"431";"83,76%";"408";"408";"100,00%";"0";"0,00%";"330";"55";"16.67";"275";"83,33%";"16.67";16.670
"MULTIPOLYGON (((-58.5066997547519 -34.6478955018917,-58.5065045591214 -34.6478038792376,-58.5054528418262 -34.6486972373244,-58.5063357822596 -34.6495033573686,-58.5072855847042 -34.6503705046463,-58.5082304616707 -34.6512331390571,-58.5083392601901 -34.651337115571,-58.5094622785304 -34.6505415959091,-58.5106126191937 -34.6497259840519,-58.5100990380226 -34.6494868113637,-58.5091265236553 -34.6490338619755,-58.5089411253723 -34.6489468875381,-58.5076758244088 -34.6483533287202,-58.5066997547519 -34.6478955018917)))";;"3425";9_6_1;COMUNA 9;"6";"1";"1111";"506";"605";"83,64%";"483";"482";"99,79%";"1";"0,21%";"408";"17";"4.17";"391";"95,83%";"4.17";4.170
"MULTIPOLYGON (((-58.493859704194 -34.6459920764972,-58.4927656799707 -34.6468519549673,-58.4926298836893 -34.6469584705036,-58.4933235891147 -34.6475443725099,-58.4934478738809 -34.6476488514639,-58.4942363819988 -34.6483119801346,-58.495357678233 -34.64744870099,-58.4954874236578 -34.6473478180273,-58.4967878420116 -34.6463361629046,-58.496036815245 -34.6456439548739,-58.4952335458668 -34.6449036560052,-58.4948978221746 -34.6451761478899,-58.493859704194 -34.6459920764972)))";;"3426";9_6_10;COMUNA 9;"6";"10";"899";"404";"495";"81,62%";"380";"380";"100,00%";"0";"0,00%";"345";"42";"12.17";"303";"87,83%";"12.17";12.170
"MULTIPOLYGON (((-58.4975472356452 -34.6470359697032,-58.4967878420116 -34.6463361629046,-58.4954874236578 -34.6473478180273,-58.495357678233 -34.64744870099,-58.4942363819988 -34.6483119801346,-58.4946534013315 -34.648662727289,-58.4950287365689 -34.6489727081727,-58.495823658601 -34.6496292048101,-58.4970729133744 -34.6486681962405,-58.4982967530105 -34.6477267602128,-58.4975472356452 -34.6470359697032)))";;"3427";9_6_11;COMUNA 9;"6";"11";"823";"383";"440";"87,05%";"302";"302";"100,00%";"0";"0,00%";"309";"53";"17.15";"256";"82,85%";"17.15";17.150
"MULTIPOLYGON (((-58.4997959102953 -34.6491083975519,-58.4994229279481 -34.6487646972299,-58.4990442367547 -34.6484156451733,-58.4982967530105 -34.6477267602128,-58.4970729133744 -34.6486681962405,-58.495823658601 -34.6496292048101,-58.4966077666273 -34.6502767552679,-58.4974059530428 -34.6509359166711,-58.4975453281165 -34.650827422973,-58.4981425277517 -34.6503712512729,-58.4986534222007 -34.6499810899932,-58.4997959102953 -34.6491083975519)))";;"3428";9_6_12;COMUNA 9;"6";"12";"830";"404";"426";"94,84%";"324";"324";"100,00%";"0";"0,00%";"286";"10";"3.5";"276";"96,50%";"3.5";3.500
"MULTIPOLYGON (((-58.5071813373547 -34.6520812979805,-58.5073164558091 -34.6520013166652,-58.5083392601901 -34.651337115571,-58.5082304616707 -34.6512331390571,-58.5072855847042 -34.6503705046463,-58.5063357822596 -34.6495033573686,-58.5054528418262 -34.6486972373244,-58.5049537529202 -34.6490985501657,-58.5048678876788 -34.649167596056,-58.5044641999717 -34.6494923926606,-58.5053515056476 -34.6503378856094,-58.5062720819113 -34.6512149807556,-58.506140302654 -34.6513243268074,-58.5052100855226 -34.6520946775613,-58.5059552918364 -34.6528073943694,-58.5060195295431 -34.652769201422,-58.5061710076553 -34.6526792152751,-58.5071813373547 -34.6520812979805)))";;"3429";9_6_2;COMUNA 9;"6";"2";"834";"366";"468";"78,21%";"312";"311";"99,68%";"1";"0,32%";"259";"1";"0.39";"258";"99,61%";"0.39";0.390
"MULTIPOLYGON (((-58.5059552918364 -34.6528073943694,-58.5052100855226 -34.6520946775613,-58.506140302654 -34.6513243268074,-58.5062720819113 -34.6512149807556,-58.5053515056476 -34.6503378856094,-58.5044641999717 -34.6494923926606,-58.5039283016709 -34.6499237147596,-58.5034794579967 -34.6502847920194,-58.5033623279783 -34.650381101627,-58.5022041313077 -34.6513324262782,-58.5031204239936 -34.6522087717995,-58.5040262485651 -34.6530749727059,-58.5046343484927 -34.6536565428182,-58.504789460666 -34.6535000058929,-58.5059552918364 -34.6528073943694)))";;"3430";9_6_3;COMUNA 9;"6";"3";"929";"419";"510";"82,16%";"444";"442";"99,55%";"2";"0,45%";"373";"19";"5.09";"354";"94,91%";"5.09";5.090
"MULTIPOLYGON (((-58.5013031313903 -34.6504973377414,-58.5020675459416 -34.6512018327481,-58.5022041313077 -34.6513324262782,-58.5033623279783 -34.650381101627,-58.5034794579967 -34.6502847920194,-58.5039283016709 -34.6499237147596,-58.5030642175061 -34.6491261629009,-58.5023089353487 -34.6484289246731,-58.5028773753571 -34.6479766827397,-58.5027676482857 -34.6478677718686,-58.5021436631575 -34.6472755628863,-58.5015629585717 -34.647740411378,-58.5011171822366 -34.6480971831891,-58.5009934056892 -34.6481937039235,-58.4997959102953 -34.6491083975519,-58.5005469995522 -34.6498005819983,-58.5013031313903 -34.6504973377414)))";;"3431";9_6_4;COMUNA 9;"6";"4";"905";"438";"467";"93,79%";"424";"424";"100,00%";"0";"0,00%";"341";"35";"10.26";"306";"89,74%";"10.26";10.260
"MULTIPOLYGON (((-58.5025827863622 -34.6469240713055,-58.5021436631575 -34.6472755628863,-58.5027676482857 -34.6478677718686,-58.5028773753571 -34.6479766827397,-58.5023089353487 -34.6484289246731,-58.5030642175061 -34.6491261629009,-58.5039283016709 -34.6499237147596,-58.5044641999717 -34.6494923926606,-58.5048678876788 -34.649167596056,-58.5049537529202 -34.6490985501657,-58.5054528418262 -34.6486972373244,-58.5065045591214 -34.6478038792376,-58.5053834287035 -34.6472779931804,-58.5043581177728 -34.6467970654461,-58.5033388703242 -34.6463188735913,-58.5030772746925 -34.6465282626746,-58.5025827863622 -34.6469240713055)))";;"3432";9_6_5;COMUNA 9;"6";"5";"1109";"523";"586";"89,25%";"444";"444";"100,00%";"0";"0,00%";"412";"7";"1.7";"405";"98,30%";"1.7";1.700
"MULTIPOLYGON (((-58.4999034780139 -34.6451514833836,-58.4992946680762 -34.6456465420039,-58.5000544180227 -34.6463478825006,-58.5008046324749 -34.6470403476483,-58.5015629585717 -34.647740411378,-58.5021436631575 -34.6472755628863,-58.5025827863622 -34.6469240713055,-58.5030772746925 -34.6465282626746,-58.5033388703242 -34.6463188735913,-58.5022995130934 -34.6458181438034,-58.5012751815462 -34.6453507112456,-58.5002489804617 -34.6448692561018,-58.5000262272528 -34.6450516540615,-58.4999034780139 -34.6451514833836)))";;"3433";9_6_6;COMUNA 9;"6";"6";"709";"325";"384";"84,64%";"288";"288";"100,00%";"0";"0,00%";"259";"2";"0.77";"257";"99,23%";"0.77";0.770
"MULTIPOLYGON (((-58.4990442367547 -34.6484156451733,-58.4994229279481 -34.6487646972299,-58.4997959102953 -34.6491083975519,-58.5009934056892 -34.6481937039235,-58.5011171822366 -34.6480971831891,-58.5015629585717 -34.647740411378,-58.5008046324749 -34.6470403476483,-58.5000544180227 -34.6463478825006,-58.4992946680762 -34.6456465420039,-58.4987309991707 -34.6461048225257,-58.4975472356452 -34.6470359697032,-58.4982967530105 -34.6477267602128,-58.4990442367547 -34.6484156451733)))";;"3434";9_6_7;COMUNA 9;"6";"7";"999";"456";"543";"83,98%";"450";"450";"100,00%";"0";"0,00%";"374";"41";"10.96";"333";"89,04%";"10.96";10.960
"MULTIPOLYGON (((-58.4972059123875 -34.6446966286127,-58.4962512329843 -34.6454745950799,-58.496036815245 -34.6456439548739,-58.4967878420116 -34.6463361629046,-58.4975472356452 -34.6470359697032,-58.4987309991707 -34.6461048225257,-58.4992946680762 -34.6456465420039,-58.4999034780139 -34.6451514833836,-58.5000262272528 -34.6450516540615,-58.5002489804617 -34.6448692561018,-58.499663267006 -34.6445944265321,-58.4992217684553 -34.6443872996104,-58.4981861305205 -34.6439013226673,-58.4971376351116 -34.643409424841,-58.4966769521605 -34.6437697765428,-58.4964198607047 -34.6439708400635,-58.4972059123875 -34.6446966286127)))";;"3435";9_6_8;COMUNA 9;"6";"8";"785";"382";"403";"94,79%";"351";"350";"99,72%";"1";"0,29%";"281";"17";"6.05";"264";"93,95%";"6.05";6.050
"MULTIPOLYGON (((-58.4972059123875 -34.6446966286127,-58.4964198607047 -34.6439708400635,-58.4953984679731 -34.6447698753652,-58.495302206673 -34.6448479317207,-58.4952335458668 -34.6449036560052,-58.496036815245 -34.6456439548739,-58.4962512329843 -34.6454745950799,-58.4972059123875 -34.6446966286127)))";;"3436";9_6_9;COMUNA 9;"6";"9";"890";"445";"445";"100,00%";"452";"452";"100,00%";"0";"0,00%";"373";"2";"0.54";"371";"99,46%";"0.54";0.540
"MULTIPOLYGON (((-58.5249224663373 -34.6563780277517,-58.5245896293458 -34.6562231926662,-58.5238824403368 -34.6558945259587,-58.5234032259728 -34.6556718012627,-58.5228898275759 -34.6554333164466,-58.5223433537016 -34.6551791409589,-58.5218556223228 -34.6549524705388,-58.5201169044863 -34.6562334796981,-58.520509611572 -34.6565827408647,-58.5199289923039 -34.6569928153178,-58.5202984207373 -34.6573211015244,-58.5201030135123 -34.6574707754409,-58.519514402406 -34.6579214865942,-58.5198836730355 -34.658264563235,-58.5204014573999 -34.6585470034348,-58.5205715508854 -34.6586381930324,-58.5207508521963 -34.6587333922066,-58.5212459030857 -34.6591607733198,-58.5212592234209 -34.659150522923,-58.5215452494966 -34.6593838669153,-58.5219971068143 -34.6597524942531,-58.5258694699393 -34.6568242781801,-58.5253532593202 -34.6565800527646,-58.5249239210795 -34.6563769249447,-58.5249224663373 -34.6563780277517)))";;"3437";9_7_1;COMUNA 9;"7";"1";"765";"352";"413";"85,23%";"312";"312";"100,00%";"0";"0,00%";"269";"2";"0.74";"267";"99,26%";"0.74";0.740
"MULTIPOLYGON (((-58.5128324618364 -34.6537820431941,-58.5121423557425 -34.6531178687864,-58.5115076860785 -34.6525069092318,-58.5103861896252 -34.6532933621075,-58.5094108581203 -34.6539773512983,-58.5092742997608 -34.6540753641572,-58.5093771342507 -34.6541732854566,-58.5099108412295 -34.6546885880433,-58.510602052359 -34.6553560140082,-58.5117156493164 -34.6545706189468,-58.5127151597131 -34.6538657557947,-58.5128324618364 -34.6537820431941)))";;"3438";9_7_10;COMUNA 9;"7";"10";"669";"307";"362";"84,81%";"270";"270";"100,00%";"0";"0,00%";"245";"35";"14.29";"210";"85,71%";"14.29";14.290
"MULTIPOLYGON (((-58.5138639755911 -34.656648318002,-58.5147888201059 -34.655919313766,-58.5149303095289 -34.6558077007063,-58.5143051495172 -34.6552055550005,-58.5135243731142 -34.6544535370243,-58.5134078882455 -34.6543402723443,-58.5129367504281 -34.6538824257578,-58.5128324618364 -34.6537820431941,-58.5127151597131 -34.6538657557947,-58.5117156493164 -34.6545706189468,-58.5123333686971 -34.655168414707,-58.5121984346171 -34.6552723458251,-58.5112706770323 -34.656001542932,-58.5113956882093 -34.6561222007989,-58.5120625352303 -34.6567673738809,-58.5128034979862 -34.6574842754388,-58.5138639755911 -34.656648318002)))";;"3439";9_7_11;COMUNA 9;"7";"11";"767";"362";"405";"89,38%";"324";"324";"100,00%";"0";"0,00%";"278";"9";"3.24";"269";"96,76%";"3.24";3.240
"MULTIPOLYGON (((-58.5123333686971 -34.655168414707,-58.5117156493164 -34.6545706189468,-58.510602052359 -34.6553560140082,-58.5095028317824 -34.6561311817259,-58.5087310735209 -34.6566754349409,-58.508777199403 -34.6567088691908,-58.5092376929461 -34.6570427180396,-58.5094563881534 -34.6572012304989,-58.509617526992 -34.6573082139408,-58.5104972331476 -34.6578925369741,-58.5107131970099 -34.6580359773708,-58.5114049851204 -34.6584656448956,-58.5117003487134 -34.6582583375212,-58.5128034979862 -34.6574842754388,-58.5120625352303 -34.6567673738809,-58.5113956882093 -34.6561222007989,-58.5112706770323 -34.656001542932,-58.5121984346171 -34.6552723458251,-58.5123333686971 -34.655168414707)))";;"3440";9_7_12;COMUNA 9;"7";"12";"1014";"487";"527";"92,41%";"372";"371";"99,73%";"1";"0,27%";"315";"2";"0.63";"313";"99,37%";"0.63";0.630
"MULTIPOLYGON (((-58.5099108412295 -34.6546885880433,-58.5093771342507 -34.6541732854566,-58.5092742997608 -34.6540753641572,-58.5086601115792 -34.6534902278783,-58.5075705280611 -34.6542658677506,-58.5074259586307 -34.6543687407811,-58.5065001023875 -34.655046491062,-58.5072015210962 -34.6555636465426,-58.5074348745827 -34.6557357492634,-58.5079255391114 -34.656091494097,-58.5079741368472 -34.6561266883518,-58.5087310735209 -34.6566754349409,-58.5095028317824 -34.6561311817259,-58.510602052359 -34.6553560140082,-58.5099108412295 -34.6546885880433)))";;"3441";9_7_13;COMUNA 9;"7";"13";"829";"379";"450";"84,22%";"374";"374";"100,00%";"0";"0,00%";"324";"12";"3.7";"312";"96,30%";"3.7";3.700
"MULTIPOLYGON (((-58.5060195295431 -34.652769201422,-58.5059552918364 -34.6528073943694,-58.504789460666 -34.6535000058929,-58.5046343484927 -34.6536565428182,-58.5057121570745 -34.6544655573652,-58.5065001023875 -34.655046491062,-58.5074259586307 -34.6543687407811,-58.5075705280611 -34.6542658677506,-58.5086601115792 -34.6534902278783,-58.5079726880649 -34.6528352544388,-58.5071813373547 -34.6520812979805,-58.5061710076553 -34.6526792152751,-58.5060195295431 -34.652769201422)))";;"3442";9_7_14;COMUNA 9;"7";"14";"861";"375";"486";"77,16%";"337";"335";"99,41%";"2";"0,60%";"297";"4";"1.35";"293";"98,65%";"1.35";1.350
"MULTIPOLYGON (((-58.520056982184 -34.6605322011611,-58.5204700049705 -34.6609071723031,-58.5219971068143 -34.6597524942531,-58.5215452494966 -34.6593838669153,-58.5212592234209 -34.659150522923,-58.5212459030857 -34.6591607733198,-58.5207508521963 -34.6587333922066,-58.5205715508854 -34.6586381930324,-58.5204014573999 -34.6585470034348,-58.5198836730355 -34.658264563235,-58.519514402406 -34.6579214865942,-58.5201030135123 -34.6574707754409,-58.5202984207373 -34.6573211015244,-58.5199289923039 -34.6569928153178,-58.520509611572 -34.6565827408647,-58.5201169044863 -34.6562334796981,-58.5187768248022 -34.6572606118693,-58.5183851449172 -34.6569119785107,-58.5179982437788 -34.6565675671793,-58.517607423183 -34.65621970556,-58.5174707899392 -34.6563243475033,-58.5163358040084 -34.6571986096714,-58.5167250888962 -34.6575450675003,-58.5171122450959 -34.6578896235519,-58.5175027302844 -34.6582370642636,-58.5176153823749 -34.6583373685631,-58.5178766828878 -34.6585821167514,-58.5180562852472 -34.658750350008,-58.5182300837301 -34.6589049937017,-58.518609236057 -34.6592422244098,-58.5187386909385 -34.659357379525,-58.5190150843298 -34.6596033155087,-58.5197725492442 -34.6602730527094,-58.5197719952762 -34.6602734671959,-58.520056982184 -34.6605322011611)))";;"3443";9_7_2;COMUNA 9;"7";"2";"842";"402";"440";"91,36%";"359";"359";"100,00%";"0";"0,00%";"300";"1";"0.33";"299";"99,67%";"0.33";0.330
"MULTIPOLYGON (((-58.5179982437788 -34.6565675671793,-58.5183851449172 -34.6569119785107,-58.5187768248022 -34.6572606118693,-58.5201169044863 -34.6562334796981,-58.5218556223228 -34.6549524705388,-58.5212865632218 -34.6546881601053,-58.5207629465405 -34.6544446006275,-58.5202453859403 -34.6542041347142,-58.520088057569 -34.6543198460479,-58.5189474159225 -34.6551934312018,-58.517607423183 -34.65621970556,-58.5179982437788 -34.6565675671793)))";;"3444";9_7_3;COMUNA 9;"7";"3";"568";"259";"309";"83,82%";"256";"256";"100,00%";"0";"0,00%";"220";"2";"0.91";"218";"99,09%";"0.91";0.910
"MULTIPOLYGON (((-58.5181722642333 -34.6545040478756,-58.5180589345938 -34.6544033217853,-58.5168270430847 -34.655351226435,-58.5167228657195 -34.6554323313322,-58.5155152273398 -34.6563710566408,-58.5155412775925 -34.6564598507409,-58.515578818389 -34.6565249771954,-58.5159487395525 -34.6568541919213,-58.5163358040084 -34.6571986096714,-58.5174707899392 -34.6563243475033,-58.517607423183 -34.65621970556,-58.5189474159225 -34.6551934312018,-58.520088057569 -34.6543198460479,-58.5202453859403 -34.6542041347142,-58.5199089858243 -34.6540476687032,-58.5197181949004 -34.653959023073,-58.5191950990109 -34.6537158791327,-58.5181722642333 -34.6545040478756)))";;"3445";9_7_4;COMUNA 9;"7";"4";"669";"298";"371";"80,32%";"285";"285";"100,00%";"0";"0,00%";"242";"0";"0";"242";"100,00%";"0";0.000
"MULTIPOLYGON (((-58.5167883184122 -34.653070754284,-58.5162114280458 -34.6535713756578,-58.5159101588188 -34.6538289798502,-58.5153255018882 -34.6543285439953,-58.515186236433 -34.6544482554105,-58.5143051495172 -34.6552055550005,-58.5149303095289 -34.6558077007063,-58.5155152273398 -34.6563710566408,-58.5167228657195 -34.6554323313322,-58.5168270430847 -34.655351226435,-58.5180589345938 -34.6544033217853,-58.5181722642333 -34.6545040478756,-58.5191950990109 -34.6537158791327,-58.5191942009744 -34.6537154617716,-58.5181805438476 -34.6532443592637,-58.5171458815146 -34.6527633325676,-58.5167883184122 -34.653070754284)))";;"3446";9_7_5;COMUNA 9;"7";"5";"709";"332";"377";"88,06%";"298";"298";"100,00%";"0";"0,00%";"257";"2";"0.78";"255";"99,22%";"0.78";0.780
"MULTIPOLYGON (((-58.5160778143411 -34.6522668886837,-58.5154162885279 -34.6519423076823,-58.5139435407404 -34.6529893044774,-58.5128324618364 -34.6537820431941,-58.5129367504281 -34.6538824257578,-58.5134078882455 -34.6543402723443,-58.5135243731142 -34.6544535370243,-58.5143051495172 -34.6552055550005,-58.515186236433 -34.6544482554105,-58.5153255018882 -34.6543285439953,-58.5159101588188 -34.6538289798502,-58.5162114280458 -34.6535713756578,-58.5167883184122 -34.653070754284,-58.5171458815146 -34.6527633325676,-58.5165561370041 -34.6524891497353,-58.5160778143411 -34.6522668886837)))";;"3447";9_7_6;COMUNA 9;"7";"6";"853";"402";"451";"89,14%";"338";"338";"100,00%";"0";"0,00%";"308";"2";"0.65";"306";"99,35%";"0.65";0.650
"MULTIPOLYGON (((-58.5144159376129 -34.6514942720175,-58.5135175396456 -34.6510766091055,-58.5127542908787 -34.6516201099864,-58.5126194434773 -34.6517160131849,-58.5115076860785 -34.6525069092318,-58.5121423557425 -34.6531178687864,-58.5128324618364 -34.6537820431941,-58.5139435407404 -34.6529893044774,-58.5154162885279 -34.6519423076823,-58.5144159376129 -34.6514942720175)))";;"3448";9_7_7;COMUNA 9;"7";"7";"600";"264";"336";"78,57%";"271";"271";"100,00%";"0";"0,00%";"232";"1";"0.43";"231";"99,57%";"0.43";0.430
"MULTIPOLYGON (((-58.5094622785304 -34.6505415959091,-58.5083392601901 -34.651337115571,-58.5090850830673 -34.6520498835264,-58.5102084461677 -34.6512568218157,-58.5103304638537 -34.6513738199578,-58.5108882889401 -34.6519107998703,-58.5115076860785 -34.6525069092318,-58.5126194434773 -34.6517160131849,-58.5127542908787 -34.6516201099864,-58.5135175396456 -34.6510766091055,-58.5126460877314 -34.6506714640939,-58.5116780639877 -34.6502213503014,-58.5106526961248 -34.649767589268,-58.5106126191937 -34.6497259840519,-58.5094622785304 -34.6505415959091)))";;"3449";9_7_8;COMUNA 9;"7";"8";"737";"348";"389";"89,46%";"313";"313";"100,00%";"0";"0,00%";"275";"3";"1.09";"272";"98,91%";"1.09";1.090
"MULTIPOLYGON (((-58.5073164558091 -34.6520013166652,-58.5071813373547 -34.6520812979805,-58.5079726880649 -34.6528352544388,-58.5086601115792 -34.6534902278783,-58.5092742997608 -34.6540753641572,-58.5094108581203 -34.6539773512983,-58.5103861896252 -34.6532933621075,-58.5115076860785 -34.6525069092318,-58.5108882889401 -34.6519107998703,-58.5103304638537 -34.6513738199578,-58.5102084461677 -34.6512568218157,-58.5090850830673 -34.6520498835264,-58.5083392601901 -34.651337115571,-58.5073164558091 -34.6520013166652)))";;"3450";9_7_9;COMUNA 9;"7";"9";"838";"389";"449";"86,64%";"339";"339";"100,00%";"0";"0,00%";"313";"1";"0.32";"312";"99,68%";"0.32";0.320
"MULTIPOLYGON (((-58.5142047021428 -34.6588400685045,-58.5152775470013 -34.6580137418971,-58.5163358040084 -34.6571986096714,-58.5159487395525 -34.6568541919213,-58.515578818389 -34.6565249771954,-58.5155412775925 -34.6564598507409,-58.5155152273398 -34.6563710566408,-58.5149303095289 -34.6558077007063,-58.5147888201059 -34.655919313766,-58.5138639755911 -34.656648318002,-58.5128034979862 -34.6574842754388,-58.5117003487134 -34.6582583375212,-58.5114049851204 -34.6584656448956,-58.5123245099598 -34.6590367693214,-58.5125887318171 -34.6592008915312,-58.5132540052848 -34.6595849242205,-58.51347934539 -34.6597150455485,-58.5143863477665 -34.6590157713018,-58.5142047021428 -34.6588400685045)))";;"3451";9_8_1;COMUNA 9;"8";"1";"770";"369";"401";"92,02%";"336";"335";"99,70%";"1";"0,30%";"287";"6";"2.09";"281";"97,91%";"2.09";2.090
"MULTIPOLYGON (((-58.5063541209752 -34.6604259235215,-58.5051605989952 -34.6618403285671,-58.5054659434377 -34.6620942430634,-58.5062644864803 -34.6627584859977,-58.5070568174745 -34.663417514472,-58.5085017090143 -34.6622144114423,-58.5097076843761 -34.6612101918394,-58.5089133053409 -34.6605465331107,-58.5081165513941 -34.6598807572774,-58.5073196396964 -34.6592149057927,-58.5063541209752 -34.6604259235215)))";;"3452";9_8_10;COMUNA 9;"8";"10";"905";"448";"457";"98,03%";"361";"360";"99,72%";"1";"0,28%";"326";"30";"9.2";"296";"90,80%";"9.2";9.200
"MULTIPOLYGON (((-58.5085017090143 -34.6622144114423,-58.5070568174745 -34.663417514472,-58.5071485690505 -34.6634938212091,-58.5078529990566 -34.6640811843109,-58.508654139267 -34.6647490724728,-58.5087591966371 -34.664836711305,-58.5094347431134 -34.6654035120917,-58.510956813336 -34.6642727471195,-58.5116886532273 -34.6637289894885,-58.5121368685453 -34.6633960528439,-58.5122357802957 -34.6633223486758,-58.5113025349344 -34.6625426320968,-58.5105047195896 -34.6618761682822,-58.5097076843761 -34.6612101918394,-58.5085017090143 -34.6622144114423)))";;"3453";9_8_11;COMUNA 9;"8";"11";"905";"437";"468";"93,38%";"367";"367";"100,00%";"0";"0,00%";"323";"21";"6.5";"302";"93,50%";"6.5";6.500
"MULTIPOLYGON (((-58.5103550428899 -34.6661756418144,-58.5110908697936 -34.6667929330507,-58.5111285103809 -34.6668245096812,-58.5111295166263 -34.666823662769,-58.5114323023718 -34.6670644192043,-58.5118677026426 -34.6674106187017,-58.514595938737 -34.6653482150471,-58.5141605615851 -34.6649725239181,-58.5138926382288 -34.664741327807,-58.513914540281 -34.664724792502,-58.5131333120917 -34.6640722128004,-58.5122357802957 -34.6633223486758,-58.5121368685453 -34.6633960528439,-58.5116886532273 -34.6637289894885,-58.510956813336 -34.6642727471195,-58.5094347431134 -34.6654035120917,-58.5103550428899 -34.6661756418144)))";;"3454";9_8_12;COMUNA 9;"8";"12";"954";"463";"491";"94,30%";"401";"401";"100,00%";"0";"0,00%";"331";"2";"0.6";"329";"99,40%";"0.6";0.600
"MULTIPOLYGON (((-58.5099648403345 -34.6681774348801,-58.5103845969076 -34.6685317002426,-58.5118677026426 -34.6674106187017,-58.5114323023718 -34.6670644192043,-58.5111295166263 -34.666823662769,-58.5111285103809 -34.6668245096812,-58.5110908697936 -34.6667929330507,-58.5103550428899 -34.6661756418144,-58.5094347431134 -34.6654035120917,-58.5087591966371 -34.664836711305,-58.508654139267 -34.6647490724728,-58.5078529990566 -34.6640811843109,-58.5064251882612 -34.6652657515395,-58.5065339953583 -34.6653554332472,-58.5072307591475 -34.6659307599325,-58.5079411765725 -34.666517486274,-58.5088809963104 -34.6672935635072,-58.5096675900055 -34.6679436327665,-58.5096781944895 -34.6679355094822,-58.5099648403345 -34.6681774348801)))";;"3455";9_8_13;COMUNA 9;"8";"13";"650";"315";"335";"94,03%";"232";"232";"100,00%";"0";"0,00%";"207";"1";"0.48";"206";"99,52%";"0.48";0.480
"MULTIPOLYGON (((-58.5153419741314 -34.6598929226261,-58.5164179758377 -34.6590683453764,-58.5175027302844 -34.6582370642636,-58.5171122450959 -34.6578896235519,-58.5167250888962 -34.6575450675003,-58.5163358040084 -34.6571986096714,-58.5152775470013 -34.6580137418971,-58.5142047021428 -34.6588400685045,-58.5143863477665 -34.6590157713018,-58.51347934539 -34.6597150455485,-58.5142014955771 -34.660131867162,-58.5143921376286 -34.6602419304506,-58.5145349478979 -34.6603226467551,-58.5149140146096 -34.6605369276956,-58.515516722741 -34.6608775932168,-58.5156236402274 -34.6609380415179,-58.5160048596742 -34.6606454728299,-58.516080739127 -34.6605507890714,-58.5157236778751 -34.6602328372866,-58.5155330814589 -34.6600631264835,-58.5153419741314 -34.6598929226261)))";;"3456";9_8_2;COMUNA 9;"8";"2";"733";"353";"380";"92,89%";"375";"375";"100,00%";"0";"0,00%";"294";"4";"1.36";"290";"98,64%";"1.36";1.360
"MULTIPOLYGON (((-58.516080739127 -34.6605507890714,-58.5160048596742 -34.6606454728299,-58.5156236402274 -34.6609380415179,-58.5165763551508 -34.6614765830829,-58.5166957224467 -34.6615439969619,-58.5174755369958 -34.6619848586737,-58.5174736342599 -34.661986351643,-58.5178641822254 -34.6622215200182,-58.5183470710747 -34.6625122878554,-58.5204700049705 -34.6609071723031,-58.520056982184 -34.6605322011611,-58.5197719952762 -34.6602734671959,-58.5197725492442 -34.6602730527094,-58.5190150843298 -34.6596033155087,-58.5187386909385 -34.659357379525,-58.518609236057 -34.6592422244098,-58.5182300837301 -34.6589049937017,-58.5180562852472 -34.658750350008,-58.5178766828878 -34.6585821167514,-58.5176153823749 -34.6583373685631,-58.5175027302844 -34.6582370642636,-58.5164179758377 -34.6590683453764,-58.5153419741314 -34.6598929226261,-58.5155330814589 -34.6600631264835,-58.5157236778751 -34.6602328372866,-58.516080739127 -34.6605507890714)))";;"3457";9_8_3;COMUNA 9;"8";"3";"832";"369";"463";"79,70%";"354";"354";"100,00%";"0";"0,00%";"293";"3";"1.02";"290";"98,98%";"1.02";1.020
"MULTIPOLYGON (((-58.5132297308005 -34.6621383866237,-58.5125086513063 -34.6615377509785,-58.5113025349344 -34.6625426320968,-58.5122357802957 -34.6633223486758,-58.5131333120917 -34.6640722128004,-58.513914540281 -34.664724792502,-58.5138926382288 -34.664741327807,-58.5141605615851 -34.6649725239181,-58.514595938737 -34.6653482150471,-58.5183470710747 -34.6625122878554,-58.5178641822254 -34.6622215200182,-58.5174736342599 -34.661986351643,-58.5174755369958 -34.6619848586737,-58.5166957224467 -34.6615439969619,-58.5165763551508 -34.6614765830829,-58.5152346034126 -34.6624881124254,-58.5148457874915 -34.662781245267,-58.5144032121299 -34.6631148937509,-58.5135107975876 -34.6623722904489,-58.5132297308005 -34.6621383866237)))";;"3458";9_8_4;COMUNA 9;"8";"4";"703";"324";"379";"85,49%";"347";"347";"100,00%";"0";"0,00%";"286";"1";"0.35";"285";"99,65%";"0.35";0.350
"MULTIPOLYGON (((-58.5156236402274 -34.6609380415179,-58.515516722741 -34.6608775932168,-58.5149140146096 -34.6605369276956,-58.5145349478979 -34.6603226467551,-58.5143921376286 -34.6602419304506,-58.5142014955771 -34.660131867162,-58.51347934539 -34.6597150455485,-58.5132540052848 -34.6595849242205,-58.5125887318171 -34.6592008915312,-58.5123245099598 -34.6590367693214,-58.5121803710994 -34.6591511269346,-58.5109149084763 -34.660204903293,-58.5117111765873 -34.6608708018377,-58.5125086513063 -34.6615377509785,-58.5132297308005 -34.6621383866237,-58.5135107975876 -34.6623722904489,-58.5144032121299 -34.6631148937509,-58.5148457874915 -34.662781245267,-58.5152346034126 -34.6624881124254,-58.5165763551508 -34.6614765830829,-58.5156236402274 -34.6609380415179)))";;"3459";9_8_5;COMUNA 9;"8";"5";"909";"433";"476";"90,97%";"395";"395";"100,00%";"0";"0,00%";"329";"4";"1.22";"325";"98,78%";"1.22";1.220
"MULTIPOLYGON (((-58.5117111765873 -34.6608708018377,-58.5109149084763 -34.660204903293,-58.5121803710994 -34.6591511269346,-58.5123245099598 -34.6590367693214,-58.5114049851204 -34.6584656448956,-58.5107131970099 -34.6580359773708,-58.5104972331476 -34.6578925369741,-58.5093227515821 -34.6588734423456,-58.5081165513941 -34.6598807572774,-58.5089133053409 -34.6605465331107,-58.5097076843761 -34.6612101918394,-58.5105047195896 -34.6618761682822,-58.5113025349344 -34.6625426320968,-58.5125086513063 -34.6615377509785,-58.5117111765873 -34.6608708018377)))";;"3460";9_8_6;COMUNA 9;"8";"6";"994";"502";"492";"102,03%";"404";"404";"100,00%";"0";"0,00%";"353";"49";"13.88";"304";"86,12%";"13.88";13.880
"MULTIPOLYGON (((-58.5083692896831 -34.6580763155752,-58.508529780437 -34.6582108158702,-58.5078365369085 -34.6587581778258,-58.5077724961339 -34.6588087417202,-58.5073196396964 -34.6592149057927,-58.5081165513941 -34.6598807572774,-58.5093227515821 -34.6588734423456,-58.5104972331476 -34.6578925369741,-58.509617526992 -34.6573082139408,-58.5094563881534 -34.6572012304989,-58.5092376929461 -34.6570427180396,-58.508777199403 -34.6567088691908,-58.5087310735209 -34.6566754349409,-58.5079741368472 -34.6561266883518,-58.5069990719847 -34.6569308725986,-58.5072093344297 -34.6571066461757,-58.507741730433 -34.6575517451961,-58.5083540360709 -34.6580635653535,-58.5083692896831 -34.6580763155752)))";;"3461";9_8_7;COMUNA 9;"8";"7";"1066";"510";"556";"91,73%";"359";"359";"100,00%";"0";"0,00%";"330";"7";"2.12";"323";"97,88%";"2.12";2.120
"MULTIPOLYGON (((-58.5079255391114 -34.656091494097,-58.5074348745827 -34.6557357492634,-58.5072015210962 -34.6555636465426,-58.5065001023875 -34.655046491062,-58.5057121570745 -34.6544655573652,-58.5046343484927 -34.6536565428182,-58.5039305016288 -34.6543669445599,-58.5028372707279 -34.6554704401733,-58.5017580665179 -34.6565597659634,-58.5019538097117 -34.6566956929595,-58.502487031384 -34.6571494064973,-58.5032136340912 -34.6577675653448,-58.5044059812359 -34.6567803742975,-58.504532680705 -34.6568861790269,-58.5050647198057 -34.6573307264844,-58.5057846869468 -34.6579323929429,-58.5069990719847 -34.6569308725986,-58.5079741368472 -34.6561266883518,-58.5079255391114 -34.656091494097)))";;"3462";9_8_8;COMUNA 9;"8";"8";"1082";"506";"576";"87,85%";"388";"387";"99,74%";"1";"0,26%";"335";"18";"5.37";"317";"94,63%";"5.37";5.370
"MULTIPOLYGON (((-58.5011001693459 -34.6592512495262,-58.5012462914167 -34.6593372622123,-58.5014267649794 -34.6594316443366,-58.5014884832258 -34.6594583156197,-58.501558384752 -34.6594876603962,-58.5016799422228 -34.6595320594811,-58.5018549466927 -34.6595938361542,-58.5020019068434 -34.6596468185509,-58.5021445194193 -34.6596975485911,-58.5023050331787 -34.6597542587365,-58.5023872929972 -34.6597825426532,-58.5025222342797 -34.6598309507374,-58.5026038123782 -34.6598591643057,-58.5027436136185 -34.6599109509313,-58.5028539236 -34.6599585920644,-58.5029378106236 -34.6600022980461,-58.5031121702194 -34.6601362582703,-58.5038636091778 -34.6607614471483,-58.5046596538826 -34.6614235888566,-58.5051605989952 -34.6618403285671,-58.5063541209752 -34.6604259235215,-58.5073196396964 -34.6592149057927,-58.5077724961339 -34.6588087417202,-58.5078365369085 -34.6587581778258,-58.508529780437 -34.6582108158702,-58.5083692896831 -34.6580763155752,-58.5083540360709 -34.6580635653535,-58.507741730433 -34.6575517451961,-58.5072093344297 -34.6571066461757,-58.5069990719847 -34.6569308725986,-58.5057846869468 -34.6579323929429,-58.5050647198057 -34.6573307264844,-58.504532680705 -34.6568861790269,-58.5044059812359 -34.6567803742975,-58.5032136340912 -34.6577675653448,-58.502487031384 -34.6571494064973,-58.5019538097117 -34.6566956929595,-58.5017580665179 -34.6565597659634,-58.5007663210166 -34.6573721453518,-58.4997888678956 -34.6581698639171,-58.5009580453665 -34.6591479109708,-58.5010534483056 -34.6592173196008,-58.5011001693459 -34.6592512495262)))";;"3463";9_8_9;COMUNA 9;"8";"9";"764";"368";"396";"92,93%";"276";"276";"100,00%";"0";"0,00%";"250";"17";"6.8";"233";"93,20%";"6.8";6.800
"MULTIPOLYGON (((-58.4986534222007 -34.6499810899932,-58.4981425277517 -34.6503712512729,-58.4975453281165 -34.650827422973,-58.4974059530428 -34.6509359166711,-58.497556077949 -34.6510598916452,-58.4982026201582 -34.6515998620918,-58.4989978513012 -34.6522640139326,-58.5002482180523 -34.6513057899022,-58.5013031313903 -34.6504973377414,-58.5005469995522 -34.6498005819983,-58.4997959102953 -34.6491083975519,-58.4986534222007 -34.6499810899932)))";;"3464";9_9_1;COMUNA 9;"9";"1";"792";"350";"442";"79,19%";"317";"317";"100,00%";"0";"0,00%";"282";"38";"13.48";"244";"86,52%";"13.48";13.480
"MULTIPOLYGON (((-58.4915756123238 -34.6529271438219,-58.4923694396588 -34.6535910573917,-58.4933585913472 -34.6528088881737,-58.4942229124108 -34.6521254785024,-58.4943473844231 -34.6520289645178,-58.4953464725798 -34.6512538892936,-58.4948928649884 -34.6508699138963,-58.4945668791395 -34.6505993576093,-58.4940657975488 -34.6501786298209,-58.4937776637563 -34.6499329919776,-58.4934363718647 -34.6501949173422,-58.49275250372 -34.6507198218601,-58.4926057951055 -34.6508323965119,-58.4919407457284 -34.6513443336748,-58.491769243831 -34.6514803646565,-58.4907817124258 -34.6522632250253,-58.4915756123238 -34.6529271438219)))";;"3465";9_9_10;COMUNA 9;"9";"10";"839";"408";"431";"94,66%";"313";"313";"100,00%";"0";"0,00%";"285";"4";"1.4";"281";"98,60%";"1.4";1.400
"MULTIPOLYGON (((-58.4933585913472 -34.6528088881737,-58.4923694396588 -34.6535910573917,-58.4931617451363 -34.6542536280304,-58.4934100784499 -34.6544612478963,-58.4939554268139 -34.6549161930926,-58.4949466239017 -34.6541319683245,-58.4958140125234 -34.6534456593029,-58.4959412110609 -34.6533473119318,-58.4961570133685 -34.6531804169957,-58.4969368934704 -34.6525775066192,-58.4961442343491 -34.6519181999619,-58.4954539713644 -34.6513442152776,-58.4953464725798 -34.6512538892936,-58.4943473844231 -34.6520289645178,-58.4942229124108 -34.6521254785024,-58.4933585913472 -34.6528088881737)))";;"3466";9_9_11;COMUNA 9;"9";"11";"753";"341";"412";"82,77%";"293";"293";"100,00%";"0";"0,00%";"275";"48";"17.45";"227";"82,55%";"17.45";17.450
"MULTIPOLYGON (((-58.4918654455225 -34.6565535191897,-58.4928189077103 -34.6558116244856,-58.492944412344 -34.6557148649384,-58.4930523085274 -34.6556307378959,-58.4939554268139 -34.6549161930926,-58.4934100784499 -34.6544612478963,-58.4931617451363 -34.6542536280304,-58.4923694396588 -34.6535910573917,-58.4915756123238 -34.6529271438219,-58.4914417641761 -34.6530320377043,-58.4906675513241 -34.6536389962305,-58.4905720608456 -34.6537126363589,-58.4900349325951 -34.6541349993682,-58.489510769234 -34.6545459024671,-58.4894068220548 -34.6546274065432,-58.489747642147 -34.6549169877983,-58.4901922124906 -34.65529563185,-58.4909769337534 -34.6559639226013,-58.4917626906227 -34.656633053074,-58.4918654455225 -34.6565535191897)))";;"3467";9_9_12;COMUNA 9;"9";"12";"689";"318";"371";"85,71%";"278";"278";"100,00%";"0";"0,00%";"227";"4";"1.76";"223";"98,24%";"1.76";1.760
"MULTIPOLYGON (((-58.4906675513241 -34.6536389962305,-58.4914417641761 -34.6530320377043,-58.4915756123238 -34.6529271438219,-58.4907817124258 -34.6522632250253,-58.4906384076307 -34.6523767824439,-58.4898693923358 -34.6529799318471,-58.489023704178 -34.6523586200353,-58.4889621039939 -34.6524067333386,-58.4886909248261 -34.6523962981719,-58.4875826021012 -34.6523535703488,-58.4873079481443 -34.6524072896517,-58.4870596258946 -34.6524558620803,-58.4871585932911 -34.6525402109723,-58.486988074201 -34.6525748235476,-58.4869880911072 -34.6525749620126,-58.4872866809791 -34.6528256162165,-58.4878320729805 -34.6532891103023,-58.488620080541 -34.6539588242655,-58.4894068220548 -34.6546274065432,-58.489510769234 -34.6545459024671,-58.4900349325951 -34.6541349993682,-58.4905720608456 -34.6537126363589,-58.4906675513241 -34.6536389962305)))";;"3468";9_9_13;COMUNA 9;"9";"13";"640";"299";"341";"87,68%";"214";"214";"100,00%";"0";"0,00%";"209";"2";"0.96";"207";"99,04%";"0.96";0.960
"MULTIPOLYGON (((-58.489023704178 -34.6523586200353,-58.4898693923358 -34.6529799318471,-58.4906384076307 -34.6523767824439,-58.4907817124258 -34.6522632250253,-58.4899912349743 -34.6516021876284,-58.4891968488841 -34.6509378359235,-58.4885071523347 -34.6503609946992,-58.4884066521452 -34.6502764359204,-58.4874590647825 -34.6510357392815,-58.4872988882643 -34.6511640853983,-58.4864700523586 -34.6518291287936,-58.4863943075604 -34.651888511502,-58.4870596258946 -34.6524558620803,-58.4873079481443 -34.6524072896517,-58.4875826021012 -34.6523535703488,-58.4886909248261 -34.6523962981719,-58.4889621039939 -34.6524067333386,-58.489023704178 -34.6523586200353)))";;"3469";9_9_14;COMUNA 9;"9";"14";"971";"452";"519";"87,09%";"345";"344";"99,71%";"1";"0,29%";"310";"4";"1.29";"306";"98,71%";"1.29";1.290
"MULTIPOLYGON (((-58.4989978513012 -34.6522640139326,-58.4985948857883 -34.6525728043505,-58.4978862385588 -34.6531158438693,-58.4977306733648 -34.6532375823974,-58.4985405788486 -34.6539110992941,-58.4990193670437 -34.6543092791921,-58.4997881999687 -34.654948643975,-58.5009147010082 -34.65402967764,-58.5010139486865 -34.6539477426783,-58.5001332601386 -34.6532122903095,-58.5011765341709 -34.652242852367,-58.5012714307163 -34.6521556366984,-58.5022041313077 -34.6513324262782,-58.5020675459416 -34.6512018327481,-58.5013031313903 -34.6504973377414,-58.5002482180523 -34.6513057899022,-58.4989978513012 -34.6522640139326)))";;"3470";9_9_2;COMUNA 9;"9";"2";"720";"334";"386";"86,53%";"279";"279";"100,00%";"0";"0,00%";"268";"10";"3.73";"258";"96,27%";"3.73";3.730
"MULTIPOLYGON (((-58.5022041313077 -34.6513324262782,-58.5012714307163 -34.6521556366984,-58.5011765341709 -34.652242852367,-58.5001332601386 -34.6532122903095,-58.5010139486865 -34.6539477426783,-58.5019888626724 -34.6547619633925,-58.5028372707279 -34.6554704401733,-58.5039305016288 -34.6543669445599,-58.5046343484927 -34.6536565428182,-58.5040262485651 -34.6530749727059,-58.5031204239936 -34.6522087717995,-58.5022041313077 -34.6513324262782)))";;"3471";9_9_3;COMUNA 9;"9";"3";"1033";"487";"546";"89,19%";"477";"477";"100,00%";"0";"0,00%";"396";"13";"3.28";"383";"96,72%";"3.28";3.280
"MULTIPOLYGON (((-58.4988156560034 -34.6589641929139,-58.4997888678956 -34.6581698639171,-58.5007663210166 -34.6573721453518,-58.5017580665179 -34.6565597659634,-58.5028372707279 -34.6554704401733,-58.5019888626724 -34.6547619633925,-58.5010139486865 -34.6539477426783,-58.5009147010082 -34.65402967764,-58.4997881999687 -34.654948643975,-58.4990193670437 -34.6543092791921,-58.4981394615744 -34.6551810425078,-58.4973589549898 -34.6559544584225,-58.4972476897796 -34.6560490702149,-58.4971054130614 -34.6561700294524,-58.496355982939 -34.6569129362141,-58.4968618045908 -34.6573347795759,-58.4972726552459 -34.6576774201394,-58.4978399569696 -34.6581505110187,-58.4988156560034 -34.6589641929139)))";;"3472";9_9_4;COMUNA 9;"9";"4";"628";"302";"326";"92,64%";"231";"231";"100,00%";"0";"0,00%";"211";"2";"0.95";"209";"99,05%";"0.95";0.950
"MULTIPOLYGON (((-58.4977306733648 -34.6532375823974,-58.4969272816853 -34.6538659980959,-58.4967455584389 -34.6540081658289,-58.4966188755072 -34.6539079164927,-58.4959412110609 -34.6533473119318,-58.4958140125234 -34.6534456593029,-58.4949466239017 -34.6541319683245,-58.4939554268139 -34.6549161930926,-58.4947468191245 -34.6555763590788,-58.4954047166626 -34.6561250736185,-58.4955417190188 -34.6562384907969,-58.4959543480729 -34.656579867746,-58.496250778115 -34.6568251457638,-58.496355982939 -34.6569129362141,-58.4971054130614 -34.6561700294524,-58.4972476897796 -34.6560490702149,-58.4973589549898 -34.6559544584225,-58.4981394615744 -34.6551810425078,-58.4990193670437 -34.6543092791921,-58.4985405788486 -34.6539110992941,-58.4977306733648 -34.6532375823974)))";;"3473";9_9_5;COMUNA 9;"9";"5";"713";"332";"381";"87,14%";"281";"281";"100,00%";"0";"0,00%";"261";"4";"1.53";"257";"98,47%";"1.53";1.530
"MULTIPOLYGON (((-58.4989978513012 -34.6522640139326,-58.4982026201582 -34.6515998620918,-58.497556077949 -34.6510598916452,-58.4974059530428 -34.6509359166711,-58.4966077666273 -34.6502767552679,-58.495823658601 -34.6496292048101,-58.4952855773148 -34.6500430242116,-58.4945668791395 -34.6505993576093,-58.4948928649884 -34.6508699138963,-58.4953464725798 -34.6512538892936,-58.4954539713644 -34.6513442152776,-58.4961442343491 -34.6519181999619,-58.4969368934704 -34.6525775066192,-58.4961570133685 -34.6531804169957,-58.4959412110609 -34.6533473119318,-58.4966188755072 -34.6539079164927,-58.4967455584389 -34.6540081658289,-58.4969272816853 -34.6538659980959,-58.4977306733648 -34.6532375823974,-58.4978862385588 -34.6531158438693,-58.4985948857883 -34.6525728043505,-58.4989978513012 -34.6522640139326)))";;"3474";9_9_6;COMUNA 9;"9";"6";"881";"412";"469";"87,85%";"332";"332";"100,00%";"0";"0,00%";"304";"2";"0.66";"302";"99,34%";"0.66";0.660
"MULTIPOLYGON (((-58.4937776637563 -34.6499329919776,-58.4940657975488 -34.6501786298209,-58.4945668791395 -34.6505993576093,-58.4952855773148 -34.6500430242116,-58.495823658601 -34.6496292048101,-58.4950287365689 -34.6489727081727,-58.4946534013315 -34.648662727289,-58.4942363819988 -34.6483119801346,-58.4934478738809 -34.6476488514639,-58.4933235891147 -34.6475443725099,-58.4926298836893 -34.6469584705036,-58.4914154544013 -34.6479116084988,-58.4915463023763 -34.6480256655956,-58.4922201487519 -34.648598761182,-58.4923428997842 -34.6487032416153,-58.4930017535711 -34.6492623923764,-58.4937776637563 -34.6499329919776)))";;"3475";9_9_7;COMUNA 9;"9";"7";"964";"445";"519";"85,74%";"388";"388";"100,00%";"0";"0,00%";"359";"0";"0";"359";"100,00%";"0";0.000
"MULTIPOLYGON (((-58.4930017535711 -34.6492623923764,-58.4923428997842 -34.6487032416153,-58.4922201487519 -34.648598761182,-58.4915463023763 -34.6480256655956,-58.4914154544013 -34.6479116084988,-58.4903370553957 -34.648758010131,-58.4910301561724 -34.6493233611467,-58.4911522228416 -34.6494214342811,-58.4918123424961 -34.6499516465746,-58.4919549553705 -34.6500681652472,-58.49275250372 -34.6507198218601,-58.4934363718647 -34.6501949173422,-58.4937776637563 -34.6499329919776,-58.4930017535711 -34.6492623923764)))";;"3476";9_9_8;COMUNA 9;"9";"8";"589";"292";"297";"98,32%";"218";"218";"100,00%";"0";"0,00%";"205";"2";"0.98";"203";"99,02%";"0.98";0.980
"MULTIPOLYGON (((-58.4894037243037 -34.6494856344553,-58.4892404840629 -34.6496082794272,-58.4884066521452 -34.6502764359204,-58.4885071523347 -34.6503609946992,-58.4891968488841 -34.6509378359235,-58.4899912349743 -34.6516021876284,-58.4907817124258 -34.6522632250253,-58.491769243831 -34.6514803646565,-58.4919407457284 -34.6513443336748,-58.4926057951055 -34.6508323965119,-58.49275250372 -34.6507198218601,-58.4919549553705 -34.6500681652472,-58.4918123424961 -34.6499516465746,-58.4911522228416 -34.6494214342811,-58.4910301561724 -34.6493233611467,-58.4903370553957 -34.648758010131,-58.4895472833289 -34.649377853201,-58.4894037243037 -34.6494856344553)))";;"3477";9_9_9;COMUNA 9;"9";"9";"809";"376";"433";"86,84%";"274";"274";"100,00%";"0";"0,00%";"256";"6";"2.34";"250";"97,66%";"2.34";2.340
"MULTIPOLYGON (((-58.4698929711152 -34.6556246553024,-58.4683455864184 -34.6525647170156,-58.4673984360422 -34.6511790820468,-58.4670088234769 -34.6514879084935,-58.4666292637506 -34.6517887753723,-58.466459597703 -34.6519968150963,-58.4656843627853 -34.652678124413,-58.4645931981392 -34.6535337349694,-58.463766456962 -34.6540928460121,-58.4629586667054 -34.6547232704622,-58.461913856389 -34.6555760417599,-58.461279266793 -34.6561586762673,-58.4603553912461 -34.6568413592169,-58.4615803361609 -34.6578785193026,-58.4640612527432 -34.6597604018296,-58.464425103268 -34.6600654059216,-58.467620690422 -34.6575713286239,-58.4695238734891 -34.6591279317295,-58.4705676484154 -34.6584079944346,-58.4695304360777 -34.656080707233,-58.4693940389283 -34.6557477472424,-58.4698929711152 -34.6556246553024)))";;"3478";9_13_7;COMUNA 9;"1";"7";"1146";"575";"571";"100,70%";"397";"397";"100,00%";"0";"0,00%";"358";"24";"6.7";"334";"93,30%";"6.7";6.700
"MULTIPOLYGON (((-58.3890928554348 -34.5785518913069,-58.3888967628503 -34.578378822781,-58.3881007178136 -34.5783584140103,-58.3881983459401 -34.578459503692,-58.388050530001 -34.5785546021552,-58.3879068017017 -34.5786546331423,-58.387585009417 -34.578841115319,-58.3873761236842 -34.5789646619448,-58.3870430523464 -34.5791418017317,-58.3864415989214 -34.579441597133,-58.3862074983786 -34.5796017921921,-58.3861072157681 -34.5796729570866,-58.3862075007224 -34.5797496002848,-58.3862977683641 -34.579714633861,-58.3863642672098 -34.5797810755467,-58.386084161541 -34.5800438700882,-58.3862019867187 -34.5802001111006,-58.386725758408 -34.5799598673574,-58.3880061645226 -34.5792742286292,-58.3884222839008 -34.5790142948507,-58.3890928554348 -34.5785518913069)))";;"3479";1_2_2;COMUNA 1;"2";"2";"401";"188";"213";"88,26%";"124";"124";"100,00%";"0";"0,00%";"128";"25";"19.53";"103";"80,47%";"19.53";19.530
"MULTIPOLYGON (((-58.3890928554348 -34.5785518913069,-58.3894841817129 -34.5782256801809,-58.3892001671449 -34.5781850350978,-58.3889252998955 -34.5781869514687,-58.3868351565548 -34.5780403682717,-58.3867344249439 -34.5780596660162,-58.3866285523084 -34.5780995313173,-58.3865198748973 -34.5781337607384,-58.3864082596469 -34.5782319556326,-58.3861810429539 -34.5782106690036,-58.3860655489518 -34.5782125641297,-58.3859494054372 -34.5782172800845,-58.385729905848 -34.5782098176153,-58.385616139385 -34.5782221407021,-58.3857241966796 -34.578711356639,-58.3858644927963 -34.5792896107665,-58.3859540451422 -34.5793616730926,-58.3860312083724 -34.5794627980008,-58.3861126854349 -34.5794846064759,-58.3862355038592 -34.5795799855157,-58.3864415989214 -34.579441597133,-58.3870430523464 -34.5791418017317,-58.3873761236842 -34.5789646619448,-58.387585009417 -34.578841115319,-58.3879068017017 -34.5786546331423,-58.388050530001 -34.5785546021552,-58.3881983459401 -34.578459503692,-58.3881007178136 -34.5783584140103,-58.3888967628503 -34.578378822781,-58.3890928554348 -34.5785518913069)))";;"3480";1_2_1;COMUNA 1;"2";"1";"478";"232";"246";"94,31%";"149";"148";"99,33%";"1";"0,68%";"161";"43";"26.71";"118";"73,29%";"26.71";26.710
"MULTIPOLYGON (((-58.3849291791075 -34.5800280196586,-58.3850771505112 -34.5799447673755,-58.3857922893704 -34.5795883124707,-58.3860312083724 -34.5794627980008,-58.3859540451422 -34.5793616730926,-58.3858644927963 -34.5792896107665,-58.3857241966796 -34.578711356639,-58.385616139385 -34.5782221407021,-58.3847125730541 -34.5781639267123,-58.3844569525076 -34.5781426187224,-58.3842666447186 -34.5781401472025,-58.3839172463902 -34.5781645906419,-58.3837354376964 -34.578185617552,-58.3835536444996 -34.5781901985604,-58.3833718311957 -34.57821592368,-58.3832155684211 -34.5782557614333,-58.3830166527453 -34.5783437333807,-58.3828575064245 -34.5784282069578,-58.3798382017374 -34.5801625788978,-58.3798473641002 -34.5803283076123,-58.3801046291719 -34.5806398328265,-58.3805912694178 -34.5812290586205,-58.3805848159148 -34.5812975077932,-58.3791008505578 -34.5821335769212,-58.3791771247445 -34.5822389151367,-58.3792538308576 -34.5823382674382,-58.3794969392753 -34.5825900634062,-58.3795882539056 -34.582556603127,-58.38109709828 -34.581904793844,-58.3822776711684 -34.5813560159448,-58.38336062585 -34.5806833526767,-58.3834874736387 -34.580804491044,-58.3835226108929 -34.5807823157765,-58.3838502395317 -34.5806137437619,-58.3838673692239 -34.5805939916412,-58.3841224828591 -34.5804487979749,-58.3841459578852 -34.5804271686967,-58.3849291791075 -34.5800280196586)))";;"3481";1_2_4;COMUNA 1;"2";"4";"602";"297";"305";"97,38%";"120";"120";"100,00%";"0";"0,00%";"163";"23";"14.11";"140";"85,89%";"14.11";14.110
"MULTIPOLYGON (((-58.3848242503381 -34.5808639968557,-58.3851358713451 -34.580718700498,-58.385453170752 -34.5805556843841,-58.3862019867187 -34.5802001111006,-58.386084161541 -34.5800438700882,-58.3863642672098 -34.5797810755467,-58.3862977683641 -34.579714633861,-58.3862075007224 -34.5797496002848,-58.3861072157681 -34.5796729570866,-58.3862355038592 -34.5795799855157,-58.3861126854349 -34.5794846064759,-58.3860312083724 -34.5794627980008,-58.3857922893704 -34.5795883124707,-58.3850771505112 -34.5799447673755,-58.3849291791075 -34.5800280196586,-58.3850391147125 -34.5800919481253,-58.3851384423357 -34.5801899859188,-58.3845797388283 -34.5805183735739,-58.384663090568 -34.5805945917427,-58.3848242503381 -34.5808639968557)))";;"3482";1_2_3;COMUNA 1;"2";"3";"337";"170";"167";"101,80%";"104";"104";"100,00%";"0";"0,00%";"104";"25";"24.04";"79";"75,96%";"24.04";24.040
"MULTIPOLYGON (((-58.3835643062297 -34.5815282661593,-58.3848242503381 -34.5808639968556,-58.384663090568 -34.5805945917427,-58.3845797388283 -34.5805183735739,-58.3851384423357 -34.5801899859188,-58.3850391147125 -34.5800919481253,-58.3849291791075 -34.5800280196586,-58.3841459578852 -34.5804271686967,-58.3841224828591 -34.5804487979749,-58.3838673692239 -34.5805939916412,-58.3838502395317 -34.5806137437619,-58.3835226108929 -34.5807823157765,-58.3834874736387 -34.580804491044,-58.3836221800292 -34.5808917140259,-58.3837181432629 -34.5809904444499,-58.3834765914755 -34.5811061612852,-58.3836800503337 -34.5812681249773,-58.3835643062297 -34.5815282661593)))";;"3483";1_2_5;COMUNA 1;"2";"5";"307";"174";"133";"130,83%";"82";"82";"100,00%";"0";"0,00%";"95";"16";"16.84";"79";"83,16%";"16.84";16.840
"MULTIPOLYGON (((-58.3826696832532 -34.5817937250612,-58.3827979316697 -34.5818787184621,-58.3835643062297 -34.5815282661593,-58.3836800503337 -34.5812681249773,-58.3834765914755 -34.5811061612852,-58.3837181432629 -34.5809904444499,-58.3836221800292 -34.5808917140259,-58.3834874736387 -34.580804491044,-58.38336062585 -34.5806833526768,-58.3822776711684 -34.5813560159448,-58.3824640479668 -34.5815903773889,-58.3814636905672 -34.5820872922224,-58.3816381626162 -34.5822345655519,-58.3817061566522 -34.5823058568614,-58.3820879307777 -34.5821059844013,-58.3826696832532 -34.5817937250612)))";;"3484";1_2_6;COMUNA 1;"2";"6";"732";"366";"366";"100,00%";"180";"180";"100,00%";"0";"0,00%";"215";"57";"26.51";"158";"73,49%";"26.51";26.510
"MULTIPOLYGON (((-58.3817061566522 -34.5823058568614,-58.3816381626162 -34.5822345655519,-58.3814636905672 -34.5820872922224,-58.381350343495 -34.582146238592,-58.3806158560572 -34.5824746435148,-58.3804864407243 -34.5825292800519,-58.37994357131 -34.5827307259528,-58.3796488964525 -34.5828317956587,-58.3799772462967 -34.5831567904321,-58.3800902906335 -34.5832865523107,-58.3801100168901 -34.583447743735,-58.3802194323572 -34.5834034115235,-58.3803030547041 -34.5832998535303,-58.380404577202 -34.5831930182004,-58.3804881586189 -34.5831305769064,-58.3805162362707 -34.5830876173561,-58.3806176038668 -34.5829828888702,-58.3808738833625 -34.5827990887164,-58.3811852419691 -34.5825878162703,-58.3816712329154 -34.5823138093666,-58.3817061566522 -34.5823058568614)))";;"3485";1_2_8;COMUNA 1;"2";"8";"486";"266";"220";"120,91%";"135";"135";"100,00%";"0";"0,00%";"145";"55";"37.93";"90";"62,07%";"37.93";37.930
"MULTIPOLYGON (((-58.3794969392753 -34.5825900634062,-58.3792538308576 -34.5823382674382,-58.3791771247445 -34.5822389151367,-58.3790510535325 -34.5822878448853,-58.3788706821169 -34.582395894566,-58.3788847182075 -34.5824476077366,-58.3784956200882 -34.5826486567944,-58.3786818532614 -34.5828593002557,-58.3783513096101 -34.583047307166,-58.3784712296736 -34.5831741487564,-58.3785546218831 -34.583300846195,-58.3778821290265 -34.583650696295,-58.3777512036239 -34.5837362382214,-58.3779786558063 -34.5839120166753,-58.3781116795665 -34.5839981459538,-58.3782748468047 -34.5840767102633,-58.378499654078 -34.5837499585189,-58.3787117023388 -34.5834873679325,-58.3787722905125 -34.583430682272,-58.3789261596366 -34.5832843766449,-58.3790411046489 -34.5831796075055,-58.3792983026855 -34.5830039861247,-58.3796087015689 -34.5828204054818,-58.3793829523398 -34.5826189997833,-58.3794969392753 -34.5825900634062)))";;"3486";1_2_11;COMUNA 1;"2";"11";"611";"308";"303";"101,65%";"172";"172";"100,00%";"0";"0,00%";"200";"53";"26.5";"147";"73,50%";"26.5";26.500
"MULTIPOLYGON (((-58.3805848159148 -34.5812975077932,-58.3805912694178 -34.5812290586205,-58.3798473641002 -34.5803283076123,-58.3798382017374 -34.5801625788978,-58.3761619620597 -34.5799483186483,-58.3751269621437 -34.5805351929169,-58.3758329630304 -34.5814421354896,-58.3759279469754 -34.5815733234387,-58.3763803317411 -34.5821243498051,-58.3765024522448 -34.5822967657414,-58.37662456939 -34.5824729278449,-58.3767105119888 -34.5825891236038,-58.3772901033118 -34.5832910562935,-58.3784956200882 -34.5826486567944,-58.3788847182075 -34.5824476077366,-58.3788706821169 -34.582395894566,-58.3790510535325 -34.5822878448853,-58.3791771247445 -34.5822389151367,-58.3791008505578 -34.5821335769211,-58.3805848159148 -34.5812975077932)))";;"3487";1_2_12;COMUNA 1;"2";"12";"1225";"636";"589";"107,98%";"342";"341";"99,71%";"1";"0,29%";"366";"111";"30.33";"255";"69,67%";"30.33";30.330
"MULTIPOLYGON (((-58.3777512036239 -34.5837362382214,-58.3778821290265 -34.583650696295,-58.3785546218831 -34.583300846195,-58.3784712296736 -34.5831741487564,-58.37835130961 -34.583047307166,-58.3786818532614 -34.5828593002557,-58.3784956200882 -34.5826486567944,-58.3772901033118 -34.5832910562935,-58.3774852988573 -34.5835033393716,-58.3775935489272 -34.583621347648,-58.3777512036239 -34.5837362382214)))";;"3488";1_2_13;COMUNA 1;"2";"13";"476";"234";"242";"96,69%";"122";"122";"100,00%";"0";"0,00%";"162";"37";"22.84";"125";"77,16%";"22.84";22.840
"MULTIPOLYGON (((-58.3775935489272 -34.583621347648,-58.3774852988573 -34.5835033393716,-58.3772901033118 -34.5832910562935,-58.3764362898041 -34.5837931987455,-58.3757794905326 -34.5841916226563,-58.3760023944834 -34.5844737037903,-58.3766594402643 -34.5841252316493,-58.3775935489272 -34.583621347648)))";;"3489";1_2_14;COMUNA 1;"2";"14";"688";"331";"357";"92,72%";"168";"168";"100,00%";"0";"0,00%";"261";"96";"36.78";"165";"63,22%";"36.78";36.780
"MULTIPOLYGON (((-58.3771059801133 -34.5847063772867,-58.3774631215476 -34.5845235145031,-58.3773422178716 -34.5843744328294,-58.3775373201071 -34.5841591168383,-58.3776667812408 -34.5839602015514,-58.3777092241823 -34.5837684343282,-58.377751203624 -34.5837362382214,-58.3775935489272 -34.583621347648,-58.3766594402643 -34.5841252316493,-58.3768732066264 -34.5844071113187,-58.3771059801133 -34.5847063772867)))";;"3490";1_2_15;COMUNA 1;"2";"15";"757";"377";"380";"99,21%";"154";"154";"100,00%";"0";"0,00%";"278";"97";"34.89";"181";"65,11%";"34.89";34.890
"MULTIPOLYGON (((-58.3773249020546 -34.5850210744855,-58.3773954245036 -34.5850184968884,-58.377878892782 -34.5847869348504,-58.3780654246617 -34.5846883839163,-58.3780311963076 -34.5846143498522,-58.3779909821867 -34.5845600477099,-58.3779140565807 -34.5845041439102,-58.378092650857 -34.584313417147,-58.3782748468047 -34.5840767102633,-58.3781116795665 -34.5839981459538,-58.3779786558063 -34.5839120166753,-58.3777512036239 -34.5837362382214,-58.3777092241823 -34.5837684343282,-58.3776667812408 -34.5839602015514,-58.3775373201071 -34.5841591168383,-58.3773422178716 -34.5843744328294,-58.3774631215476 -34.5845235145031,-58.3771059801133 -34.5847063772867,-58.3773249020546 -34.5850210744855)))";;"3491";1_2_17;COMUNA 1;"2";"17";"712";"347";"365";"95,07%";"162";"162";"100,00%";"0";"0,00%";"227";"52";"22.91";"175";"77,09%";"22.91";22.910
"MULTIPOLYGON (((-58.3787722905125 -34.583430682272,-58.3787117023388 -34.5834873679325,-58.378499654078 -34.5837499585189,-58.3782748468047 -34.5840767102633,-58.378092650857 -34.584313417147,-58.3779140565807 -34.5845041439102,-58.3779909821867 -34.58456004771,-58.3780311963076 -34.5846143498522,-58.3780654246617 -34.5846883839163,-58.3781026934849 -34.5847056788303,-58.3781474370821 -34.5847057098364,-58.378194630044 -34.5846803014737,-58.378363964091 -34.5845691429254,-58.3784237775181 -34.5845306757456,-58.3784773035628 -34.5844875207318,-58.3785207696204 -34.5844370733643,-58.3786206389771 -34.5842977464536,-58.3785878607217 -34.5842644192204,-58.3786801832138 -34.5841636784824,-58.3788056305788 -34.5839984750401,-58.3788818092271 -34.5838838113656,-58.3789804111673 -34.5837173557905,-58.3790400902214 -34.5836686821616,-58.3789558537636 -34.5835926481556,-58.3789043044098 -34.5835478596483,-58.3787722905125 -34.583430682272)))";;"3492";1_2_18;COMUNA 1;"2";"18";"480";"239";"241";"99,17%";"126";"126";"100,00%";"0";"0,00%";"148";"33";"22.3";"115";"77,70%";"22.3";22.300
"MULTIPOLYGON (((-58.3790400902214 -34.5836686821616,-58.3793251717822 -34.583478291705,-58.3797019873947 -34.5832988358623,-58.3799235195061 -34.5831925256706,-58.3799772462967 -34.5831567904321,-58.3796488964525 -34.5828317956587,-58.3796087015689 -34.5828204054818,-58.3792983026855 -34.5830039861247,-58.3790411046489 -34.5831796075055,-58.3789261596366 -34.5832843766449,-58.3787722905125 -34.583430682272,-58.3789043044098 -34.5835478596482,-58.3789558537636 -34.5835926481556,-58.3790400902214 -34.5836686821616)))";;"3493";1_2_10;COMUNA 1;"2";"10";"327";"145";"182";"79,67%";"59";"59";"100,00%";"0";"0,00%";"88";"16";"18.18";"72";"81,82%";"18.18";18.180
"MULTIPOLYGON (((-58.3822776711684 -34.5813560159448,-58.38109709828 -34.581904793844,-58.3795882539056 -34.582556603127,-58.3794969392753 -34.5825900634062,-58.3793829523398 -34.5826189997833,-58.3796087015689 -34.5828204054818,-58.3796488964525 -34.5828317956587,-58.37994357131 -34.5827307259528,-58.3804864407243 -34.5825292800519,-58.3806158560572 -34.5824746435148,-58.381350343495 -34.582146238592,-58.3814636905672 -34.5820872922224,-58.3824640479668 -34.5815903773889,-58.3822776711684 -34.5813560159448)))";;"3494";1_2_7;COMUNA 1;"2";"7";"438";"217";"221";"98,19%";"77";"77";"100,00%";"0";"0,00%";"151";"51";"33.77";"100";"66,23%";"33.77";33.770
"MULTIPOLYGON (((-58.3799772462967 -34.5831567904321,-58.3799235195061 -34.5831925256706,-58.3797019873946 -34.5832988358623,-58.3793251717822 -34.583478291705,-58.3790400902214 -34.5836686821616,-58.3789804111673 -34.5837173557905,-58.3788818092271 -34.5838838113656,-58.3788056305788 -34.5839984750401,-58.3786801832138 -34.5841636784824,-58.3785878607217 -34.5842644192204,-58.3786206389771 -34.5842977464536,-58.3786993222647 -34.5843541097773,-58.3787619955942 -34.5843217733788,-58.3789330493401 -34.5842119933058,-58.3789605634718 -34.584174972729,-58.3790305381922 -34.5841118692137,-58.3791833370838 -34.5839995706787,-58.3793068273329 -34.5839260417017,-58.3795223415809 -34.5838001798716,-58.3796519542703 -34.583943354781,-58.3797354062453 -34.584012487848,-58.3797944122846 -34.5841050207334,-58.3799612872403 -34.584055287945,-58.380004156511 -34.583918048857,-58.3801057468574 -34.5837437821947,-58.3801396974991 -34.5835974291669,-58.3801100168901 -34.583447743735,-58.3800902906335 -34.5832865523107,-58.3799772462967 -34.5831567904321)))";;"3495";1_2_9;COMUNA 1;"2";"9";"511";"259";"252";"102,78%";"99";"99";"100,00%";"0";"0,00%";"156";"54";"34.62";"102";"65,38%";"34.62";34.620
"MULTIPOLYGON (((-58.3797354062453 -34.584012487848,-58.3796519542703 -34.583943354781,-58.3795223415809 -34.5838001798716,-58.3793068273329 -34.5839260417017,-58.3791833370838 -34.5839995706787,-58.3790305381922 -34.5841118692137,-58.3789605634718 -34.584174972729,-58.3789330493401 -34.5842119933058,-58.3787619955942 -34.5843217733788,-58.3786993222647 -34.5843541097773,-58.3786206389771 -34.5842977464536,-58.3785207696204 -34.5844370733643,-58.3784773035628 -34.5844875207318,-58.3784237775181 -34.5845306757456,-58.378194630044 -34.5846803014737,-58.3781474370821 -34.5847057098363,-58.3781026934849 -34.5847056788303,-58.3780654246617 -34.5846883839163,-58.377878892782 -34.5847869348504,-58.3773954245036 -34.5850184968884,-58.3773249020546 -34.5850210744855,-58.3770368796876 -34.5851745276998,-58.3770686592414 -34.5852434433001,-58.3770885101543 -34.5854068677825,-58.3771030804696 -34.5853995971191,-58.3790679120869 -34.5843684345806,-58.3797354062453 -34.584012487848)))";;"3496";1_2_19;COMUNA 1;"2";"19";"547";"277";"270";"102,59%";"99";"99";"100,00%";"0";"0,00%";"200";"57";"28.5";"143";"71,50%";"28.5";28.500
"MULTIPOLYGON (((-58.3766594402643 -34.5841252316493,-58.3760023944834 -34.5844737037903,-58.3757794905326 -34.5841916226563,-58.3756481811196 -34.5842222129066,-58.3755367870144 -34.5843118246194,-58.3766327692747 -34.5856386794104,-58.3769275628094 -34.585686321587,-58.3770532176402 -34.5858118710261,-58.3770537566925 -34.5858590053353,-58.3771114213659 -34.5857385981849,-58.3770811738574 -34.5854753688584,-58.3770885101543 -34.5854068677825,-58.3770686592414 -34.5852434433001,-58.3770368796876 -34.5851745276998,-58.3773249020546 -34.5850210744855,-58.3771059801133 -34.5847063772867,-58.3768732066264 -34.5844071113187,-58.3766594402643 -34.5841252316493)))";;"3497";1_2_16;COMUNA 1;"2";"16";"1128";"570";"558";"102,15%";"376";"376";"100,00%";"0";"0,00%";"444";"172";"38.74";"272";"61,26%";"38.74";38.740
"MULTIPOLYGON (((-58.3902517084077 -34.579980820677,-58.3909067704927 -34.5797334501142,-58.3901554646791 -34.5786072583635,-58.3899149107137 -34.5782401325995,-58.3894841817129 -34.5782256801809,-58.3890928554348 -34.5785518913069,-58.3884222839008 -34.5790142948507,-58.3888117136387 -34.5794238851298,-58.3885789173822 -34.5795309898794,-58.3884720660799 -34.5797214004945,-58.388681301231 -34.5799723146374,-58.3887827596218 -34.5800904334713,-58.3891121472915 -34.5800974435084,-58.3896869153752 -34.5798584809979,-58.3900976311313 -34.5797984893254,-58.3902517084077 -34.579980820677)))";;"3498";1_3_1;COMUNA 1;"3";"1";"594";"322";"272";"118,38%";"168";"168";"100,00%";"0";"0,00%";"191";"58";"30.37";"133";"69,63%";"30.37";30.370
"MULTIPOLYGON (((-58.3884114227417 -34.5797435180313,-58.3884720660799 -34.5797214004945,-58.3885789173822 -34.5795309898794,-58.3888117136387 -34.5794238851298,-58.3884222839008 -34.5790142948507,-58.3880061645226 -34.5792742286292,-58.386725758408 -34.5799598673574,-58.3862019867187 -34.5802001111006,-58.385453170752 -34.5805556843841,-58.3851358713451 -34.580718700498,-58.3853845592122 -34.5809623892845,-58.3855213719921 -34.5809091175333,-58.3854645764896 -34.5807867035766,-58.3857321489942 -34.5806762616903,-58.3858469896612 -34.5807913362588,-58.3861479731878 -34.5806574282492,-58.3862503408455 -34.580609645206,-58.3863134667538 -34.5805946706433,-58.3865170036675 -34.5805040540637,-58.3865482507446 -34.5804660261083,-58.3865855450129 -34.5804571692991,-58.3866778136079 -34.58042184948,-58.3868168961375 -34.580393399062,-58.3869350788066 -34.5803528289211,-58.3870564081565 -34.5803010187796,-58.3871024164733 -34.5802958587451,-58.3876782105614 -34.5800252007472,-58.3880045082017 -34.5799016158157,-58.3884114227417 -34.5797435180313)))";;"3499";1_3_2;COMUNA 1;"3";"2";"564";"283";"281";"100,71%";"156";"154";"98,72%";"2";"1,30%";"161";"58";"36.02";"103";"63,98%";"36.02";36.020
"MULTIPOLYGON (((-58.3876782105615 -34.5800252007473,-58.3871024164733 -34.5802958587452,-58.3870564081565 -34.5803010187796,-58.3869350788066 -34.5803528289211,-58.3868168961375 -34.580393399062,-58.3866778136079 -34.58042184948,-58.3865855450129 -34.5804571692991,-58.3865482507446 -34.5804660261083,-58.3865170042346 -34.5805034325505,-58.3863134667538 -34.5805946706433,-58.3862503408455 -34.580609645206,-58.3861479737576 -34.580656806736,-58.3858469896612 -34.5807913362588,-58.3857321489942 -34.5806762616903,-58.3854645764896 -34.5807867035766,-58.3855213719921 -34.5809091175333,-58.3853845592122 -34.5809623892845,-58.3854736323727 -34.5810794926369,-58.3856290717133 -34.5811214856615,-58.3856619610952 -34.5811979030949,-58.3858948269552 -34.5810044488586,-58.3862378512364 -34.5809139397674,-58.3862264258972 -34.5808906644279,-58.3866907435342 -34.5807295840585,-58.3869359656978 -34.5806659975337,-58.3881970949031 -34.5804825717308,-58.3885142624016 -34.5803408280984,-58.3885666946663 -34.5802542544351,-58.3885697058174 -34.580138782234,-58.3884114227417 -34.5797435180313,-58.3880045082017 -34.5799016158157,-58.3876782105615 -34.5800252007473)))";;"3500";1_3_3;COMUNA 1;"3";"3";"659";"314";"345";"91,01%";"174";"174";"100,00%";"0";"0,00%";"200";"60";"30";"140";"70,00%";"30";30.000
"MULTIPOLYGON (((-58.3900976311313 -34.5797984893254,-58.3896869153752 -34.5798584809979,-58.3891121472915 -34.5800974435084,-58.3887827596218 -34.5800904334713,-58.388681301231 -34.5799723146374,-58.3884720660799 -34.5797214004946,-58.3884114227417 -34.5797435180313,-58.3885697058174 -34.580138782234,-58.3885666946663 -34.5802542544351,-58.3885142624016 -34.5803408280984,-58.3881970949031 -34.5804825717308,-58.3869359656978 -34.5806659975337,-58.3866907435342 -34.5807295840585,-58.3862264258972 -34.5808906644279,-58.3862378512364 -34.5809139397674,-58.3858948269552 -34.5810044488586,-58.3860047237579 -34.5811425854809,-58.3861552206465 -34.5811527793662,-58.3862577835053 -34.5811793426388,-58.3863622249333 -34.5811599528318,-58.3864192440482 -34.5811378902255,-58.386486919496 -34.5811497182392,-58.3865616969901 -34.5811865953357,-58.3867086090767 -34.5812816805171,-58.3871990472724 -34.5810815211551,-58.3874856037522 -34.5809541302488,-58.3878194905929 -34.580835458302,-58.3881402363642 -34.5806922615241,-58.3890192093335 -34.5804158304687,-58.3897151737388 -34.5801779290113,-58.3902517084077 -34.579980820677,-58.3900976311313 -34.5797984893254)))";;"3501";1_3_23;COMUNA 1;"3";"23";"837";"424";"413";"102,66%";"280";"280";"100,00%";"0";"0,00%";"267";"105";"39.33";"162";"60,67%";"39.33";39.330
"MULTIPOLYGON (((-58.3874022455432 -34.5821901799643,-58.3878734793099 -34.5828404963691,-58.3880906627529 -34.5826903414949,-58.3883416710089 -34.5825167551786,-58.3883919383108 -34.5824846718034,-58.3884427136573 -34.58245575786,-58.3886280058675 -34.5823541057252,-58.3887903806529 -34.5822655385592,-58.3889326496076 -34.5821883679435,-58.389024485542 -34.582139921787,-58.3891664124647 -34.5820623066505,-58.3893578343882 -34.5819598824132,-58.3895016344376 -34.5818833458787,-58.3896332969139 -34.5818122959202,-58.3896844789239 -34.5817851260739,-58.3897717689179 -34.5817407552514,-58.3899343085288 -34.581655707923,-58.3900262263975 -34.5816080142487,-58.3901874012053 -34.5815251489567,-58.3904294180214 -34.5814011324695,-58.3905501285335 -34.5813386661034,-58.3906102710314 -34.5813072214733,-58.3906703284565 -34.5812756359124,-58.3907172671708 -34.581250662576,-58.3907991334676 -34.5812065540845,-58.3909216351228 -34.5811399333032,-58.3910239490782 -34.5810847727081,-58.3910944824159 -34.5810467211307,-58.391170213857 -34.5810069751663,-58.3912907517436 -34.5809459164705,-58.3913929670231 -34.5809029462889,-58.3915323076856 -34.5808592229947,-58.391653517558 -34.58082890055,-58.3916110971341 -34.5807657391842,-58.3912234899015 -34.5801886110557,-58.3910040158461 -34.5798811573486,-58.3909067704927 -34.5797334501142,-58.3902517084077 -34.579980820677,-58.3897151737388 -34.5801779290113,-58.3890192093335 -34.5804158304687,-58.3881402363642 -34.5806922615241,-58.3878194905929 -34.580835458302,-58.3874856037522 -34.5809541302488,-58.3871990472724 -34.5810815211551,-58.3867086090767 -34.5812816805171,-58.3866997473839 -34.5814181394645,-58.3868368637926 -34.5815741765754,-58.3874022455432 -34.5821901799643)))";;"3502";1_3_22;COMUNA 1;"3";"22";"670";"359";"311";"115,43%";"197";"197";"100,00%";"0";"0,00%";"205";"76";"37.07";"129";"62,93%";"37.07";37.070
"MULTIPOLYGON (((-58.3851358713451 -34.580718700498,-58.3848242503381 -34.5808639968557,-58.3835643062297 -34.5815282661593,-58.3840164169386 -34.5821763467243,-58.384857308059 -34.5817258157047,-58.3851224976592 -34.5816017494115,-58.3852647085657 -34.5815251158354,-58.3853069026483 -34.5815323475298,-58.3853334784949 -34.5815095248375,-58.3855356252015 -34.5813511353981,-58.3856619610952 -34.5811979030949,-58.3856290717133 -34.5811214856615,-58.3854736323727 -34.5810794926369,-58.3853845592122 -34.5809623892845,-58.3851358713451 -34.580718700498)))";;"3503";1_3_4;COMUNA 1;"3";"4";"428";"226";"202";"111,88%";"133";"133";"100,00%";"0";"0,00%";"132";"45";"34.09";"87";"65,91%";"34.09";34.090
"MULTIPOLYGON (((-58.3867086090767 -34.5812816805171,-58.3865616969901 -34.5811865953357,-58.386486919496 -34.5811497182392,-58.3864192440482 -34.5811378902255,-58.3863622249333 -34.5811599528318,-58.3862577835053 -34.5811793426388,-58.3861552206465 -34.5811527793662,-58.3860047237579 -34.5811425854809,-58.3858948269552 -34.5810044488586,-58.3856619610952 -34.5811979030949,-58.3855356252015 -34.5813511353981,-58.3853334784949 -34.5815095248375,-58.3853069026483 -34.5815323475298,-58.3852647085657 -34.5815251158354,-58.3851224976592 -34.5816017494115,-58.384857308059 -34.5817258157047,-58.3840164169386 -34.5821763467243,-58.3838795905986 -34.5822519173386,-58.3836643570664 -34.58235467433,-58.3836870118068 -34.5824700067255,-58.3838006801098 -34.5826301130202,-58.3839370862007 -34.582818474955,-58.384213973957 -34.5826753761926,-58.3842378517025 -34.5826593559691,-58.3844619098442 -34.5825559538387,-58.3847855408304 -34.5823851147162,-58.3855097255888 -34.5820040103614,-58.3864681439656 -34.581491384114,-58.3866845121429 -34.5814009294095,-58.3866997473839 -34.5814181394645,-58.3867086090767 -34.5812816805171)))";;"3504";1_3_19;COMUNA 1;"3";"19";"1017";"536";"481";"111,43%";"311";"311";"100,00%";"0";"0,00%";"343";"88";"25.66";"255";"74,34%";"25.66";25.660
"MULTIPOLYGON (((-58.3866845121429 -34.5814009294095,-58.3864681439656 -34.581491384114,-58.3855097255888 -34.5820040103614,-58.3847855408304 -34.5823851147162,-58.3844619098442 -34.5825559538387,-58.3842378517025 -34.5826593559691,-58.3842754831274 -34.5826622296559,-58.3843761808188 -34.5827551669484,-58.3846107552319 -34.5829513801706,-58.3858017242065 -34.5822514124212,-58.3867142408648 -34.5816272219823,-58.3868368637926 -34.5815741765754,-58.3866997473839 -34.5814181394645,-58.3866845121429 -34.5814009294095)))";;"3505";1_3_20;COMUNA 1;"3";"20";"397";"203";"194";"104,64%";"109";"109";"100,00%";"0";"0,00%";"115";"33";"28.7";"82";"71,30%";"28.7";28.700
"MULTIPOLYGON (((-58.3842754831274 -34.5826622296559,-58.3842378517025 -34.5826593559691,-58.384213973957 -34.5826753761926,-58.3839370862007 -34.582818474955,-58.3836311019571 -34.5829702338185,-58.3829625849791 -34.5832731311823,-58.3829514136277 -34.5832838851037,-58.3831938100587 -34.5835530825167,-58.3835650609262 -34.5833910735508,-58.3837488283315 -34.5833449075713,-58.384432584555 -34.5830113766136,-58.384610755232 -34.5829513801706,-58.3843761808188 -34.5827551669484,-58.3842754831274 -34.5826622296559)))";;"3506";1_3_18;COMUNA 1;"3";"18";"783";"411";"372";"110,48%";"175";"175";"100,00%";"0";"0,00%";"231";"79";"34.2";"152";"65,80%";"34.2";34.200
"MULTIPOLYGON (((-58.3836870118068 -34.5824700067255,-58.3835491453184 -34.5825536956864,-58.3833419469197 -34.5826480126966,-58.3830727936189 -34.5827582976865,-58.3828733518881 -34.5828366102199,-58.3825538501516 -34.5829692733525,-58.3824286888119 -34.5830450324911,-58.3824573392578 -34.5830835785318,-58.3824381314339 -34.583102380544,-58.3820950973787 -34.583244797327,-58.3821470473205 -34.5833175397267,-58.3822494950143 -34.5833081936093,-58.3824808700926 -34.5833711038413,-58.3825414750763 -34.5834746942542,-58.3829514136277 -34.5832838851037,-58.3829625849791 -34.5832731311823,-58.3836311019571 -34.5829702338185,-58.3839370862007 -34.582818474955,-58.3838006801098 -34.5826301130202,-58.3836870118068 -34.5824700067255)))";;"3507";1_3_17;COMUNA 1;"3";"17";"571";"277";"294";"94,22%";"187";"187";"100,00%";"0";"0,00%";"182";"53";"29.12";"129";"70,88%";"29.12";29.120
"MULTIPOLYGON (((-58.38234767464 -34.5829412725806,-58.3824861809117 -34.5828891852102,-58.3825538501516 -34.5829692733525,-58.3828733518881 -34.5828366102199,-58.3830727936189 -34.5827582976865,-58.3833419469197 -34.5826480126966,-58.3835491453184 -34.5825536956864,-58.3836870118068 -34.5824700067255,-58.3836643570664 -34.5823546743299,-58.3838795905986 -34.5822519173386,-58.3840164169386 -34.5821763467244,-58.3835643062297 -34.5815282661593,-58.3827979316697 -34.5818787184621,-58.3830010432474 -34.5820962212851,-58.3824127059758 -34.5824147257215,-58.3820143899385 -34.582629920987,-58.3819730866211 -34.5827337759498,-58.3821094524048 -34.5829597946588,-58.38234767464 -34.5829412725806)))";;"3508";1_3_5;COMUNA 1;"3";"5";"1283";"688";"595";"115,63%";"232";"232";"100,00%";"0";"0,00%";"412";"161";"39.08";"251";"60,92%";"39.08";39.080
"MULTIPOLYGON (((-58.3824573401233 -34.583082678041,-58.3824286888119 -34.5830450324911,-58.3825538501516 -34.5829692733525,-58.3824861809117 -34.5828891852102,-58.3823476746401 -34.5829412725806,-58.3821094524048 -34.5829597946588,-58.3819730866211 -34.5827337759498,-58.3820143899385 -34.582629920987,-58.3818606017469 -34.5827075119264,-58.3817643915145 -34.5827509877413,-58.3815031726072 -34.582897840749,-58.3811815196046 -34.5830863061076,-58.3811704326731 -34.5830771216709,-58.3811599528586 -34.5830834948915,-58.3811062217421 -34.5831199559807,-58.3810689825395 -34.5831511256099,-58.380916639308 -34.5832588828396,-58.3807782001478 -34.5833695998367,-58.3807581703042 -34.5833721435957,-58.3806874748918 -34.5834318394636,-58.3805939715867 -34.583523170493,-58.3805081827289 -34.5836195908926,-58.3804303893255 -34.5837208193766,-58.3803608555716 -34.5838265617344,-58.380321822073 -34.5838603494305,-58.380197460766 -34.5841230839114,-58.3805240583221 -34.5839797160185,-58.381031223933 -34.5837058973666,-58.3812083026172 -34.5836150273393,-58.3818890899355 -34.5832394239447,-58.3820384096587 -34.5831654207291,-58.3820950973787 -34.583244797327,-58.3824381322996 -34.5831014800531,-58.3824573401233 -34.583082678041)))";;"3509";1_3_7;COMUNA 1;"3";"7";"403";"201";"202";"99,50%";"108";"108";"100,00%";"0";"0,00%";"148";"52";"35.14";"96";"64,86%";"35.14";35.140
"MULTIPOLYGON (((-58.3820143899385 -34.582629920987,-58.3824127059758 -34.5824147257215,-58.3830010432474 -34.5820962212851,-58.3827979316697 -34.5818787184621,-58.3826696832532 -34.5817937250612,-58.3820879307777 -34.5821059844013,-58.3817061566522 -34.5823058568614,-58.3816712329154 -34.5823138093666,-58.3811852419691 -34.5825878162703,-58.3808738833625 -34.5827990887164,-58.3806176038668 -34.5829828888702,-58.3805162362707 -34.5830876173561,-58.3804881586189 -34.5831305769064,-58.380404577202 -34.5831930182004,-58.3803030547041 -34.5832998535303,-58.3802194323572 -34.5834034115235,-58.3801100168901 -34.583447743735,-58.3801396974991 -34.5835974291669,-58.3801057468574 -34.5837437821947,-58.380004156511 -34.583918048857,-58.3799612872403 -34.584055287945,-58.3800035895296 -34.5840616672742,-58.3801008536926 -34.5839807913034,-58.380321822073 -34.5838603494305,-58.3803608555716 -34.5838265617344,-58.3804303893255 -34.5837208193765,-58.3805081827289 -34.5836195908926,-58.3805852853488 -34.5835324175295,-58.3806874748918 -34.5834318394636,-58.3807581703042 -34.5833721435957,-58.3807782001478 -34.5833695998367,-58.380916639308 -34.5832588828396,-58.3810689825395 -34.5831511256099,-58.3811062217421 -34.5831199559807,-58.3811599528586 -34.5830834948915,-58.3811704326731 -34.5830771216709,-58.3811815196046 -34.5830863061076,-58.3815031726072 -34.582897840749,-58.3817643915145 -34.5827509877413,-58.3818606017469 -34.5827075119264,-58.3820143899385 -34.582629920987)))";;"3510";1_3_6;COMUNA 1;"3";"6";"1027";"506";"521";"97,12%";"252";"252";"100,00%";"0";"0,00%";"341";"104";"30.5";"237";"69,50%";"30.5";30.500
"MULTIPOLYGON (((-58.381031223933 -34.5837058973666,-58.3805240583221 -34.5839797160185,-58.380197460766 -34.5841230839114,-58.3803693230008 -34.5843063738658,-58.3811714287643 -34.5838848512083,-58.3821470473206 -34.5833175397267,-58.3820950973787 -34.583244797327,-58.3820384096587 -34.5831654207292,-58.3818890899355 -34.5832394239447,-58.3812083026172 -34.5836150273393,-58.381031223933 -34.5837058973666)))";;"3511";1_3_16;COMUNA 1;"3";"16";"726";"385";"341";"112,90%";"202";"202";"100,00%";"0";"0,00%";"254";"114";"44.88";"140";"55,12%";"44.88";44.880
"MULTIPOLYGON (((-58.3825414750763 -34.5834746942542,-58.3824808700926 -34.5833711038413,-58.3822494950143 -34.5833081936093,-58.3821470473205 -34.5833175397267,-58.3811714287643 -34.5838848512083,-58.3803693230009 -34.5843063738658,-58.3802862892308 -34.5843500867396,-58.3804684817083 -34.5845421591088,-58.3808613781888 -34.5843113288963,-58.3825414750763 -34.5834746942542)))";;"3512";1_3_15;COMUNA 1;"3";"15";"843";"440";"403";"109,18%";"263";"263";"100,00%";"0";"0,00%";"310";"105";"33.87";"205";"66,13%";"33.87";33.870
"MULTIPOLYGON (((-58.3829514136277 -34.5832838851037,-58.3825414750763 -34.5834746942542,-58.3808613781888 -34.5843113288963,-58.3809977690548 -34.5844354283586,-58.3815220850071 -34.5842058547244,-58.3831938100587 -34.5835530825167,-58.3829514136277 -34.5832838851037)))";;"3513";1_3_14;COMUNA 1;"3";"14";"471";"249";"222";"112,16%";"133";"133";"100,00%";"0";"0,00%";"147";"62";"42.18";"85";"57,82%";"42.18";42.180
"MULTIPOLYGON (((-58.3835650609262 -34.5833910735508,-58.3831938100587 -34.5835530825166,-58.381522085007 -34.5842058547244,-58.3809977690548 -34.5844354283586,-58.3808464320015 -34.5845085105851,-58.3812495537425 -34.5847642290486,-58.3821175493737 -34.5842991845919,-58.3836690754904 -34.5834796393201,-58.3835650609262 -34.5833910735508)))";;"3514";1_3_13;COMUNA 1;"3";"13";"381";"205";"176";"116,48%";"91";"91";"100,00%";"0";"0,00%";"118";"56";"47.46";"62";"52,54%";"47.46";47.460
"MULTIPOLYGON (((-58.3790679120867 -34.5843684345735,-58.3770885101543 -34.5854068677825,-58.3770811738574 -34.5854753688584,-58.3771114213659 -34.5857385981849,-58.3772053258581 -34.5857314918295,-58.377351122042 -34.5855475130498,-58.3778725538552 -34.5851901776786,-58.3779082046177 -34.5851523691001,-58.3780731911221 -34.5850481839347,-58.3787514425253 -34.584667830974,-58.3788483427589 -34.5846297686025,-58.3791446896063 -34.5844719992433,-58.3797944122846 -34.5841050207334,-58.3797354062453 -34.584012487848,-58.3790679120867 -34.5843684345735)))";;"3515";1_3_8;COMUNA 1;"3";"8";"797";"374";"423";"88,42%";"286";"286";"100,00%";"0";"0,00%";"257";"89";"34.63";"168";"65,37%";"34.63";34.630
"MULTIPOLYGON (((-58.3779082046177 -34.5851523691001,-58.3778725538552 -34.5851901776786,-58.3782713002703 -34.5855958025911,-58.378507696053 -34.5853812791047,-58.3788472042662 -34.5851865928099,-58.3789131553924 -34.5852116936051,-58.3789778254366 -34.5851716491841,-58.3790181878109 -34.5852028570443,-58.3791677345549 -34.5851127596876,-58.3792172964289 -34.5851622344799,-58.3796229178467 -34.5849781024106,-58.379460502841 -34.5847713283895,-58.3795224165904 -34.5847326622253,-58.3797490192705 -34.584608271703,-58.3798048830258 -34.5846705273599,-58.3801146249272 -34.5845237871922,-58.3801381310408 -34.5844381641665,-58.3801085925189 -34.5843912466714,-58.3801825900457 -34.5843556138365,-58.3802862892308 -34.5843500867396,-58.3803693230008 -34.5843063738658,-58.380197460766 -34.5841230839114,-58.380321822073 -34.5838603494304,-58.3801008536926 -34.5839807913034,-58.3800035895296 -34.5840616672744,-58.3799612872403 -34.584055287945,-58.3797944122846 -34.5841050207334,-58.3791446896063 -34.5844719992433,-58.3788483427588 -34.5846297686025,-58.3787514425253 -34.584667830974,-58.3780731911221 -34.5850481839347,-58.3779082046177 -34.5851523691001)))";;"3516";1_3_9;COMUNA 1;"3";"9";"1092";"528";"564";"93,62%";"372";"372";"100,00%";"0";"0,00%";"380";"136";"35.79";"244";"64,21%";"35.79";35.790
"MULTIPOLYGON (((-58.3836826730853 -34.5874961846054,-58.3838373043093 -34.5874163965732,-58.384317385724 -34.5870811760235,-58.3845074767953 -34.586956140005,-58.3847113977328 -34.5864528295136,-58.3850582940573 -34.5858795655915,-58.3853252002859 -34.5853834474545,-58.3855993091385 -34.5850143806391,-58.3859756507791 -34.5845886146303,-58.3864214464393 -34.584098381193,-58.3866428058206 -34.5838573827748,-58.3867336564576 -34.5837707456887,-58.3869635947458 -34.583551372613,-58.3874134362518 -34.5831888896634,-58.3878226116866 -34.5828768751105,-58.3878734793099 -34.5828404963691,-58.3874022455432 -34.5821901799643,-58.3868368637926 -34.5815741765754,-58.3867142408648 -34.5816272219823,-58.3858017242065 -34.5822514124212,-58.3846107552319 -34.5829513801706,-58.384432584555 -34.5830113766136,-58.3837488283315 -34.5833449075713,-58.3835650609262 -34.5833910735507,-58.3836690754904 -34.5834796393201,-58.3821175493737 -34.5842991845919,-58.3822173531821 -34.5844390453867,-58.3819004082432 -34.5847563603118,-58.3814487528882 -34.5849873925518,-58.3815620547732 -34.5851527769807,-58.378103668732 -34.5868569852894,-58.3778823885275 -34.5864902057974,-58.3786430508459 -34.5861097848125,-58.3785600580193 -34.5859845183159,-58.3788614343392 -34.5857821597537,-58.3787474128224 -34.5856435194577,-58.3785549845179 -34.5857745595781,-58.3783601433275 -34.5858766171237,-58.3782910959832 -34.5858404439529,-58.3783015614211 -34.5857788637434,-58.3783548483985 -34.5857251304986,-58.3784746521009 -34.5856596229187,-58.3785599896339 -34.5856339503,-58.3786518933529 -34.5855699184664,-58.3787742465889 -34.5854837315989,-58.3788800747942 -34.5854111414613,-58.3790080893639 -34.5853213141571,-58.3789852341576 -34.5852825940312,-58.3792172964289 -34.5851622344799,-58.3791677345549 -34.5851127596876,-58.3790181878109 -34.5852028570443,-58.3789778254366 -34.5851716491841,-58.3789131553924 -34.5852116936051,-58.3788472042662 -34.5851865928099,-58.378507696053 -34.5853812791047,-58.3782713002703 -34.5855958025911,-58.3778725538552 -34.5851901776786,-58.377351122042 -34.5855475130498,-58.3772053258581 -34.5857314918295,-58.3771114213659 -34.5857385981849,-58.3770560405543 -34.5858552836653,-58.3770537566925 -34.5858590053353,-58.3771413848715 -34.58603223638,-58.3772147454051 -34.5862397609208,-58.3772513488885 -34.5864186669828,-58.3726893235965 -34.5889914059596,-58.3734976811433 -34.5899830951109,-58.3737909069729 -34.5903576900843,-58.3736382080811 -34.590446741553,-58.3735516937449 -34.5904958460311,-58.374001304695 -34.590945612853,-58.3741530451682 -34.5911121801702,-58.3744314436999 -34.5914279155347,-58.3754398956107 -34.5926562241597,-58.3766700174054 -34.5918546012996,-58.3771294215245 -34.5915552646306,-58.3778553805851 -34.5910789921712,-58.3787492046658 -34.590492615319,-58.3794523588356 -34.5900710928065,-58.3794497097895 -34.59007483921,-58.3795393494004 -34.5900213770799,-58.3809054173486 -34.5892778341573,-58.3819683995856 -34.5886992231426,-58.3828356615704 -34.5882270988567,-58.3838433859003 -34.5876791725766,-58.3836826730853 -34.5874961846054)))";;"3517";1_3_21;COMUNA 1;"3";"21";"300";"150";"150";"100,00%";"108";"108";"100,00%";"0";"0,00%";"109";"32";"29.36";"77";"70,64%";"29.36";29.360
"MULTIPOLYGON (((-58.3638891678704 -34.6000018342418,-58.364696003996 -34.6000625086033,-58.3648082800618 -34.5990255875953,-58.3640016353561 -34.5989753584616,-58.3638891678704 -34.6000018342418)))";;"3518";1_13_2;COMUNA 1;"13";"2";"128";"60";"68";"88,24%";"183";"183";"100,00%";"0";"0,00%";"60";"0";"0";"60";"100,00%";"0";0.000
"MULTIPOLYGON (((-58.3615360785252 -34.6046371431964,-58.3622798187203 -34.6046997317009,-58.363379292511 -34.6047921843211,-58.3638010173176 -34.600453797465,-58.3637421519057 -34.6004498027802,-58.3630771584802 -34.6004046734473,-58.3615360785252 -34.6046371431964)))";;"3519";1_13_3;COMUNA 1;"13";"3";"45";"27";"18";"150,00%";"473";"472";"99,79%";"1";"0,21%";"20";"0";"0";"20";"100,00%";"0";0.000
"MULTIPOLYGON (((-58.3592349235092 -34.6111901004915,-58.3594342735662 -34.6106229161482,-58.3600231344963 -34.6106268575112,-58.3603607741542 -34.6105482716636,-58.3607574053892 -34.6102331255816,-58.3613080026003 -34.610021243331,-58.3615943694127 -34.6098637418966,-58.3618515012869 -34.6096091454148,-58.3619591163776 -34.609375695007,-58.3621720422662 -34.609391152878,-58.3618807822383 -34.6116061332954,-58.3624181371402 -34.611644605697,-58.3625409563571 -34.6116533688704,-58.3625495563087 -34.6116539802889,-58.3626926590107 -34.6105180930312,-58.3629708219999 -34.6080993693633,-58.3631390162222 -34.6065234431014,-58.3629401291428 -34.6065104105515,-58.36278724797 -34.606503947195,-58.3626382961821 -34.6064880499031,-58.362489274506 -34.6064594758499,-58.3623670943194 -34.6064214867235,-58.3622715740002 -34.6063834489963,-58.3621760726947 -34.6063297064071,-58.3621035839308 -34.6062633061961,-58.3620157830028 -34.6061810476535,-58.3619471425697 -34.606102044426,-58.3618937791052 -34.605997700736,-58.361874714149 -34.6059155692839,-58.3618443287375 -34.6058270902091,-58.361798519313 -34.6057448662079,-58.3617337199428 -34.6056595277698,-58.361657317954 -34.6055899549179,-58.3615771530787 -34.6055330554229,-58.3614931401998 -34.6054887587818,-58.3612789606035 -34.6053918872289,-58.3613960520226 -34.6050597187108,-58.3615360785252 -34.6046371431964,-58.3609335449723 -34.6045753135767,-58.3608162070359 -34.6049075401593,-58.3587772560183 -34.610709342122,-58.3587521980448 -34.6107899574805,-58.3587656199761 -34.6108875076359,-58.3587814555677 -34.6109621012722,-58.3588017564766 -34.6110762071707,-58.3588097777272 -34.6111330470297,-58.3592349235092 -34.6111901004915)))";;"3520";1_13_6;COMUNA 1;"13";"6";"192";"103";"89";"115,73%";"260";"260";"100,00%";"0";"0,00%";"100";"0";"0";"100";"100,00%";"0";0.000
"MULTIPOLYGON (((-58.3629708219999 -34.6080993693633,-58.3626926590107 -34.6105180930312,-58.3638666239204 -34.6105999415102,-58.3641345825585 -34.608168206015,-58.3629708219999 -34.6080993693633)))";;"3521";1_13_5;COMUNA 1;"13";"5";"295";"140";"155";"90,32%";"302";"302";"100,00%";"0";"0,00%";"154";"0";"0";"154";"100,00%";"0";0.000
"MULTIPOLYGON (((-58.3625495563087 -34.6116539802889,-58.3625880569518 -34.6116567175067,-58.3634219847465 -34.6117163447138,-58.3635377584894 -34.6117763001856,-58.3636245853797 -34.6118242597683,-58.363728293706 -34.6116973350467,-58.363735545654 -34.6116339204562,-58.3638666239204 -34.6105999415102,-58.3626926590107 -34.6105180930312,-58.3625495563087 -34.6116539802889)))";;"3522";1_13_8;COMUNA 1;"13";"8";"308";"153";"155";"98,71%";"347";"347";"100,00%";"0";"0,00%";"156";"2";"1.28";"154";"98,72%";"1.28";1.280
"MULTIPOLYGON (((-58.3592349235092 -34.6111901004915,-58.3591310645826 -34.6114845299863,-58.3595275498966 -34.6114378219771,-58.3618024233687 -34.6116005049374,-58.3618807822383 -34.6116061332954,-58.3621720422662 -34.609391152878,-58.3619591163776 -34.609375695007,-58.3618515012869 -34.6096091454148,-58.3615943694127 -34.6098637418966,-58.3613080026003 -34.610021243331,-58.3607574053892 -34.6102331255816,-58.3603607741542 -34.6105482716636,-58.3600231344963 -34.6106268575112,-58.3594342735662 -34.6106229161482,-58.3592349235092 -34.6111901004915)))";;"3523";1_13_7;COMUNA 1;"13";"7";"505";"262";"243";"107,82%";"561";"561";"100,00%";"0";"0,00%";"241";"0";"0";"241";"100,00%";"0";0.000
"MULTIPOLYGON (((-58.3610565004671 -34.6160739179046,-58.3618914091498 -34.616132852152,-58.3620737740494 -34.6161457496355,-58.3621016700434 -34.6161477172009,-58.3628880712605 -34.6162031811347,-58.3630384739873 -34.6148771305783,-58.3622386695877 -34.6148206979679,-58.3620561371928 -34.6148078005925,-58.3612002032032 -34.6147473710554,-58.3610565004671 -34.6160739179046)))";;"3524";1_13_12;COMUNA 1;"13";"12";"292";"150";"142";"105,63%";"250";"250";"100,00%";"0";"0,00%";"138";"0";"0";"138";"100,00%";"0";0.000
"MULTIPOLYGON (((-58.3619074462775 -34.6179465204267,-58.3597495205797 -34.6177921074807,-58.3596588597592 -34.6179649579532,-58.3593344725867 -34.6206630204294,-58.3592858738157 -34.6210702793935,-58.3598051449845 -34.621601772344,-58.3613097857368 -34.6211455118531,-58.3614997756129 -34.6211489080631,-58.3619074462775 -34.6179465204267)))";;"3525";1_13_15;COMUNA 1;"13";"15";"0";"0";"0";;"6";"6";"100,00%";"0";"0,00%";"0";"0";"0";"0";;"0";0.000
"MULTIPOLYGON (((-58.35732317442 -34.595093242042,-58.3572253800443 -34.5951453882553,-58.3571265931584 -34.5951434013487,-58.3569842576489 -34.5951652508024,-58.3568606936534 -34.5952261319599,-58.3568058390385 -34.5952335494471,-58.3564844341208 -34.5953660921322,-58.3563036512871 -34.5954177676238,-58.3559846388475 -34.5954763645671,-58.3558149837411 -34.59548354031,-58.3556543558501 -34.5954907941614,-58.3555126924435 -34.5955190511832,-58.3553419377816 -34.5955864388851,-58.3551812335217 -34.5956527788242,-58.3551543023982 -34.5957338849702,-58.3550828781153 -34.595778049053,-58.3549845216695 -34.5959698710488,-58.3547790862979 -34.5960508194096,-58.3546720254516 -34.5960581193286,-58.3545739164007 -34.5960580324361,-58.354522421132 -34.5961012983169,-58.3541363106508 -34.5962790608385,-58.3539397871393 -34.5963821292318,-58.3534307694959 -34.5966990810069,-58.3532967822204 -34.5968465018052,-58.3530465711206 -34.5970381155348,-58.3529214084149 -34.5972741387698,-58.3528139982085 -34.5974807401128,-58.3526352576682 -34.5976576280201,-58.3523939627656 -34.5979305191204,-58.352277908036 -34.597974711615,-58.3520993218489 -34.5980334957817,-58.3519564070598 -34.598166258536,-58.3517687273678 -34.5984022237867,-58.3515541733272 -34.5986085856771,-58.3513309148421 -34.5987633879902,-58.3511611503001 -34.5989108441533,-58.3509467773756 -34.5990434699384,-58.3507949957999 -34.59911706602,-58.3506700058472 -34.599153924559,-58.3505895841138 -34.5992349805238,-58.3505002592312 -34.5992865905166,-58.3503214502517 -34.5995077723569,-58.3502231524004 -34.5995815578155,-58.3500176247643 -34.5998469415857,-58.3498656858329 -34.5999722284416,-58.3497316969139 -34.6001123210138,-58.3495530341662 -34.6002228638665,-58.3493476480477 -34.6003186627701,-58.3490617364977 -34.6005693217564,-58.3488830867273 -34.6007314148603,-58.3487669456549 -34.600834620207,-58.348615083651 -34.6009009596819,-58.3484097006916 -34.6009302756314,-58.3483114948787 -34.600996594547,-58.3480614464699 -34.6011143924719,-58.3479006547573 -34.6012323443142,-58.3477219872855 -34.6013428140309,-58.3475435163965 -34.6013722243001,-58.3475077692092 -34.6014164879895,-58.3474095382505 -34.601438438293,-58.3472665250943 -34.6015711249484,-58.3471414787987 -34.6016448825864,-58.3470610103347 -34.6017554442859,-58.3470162822038 -34.6018882941716,-58.3469981783 -34.601984196077,-58.3469268193598 -34.6020356796094,-58.3469088003933 -34.6021316520048,-58.3468461213961 -34.6022496955001,-58.3468014409356 -34.6022864854264,-58.3468192856431 -34.602316080941,-58.3467567019254 -34.6024266594105,-58.3467564454906 -34.6026111730732,-58.3467473589635 -34.6027144781387,-58.3466580516326 -34.602810312295,-58.3466489516007 -34.6028619957013,-58.3467024729642 -34.6028988789478,-58.3467113030296 -34.60298008754,-58.346720058221 -34.6030539014189,-58.346657517843 -34.6031940584265,-58.3465857201025 -34.6034375202769,-58.3466301446504 -34.6035851736453,-58.3465674745534 -34.6036957519112,-58.3465314792023 -34.6039171342864,-58.3465402886126 -34.6040131321367,-58.3464686573177 -34.6041975073546,-58.3464774976896 -34.604271250892,-58.3464057910707 -34.6044483017793,-58.3463429346598 -34.6046917719567,-58.3463161725714 -34.6047655519679,-58.3461999684097 -34.6048466412435,-58.3460748132665 -34.6049940623207,-58.3460836017829 -34.6051047085926,-58.3461459202695 -34.6051860387317,-58.3461278406082 -34.6053852541314,-58.346164265001 -34.605406698163,-58.3461543403746 -34.6056214148742,-58.3461229561237 -34.6057720946443,-58.3461119163037 -34.6059923738576,-58.3460871037385 -34.6060724939252,-58.3460617646038 -34.6062855056691,-58.3458703081117 -34.6066997038322,-58.3457463019578 -34.6068757182165,-58.3456042857685 -34.6070177702868,-58.345197861453 -34.6072364720451,-58.3451213443766 -34.6073177393202,-58.344927207482 -34.6074536133679,-58.3448006376337 -34.6075128594839,-58.3445996884823 -34.6076467545194,-58.3439998885004 -34.6079392816951,-58.3436157848156 -34.6082681446894,-58.343117119447 -34.6085939363694,-58.3428027354476 -34.6088872299866,-58.3425068136386 -34.6091346942427,-58.3423560663157 -34.6092410283556,-58.342196182623 -34.6093625650721,-58.3420102507781 -34.6094725261004,-58.3417177760797 -34.6097480914258,-58.3414672621424 -34.6098686921707,-58.3412837450472 -34.6100737987404,-58.3412373150352 -34.6101960808588,-58.3408611678435 -34.6106614267162,-58.3408608150528 -34.610902913875,-58.3408076676151 -34.6111912513724,-58.3407014578139 -34.6115343264695,-58.3404505016488 -34.6122424807536,-58.3403672330655 -34.6124487426426,-58.3402258200592 -34.6132113742642,-58.339980210898 -34.6138686858811,-58.3399372719842 -34.6143363352061,-58.3399386588009 -34.6145515554355,-58.3398700749892 -34.6148484686627,-58.3398483393575 -34.6150313405156,-58.3398430144874 -34.6153499378641,-58.3398469248221 -34.6159336241786,-58.3398517749352 -34.6161107479195,-58.3399834727848 -34.616282787869,-58.3401225461509 -34.6164214536385,-58.3403994274772 -34.6166332177636,-58.3405020300122 -34.6167224786119,-58.3405475266966 -34.6167753429145,-58.3407157571609 -34.6168990366684,-58.340818564962 -34.6169066044722,-58.3410814336422 -34.6169744043724,-58.3422058869721 -34.6169126306658,-58.3423875803444 -34.6169176693128,-58.3426053710378 -34.6169375324764,-58.34272227971 -34.6169730008505,-58.3429173252039 -34.6169934749108,-58.3429626489199 -34.6169899981551,-58.3431488773948 -34.6170404642344,-58.3432894265703 -34.6171048998978,-58.3437306720726 -34.6172357580682,-58.3440135876937 -34.6172861058031,-58.3442365842183 -34.6173601983554,-58.344415123225 -34.6173677662196,-58.3445860538762 -34.6174544137103,-58.3453576348031 -34.6174787506799,-58.3455576046296 -34.617390982059,-58.3457986391553 -34.6174207917622,-58.3458701077272 -34.617361773666,-58.3459504483238 -34.617354455956,-58.3460039966721 -34.6173176044993,-58.3463074724535 -34.617347402486,-58.346396561925 -34.6174803089696,-58.3465482369116 -34.6175100319677,-58.3466910938148 -34.6175101678998,-58.3470304069126 -34.6174366142878,-58.3471107985429 -34.6173924635958,-58.3474947648455 -34.617245216031,-58.3476278713563 -34.617149986226,-58.3477214555739 -34.6171135238958,-58.3478199446748 -34.6170412197935,-58.3479153097287 -34.6170104634147,-58.3480127531056 -34.6170169637342,-58.3481199570009 -34.6169875563991,-58.3482271507655 -34.6169654731591,-58.3483254504319 -34.6169066196417,-58.3484293597988 -34.6169189709645,-58.3485589268743 -34.6169190218342,-58.3486757995935 -34.6169203283518,-58.348843081779 -34.6169365414876,-58.34891455778 -34.6168701974085,-58.3490574739733 -34.6168260333039,-58.3491643761824 -34.6168926140322,-58.3492268118619 -34.616959082889,-58.3493696176765 -34.6169961183309,-58.3496015927873 -34.6170480255529,-58.3498513973018 -34.6171441757208,-58.3499673703241 -34.6171811152133,-58.35004771575 -34.617232881374,-58.3502126691201 -34.6172079622883,-58.3502618826123 -34.6172256843287,-58.3502706082251 -34.6173880219664,-58.3503418647319 -34.6174840064462,-58.3505292200702 -34.6175874923122,-58.3505825581173 -34.6177056440414,-58.3505556210576 -34.6178458354216,-58.3505893747527 -34.61795777174,-58.3506727690321 -34.6180870781873,-58.3508308289044 -34.6181853252275,-58.3503518891489 -34.6181366439829,-58.3501444749932 -34.6182513159281,-58.3500373300377 -34.6182364277796,-58.3499303501289 -34.618162523559,-58.3497922720087 -34.6182183132735,-58.3498676185748 -34.6183765574807,-58.3499859280915 -34.6184508243473,-58.3500995282158 -34.6184800147687,-58.3501172127616 -34.6185685552818,-58.3499744245198 -34.6186422992191,-58.3499652849827 -34.6187234203402,-58.3502499076925 -34.6187778398351,-58.350341568446 -34.6186520748687,-58.3504028207697 -34.6186500889444,-58.3505279592783 -34.6185246363473,-58.3507242756746 -34.6185543951915,-58.3506877993705 -34.6186298572756,-58.3505477672634 -34.6186814909732,-58.3504025623839 -34.6188419263271,-58.3503667496079 -34.6189304175413,-58.3504469820045 -34.6190042967618,-58.3505628135505 -34.6190218686838,-58.3506612420062 -34.6191213287505,-58.3506702013969 -34.6191738035786,-58.3508305240832 -34.6191743732544,-58.3511250204919 -34.6193000698248,-58.3512390781477 -34.6193067940371,-58.3513412115934 -34.6193119579094,-58.351467837561 -34.619284466847,-58.3515012985321 -34.6192340026518,-58.3515188502092 -34.6191678896059,-58.3516133268236 -34.61922931582,-58.3515521109707 -34.6193314466858,-58.3514633115781 -34.6193565778844,-58.3519196539775 -34.6196203120827,-58.3522155793571 -34.6196343837481,-58.3525632726188 -34.6195396948767,-58.3526902397425 -34.619770099067,-58.3529301538711 -34.6197522159685,-58.3530817295946 -34.6195384012291,-58.3535174718528 -34.6194047028665,-58.3540718296357 -34.6197015460115,-58.3542491596341 -34.6194643012338,-58.3551428496741 -34.6195528309668,-58.3552475220566 -34.6193352102132,-58.3553921056702 -34.6190346093558,-58.3553940196766 -34.6190349329556,-58.3555371757176 -34.6187268945905,-58.3557976657254 -34.6181430574223,-58.3560026388234 -34.6176393369889,-58.3562337167328 -34.6178946131557,-58.3562352828083 -34.6178926159218,-58.3563393112635 -34.6180138376382,-58.356386472095 -34.6180393725909,-58.3564549148839 -34.6180764757592,-58.3566990693153 -34.6183371197365,-58.3572562916502 -34.6189319190298,-58.3576808068317 -34.6193850473677,-58.3577894472019 -34.6195000743947,-58.3587647568686 -34.62053263496,-58.3588853110227 -34.6206602772093,-58.3592858738157 -34.6210702793935,-58.3593344725867 -34.6206630204294,-58.3596588597592 -34.6179649579532,-58.3597495205797 -34.6177921074807,-58.3619074462775 -34.6179465204267,-58.3614997756129 -34.6211489080631,-58.3613097857368 -34.6211455118531,-58.3598051449845 -34.621601772344,-58.3603435384869 -34.6221528281762,-58.3614461926738 -34.6233213938102,-58.3617706873972 -34.623674702877,-58.3618971167095 -34.6238124881423,-58.3619472292777 -34.6238669680075,-58.3622066467854 -34.6241446561818,-58.3629990105463 -34.6250122370681,-58.3630909852653 -34.6251124564278,-58.3634550081613 -34.6251213449807,-58.3635210192558 -34.6249900562153,-58.3637377049165 -34.6248863554595,-58.3641529182783 -34.6246875299578,-58.3646979948599 -34.6243901421288,-58.3650683106179 -34.6241880378652,-58.3654787758683 -34.6239640623241,-58.3657858685494 -34.623987335641,-58.3658398489279 -34.6237947663491,-58.3658564321869 -34.6235999841704,-58.3659362386448 -34.6226620578251,-58.366067066362 -34.6215088122114,-58.3661903166708 -34.620422182258,-58.3663238910546 -34.6192449231945,-58.3664514379967 -34.6181201256173,-58.3657426649405 -34.6180635060661,-58.3649335091992 -34.6179630680713,-58.3641020818789 -34.6178963402824,-58.3638980784838 -34.6178808930082,-58.3631444164426 -34.6178238698738,-58.3628795295343 -34.6175745602185,-58.3619437845843 -34.6175005521869,-58.361932945957 -34.6174996949175,-58.3617379736598 -34.6174842514906,-58.3609068046287 -34.6174184610884,-58.3608990569339 -34.6174178477998,-58.3602422513715 -34.617365887698,-58.35983953884 -34.6173280122897,-58.3580771647541 -34.6171622825111,-58.3578150406018 -34.6171328392468,-58.357670111306 -34.6171192504535,-58.3567211646212 -34.6169026252416,-58.3568448683684 -34.6163564730001,-58.3584319569556 -34.6118537364962,-58.3584747097108 -34.6117917989761,-58.3585177982841 -34.6117337351053,-58.3585700863321 -34.6116756086458,-58.3586245177812 -34.6116062864071,-58.3586790272925 -34.6115425982147,-58.3587312462584 -34.6114713725637,-58.358776674096 -34.6113814080382,-58.3588062654351 -34.6112857960045,-58.3588175452044 -34.6111884781701,-58.3588097777272 -34.6111330470297,-58.3588017564766 -34.6110762071707,-58.3587814555677 -34.6109621012722,-58.3587656199761 -34.6108875076359,-58.3587521980448 -34.6107899574805,-58.3587772560183 -34.610709342122,-58.3608162070359 -34.6049075401593,-58.3609335449723 -34.6045753135767,-58.3629201189734 -34.5989571542864,-58.3629538825684 -34.5988606796647,-58.3630064324989 -34.5987105253208,-58.3631786307544 -34.5982184640541,-58.3632336651729 -34.5980613902626,-58.363499349393 -34.5973024226175,-58.3635335606837 -34.5971803330759,-58.3634398206906 -34.5971575799366,-58.3634509301195 -34.5971256863432,-58.3632814134076 -34.5970858989456,-58.359252361857 -34.5952403200459,-58.3585157896017 -34.5951816778156,-58.3576885129925 -34.5951431492088,-58.3573908052525 -34.5951013735787,-58.35732317442 -34.595093242042)))";;"3526";1_13_14;COMUNA 1;"13";"14";"1960";"1008";"952";"105,88%";"855";"855";"100,00%";"0";"0,00%";"659";"177";"26.86";"482";"73,14%";"26.86";26.860
"MULTIPOLYGON (((-58.4872055363787 -34.5736462919561,-58.4883220131782 -34.5742589761313,-58.4889552221218 -34.5734711319641,-58.488062197114 -34.5729802434718,-58.4872055363787 -34.5736462919561)))";;"3527";12_16_14;COMUNA 12;"16";"14";"353";"152";"201";"75,62%";"199";"199";"100,00%";"0";"0,00%";"175";"1";"0.57";"174";"99,43%";"0.57";0.570
"MULTIPOLYGON (((-58.4755132447092 -34.5786921037325,-58.4756526324279 -34.578697996237,-58.4765688998753 -34.578730784263,-58.4762712824896 -34.5790695642709,-58.4754993036562 -34.5799404586258,-58.4772227097052 -34.5795329952448,-58.478988076277 -34.5791249385084,-58.4786552843039 -34.578928354533,-58.4781986790841 -34.5786688250482,-58.477773158275 -34.5784269668057,-58.4773332488211 -34.5781769394392,-58.4771503372173 -34.5780731540623,-58.4756197634905 -34.5772046947638,-58.4755132447092 -34.5786921037325)))";;"3528";15_3_1;COMUNA 15;"3";"1";"722";"335";"387";"86,56%";"356";"356";"100,00%";"0";"0,00%";"289";"0";"0";"289";"100,00%";"0";0.000
"MULTIPOLYGON (((-58.4632247630152 -34.5415326318892,-58.4643986167391 -34.5439001720765,-58.4643876521287 -34.543911513413,-58.4643881480057 -34.5439117649874,-58.4646560761197 -34.5447531611592,-58.4646703953123 -34.5447127142806,-58.4648631612672 -34.5442276880022,-58.4648879269844 -34.54416240277,-58.4650342226312 -34.5437761140934,-58.4651411989946 -34.5434978593231,-58.4651709855158 -34.5434227847266,-58.465319406709 -34.5430490314276,-58.4654879958482 -34.5426224580429,-58.4655241644232 -34.5425310443949,-58.4656585406131 -34.5421910953869,-58.46581172336 -34.5418124114851,-58.4658444815017 -34.5417331498139,-58.4658496785013 -34.5417205751276,-58.4656334981256 -34.5416114203524,-58.4646924391868 -34.5411363461244,-58.463824073494 -34.5406979558645,-58.4633644360374 -34.5413683469269,-58.4633637692783 -34.5413693194001,-58.4632247630152 -34.5415326318892)))";;"3529";13_2_5;COMUNA 13;"2";"5";"786";"394";"392";"100,51%";"483";"482";"99,79%";"1";"0,21%";"330";"4";"1.21";"326";"98,79%";"1.21";1.210
"MULTIPOLYGON (((-58.4643876521287 -34.543911513413,-58.4643986167391 -34.5439001720765,-58.4632247630152 -34.5415326318892,-58.4631820708388 -34.5415827889332,-58.4631809702139 -34.5415841550674,-58.4626020084246 -34.5421123245999,-58.4619831739576 -34.5426869978878,-58.4631176061724 -34.5432652662966,-58.4639280339338 -34.5436783790987,-58.4640579141898 -34.5437442259268,-58.4643876521287 -34.543911513413)))";;"3530";13_2_11;COMUNA 13;"2";"11";"613";"305";"308";"99,03%";"457";"457";"100,00%";"0";"0,00%";"293";"0";"0";"293";"100,00%";"0";0.000
"MULTIPOLYGON (((-58.3931963708589 -34.5948356609603,-58.3945056263186 -34.5947166645816,-58.3943168609925 -34.5936207642484,-58.393076657833 -34.5938160565559,-58.3931959749532 -34.5948322909778,-58.3931963708589 -34.5948356609603)))";;"3531";2_16_4;COMUNA 2;"16";"4";"534";"227";"307";"73,94%";"679";"678";"99,85%";"1";"0,15%";"284";"2";"0.7";"282";"99,30%";"0.7";0.700
"MULTIPOLYGON (((-58.3766534463462 -34.6034047137968,-58.3766587039104 -34.6034050360748,-58.3780710188837 -34.6034915199651,-58.3781083092373 -34.6024982691733,-58.3781146470174 -34.6023796071384,-58.3779725046942 -34.602372184301,-58.3767027666535 -34.6023028427331,-58.3766949810912 -34.6023024172822,-58.3766534463462 -34.6034047137968)))";;"3532";1_9_18;COMUNA 1;"9";"18";"395";"209";"186";"112,37%";"728";"725";"99,59%";"3";"0,41%";"169";"1";"0.59";"168";"99,41%";"0.59";0.590
"MULTIPOLYGON (((-58.3793832787935 -34.6048381774772,-58.3794979145934 -34.6048455094925,-58.3803315960928 -34.6044078898133,-58.3805559873505 -34.6042744445584,-58.3809559355612 -34.6040365352609,-58.3809751183048 -34.6036694217223,-58.3794711579487 -34.6035772749528,-58.3780710188837 -34.6034915199651,-58.3780064642962 -34.6047443387825,-58.3793832787935 -34.6048381774772)))";;"3533";1_12_12;COMUNA 1;"12";"12";"499";"255";"244";"104,51%";"471";"466";"98,94%";"5";"1,07%";"90";"17";"18.89";"73";"81,11%";"18.89";18.890
"MULTIPOLYGON (((-58.4425697555384 -34.6437839753733,-58.4424214034772 -34.6437683165054,-58.4422723732566 -34.6437384315481,-58.441922591499 -34.643668229426,-58.4416372256603 -34.644666689271,-58.4417551386873 -34.6446971642969,-58.4422781613107 -34.6448073389565,-58.4424387819119 -34.6448399019672,-58.4425920745804 -34.6448709846391,-58.4427522693732 -34.6449034767417,-58.4429003644442 -34.6449335722295,-58.4430604742637 -34.6449660639131,-58.4432151307589 -34.6449974277198,-58.4433753260384 -34.6450299190034,-58.4435282785655 -34.645060930019,-58.4436821685163 -34.645092152263,-58.4438385296882 -34.6451238676678,-58.4440003444494 -34.6451567105039,-58.4441509967462 -34.6451872978369,-58.4443118744413 -34.6452199288426,-58.4444637199239 -34.645250727243,-58.4447743985192 -34.6453137329978,-58.4449945835183 -34.645358414431,-58.4450462324814 -34.6453164487913,-58.4451274559064 -34.6452504725679,-58.4458747394733 -34.644643446489,-58.4460142565381 -34.6445340960688,-58.445375946881 -34.644404988974,-58.4450609254752 -34.6443412798675,-58.4447500798474 -34.6442783452332,-58.4444391494608 -34.6442154802181,-58.4441274526704 -34.6441524030188,-58.4438119219121 -34.6440886201812,-58.4434993739882 -34.6440253299694,-58.4431858030077 -34.6439661938512,-58.4433162820999 -34.6435240882126,-58.4432266220159 -34.6435936535628,-58.4430808013413 -34.6436850414905,-58.4429289379288 -34.643743962463,-58.4428046049258 -34.6437743657253,-58.4425697555384 -34.6437839753733)))";;"3534";7_19_2;COMUNA 7;"19";"2";"1659";"829";"830";"99,88%";"267";"267";"100,00%";"0";"0,00%";"507";"86";"16.96";"421";"83,04%";"16.96";16.960
"MULTIPOLYGON (((-58.4444637199239 -34.645250727243,-58.4443118744413 -34.6452199288426,-58.4441509967462 -34.6451872978369,-58.4440003444494 -34.6451567105039,-58.4438385296882 -34.6451238676678,-58.4436821685163 -34.645092152263,-58.4435282785655 -34.645060930019,-58.4433753260384 -34.6450299190034,-58.4432151307589 -34.6449974277198,-58.4430604742637 -34.6449660639131,-58.4429003644442 -34.6449335722295,-58.4427522693732 -34.6449034767417,-58.4425920745804 -34.6448709846391,-58.4424387819119 -34.6448399019672,-58.4422781613107 -34.6448073389565,-58.4417551386873 -34.6446971642969,-58.4414674553799 -34.645683847309,-58.4418375384879 -34.6457515893216,-58.4421501769085 -34.6458146020919,-58.4424628158026 -34.6458776140603,-58.4427758812294 -34.645940695721,-58.4430846865652 -34.6460029307959,-58.4433987754701 -34.6460662222951,-58.4437071556764 -34.6461283853005,-58.4439755721028 -34.6461824425554,-58.4440383872211 -34.6461319576735,-58.444408969269 -34.6458342581755,-58.4449945835183 -34.645358414431,-58.4447743985192 -34.6453137329978,-58.4444637199239 -34.645250727243)))";;"3535";7_19_3;COMUNA 7;"19";"3";"1339";"659";"680";"96,91%";"238";"238";"100,00%";"0";"0,00%";"363";"102";"28.1";"261";"71,90%";"28.1";28.100
"MULTIPOLYGON (((-58.4433987754701 -34.6460662222951,-58.4430846865652 -34.6460029307959,-58.4427758812294 -34.645940695721,-58.4424628158026 -34.6458776140603,-58.4421501769085 -34.6458146020919,-58.4418375384879 -34.6457515893216,-58.4414674553799 -34.645683847309,-58.4417551386873 -34.6446971642969,-58.4416372256603 -34.644666689271,-58.441922591499 -34.643668229426,-58.4415925786906 -34.6436020439328,-58.4414752466129 -34.6435785017086,-58.4407454741041 -34.6442629712797,-58.4406252933065 -34.6443752065911,-58.4405655437345 -34.6444309721399,-58.4405219886867 -34.6444717401397,-58.4401843718673 -34.6447871105857,-58.4399615655242 -34.6449952447032,-58.4398704481461 -34.6450803711581,-58.4397616013641 -34.6451822552915,-58.4396525838476 -34.6452842801431,-58.43911806166 -34.6457847567721,-58.4388507555696 -34.6460349237586,-58.4391005567246 -34.6462120200533,-58.4391578185759 -34.6462225244015,-58.4394752284909 -34.6462866717409,-58.4397955360723 -34.6463513821955,-58.4398279162188 -34.6463579377698,-58.4400982054551 -34.6464125673055,-58.4404311252623 -34.6464798137154,-58.4407233146074 -34.646538812193,-58.4410579396513 -34.6466064093214,-58.4411968299971 -34.646651294422,-58.4413943501625 -34.6466920345646,-58.4415507133398 -34.6467242458681,-58.4417115076425 -34.6467573732548,-58.4418595203109 -34.646787892532,-58.4420146908751 -34.6468198917623,-58.4421750594838 -34.6468529480403,-58.4423248619461 -34.646883819177,-58.4424854012337 -34.6469168750751,-58.4427964251403 -34.646981012705,-58.4429439273398 -34.6470113897323,-58.4431807881113 -34.6468210699322,-58.4433937828825 -34.6466499718317,-58.4436556144208 -34.6464395135848,-58.4439755721028 -34.6461824425554,-58.4437071556764 -34.6461283853005,-58.4433987754701 -34.6460662222951)))";;"3536";7_19_4;COMUNA 7;"19";"4";"1553";"769";"784";"98,09%";"288";"288";"100,00%";"0";"0,00%";"455";"91";"20";"364";"80,00%";"20";20.000
"MULTIPOLYGON (((-58.4398279162188 -34.6463579377698,-58.4397955360723 -34.6463513821955,-58.4394752284909 -34.6462866717409,-58.4391578185759 -34.6462225244015,-58.4391005567246 -34.6462120200533,-58.4388507555696 -34.6460349237586,-58.4378702500538 -34.6469527843996,-58.4382539397184 -34.6470862462826,-58.4385545650333 -34.6471488433008,-58.4388606443557 -34.647212497014,-58.4391716663903 -34.6472772777071,-58.4394808994772 -34.6473416347177,-58.4397950753413 -34.6474069778176,-58.4401079735042 -34.6474721085968,-58.440420020026 -34.6475370975675,-58.4406672205323 -34.6475885525009,-58.4407507287066 -34.6476052582103,-58.4410943055496 -34.6476739836337,-58.4414109557524 -34.6477372806901,-58.4417224936574 -34.6477995900988,-58.4419149043182 -34.647838145347,-58.4420946630778 -34.6476936644058,-58.4423082589677 -34.6475220049307,-58.4429439273398 -34.6470113897323,-58.4427964251403 -34.646981012705,-58.4424854012337 -34.6469168750751,-58.4423248619461 -34.646883819177,-58.4421750594838 -34.6468529480403,-58.4420146908751 -34.6468198917623,-58.4418595203109 -34.646787892532,-58.4417115076425 -34.6467573732548,-58.4415507133398 -34.6467242458681,-58.4413943501625 -34.6466920345646,-58.4411968299971 -34.646651294422,-58.4410579396513 -34.6466064093214,-58.4407233146074 -34.646538812193,-58.4404311252623 -34.6464798137154,-58.4400982054551 -34.6464125673055,-58.4398279162188 -34.6463579377698)))";;"3537";7_19_5;COMUNA 7;"19";"5";"1407";"674";"733";"91,95%";"310";"310";"100,00%";"0";"0,00%";"392";"78";"19.9";"314";"80,10%";"19.9";19.900
"MULTIPOLYGON (((-58.3998207390366 -34.6546356118858,-58.3990509259398 -34.654516044298,-58.3986058297994 -34.6545491018376,-58.3985329363984 -34.6545411371454,-58.3985106792208 -34.6543799562213,-58.3982754085288 -34.6543106086449,-58.3985746967749 -34.6538729673965,-58.3985085519506 -34.6538214112835,-58.3988662712588 -34.6526495552084,-58.398648885952 -34.6525831548178,-58.3984461085232 -34.653290475833,-58.3983197424127 -34.653707393246,-58.3981758921446 -34.6541398650833,-58.3980828771699 -34.6544033452032,-58.39807637203 -34.6544412989596,-58.3980546827897 -34.6544958676206,-58.3980162066936 -34.6545474689904,-58.3979849730616 -34.6546010444295,-58.3979669444227 -34.6546615301313,-58.3979586395187 -34.6547106105594,-58.3979133524946 -34.6548599581543,-58.3978658327875 -34.6549264137052,-58.3978405571502 -34.654987879825,-58.397839345464 -34.6550116843405,-58.3978501542714 -34.6550305622275,-58.3978224602768 -34.6551356924984,-58.3978062267069 -34.6551873039782,-58.397941873238 -34.6552290674469,-58.3978780745813 -34.6554026317885,-58.3978161449719 -34.655585139357,-58.3976635240311 -34.6556713974785,-58.3975727202651 -34.6559382581497,-58.39751574486 -34.6561060494596,-58.3974986355954 -34.6561862538979,-58.3975440512241 -34.6561977568295,-58.3979892133438 -34.6562727858883,-58.3980918144815 -34.6562857274428,-58.3983467702312 -34.6563372727554,-58.3985892813685 -34.6563913457264,-58.399100368903 -34.6564082324785,-58.3991521950062 -34.6563967808455,-58.3992765369679 -34.6563993803203,-58.3994466491366 -34.6563986246919,-58.3998204053572 -34.6546371840271,-58.3998207390366 -34.6546356118858)))";;"3538";4_10_9;COMUNA 4;"10";"9";"2091";"1034";"1057";"97,82%";"588";"588";"100,00%";"0";"0,00%";"624";"117";"18.75";"507";"81,25%";"18.75";18.750
"MULTIPOLYGON (((-58.4020148486442 -34.6576009048185,-58.3992347753302 -34.6574003862007,-58.3990180568951 -34.6584907611157,-58.3991422267018 -34.6585618893906,-58.3992950307853 -34.6586764601168,-58.3994382495572 -34.6588305053891,-58.3995527536833 -34.6590477031593,-58.3995532839131 -34.6591360392865,-58.3995711201509 -34.6592426437397,-58.3995189725092 -34.6593791209471,-58.3994920398861 -34.6595653493874,-58.3993915258814 -34.6597992145013,-58.399330469863 -34.6599798024359,-58.3992766165903 -34.6601130184367,-58.3991438342961 -34.6603675933787,-58.3991402010916 -34.6604327329932,-58.399150894991 -34.660506763008,-58.3991400903123 -34.660577820838,-58.3991256953518 -34.6606577597268,-58.3991220643815 -34.6607199383612,-58.399168572818 -34.6608206358384,-58.3992482403228 -34.6608752689345,-58.3993282337711 -34.6609251710959,-58.3994031035627 -34.6609496321677,-58.3995416202263 -34.6609950199191,-58.3996671650234 -34.6610177428478,-58.3998288242556 -34.6609963608802,-58.3999125340258 -34.6609940189686,-58.3999505749517 -34.6609414793421,-58.400055873455 -34.660889982743,-58.4002374290176 -34.6608705682987,-58.4004137464743 -34.6607893181812,-58.4004191933056 -34.6605720613206,-58.4005312871075 -34.6605504981999,-58.4006189664998 -34.6604663151474,-58.4007142633268 -34.6603389656706,-58.4007558511039 -34.6602303921897,-58.4008353451129 -34.660196768278,-58.401134544667 -34.6595863472202,-58.4012125400132 -34.6595029098639,-58.4020088465649 -34.657615102769,-58.4020148486442 -34.6576009048185)))";;"3539";4_25_1;COMUNA 4;"25";"1";"2357";"1193";"1164";"102,49%";"608";"608";"100,00%";"0";"0,00%";"688";"183";"26.6";"505";"73,40%";"26.6";26.600
"MULTIPOLYGON (((-58.3998599452524 -34.654450891851,-58.3998204054466 -34.6546371847644,-58.3994466491366 -34.6563986246919,-58.3992358074567 -34.65739537482,-58.3992347753302 -34.6574003862007,-58.4020148486442 -34.6576009048185,-58.4022337212554 -34.6570831569507,-58.4027454410952 -34.655872952145,-58.401033899603 -34.6561644309701,-58.4015949487623 -34.6544100145261,-58.3998599452524 -34.654450891851)))";;"3540";4_25_2;COMUNA 4;"25";"2";"2215";"1099";"1116";"98,48%";"485";"485";"100,00%";"0";"0,00%";"624";"131";"20.99";"493";"79,01%";"20.99";20.990
"MULTIPOLYGON (((-58.4015949487623 -34.6544100145261,-58.4017319893744 -34.6544109986437,-58.4018833545289 -34.6540497256365,-58.4018965445659 -34.653959870428,-58.4019557525454 -34.6537567953936,-58.4020627223066 -34.6537367071995,-58.4021058777706 -34.6536901779913,-58.4021106983297 -34.6535088370358,-58.4022011669644 -34.6534166454962,-58.4023916437516 -34.6528516335777,-58.4025108913637 -34.6527028836417,-58.4026887711429 -34.6524360636761,-58.4024693937449 -34.6523398946859,-58.4024183339423 -34.6521228218814,-58.4022856540105 -34.6522264916811,-58.4020044763817 -34.652269592763,-58.4017269605209 -34.6523160754088,-58.4014772272644 -34.6523617262793,-58.4011959574036 -34.6524131355537,-58.4009958444456 -34.6524294433905,-58.400928934188 -34.6524444099567,-58.400669816576 -34.6525023083008,-58.4004956790978 -34.6525412348285,-58.4004503339735 -34.6525506485864,-58.4003981700814 -34.6525613969112,-58.400268488771 -34.6525259774281,-58.3998599452524 -34.654450891851,-58.4015949487623 -34.6544100145261)))";;"3541";4_25_4;COMUNA 4;"25";"4";"2028";"1065";"963";"110,59%";"469";"469";"100,00%";"0";"0,00%";"573";"159";"27.75";"414";"72,25%";"27.75";27.750
"MULTIPOLYGON (((-58.4034273258205 -34.6507104916901,-58.40351683221 -34.6502499334073,-58.4008589404482 -34.6497809909727,-58.40085778805 -34.6497860553702,-58.4007590371979 -34.650219961901,-58.4005650377324 -34.6510726351174,-58.400631587489 -34.6510825988828,-58.4009476605035 -34.6510957174884,-58.40119939414 -34.6511061267063,-58.4013658246826 -34.6511130417211,-58.4014769671457 -34.6510927448552,-58.4015229923997 -34.6510843169989,-58.401727977119 -34.6510440663529,-58.4020381386017 -34.6509832333124,-58.4023157408888 -34.6509287215803,-58.402560613565 -34.6508806721446,-58.4028696658704 -34.650819977289,-58.4031321809439 -34.6507684845521,-58.403230453579 -34.6507491657436,-58.4034273258205 -34.6507104916901)))";;"3542";4_26_2;COMUNA 4;"26";"2";"1228";"604";"624";"96,79%";"252";"252";"100,00%";"0";"0,00%";"283";"19";"6.71";"264";"93,29%";"6.71";6.710
"MULTIPOLYGON (((-58.4650522431728 -34.6776095865892,-58.4646006062249 -34.6772262455978,-58.4648729064582 -34.6770079221464,-58.4648014796041 -34.6769076147115,-58.4647514797302 -34.6767896053409,-58.4647371923028 -34.6766833963785,-58.4647586164492 -34.6765594852805,-58.4648346739482 -34.6764407208273,-58.4649145843797 -34.6763445724326,-58.4649037186764 -34.6762174333258,-58.4652238544736 -34.6760688435813,-58.4646092083414 -34.6753174383183,-58.4643466456138 -34.674954897505,-58.4641413708919 -34.6746713715872,-58.4637675664901 -34.6741551647604,-58.4632821817895 -34.6734847983476,-58.4623311266462 -34.6721713842318,-58.4618700585544 -34.6715346044923,-58.4620009904147 -34.6714134049044,-58.4619289617796 -34.6713841079154,-58.461783796656 -34.6713136824997,-58.4618795234589 -34.6712196665915,-58.4617875486654 -34.6711863551905,-58.4600297481218 -34.6725667181225,-58.4599321420799 -34.6726686200471,-58.4598651384224 -34.6727560151819,-58.4598095569699 -34.672848762804,-58.4597659944899 -34.6729457361526,-58.4596652268575 -34.6732349666593,-58.4596369205336 -34.6733868009326,-58.4595465569949 -34.6735347602649,-58.4594053038844 -34.6736524356766,-58.4592269711006 -34.6737282777879,-58.4590036314304 -34.6737558775786,-58.4594251579132 -34.6738488498165,-58.459611499092 -34.6738967432597,-58.4599633777303 -34.6741396453541,-58.4603205422778 -34.6744278294002,-58.4606673094884 -34.6747143220283,-58.4606097637822 -34.6749348197604,-58.460685289157 -34.6750017946071,-58.4609783620068 -34.6749733476534,-58.4610855131858 -34.6750625767948,-58.4611972677635 -34.6751556088132,-58.4619787043722 -34.6758039426304,-58.4623614567562 -34.6761215581477,-58.4631843416538 -34.6768042513234,-58.4639182405699 -34.6774143322944,-58.4642964043239 -34.677728631754,-58.4643612790868 -34.6777888436952,-58.4644844646741 -34.6779033519244,-58.4646254685421 -34.6780651144746,-58.4650551348887 -34.6786231493228,-58.465111827432 -34.6786976571517,-58.4654599985259 -34.6791529430167,-58.465837838044 -34.6795476621813,-58.4658843008495 -34.6795933663574,-58.4658858336313 -34.6795486468767,-58.4658858310879 -34.6794822367462,-58.4659041571102 -34.6794137838294,-58.4659175398445 -34.679376599437,-58.4659588840628 -34.6793313155019,-58.4659929828363 -34.6793061731036,-58.466056322203 -34.6792830017751,-58.4661281870091 -34.6792729290975,-58.4662228137385 -34.6792714474888,-58.465920594713 -34.6790120830743,-58.4654454878469 -34.6785982109441,-58.4652700413609 -34.6784453939774,-58.4647380763079 -34.6778607412249,-58.4650522431728 -34.6776095865892)))";;"3543";8_7_14;COMUNA 8;"7";"14";"2062";"1037";"1025";"101,17%";"259";"259";"100,00%";"0";"0,00%";"574";"188";"32.75";"386";"67,25%";"32.75";32.750
"MULTIPOLYGON (((-58.4646092083414 -34.6753174383183,-58.4652238544736 -34.6760688435813,-58.4649037186764 -34.6762174333258,-58.4649145843797 -34.6763445724326,-58.4648346739482 -34.6764407208273,-58.4647586164492 -34.6765594852805,-58.4647371923028 -34.6766833963785,-58.4647514797302 -34.6767896053409,-58.4648014796041 -34.6769076147115,-58.4648729064582 -34.6770079221464,-58.4646006062249 -34.6772262455978,-58.4650522431728 -34.6776095865892,-58.4651677156122 -34.6775172737893,-58.4654491103829 -34.6772922619983,-58.4658229087169 -34.676993372079,-58.4667693694322 -34.6762365640911,-58.4660186614005 -34.6754958634342,-58.4661371473798 -34.6753686737499,-58.4662263068881 -34.675200216121,-58.4661418256895 -34.6751224700344,-58.4657917894806 -34.6745899303252,-58.4656805486223 -34.6746819777514,-58.4655073348396 -34.6747816323497,-58.4654354765262 -34.674873467363,-58.4654198778874 -34.674909243292,-58.465268315454 -34.6750058688141,-58.4652466651171 -34.6750676314395,-58.4650688461097 -34.6751439750391,-58.4649617793465 -34.6751852457517,-58.4648473813322 -34.6752243333439,-58.4646092083414 -34.6753174383183)))";;"3544";8_7_9;COMUNA 8;"7";"9";"3088";"1558";"1530";"101,83%";"494";"494";"100,00%";"0";"0,00%";"814";"202";"24.82";"612";"75,18%";"24.82";24.820
"MULTIPOLYGON (((-58.441667337427 -34.5765628974651,-58.4418782017028 -34.5767719675169,-58.4427279199623 -34.5761631401591,-58.4429191824039 -34.5760402787889,-58.4439717118315 -34.5753642894502,-58.4436828024089 -34.5750726126989,-58.443658202606 -34.5750477497849,-58.4435750850094 -34.5750885658586,-58.4430295285421 -34.5755048891601,-58.4430082213246 -34.5755208665398,-58.4427121694467 -34.575673167346,-58.441667337427 -34.5765628974651)))";;"3545";14_5_1;COMUNA 14;"5";"1";"788";"352";"436";"80,73%";"408";"408";"100,00%";"0";"0,00%";"357";"1";"0.28";"356";"99,72%";"0.28";0.280
"MULTIPOLYGON (((-58.4410514900132 -34.5759522820648,-58.441667337427 -34.5765628974651,-58.4427121694467 -34.575673167346,-58.4430082213246 -34.5755208665398,-58.4430295285421 -34.5755048891601,-58.4435750850094 -34.5750885658586,-58.443658202606 -34.5750477497849,-58.4435698260454 -34.5749584761119,-58.443487274644 -34.574999640694,-58.4428636523407 -34.5752575111477,-58.442853686128 -34.5752695278077,-58.4418846218159 -34.5756097364338,-58.4417237720227 -34.5756651337785,-58.4416444114017 -34.5756925860655,-58.4415791011349 -34.5757132094578,-58.4414835625779 -34.5757429124559,-58.441265878072 -34.5758048374255,-58.4410513579663 -34.5759521510251,-58.4410514900132 -34.5759522820648)))";;"3546";14_5_2;COMUNA 14;"5";"2";"955";"446";"509";"87,62%";"414";"414";"100,00%";"0";"0,00%";"370";"1";"0.27";"369";"99,73%";"0.27";0.270
"MULTIPOLYGON (((-58.4428536861535 -34.5752695278314,-58.4428636523442 -34.5752575111678,-58.4435698260454 -34.5749584761119,-58.4434465008786 -34.5748340444229,-58.4431391235986 -34.5745237711061,-58.4424204434276 -34.5737982004077,-58.4417030525011 -34.5730740341266,-58.4408701465042 -34.5736238410697,-58.4406845894137 -34.5737529681803,-58.4413836739283 -34.5744686156813,-58.4408493159964 -34.5748141696808,-58.4402741645792 -34.5751805597868,-58.4408818425488 -34.5757838644747,-58.4407709805151 -34.5758032820497,-58.4407237198545 -34.5758259505652,-58.4406791018523 -34.5758363654998,-58.4405617681127 -34.5758583170353,-58.44053630891 -34.5758630309245,-58.4405152773803 -34.5758669709325,-58.440425276028 -34.5758838566645,-58.440305132281 -34.5759063004189,-58.4401842221191 -34.5759289551901,-58.4401607212552 -34.5759333876601,-58.4401396046606 -34.5759369050345,-58.4400850251096 -34.5759458389744,-58.440034447475 -34.5759541398035,-58.4399631789589 -34.5759658876092,-58.4399363574855 -34.5759702489918,-58.4398671328546 -34.5759803069102,-58.4398118724048 -34.5759881137924,-58.4397223828054 -34.576000773571,-58.4396593742622 -34.5760085084997,-58.4395661387779 -34.5760194068188,-58.4394827804812 -34.576028405457,-58.439215252005 -34.576051805972,-58.4391522631359 -34.5759894672596,-58.4390602894527 -34.5760544522279,-58.4388908511112 -34.5760617435478,-58.4388907922467 -34.5760617172513,-58.4388820035137 -34.5760673102669,-58.438656264639 -34.5762111280481,-58.4386510107221 -34.5762145755911,-58.4388017458578 -34.576218211616,-58.4388364908941 -34.5761962456551,-58.439105123129 -34.5761858749034,-58.4392210921998 -34.5761753334394,-58.4393319522887 -34.5761659176954,-58.4393555378546 -34.5761634573156,-58.4394413653761 -34.5761548113627,-58.4395343451858 -34.5761453920263,-58.4396618092374 -34.5761324578573,-58.4396989332693 -34.5761278167749,-58.4397396334578 -34.576122753801,-58.439789103754 -34.5761166360773,-58.4398426610852 -34.5761100261204,-58.4398951969313 -34.5761025004176,-58.4399452635183 -34.5760952559338,-58.4399833243689 -34.5760896289825,-58.4400488028226 -34.5760792886011,-58.4401273089371 -34.5760664857017,-58.4401922766056 -34.5760557225958,-58.4402362128771 -34.5760481247345,-58.4404451662024 -34.5760093585546,-58.4405486214313 -34.5759886018475,-58.44059664517 -34.5759786101307,-58.4406567600918 -34.5759656627077,-58.4407018888799 -34.5759558112777,-58.4407579167774 -34.5759432151957,-58.4408090912627 -34.5759313928983,-58.4408806163498 -34.5759147148586,-58.4409839884623 -34.5758852954292,-58.4412554464087 -34.575807804933,-58.4412658780761 -34.5758048374368,-58.4414835625987 -34.5757429124731,-58.4415791011556 -34.575713209475,-58.4416444114225 -34.5756925860827,-58.4417237720435 -34.5756651337957,-58.4418846218367 -34.575609736451,-58.4428536861535 -34.5752695278314)))";;"3547";14_5_3;COMUNA 14;"5";"3";"972";"442";"530";"83,40%";"531";"527";"99,25%";"4";"0,76%";"412";"5";"1.21";"407";"98,79%";"1.21";1.210
"MULTIPOLYGON (((-58.3664578027422 -34.6462485113526,-58.3666969741137 -34.6462732780822,-58.3668137119307 -34.6454655285322,-58.3669430735577 -34.6445710958869,-58.3654613466024 -34.6444504831515,-58.3641970842275 -34.6443338311927,-58.3628167091729 -34.6436950128579,-58.3626862575221 -34.643926411099,-58.3630563138694 -34.6449865586486,-58.3630889672124 -34.6450187009314,-58.363130242128 -34.6450625749901,-58.36313165677 -34.6450632549461,-58.363369692581 -34.6457291998045,-58.3633674404342 -34.6459407751151,-58.3633671443569 -34.6459416150121,-58.3652063030238 -34.6461241332241,-58.3664578027422 -34.6462485113526)))";;"3548";4_21_11;COMUNA 4;"21";"11";"912";"462";"450";"102,67%";"287";"287";"100,00%";"0";"0,00%";"281";"105";"37.37";"176";"62,63%";"37.37";37.370
"MULTIPOLYGON (((-58.3668137119307 -34.6454655285322,-58.3666969741137 -34.6462732780822,-58.3664578027422 -34.6462485113526,-58.3652063030238 -34.6461241332241,-58.3633671443569 -34.6459416150121,-58.3637880724083 -34.6470647341025,-58.3640376962991 -34.6475068400294,-58.3642908465239 -34.6478413361839,-58.3644493289463 -34.6479640590527,-58.3645211942762 -34.6480527252551,-58.3645040614693 -34.6480525774336,-58.3643321397177 -34.6481301564479,-58.364254562106 -34.648287588503,-58.3643481473688 -34.6483202003393,-58.3646500393211 -34.6485662958655,-58.365132752292 -34.648896763308,-58.3675269700327 -34.6500793243279,-58.3676456441127 -34.6501441905936,-58.367680599141 -34.6499551764075,-58.3676806770445 -34.6499552151607,-58.368076772449 -34.6479335614402,-58.3681198276999 -34.6476903481035,-58.3681729815746 -34.6473338997266,-58.3682721613008 -34.6466683931182,-58.3683053145839 -34.6464390456557,-58.3683368349466 -34.64622173953,-58.3683915377961 -34.6458502917138,-58.3684215987726 -34.6456420691992,-58.368521916888 -34.6449459283428,-58.3685539458823 -34.6447299605686,-58.3669430735577 -34.6445710958869,-58.3668137119307 -34.6454655285322)))";;"3549";4_21_12;COMUNA 4;"21";"12";"557";"261";"296";"88,18%";"201";"201";"100,00%";"0";"0,00%";"190";"33";"17.37";"157";"82,63%";"17.37";17.370
"MULTIPOLYGON (((-58.3821175493669 -34.5842991845676,-58.3812495537363 -34.5847642290387,-58.380846431992 -34.5845085105731,-58.3800077874773 -34.5849843113819,-58.3799287308577 -34.5850495876845,-58.3799717506673 -34.5851169264617,-58.3798663652225 -34.5851802051904,-58.3796917280294 -34.5853239835728,-58.3792821627891 -34.5855417523298,-58.3789039076977 -34.5857907944927,-58.3788577244868 -34.5857846507256,-58.3785600580136 -34.5859845183005,-58.3786430508193 -34.5861097848161,-58.3798370021824 -34.5855066504915,-58.3800180998396 -34.5854883601727,-58.3811903214554 -34.5848257301745,-58.3814487528575 -34.5849873925461,-58.3819004082148 -34.5847563603075,-58.3822173531893 -34.5844390453752,-58.3821175493669 -34.5842991845676)))";;"3550";1_3_12;COMUNA 1;"3";"12";"561";"269";"292";"92,12%";"170";"170";"100,00%";"0";"0,00%";"181";"70";"38.67";"111";"61,33%";"38.67";38.670
"MULTIPOLYGON (((-58.3811903214861 -34.5848257301949,-58.3800180998523 -34.5854883601735,-58.379837002172 -34.5855066504865,-58.3786430508459 -34.5861097848125,-58.3778823885275 -34.5864902057974,-58.378103668732 -34.5868569852894,-58.3815620547732 -34.5851527769807,-58.3814487528882 -34.5849873925518,-58.3811903214861 -34.5848257301949)))";;"3551";1_3_11;COMUNA 1;"3";"11";"745";"377";"368";"102,45%";"223";"223";"100,00%";"0";"0,00%";"267";"95";"35.58";"172";"64,42%";"35.58";35.580
"MULTIPOLYGON (((-58.3808613781612 -34.5843113288848,-58.3804684817014 -34.58454215911,-58.3802862892206 -34.5843500867301,-58.380182590024 -34.5843556138299,-58.3801085925261 -34.5843912466509,-58.3801381310281 -34.5844381641689,-58.3801146249319 -34.5845237871888,-58.3799493664936 -34.5846001385848,-58.3798048830119 -34.5846705273387,-58.3797490192753 -34.5846082716828,-58.3795224165953 -34.5847326622093,-58.3794605028171 -34.5847713283756,-58.3796229178473 -34.5849781023978,-58.3792172964102 -34.5851622344777,-58.3789852341515 -34.5852825940113,-58.3790080893695 -34.5853213141402,-58.3788800747633 -34.585411141442,-58.3787742465885 -34.5854837315753,-58.3786518933244 -34.5855699184618,-58.3785599896278 -34.5856339502743,-58.3784746520943 -34.5856596229105,-58.378354848405 -34.5857251304735,-58.3783015614271 -34.5857788637515,-58.378291095976 -34.5858404439489,-58.3783601433185 -34.5858766171145,-58.378554984494 -34.5857745595759,-58.3787474128264 -34.5856435194383,-58.3788614343365 -34.5857821597414,-58.3788577244868 -34.5857846507256,-58.3789039076977 -34.5857907944927,-58.3792821627891 -34.5855417523298,-58.3796917280294 -34.5853239835728,-58.3798663652225 -34.5851802051904,-58.3799717506673 -34.5851169264617,-58.3799287308577 -34.5850495876845,-58.3800077874773 -34.5849843113819,-58.380846431992 -34.5845085105731,-58.3809977690572 -34.5844354283399,-58.3808613781612 -34.5843113288848)))";;"3552";1_3_10;COMUNA 1;"3";"10";"745";"367";"378";"97,09%";"261";"261";"100,00%";"0";"0,00%";"261";"86";"32.95";"175";"67,05%";"32.95";32.950
"MULTIPOLYGON (((-58.4353204006853 -34.6490518094944,-58.4349628987854 -34.649339695154,-58.4348014196448 -34.6494721940668,-58.434763202167 -34.6494374335946,-58.4347275326205 -34.6494047798596,-58.4346223140753 -34.6494902555605,-58.4343610240125 -34.649767245727,-58.4342935102058 -34.6498265980044,-58.4342716818065 -34.6498625799171,-58.4341563444101 -34.6499669223139,-58.4341169426909 -34.6500554368755,-58.4340779102066 -34.6500612025417,-58.434057011243 -34.6501199317958,-58.4340179688282 -34.6501544306989,-58.4340039812978 -34.6501878791182,-58.4339914480734 -34.650205130208,-58.4339775509416 -34.6502235077697,-58.4339483186239 -34.6502292757022,-58.4339312618028 -34.6505132942948,-58.4353496349236 -34.650595524539,-58.4353892124541 -34.6502275646114,-58.4353938247275 -34.650195804126,-58.4354030442544 -34.6501475653028,-58.4353877139092 -34.6501196032826,-58.4353661554566 -34.6501132602333,-58.4354323415164 -34.6499430586606,-58.4354506816437 -34.6498881315286,-58.435660395498 -34.6499212777995,-58.4357472369683 -34.6499120009703,-58.4355464270489 -34.6494913099345,-58.4353560051681 -34.6491030162154,-58.4353204006853 -34.6490518094944)))";;"3553";7_18_11;COMUNA 7;"18";"11";"1325";"685";"640";"107,03%";"223";"223";"100,00%";"0";"0,00%";"403";"143";"35.48";"260";"64,52%";"35.48";35.480
"MULTIPOLYGON (((-58.4305172832411 -34.6498100960128,-58.4304299086964 -34.6498743002079,-58.430846751902 -34.6502261809506,-58.4309830594401 -34.6503412903597,-58.4313108937624 -34.6503571503102,-58.4311141834386 -34.650193503052,-58.4322921103798 -34.6491998992767,-58.4325663961875 -34.6492903926319,-58.4331305343816 -34.6493165878574,-58.4331549870194 -34.6493310308401,-58.433281155994 -34.6494440225011,-58.4333581835956 -34.6494729855954,-58.4334808094464 -34.6494845646843,-58.4335731823657 -34.6494969110987,-58.4335507965825 -34.6499073406573,-58.4335459052087 -34.6504909485823,-58.4339312618028 -34.6505132942948,-58.4339483186239 -34.6502292757022,-58.4339775509416 -34.6502235077697,-58.4339914480734 -34.650205130208,-58.4340039812978 -34.6501878791182,-58.4340179688282 -34.6501544306989,-58.434057011243 -34.6501199317958,-58.4340779102066 -34.6500612025417,-58.4341169426909 -34.6500554368755,-58.4341563444101 -34.6499669223139,-58.4342716818065 -34.6498625799171,-58.4342935102058 -34.6498265980044,-58.4343610240125 -34.649767245727,-58.4346223140753 -34.6494902555605,-58.4347275326205 -34.6494047798596,-58.4343358751433 -34.6490436969052,-58.4338969600572 -34.6486674558716,-58.4334530198604 -34.6482947332647,-58.4334222657042 -34.6482679645085,-58.432967003288 -34.6478744621097,-58.4328401645705 -34.6479735186404,-58.4319619117205 -34.6486750823001,-58.4308162311281 -34.6495901679138,-58.4305894843589 -34.6497570148556,-58.4305172832411 -34.6498100960128)))";;"3554";7_18_9;COMUNA 7;"18";"9";"1203";"594";"609";"97,54%";"274";"274";"100,00%";"0";"0,00%";"377";"160";"42.44";"217";"57,56%";"42.44";42.440
